1.К-сть одержаних бюлетенів,"2.К-сть виборців, внесених до списку","3.К-сть виборців, внесених до витягу для голос. за місцем перебув.",4.К-сть невикор. бюлетенів,"5.К-сть виборців, які отримали бюлетені у приміщ.","6.К-сть виборців, які отримали бюлетені за місцем перебув.","7.Загальна к-сть виборців, які отримали бюлетені","8.К-сть бюлетенів, що не підлягають врахуванню","9.К-сть виборців, які взяли участь у голосуванні","10.К-сть бюлетенів, визнаних недійсними",Зеленський Володимир,Порошенко Петро,Дата та час протоколу,11,0,Vinnitsa
1696,1694,103,602,1004,90,1094,0,1094,16,579,499,22.04.2019 00:30,11,0,Vinnitsa
2128,2095,15,822,1295,11,1306,0,1306,28,751,527,22.04.2019 00:20,11,0,Vinnitsa
1296,1281,4,484,808,4,812,0,812,14,471,327,22.04.2019 01:15,11,0,Vinnitsa
2448,2422,14,933,1504,11,1515,0,1515,37,769,709,22.04.2019 01:30,11,0,Vinnitsa
240,222,0,108,132,0,132,0,132,0,77,55,21.04.2019 22:10,11,0,Vinnitsa
1680,1647,24,610,1046,24,1070,0,1070,22,587,461,22.04.2019 00:30,11,0,Vinnitsa
480,458,2,150,329,1,330,0,330,2,174,154,22.04.2019 01:40,11,0,Vinnitsa
384,373,16,127,241,16,257,0,257,9,149,99,22.04.2019 00:20,11,0,Vinnitsa
688,679,36,204,451,33,484,0,484,13,235,236,22.04.2019 00:04,11,0,Vinnitsa
304,291,27,111,166,27,193,0,193,2,105,86,22.04.2019 00:20,11,0,Vinnitsa
400,386,19,139,244,17,261,0,261,4,143,114,22.04.2019 00:05,11,0,Vinnitsa
304,301,14,101,189,14,203,0,203,4,95,104,22.04.2019 00:10,11,0,Vinnitsa
1376,1355,32,470,878,28,906,0,906,16,470,420,22.04.2019 00:10,11,0,Vinnitsa
1792,1766,59,666,1080,46,1126,0,1126,30,541,555,22.04.2019 00:03,11,0,Vinnitsa
544,535,52,203,291,50,341,0,341,12,132,197,22.04.2019 00:30,11,0,Vinnitsa
752,745,12,329,411,12,423,0,423,10,228,185,22.04.2019 00:30,11,0,Vinnitsa
144,132,1,49,95,0,95,0,95,0,51,44,22.04.2019 00:35,11,0,Vinnitsa
2512,2473,15,949,1552,11,1563,0,1563,23,836,704,22.04.2019 00:40,11,0,Vinnitsa
384,390,2,108,274,2,276,0,276,9,148,119,22.04.2019 00:01,11,0,Vinnitsa
479,160,45,384,62,33,95,0,95,4,54,37,21.04.2019 22:10,11,0,Vinnitsa
432,78,7,354,71,7,78,0,78,4,54,20,22.04.2019 00:25,11,0,Vinnitsa
1120,485,38,636,446,38,484,0,484,26,412,46,22.04.2019 00:02,11,0,Vinnitsa
2320,2391,8,737,1577,6,1583,0,1583,44,890,649,22.04.2019 00:50,11,0,Vinnitsa
2080,2046,9,667,1406,7,1413,0,1413,43,736,634,22.04.2019 00:30,11,0,Vinnitsa
2192,2166,5,685,1502,5,1507,0,1507,40,792,675,22.04.2019 02:10,11,0,Vinnitsa
1888,1877,14,705,1169,14,1183,0,1183,37,691,455,22.04.2019 01:20,11,0,Vinnitsa
1984,1972,9,754,1223,7,1230,0,1230,33,744,453,22.04.2019 00:27,11,0,Vinnitsa
1552,1530,2,542,1008,2,1010,0,1010,28,546,435,22.04.2019 00:15,11,0,Vinnitsa
2032,2024,20,707,1308,17,1325,0,1325,44,719,562,22.04.2019 00:15,11,0,Vinnitsa
2032,2013,17,717,1302,13,1315,0,1315,32,785,498,22.04.2019 00:30,11,0,Vinnitsa
224,214,35,38,156,30,186,0,186,17,96,73,22.04.2019 00:35,11,0,Vinnitsa
2144,2115,12,704,1430,10,1440,0,1440,56,793,591,22.04.2019 00:35,11,0,Vinnitsa
2304,2263,27,847,1434,23,1457,0,1457,26,857,574,22.04.2019 00:30,11,0,Vinnitsa
1872,1833,22,645,1212,15,1227,0,1227,37,671,519,22.04.2019 00:25,11,0,Vinnitsa
1952,1917,9,665,1280,7,1287,0,1287,32,677,578,22.04.2019 01:20,11,0,Vinnitsa
1984,1962,14,652,1318,14,1332,0,1332,49,754,529,22.04.2019 00:05,11,0,Vinnitsa
2142,2124,6,638,1498,6,1504,0,1504,49,821,634,22.04.2019 00:20,11,0,Vinnitsa
2256,2231,8,895,1356,5,1361,0,1361,39,735,587,22.04.2019 00:30,11,0,Vinnitsa
1856,1914,6,690,1162,4,1166,0,1166,40,647,479,22.04.2019 00:30,11,0,Vinnitsa
1488,1513,24,484,983,21,1004,0,1004,34,532,438,22.04.2019 00:51,11,0,Vinnitsa
2080,2063,4,730,1346,4,1350,0,1350,45,765,540,22.04.2019 00:10,11,0,Vinnitsa
2080,2043,7,677,1398,5,1403,0,1403,53,777,573,22.04.2019 01:10,11,0,Vinnitsa
1344,1364,0,452,892,0,892,0,892,15,597,280,22.04.2019 00:30,11,0,Vinnitsa
2128,2118,23,721,1385,22,1407,0,1407,47,813,547,22.04.2019 01:30,11,0,Vinnitsa
1504,1486,14,454,1037,13,1050,0,1050,61,585,404,22.04.2019 00:05,11,0,Vinnitsa
1824,1823,9,673,1143,8,1151,0,1151,43,690,418,22.04.2019 01:30,11,0,Vinnitsa
1728,1711,10,658,1063,7,1070,0,1070,21,616,433,22.04.2019 00:15,11,0,Vinnitsa
2032,2019,6,699,1327,6,1333,0,1333,51,749,533,22.04.2019 00:38,11,0,Vinnitsa
2016,2009,40,664,1312,40,1352,0,1352,36,861,455,22.04.2019 02:15,11,0,Vinnitsa
128,39,19,89,21,18,39,0,39,2,23,14,22.04.2019 00:04,11,0,Vinnitsa
96,63,0,34,62,0,62,0,62,4,43,15,22.04.2019 00:10,11,0,Vinnitsa
272,44,7,229,37,6,43,0,43,1,25,17,22.04.2019 00:03,11,0,Vinnitsa
464,56,0,422,42,0,42,0,42,1,31,10,22.04.2019 00:06,11,0,Vinnitsa
1040,503,73,616,366,58,424,0,424,37,241,146,21.04.2019 23:40,11,0,Vinnitsa
240,94,12,152,78,10,88,0,88,0,47,41,22.04.2019 00:10,11,0,Vinnitsa
144,33,0,112,32,0,32,0,32,0,23,9,22.04.2019 00:20,11,0,Vinnitsa
736,196,153,555,41,140,181,0,181,6,111,64,22.04.2019 00:05,11,0,Vinnitsa
128,12,0,116,12,0,12,0,12,0,6,6,22.04.2019 00:05,11,0,Vinnitsa
64,20,1,45,18,1,19,0,19,0,11,8,22.04.2019 00:05,11,0,Vinnitsa
320,43,13,277,30,13,43,0,43,0,28,15,22.04.2019 00:20,11,0,Vinnitsa
352,348,1,107,245,0,245,0,245,5,128,112,22.04.2019 00:05,11,0,Vinnitsa
720,720,11,6,703,11,714,0,714,60,574,80,22.04.2019 00:30,12,0,Vinnitsa
704,698,24,287,397,20,417,0,417,24,267,126,22.04.2019 00:15,12,0,Vinnitsa
2000,1971,175,704,1122,174,1296,0,1296,34,689,573,22.04.2019 00:15,12,0,Vinnitsa
1264,1245,33,462,769,33,802,0,802,15,491,296,22.04.2019 00:30,12,0,Vinnitsa
976,976,12,365,599,12,611,0,611,16,396,199,22.04.2019 00:50,12,0,Vinnitsa
1040,1031,5,340,695,5,700,0,700,8,351,341,22.04.2019 00:10,12,0,Vinnitsa
688,679,65,206,419,63,482,0,482,8,222,252,22.04.2019 00:20,12,0,Vinnitsa
2400,2371,35,931,1437,32,1469,0,1469,32,859,578,22.04.2019 00:15,12,0,Vinnitsa
2160,2127,33,786,1344,30,1374,0,1374,38,783,553,22.04.2019 00:02,12,0,Vinnitsa
2544,2518,16,1001,1531,12,1543,0,1543,34,839,670,22.04.2019 00:25,12,0,Vinnitsa
1376,1360,108,369,899,108,1007,0,1007,15,456,536,22.04.2019 00:05,12,0,Vinnitsa
608,593,20,187,405,16,421,0,421,4,269,148,22.04.2019 00:10,12,0,Vinnitsa
400,396,48,130,225,45,270,0,270,2,161,107,22.04.2019 00:15,12,0,Vinnitsa
480,474,25,183,274,23,297,0,297,10,142,145,22.04.2019 00:05,12,0,Vinnitsa
160,152,11,65,86,9,95,0,95,0,47,48,21.04.2019 21:30,12,0,Vinnitsa
432,426,14,150,271,11,282,0,282,8,164,110,22.04.2019 00:10,12,0,Vinnitsa
224,209,10,77,138,9,147,0,147,4,78,65,22.04.2019 00:10,12,0,Vinnitsa
880,875,60,327,506,47,553,0,553,7,331,215,22.04.2019 00:18,12,0,Vinnitsa
560,550,20,189,358,13,371,0,371,7,207,157,22.04.2019 00:05,12,0,Vinnitsa
1744,1731,44,622,1084,38,1122,0,1122,17,681,424,21.04.2019 23:25,12,0,Vinnitsa
1728,1706,53,724,968,36,1004,0,1004,28,543,433,22.04.2019 00:20,12,0,Vinnitsa
304,301,32,109,165,30,195,0,195,7,124,64,22.04.2019 00:15,12,0,Vinnitsa
544,539,20,197,328,19,347,0,347,6,175,166,22.04.2019 00:14,12,0,Vinnitsa
1280,1257,92,410,784,86,870,0,870,19,441,410,22.04.2019 00:05,12,0,Vinnitsa
320,303,7,141,172,7,179,0,179,2,109,68,22.04.2019 00:15,12,0,Vinnitsa
416,405,12,165,239,12,251,0,251,8,144,99,22.04.2019 00:10,12,0,Vinnitsa
400,389,17,137,246,17,263,0,263,6,153,104,22.04.2019 00:05,12,0,Vinnitsa
960,953,65,321,579,60,639,0,639,11,383,245,22.04.2019 00:20,12,0,Vinnitsa
1200,1196,35,390,775,35,810,0,810,15,505,290,22.04.2019 00:05,12,0,Vinnitsa
1120,1104,44,406,674,40,714,0,714,16,391,307,22.04.2019 00:03,12,0,Vinnitsa
528,534,30,124,375,29,404,0,404,7,200,197,22.04.2019 00:21,12,0,Vinnitsa
240,236,7,47,186,7,193,0,193,6,102,85,22.04.2019 00:15,12,0,Vinnitsa
656,646,16,242,402,12,414,0,414,7,231,176,22.04.2019 00:15,12,0,Vinnitsa
400,393,34,112,255,33,288,0,288,2,157,129,22.04.2019 00:06,12,0,Vinnitsa
304,291,17,133,156,15,171,0,171,5,119,47,22.04.2019 00:02,12,0,Vinnitsa
976,967,48,379,555,42,597,0,597,17,406,174,22.04.2019 00:02,12,0,Vinnitsa
1872,1851,74,730,1071,71,1142,0,1142,7,667,468,22.04.2019 00:40,12,0,Vinnitsa
1088,1064,52,374,665,49,714,0,714,14,419,281,22.04.2019 00:15,12,0,Vinnitsa
880,863,69,336,488,56,544,0,544,11,320,213,22.04.2019 00:45,12,0,Vinnitsa
496,481,30,178,291,27,318,0,318,14,188,116,21.04.2019 21:50,12,0,Vinnitsa
1664,1665,8,563,1094,7,1101,0,1101,30,646,425,22.04.2019 00:05,12,0,Vinnitsa
2288,2252,8,820,1462,6,1468,0,1468,50,860,558,22.04.2019 00:30,12,0,Vinnitsa
2016,2005,16,667,1338,11,1349,0,1349,35,767,547,22.04.2019 00:20,12,0,Vinnitsa
1792,1772,10,631,1151,10,1161,0,1161,36,687,438,22.04.2019 00:06,12,0,Vinnitsa
1344,1356,4,449,891,4,895,0,895,17,476,402,22.04.2019 00:15,12,0,Vinnitsa
1760,1703,1,725,1034,1,1035,0,1035,28,518,489,22.04.2019 00:15,12,0,Vinnitsa
1936,1907,19,632,1288,16,1304,0,1304,33,751,520,22.04.2019 00:15,12,0,Vinnitsa
2224,2193,9,1006,1209,9,1218,0,1218,34,687,497,22.04.2019 00:40,12,0,Vinnitsa
1936,1921,5,735,1197,4,1201,0,1201,39,666,496,22.04.2019 00:45,12,0,Vinnitsa
2112,2085,8,919,1185,8,1193,0,1193,25,659,509,22.04.2019 00:17,12,0,Vinnitsa
2208,2193,9,811,1390,7,1397,0,1397,53,783,561,22.04.2019 01:20,12,0,Vinnitsa
2240,2217,15,779,1447,14,1461,0,1461,45,750,666,22.04.2019 00:30,12,0,Vinnitsa
2080,2031,3,732,1345,3,1348,0,1348,33,622,693,22.04.2019 00:20,12,0,Vinnitsa
2128,2104,22,851,1260,17,1277,0,1277,29,750,498,22.04.2019 00:10,12,0,Vinnitsa
1664,1653,14,602,1051,11,1062,0,1062,38,592,432,22.04.2019 00:32,12,0,Vinnitsa
2352,2333,15,887,1454,11,1465,0,1465,47,803,615,22.04.2019 00:03,12,0,Vinnitsa
2448,2464,13,905,1533,10,1543,0,1543,52,860,631,22.04.2019 00:10,12,0,Vinnitsa
2176,2158,13,758,1409,9,1418,0,1418,41,860,517,22.04.2019 00:50,12,0,Vinnitsa
2192,2163,7,1054,1131,7,1138,0,1138,23,639,476,22.04.2019 00:20,12,0,Vinnitsa
2288,2276,15,879,1399,10,1409,0,1409,42,778,589,22.04.2019 00:45,12,0,Vinnitsa
2112,2078,3,909,1200,3,1203,0,1203,29,632,542,22.04.2019 01:05,12,0,Vinnitsa
1568,1555,6,602,961,5,966,0,966,26,520,420,22.04.2019 00:10,12,0,Vinnitsa
832,827,2,346,484,2,486,0,486,12,271,203,22.04.2019 00:10,12,0,Vinnitsa
2400,2367,11,907,1485,8,1493,0,1493,55,886,552,22.04.2019 01:40,12,0,Vinnitsa
1680,1650,5,632,1045,3,1048,0,1048,28,543,477,22.04.2019 00:40,12,0,Vinnitsa
2352,2308,4,838,1510,4,1514,0,1514,33,831,650,22.04.2019 00:10,12,0,Vinnitsa
2368,2350,15,894,1465,9,1474,0,1474,32,902,540,22.04.2019 03:01,12,0,Vinnitsa
2144,2105,10,900,1236,8,1244,0,1244,43,699,502,22.04.2019 00:12,12,0,Vinnitsa
2000,1986,14,729,1264,7,1271,0,1271,38,756,477,22.04.2019 00:50,12,0,Vinnitsa
1872,1849,11,710,1158,4,1162,0,1162,28,675,459,22.04.2019 00:25,12,0,Vinnitsa
2112,2093,13,707,1400,5,1405,0,1405,46,820,539,22.04.2019 00:10,12,0,Vinnitsa
2400,2381,14,948,1443,9,1452,0,1452,39,856,557,21.04.2019 22:31,12,0,Vinnitsa
2144,2106,17,788,1342,14,1356,0,1356,45,781,530,22.04.2019 00:15,12,0,Vinnitsa
2080,2049,13,902,1166,12,1178,0,1178,38,664,476,22.04.2019 01:00,12,0,Vinnitsa
2448,2419,19,984,1450,14,1464,0,1464,48,826,590,22.04.2019 00:30,12,0,Vinnitsa
2016,2001,6,773,1239,4,1243,0,1243,40,664,539,22.04.2019 01:20,12,0,Vinnitsa
2368,2332,11,985,1373,10,1383,0,1383,26,799,558,22.04.2019 01:50,12,0,Vinnitsa
2112,2070,8,768,1338,6,1344,0,1344,36,737,571,22.04.2019 00:30,12,0,Vinnitsa
2096,2082,12,753,1334,9,1343,0,1343,42,777,524,22.04.2019 00:05,12,0,Vinnitsa
2624,2537,17,1110,1497,17,1514,0,1514,40,850,624,22.04.2019 00:01,12,0,Vinnitsa
2352,2320,7,960,1387,5,1392,0,1392,34,781,577,22.04.2019 00:20,12,0,Vinnitsa
2304,2264,19,968,1320,16,1336,0,1336,40,730,566,22.04.2019 00:56,12,0,Vinnitsa
2192,2175,14,807,1373,12,1385,0,1385,37,761,587,22.04.2019 00:10,12,0,Vinnitsa
2256,2193,8,908,1344,4,1348,0,1348,29,862,457,22.04.2019 00:40,12,0,Vinnitsa
2336,2298,7,891,1440,5,1445,0,1445,33,809,603,22.04.2019 00:30,12,0,Vinnitsa
336,159,65,200,88,48,136,0,136,2,93,41,22.04.2019 00:15,12,0,Vinnitsa
96,46,17,51,29,16,45,0,45,2,27,16,22.04.2019 00:05,12,0,Vinnitsa
96,13,1,83,12,1,13,0,13,0,8,5,22.04.2019 00:15,12,0,Vinnitsa
176,72,63,109,9,58,67,0,67,3,38,26,22.04.2019 00:10,12,0,Vinnitsa
208,16,0,192,16,0,16,0,16,0,9,7,22.04.2019 00:15,12,0,Vinnitsa
464,382,318,94,52,318,370,0,370,38,275,57,22.04.2019 00:40,12,0,Vinnitsa
848,452,0,427,421,0,421,0,421,10,356,55,22.04.2019 00:07,12,0,Vinnitsa
2128,2081,10,772,1349,7,1356,0,1356,40,782,534,22.04.2019 01:15,12,0,Vinnitsa
2368,2325,13,716,1640,12,1652,0,1652,55,950,647,22.04.2019 00:20,12,0,Vinnitsa
400,396,23,85,295,20,315,0,315,2,140,173,21.04.2019 20:35,13,0,Vinnitsa
384,374,33,137,217,30,247,0,247,2,127,118,21.04.2019 23:00,13,0,Vinnitsa
960,955,44,328,589,43,632,0,632,11,383,238,21.04.2019 21:40,13,0,Vinnitsa
48,42,7,14,28,6,34,0,34,0,26,8,21.04.2019 21:31,13,0,Vinnitsa
208,197,19,75,115,18,133,0,133,2,92,39,21.04.2019 21:10,13,0,Vinnitsa
560,551,33,182,345,33,378,0,378,10,278,90,22.04.2019 00:07,13,0,Vinnitsa
1696,1789,70,563,1072,61,1133,0,1133,34,514,585,22.04.2019 00:40,13,0,Vinnitsa
240,234,19,94,129,17,146,0,146,0,66,80,21.04.2019 21:43,13,0,Vinnitsa
624,607,64,191,372,61,433,0,433,7,218,208,21.04.2019 20:48,13,0,Vinnitsa
496,488,50,189,268,39,307,0,307,9,202,96,21.04.2019 21:22,13,0,Vinnitsa
400,389,36,114,256,30,286,0,286,9,96,181,21.04.2019 21:10,13,0,Vinnitsa
544,526,60,200,292,52,344,0,344,3,231,110,21.04.2019 20:45,13,0,Vinnitsa
1568,1548,50,708,810,50,860,0,860,16,530,314,21.04.2019 22:06,13,0,Vinnitsa
1664,1648,43,787,837,40,877,0,877,9,546,322,22.04.2019 00:14,13,0,Vinnitsa
544,534,42,226,280,38,318,0,318,7,171,140,21.04.2019 23:11,13,0,Vinnitsa
400,392,45,157,202,41,243,0,243,7,130,106,21.04.2019 23:50,13,0,Vinnitsa
320,296,21,127,173,20,193,0,193,1,105,87,22.04.2019 00:15,13,0,Vinnitsa
112,109,11,31,72,9,81,0,81,1,43,37,22.04.2019 00:05,13,0,Vinnitsa
2096,2065,40,925,1135,36,1171,0,1171,32,709,430,22.04.2019 02:10,13,0,Vinnitsa
464,457,8,177,280,7,287,0,287,7,189,91,22.04.2019 00:15,13,0,Vinnitsa
928,920,51,299,579,50,629,0,629,17,373,239,21.04.2019 21:20,13,0,Vinnitsa
480,475,31,156,300,24,324,0,324,5,173,146,21.04.2019 22:18,13,0,Vinnitsa
304,302,28,131,152,21,173,0,173,1,120,52,21.04.2019 21:00,13,0,Vinnitsa
448,437,24,168,256,24,280,0,280,5,188,87,21.04.2019 20:48,13,0,Vinnitsa
256,250,28,74,154,28,182,0,182,3,101,78,21.04.2019 22:17,13,0,Vinnitsa
240,246,38,50,153,37,190,0,190,3,111,76,21.04.2019 21:45,13,0,Vinnitsa
928,913,78,380,477,71,548,0,548,11,260,277,22.04.2019 00:15,13,0,Vinnitsa
544,535,86,197,271,76,347,0,347,2,211,134,21.04.2019 22:10,13,0,Vinnitsa
496,489,51,190,261,45,306,0,306,5,150,151,21.04.2019 20:50,13,0,Vinnitsa
112,112,14,32,68,12,80,0,80,1,39,40,21.04.2019 20:45,13,0,Vinnitsa
272,267,25,99,153,20,173,0,173,3,101,69,21.04.2019 21:50,13,0,Vinnitsa
176,165,14,55,109,12,121,0,121,0,72,49,21.04.2019 20:47,13,0,Vinnitsa
784,778,80,336,375,73,448,0,448,13,283,152,22.04.2019 00:01,13,0,Vinnitsa
768,744,100,177,493,98,591,0,591,9,354,228,22.04.2019 00:12,13,0,Vinnitsa
528,509,78,110,344,74,418,0,418,10,271,137,21.04.2019 20:30,13,0,Vinnitsa
320,304,48,76,204,40,244,0,244,1,156,87,21.04.2019 21:10,13,0,Vinnitsa
1504,1485,49,514,947,43,990,0,990,20,539,431,22.04.2019 01:15,13,0,Vinnitsa
1392,1367,45,557,798,37,835,0,835,13,448,374,21.04.2019 21:15,13,0,Vinnitsa
624,604,25,141,458,25,483,0,483,10,281,192,21.04.2019 21:30,13,0,Vinnitsa
832,824,53,313,472,47,519,0,519,8,343,168,21.04.2019 22:00,13,0,Vinnitsa
1504,1501,47,607,859,38,897,0,897,18,461,418,21.04.2019 22:35,13,0,Vinnitsa
656,628,23,292,346,18,364,0,364,8,267,89,21.04.2019 21:45,13,0,Vinnitsa
288,282,32,121,139,28,167,0,167,4,78,85,21.04.2019 22:30,13,0,Vinnitsa
208,199,9,90,111,7,118,0,118,3,72,43,22.04.2019 00:57,13,0,Vinnitsa
432,416,26,162,244,26,270,0,270,5,145,120,21.04.2019 21:20,13,0,Vinnitsa
240,237,21,92,131,17,148,0,148,1,80,67,21.04.2019 20:37,13,0,Vinnitsa
208,198,19,81,110,17,127,0,127,2,80,45,21.04.2019 20:40,13,0,Vinnitsa
1024,1019,64,355,613,56,669,0,669,18,400,251,22.04.2019 00:35,13,0,Vinnitsa
2240,2182,44,797,1400,43,1443,0,1443,22,910,511,21.04.2019 22:00,13,0,Vinnitsa
1840,1824,26,714,1108,18,1126,0,1126,40,637,449,22.04.2019 00:35,13,0,Vinnitsa
2336,2287,13,847,1480,9,1489,0,1489,32,795,662,21.04.2019 23:50,13,0,Vinnitsa
1568,1559,20,594,956,18,974,0,974,27,525,422,22.04.2019 00:20,13,0,Vinnitsa
1904,1903,39,649,1224,31,1255,0,1255,28,641,586,22.04.2019 00:10,13,0,Vinnitsa
1664,1640,13,646,1006,12,1018,0,1018,29,539,450,22.04.2019 00:15,13,0,Vinnitsa
1744,1708,31,591,1125,28,1153,0,1153,30,682,441,21.04.2019 22:00,13,0,Vinnitsa
208,192,0,91,117,0,117,0,117,2,78,37,21.04.2019 22:05,13,0,Vinnitsa
320,312,14,141,168,11,179,0,179,3,114,62,21.04.2019 21:30,13,0,Vinnitsa
2304,2309,25,823,1462,19,1481,0,1481,32,866,583,21.04.2019 23:40,13,0,Vinnitsa
272,103,21,186,67,19,86,0,86,1,57,28,21.04.2019 20:45,13,0,Vinnitsa
480,459,35,149,300,31,331,0,331,4,188,139,21.04.2019 23:05,13,0,Vinnitsa
224,207,4,103,117,4,121,0,121,3,71,47,21.04.2019 20:40,13,0,Vinnitsa
176,165,18,65,94,17,111,0,111,5,66,40,21.04.2019 23:05,13,0,Vinnitsa
80,77,1,28,51,1,52,0,52,0,27,25,22.04.2019 00:23,13,0,Vinnitsa
80,79,6,15,60,5,65,0,65,0,31,34,21.04.2019 21:00,13,0,Vinnitsa
496,482,36,192,270,34,304,0,304,5,194,105,21.04.2019 23:50,13,0,Vinnitsa
144,138,7,49,88,7,95,0,95,4,57,34,21.04.2019 23:00,13,0,Vinnitsa
896,877,24,440,434,22,456,0,456,7,258,191,22.04.2019 00:10,13,0,Vinnitsa
1024,1001,19,438,571,15,586,0,586,15,303,268,22.04.2019 00:30,13,0,Vinnitsa
528,520,36,216,278,34,312,0,312,6,226,80,21.04.2019 22:02,13,0,Vinnitsa
192,187,5,72,115,5,120,0,120,3,74,43,21.04.2019 21:10,13,0,Vinnitsa
288,270,27,61,200,27,227,0,227,0,137,90,22.04.2019 04:30,13,0,Vinnitsa
544,534,70,185,291,68,359,0,359,8,215,136,22.04.2019 00:15,13,0,Vinnitsa
1568,1542,60,688,827,53,880,0,880,15,655,210,22.04.2019 00:50,13,0,Vinnitsa
1264,1242,43,526,703,35,738,0,738,9,548,181,22.04.2019 00:10,13,0,Vinnitsa
1056,1023,53,472,544,40,584,0,584,7,392,185,21.04.2019 22:20,13,0,Vinnitsa
512,495,9,208,295,9,304,0,304,6,234,64,22.04.2019 05:25,13,0,Vinnitsa
560,556,8,289,266,5,271,0,271,2,173,96,21.04.2019 20:50,13,0,Vinnitsa
1376,1355,37,489,850,37,887,0,887,16,516,355,21.04.2019 21:00,13,0,Vinnitsa
608,589,10,254,346,8,354,0,354,0,201,153,21.04.2019 21:00,13,0,Vinnitsa
224,225,20,63,141,20,161,0,161,0,98,63,21.04.2019 22:00,13,0,Vinnitsa
224,208,17,75,132,17,149,0,149,2,86,61,22.04.2019 00:05,13,0,Vinnitsa
80,73,18,13,49,18,67,0,67,3,34,30,21.04.2019 21:25,13,0,Vinnitsa
192,183,2,68,122,2,124,0,124,3,67,54,21.04.2019 21:20,13,0,Vinnitsa
688,673,47,279,368,41,409,0,409,7,271,131,21.04.2019 22:25,13,0,Vinnitsa
432,418,36,119,277,36,313,0,313,7,216,90,22.04.2019 01:10,13,0,Vinnitsa
400,385,19,176,205,19,224,0,224,5,144,75,21.04.2019 21:03,13,0,Vinnitsa
144,139,1,64,79,1,80,0,80,1,51,28,21.04.2019 21:30,13,0,Vinnitsa
480,469,31,215,238,27,265,0,265,1,195,69,21.04.2019 20:30,13,0,Vinnitsa
256,253,13,96,151,9,160,0,160,2,91,67,21.04.2019 21:00,13,0,Vinnitsa
64,53,11,28,25,11,36,0,36,0,20,16,21.04.2019 20:40,13,0,Vinnitsa
240,224,24,84,133,23,156,0,156,2,104,50,21.04.2019 21:00,13,0,Vinnitsa
64,59,6,26,34,4,38,0,38,2,16,20,21.04.2019 21:20,13,0,Vinnitsa
112,109,16,27,69,16,85,0,85,0,36,49,22.04.2019 00:15,13,0,Vinnitsa
256,254,31,86,143,27,170,0,170,2,120,48,21.04.2019 20:36,13,0,Vinnitsa
400,392,42,143,220,37,257,0,257,4,131,122,21.04.2019 21:50,13,0,Vinnitsa
32,33,1,9,22,1,23,0,23,1,11,11,22.04.2019 02:50,13,0,Vinnitsa
624,608,69,234,321,69,390,0,390,7,227,156,21.04.2019 23:30,13,0,Vinnitsa
208,193,4,88,116,4,120,0,120,1,73,46,21.04.2019 20:50,13,0,Vinnitsa
400,394,37,153,210,37,247,0,247,4,164,79,21.04.2019 20:25,13,0,Vinnitsa
304,294,33,90,181,33,214,0,214,2,135,77,22.04.2019 00:15,13,0,Vinnitsa
448,431,20,176,252,20,272,0,272,6,203,63,21.04.2019 21:00,13,0,Vinnitsa
336,326,20,106,211,19,230,0,230,3,142,85,22.04.2019 01:20,13,0,Vinnitsa
384,375,23,109,253,22,275,0,275,4,169,102,21.04.2019 21:00,13,0,Vinnitsa
384,378,33,165,193,26,219,0,219,6,148,65,21.04.2019 20:40,13,0,Vinnitsa
816,796,30,395,395,26,421,0,421,8,248,165,21.04.2019 21:15,13,0,Vinnitsa
2416,2378,40,1013,1373,30,1403,0,1403,31,984,388,22.04.2019 01:50,13,0,Vinnitsa
512,500,8,225,280,7,287,0,287,14,213,60,22.04.2019 00:10,13,0,Vinnitsa
544,527,27,244,273,27,300,0,300,5,237,58,22.04.2019 06:20,13,0,Vinnitsa
960,942,79,331,553,76,629,0,629,18,444,167,22.04.2019 01:35,13,0,Vinnitsa
176,169,11,44,123,9,132,0,132,0,78,54,22.04.2019 02:05,13,0,Vinnitsa
224,219,11,58,155,11,166,0,166,2,136,28,21.04.2019 20:39,13,0,Vinnitsa
80,69,4,21,55,4,59,0,59,0,40,19,21.04.2019 21:30,13,0,Vinnitsa
464,459,21,100,343,21,364,0,364,4,285,75,21.04.2019 21:15,13,0,Vinnitsa
752,748,6,361,385,6,391,0,391,2,282,107,22.04.2019 00:05,13,0,Vinnitsa
432,424,29,168,237,27,264,0,264,5,159,100,21.04.2019 21:36,13,0,Vinnitsa
96,88,9,44,44,8,52,0,52,0,38,14,21.04.2019 20:35,13,0,Vinnitsa
208,205,15,88,105,15,120,0,120,4,83,33,21.04.2019 20:10,13,0,Vinnitsa
384,384,18,164,205,15,220,0,220,3,132,85,21.04.2019 21:40,13,0,Vinnitsa
528,522,35,199,294,35,329,0,329,5,212,112,22.04.2019 00:05,13,0,Vinnitsa
304,293,15,121,169,14,183,0,183,6,135,42,21.04.2019 20:56,13,0,Vinnitsa
112,107,9,34,69,9,78,0,78,3,55,20,21.04.2019 21:12,13,0,Vinnitsa
1392,1379,88,579,738,75,813,0,813,24,452,337,22.04.2019 00:25,13,0,Vinnitsa
80,88,2,35,43,2,45,0,45,1,32,12,21.04.2019 20:30,13,0,Vinnitsa
96,82,2,45,49,2,51,0,51,0,30,21,21.04.2019 23:07,13,0,Vinnitsa
192,191,12,72,110,10,120,0,120,4,75,41,22.04.2019 00:30,13,0,Vinnitsa
736,709,52,423,261,52,313,0,313,3,242,68,21.04.2019 21:10,13,0,Vinnitsa
368,363,30,137,202,29,231,0,231,3,176,52,21.04.2019 21:30,13,0,Vinnitsa
800,779,35,252,513,35,548,0,548,16,382,150,22.04.2019 00:13,13,0,Vinnitsa
448,438,15,206,229,13,242,0,242,6,174,62,22.04.2019 00:02,13,0,Vinnitsa
432,418,29,172,231,29,260,0,260,4,158,98,21.04.2019 23:30,13,0,Vinnitsa
96,82,12,35,49,12,61,0,61,3,36,22,21.04.2019 21:30,13,0,Vinnitsa
64,33,11,31,22,11,33,0,33,0,27,6,21.04.2019 21:55,13,0,Vinnitsa
496,475,38,142,317,37,354,0,354,11,208,135,21.04.2019 21:00,13,0,Vinnitsa
80,73,16,23,42,15,57,0,57,0,34,23,21.04.2019 21:00,13,0,Vinnitsa
160,149,9,58,93,9,102,0,102,0,63,39,21.04.2019 21:00,13,0,Vinnitsa
1024,998,14,402,609,13,622,0,622,15,428,179,22.04.2019 00:20,13,0,Vinnitsa
352,340,19,119,214,19,233,0,233,3,172,58,21.04.2019 20:57,13,0,Vinnitsa
704,692,24,344,336,24,360,0,360,8,266,86,21.04.2019 20:38,13,0,Vinnitsa
288,286,10,115,163,10,173,0,173,0,126,47,21.04.2019 20:15,13,0,Vinnitsa
336,336,22,120,195,21,216,0,216,1,163,52,21.04.2019 20:44,13,0,Vinnitsa
480,474,19,160,301,19,320,0,320,3,154,163,21.04.2019 20:40,13,0,Vinnitsa
64,59,1,25,38,1,39,0,39,0,21,18,21.04.2019 20:55,13,0,Vinnitsa
672,661,46,233,393,46,439,0,439,5,285,149,21.04.2019 21:55,13,0,Vinnitsa
240,220,10,59,171,10,181,0,181,2,120,59,22.04.2019 00:05,13,0,Vinnitsa
1488,1472,41,736,711,41,752,0,752,14,524,214,21.04.2019 22:00,13,0,Vinnitsa
464,461,2,186,277,1,278,0,278,4,204,70,21.04.2019 20:45,13,0,Vinnitsa
960,950,16,459,485,16,501,0,501,9,366,126,22.04.2019 00:15,13,0,Vinnitsa
416,412,19,189,210,17,227,0,227,13,147,67,22.04.2019 03:00,13,0,Vinnitsa
272,263,26,56,195,21,216,0,216,1,52,163,21.04.2019 21:20,13,0,Vinnitsa
352,351,24,87,241,24,265,0,265,0,104,161,21.04.2019 22:40,13,0,Vinnitsa
32,26,0,7,25,0,25,0,25,0,17,8,21.04.2019 20:35,13,0,Vinnitsa
160,151,0,64,96,0,96,0,96,0,77,19,21.04.2019 21:20,13,0,Vinnitsa
144,134,0,50,94,0,94,0,94,1,77,16,21.04.2019 20:35,13,0,Vinnitsa
288,275,29,69,192,27,219,0,219,1,139,79,21.04.2019 21:00,13,0,Vinnitsa
208,203,29,27,152,29,181,0,181,4,97,80,21.04.2019 20:15,13,0,Vinnitsa
208,201,21,61,127,20,147,0,147,2,91,54,21.04.2019 20:45,13,0,Vinnitsa
480,475,49,165,270,45,315,0,315,4,147,164,21.04.2019 21:25,13,0,Vinnitsa
240,235,8,110,122,8,130,0,130,2,66,62,21.04.2019 21:10,13,0,Vinnitsa
208,201,17,64,127,17,144,0,144,6,67,71,21.04.2019 21:00,13,0,Vinnitsa
688,676,10,320,358,10,368,0,368,9,251,108,21.04.2019 22:00,13,0,Vinnitsa
352,341,47,82,223,47,270,0,270,7,95,168,21.04.2019 21:45,13,0,Vinnitsa
160,153,22,49,89,22,111,0,111,0,60,51,21.04.2019 20:25,13,0,Vinnitsa
352,334,18,91,243,18,261,0,261,4,124,133,21.04.2019 21:50,13,0,Vinnitsa
160,164,8,34,118,8,126,0,126,3,69,54,21.04.2019 21:40,13,0,Vinnitsa
224,208,0,63,161,0,161,0,161,3,103,55,21.04.2019 21:00,13,0,Vinnitsa
160,158,0,35,125,0,125,0,125,1,69,55,21.04.2019 21:15,13,0,Vinnitsa
256,248,11,61,184,11,195,0,195,1,132,62,21.04.2019 21:00,13,0,Vinnitsa
448,431,37,158,253,37,290,0,290,1,156,133,21.04.2019 20:30,13,0,Vinnitsa
224,214,14,72,138,14,152,0,152,3,64,85,21.04.2019 22:20,13,0,Vinnitsa
448,450,51,114,286,48,334,0,334,5,192,137,21.04.2019 20:30,13,0,Vinnitsa
192,189,28,70,94,28,122,0,122,6,57,59,21.04.2019 20:40,13,0,Vinnitsa
288,271,18,107,165,16,181,0,181,4,107,70,21.04.2019 21:37,13,0,Vinnitsa
144,128,1,52,91,1,92,0,92,1,53,38,21.04.2019 20:45,13,0,Vinnitsa
96,83,1,46,49,1,50,0,50,1,24,25,21.04.2019 20:20,13,0,Vinnitsa
288,285,16,97,175,16,191,0,191,6,136,49,22.04.2019 05:30,13,0,Vinnitsa
192,175,16,89,87,16,103,0,103,0,44,59,21.04.2019 20:50,13,0,Vinnitsa
192,189,11,84,97,11,108,0,108,2,51,55,21.04.2019 20:32,13,0,Vinnitsa
448,442,18,125,307,16,323,0,323,4,168,151,21.04.2019 20:50,13,0,Vinnitsa
304,301,15,84,205,15,220,0,220,7,135,78,21.04.2019 21:20,13,0,Vinnitsa
512,501,1,169,342,1,343,0,343,4,233,106,21.04.2019 21:30,13,0,Vinnitsa
416,394,36,79,305,32,337,0,337,6,226,105,22.04.2019 00:17,13,0,Vinnitsa
368,361,31,136,201,31,232,0,232,3,103,126,21.04.2019 20:55,13,0,Vinnitsa
304,287,22,138,146,20,166,0,166,3,78,85,21.04.2019 21:10,13,0,Vinnitsa
256,243,32,82,145,29,174,0,174,1,92,81,21.04.2019 20:30,13,0,Vinnitsa
352,340,8,90,254,8,262,0,262,8,182,72,21.04.2019 20:28,13,0,Vinnitsa
368,348,12,102,255,11,266,0,266,1,172,93,21.04.2019 20:30,13,0,Vinnitsa
720,698,70,252,398,70,468,0,468,9,322,137,22.04.2019 00:25,13,0,Vinnitsa
736,716,61,261,414,61,475,0,475,2,321,152,21.04.2019 21:15,13,0,Vinnitsa
176,163,18,71,87,18,105,0,105,1,69,35,21.04.2019 21:45,13,0,Vinnitsa
400,388,27,170,204,26,230,0,230,2,169,59,21.04.2019 22:40,13,0,Vinnitsa
576,569,16,94,467,15,482,0,482,15,354,113,22.04.2019 00:20,13,0,Vinnitsa
240,238,25,43,172,25,197,0,197,2,99,96,21.04.2019 21:20,13,0,Vinnitsa
208,192,19,82,107,19,126,0,126,3,96,27,21.04.2019 20:45,13,0,Vinnitsa
416,398,16,160,240,16,256,0,256,7,130,119,21.04.2019 21:00,13,0,Vinnitsa
240,229,13,74,153,13,166,0,166,0,65,101,21.04.2019 20:45,13,0,Vinnitsa
464,438,16,118,331,15,346,0,346,7,202,137,21.04.2019 20:51,13,0,Vinnitsa
544,525,19,276,250,18,268,0,268,5,181,82,21.04.2019 20:42,13,0,Vinnitsa
1328,1294,49,508,773,47,820,0,820,10,540,270,21.04.2019 21:00,13,0,Vinnitsa
912,898,43,394,478,40,518,0,518,18,319,181,21.04.2019 20:50,13,0,Vinnitsa
464,457,29,88,347,29,376,0,376,6,252,118,21.04.2019 21:10,13,0,Vinnitsa
384,381,30,153,204,27,231,0,231,4,133,94,21.04.2019 21:08,13,0,Vinnitsa
336,322,23,92,224,20,244,0,244,8,95,141,22.04.2019 00:20,13,0,Vinnitsa
128,122,16,39,73,16,89,0,89,0,58,31,21.04.2019 20:30,13,0,Vinnitsa
928,908,12,424,492,12,504,0,504,9,311,184,21.04.2019 23:56,13,0,Vinnitsa
592,573,13,316,263,13,276,0,276,10,183,83,21.04.2019 22:52,13,0,Vinnitsa
64,23,6,41,17,6,23,0,23,0,11,12,21.04.2019 21:21,13,0,Vinnitsa
1984,1979,27,776,1191,17,1208,0,1208,45,882,281,22.04.2019 00:30,13,0,Vinnitsa
1792,1770,12,590,1193,9,1202,0,1202,39,837,326,22.04.2019 00:05,13,0,Vinnitsa
1536,1503,25,595,918,23,941,0,941,27,644,270,22.04.2019 02:05,13,0,Vinnitsa
1728,1700,27,644,1063,21,1084,0,1084,36,740,308,22.04.2019 00:30,13,0,Vinnitsa
1888,1874,29,724,1141,23,1164,0,1164,26,812,326,22.04.2019 00:22,13,0,Vinnitsa
672,667,4,309,360,3,363,0,363,9,251,103,22.04.2019 00:30,13,0,Vinnitsa
1616,1587,24,665,930,21,951,0,951,20,708,223,22.04.2019 00:10,13,0,Vinnitsa
1472,1468,15,573,888,11,899,0,899,24,638,237,22.04.2019 00:25,13,0,Vinnitsa
1120,1101,17,477,627,16,643,0,643,15,483,145,22.04.2019 00:45,13,0,Vinnitsa
1088,1055,14,468,609,11,620,0,620,19,448,153,22.04.2019 05:00,13,0,Vinnitsa
928,914,11,365,555,8,563,0,563,9,425,129,22.04.2019 00:10,13,0,Vinnitsa
640,632,3,227,410,3,413,0,413,7,295,111,22.04.2019 01:05,13,0,Vinnitsa
2224,2185,7,805,1414,5,1419,0,1419,24,1034,361,22.04.2019 02:00,13,0,Vinnitsa
1584,1560,12,640,934,10,944,0,944,26,684,234,22.04.2019 02:15,13,0,Vinnitsa
128,10,0,118,10,0,10,0,10,4,4,2,21.04.2019 20:06,13,0,Vinnitsa
272,26,26,249,0,23,23,0,23,0,15,8,22.04.2019 03:23,13,0,Vinnitsa
2288,2239,22,978,1293,17,1310,0,1310,32,932,346,22.04.2019 00:25,13,0,Vinnitsa
1968,1957,18,742,1215,11,1226,0,1226,45,784,397,22.04.2019 00:30,13,0,Vinnitsa
1840,1808,30,726,1090,24,1114,0,1114,26,728,360,22.04.2019 00:10,13,0,Vinnitsa
2016,1994,33,797,1195,24,1219,0,1219,18,815,386,22.04.2019 00:30,13,0,Vinnitsa
1936,1915,25,729,1189,18,1207,0,1207,32,815,360,22.04.2019 00:10,13,0,Vinnitsa
1984,2026,24,703,1261,20,1281,0,1281,27,850,404,22.04.2019 01:45,13,0,Vinnitsa
1920,1892,13,734,1173,13,1186,0,1186,23,807,356,22.04.2019 00:05,13,0,Vinnitsa
1712,1683,13,670,1030,12,1042,0,1042,38,693,311,22.04.2019 01:35,13,0,Vinnitsa
2032,1995,28,745,1264,23,1287,0,1287,26,846,415,22.04.2019 00:20,13,0,Vinnitsa
1456,1431,21,574,864,18,882,0,882,22,601,259,22.04.2019 00:15,13,0,Vinnitsa
400,396,1,87,312,1,313,0,313,5,201,107,22.04.2019 00:05,13,0,Vinnitsa
224,40,14,194,17,13,30,0,30,0,21,9,21.04.2019 22:40,13,0,Vinnitsa
1520,1498,6,618,896,6,902,0,902,26,561,315,21.04.2019 23:18,14,0,Vinnitsa
2144,2105,4,873,1267,4,1271,0,1271,30,769,472,22.04.2019 01:11,14,0,Vinnitsa
2192,2179,34,971,1187,34,1221,0,1221,24,806,391,22.04.2019 00:20,14,0,Vinnitsa
1504,1484,14,604,889,11,900,0,900,23,576,301,22.04.2019 02:20,14,0,Vinnitsa
1888,1851,3,746,1139,3,1142,0,1142,28,778,336,22.04.2019 02:20,14,0,Vinnitsa
1744,1717,6,690,1049,5,1054,0,1054,29,654,371,21.04.2019 23:00,14,0,Vinnitsa
2176,2133,5,847,1324,5,1329,0,1329,28,809,492,22.04.2019 00:20,14,0,Vinnitsa
2176,2150,10,927,1239,10,1249,0,1249,22,782,445,22.04.2019 02:20,14,0,Vinnitsa
736,722,0,292,444,0,444,0,444,13,271,160,22.04.2019 00:00,14,0,Vinnitsa
704,691,40,299,365,40,405,0,405,10,248,147,22.04.2019 01:10,14,0,Vinnitsa
160,146,8,65,87,8,95,0,95,2,54,39,22.04.2019 01:00,14,0,Vinnitsa
256,252,0,111,145,0,145,0,145,0,97,48,22.04.2019 00:20,14,0,Vinnitsa
144,141,1,39,104,1,105,0,105,0,68,37,22.04.2019 01:00,14,0,Vinnitsa
368,358,23,145,200,23,223,0,223,1,99,123,22.04.2019 02:40,14,0,Vinnitsa
128,120,9,48,71,9,80,0,80,1,54,25,22.04.2019 00:12,14,0,Vinnitsa
672,667,4,188,482,2,484,0,484,9,206,269,22.04.2019 00:20,14,0,Vinnitsa
208,208,0,80,128,0,128,0,128,8,64,56,21.04.2019 22:14,14,0,Vinnitsa
608,599,53,256,301,51,352,0,352,5,240,107,22.04.2019 01:00,14,0,Vinnitsa
656,624,30,245,381,30,411,0,411,9,263,139,22.04.2019 00:30,14,0,Vinnitsa
560,546,46,208,306,46,352,0,352,3,228,121,22.04.2019 04:00,14,0,Vinnitsa
192,174,18,78,97,17,114,0,114,3,80,31,22.04.2019 00:15,14,0,Vinnitsa
768,751,21,354,393,21,414,0,414,9,239,166,22.04.2019 00:20,14,0,Vinnitsa
1072,1059,32,487,557,28,585,0,585,13,373,199,22.04.2019 00:05,14,0,Vinnitsa
592,592,31,229,332,31,363,0,363,13,226,124,21.04.2019 22:00,14,0,Vinnitsa
320,314,13,93,214,13,227,0,227,1,107,119,21.04.2019 22:22,14,0,Vinnitsa
224,206,19,67,138,19,157,0,157,0,105,52,21.04.2019 21:00,14,0,Vinnitsa
160,149,10,64,88,8,96,0,96,0,61,35,21.04.2019 22:40,14,0,Vinnitsa
320,311,14,138,168,14,182,0,182,1,158,23,21.04.2019 22:00,14,0,Vinnitsa
144,138,12,56,76,12,88,0,88,2,61,25,21.04.2019 21:40,14,0,Vinnitsa
560,556,25,252,283,25,308,0,308,17,166,125,21.04.2019 23:40,14,0,Vinnitsa
608,587,20,291,297,20,317,0,317,5,209,103,21.04.2019 21:00,14,0,Vinnitsa
480,471,32,154,294,32,326,0,326,5,167,154,22.04.2019 00:10,14,0,Vinnitsa
992,956,22,482,488,22,510,0,510,5,330,175,21.04.2019 23:00,14,0,Vinnitsa
1296,1256,4,543,749,4,753,0,753,14,467,272,22.04.2019 00:20,14,0,Vinnitsa
304,283,26,117,161,26,187,0,187,0,118,69,21.04.2019 22:58,14,0,Vinnitsa
272,263,18,53,201,18,219,0,219,4,166,49,21.04.2019 23:00,14,0,Vinnitsa
352,340,16,127,210,15,225,0,225,4,168,53,22.04.2019 00:20,14,0,Vinnitsa
144,135,6,51,87,6,93,0,93,2,46,45,21.04.2019 23:00,14,0,Vinnitsa
352,347,2,130,220,2,222,0,222,4,153,65,21.04.2019 22:05,14,0,Vinnitsa
544,533,24,205,315,24,339,0,339,5,232,102,22.04.2019 01:00,14,0,Vinnitsa
224,209,5,89,130,5,135,0,135,3,74,58,21.04.2019 21:30,14,0,Vinnitsa
176,168,25,44,107,25,132,0,132,2,69,61,21.04.2019 22:00,14,0,Vinnitsa
128,119,0,22,106,0,106,0,106,1,58,47,21.04.2019 22:00,14,0,Vinnitsa
1088,1092,63,390,635,63,698,0,698,18,515,165,22.04.2019 03:00,14,0,Vinnitsa
608,596,74,249,289,70,359,0,359,6,227,126,21.04.2019 21:13,14,0,Vinnitsa
320,314,31,34,255,31,286,0,286,2,179,105,21.04.2019 23:00,14,0,Vinnitsa
752,733,10,309,433,10,443,0,443,7,290,146,21.04.2019 23:01,14,0,Vinnitsa
512,501,6,210,296,6,302,0,302,12,224,66,22.04.2019 01:00,14,0,Vinnitsa
176,169,17,46,113,17,130,0,130,2,88,40,21.04.2019 22:25,14,0,Vinnitsa
192,190,14,55,123,14,137,0,137,2,119,16,22.04.2019 00:15,14,0,Vinnitsa
288,270,11,134,143,11,154,0,154,3,108,43,21.04.2019 21:00,14,0,Vinnitsa
128,116,6,46,76,6,82,0,82,4,58,20,22.04.2019 02:20,14,0,Vinnitsa
688,666,62,308,322,58,380,0,380,11,255,114,22.04.2019 01:00,14,0,Vinnitsa
304,289,15,101,188,15,203,0,203,1,133,69,21.04.2019 22:00,14,0,Vinnitsa
368,361,16,156,196,16,212,0,212,3,94,115,22.04.2019 00:50,14,0,Vinnitsa
224,209,23,32,169,23,192,0,192,0,77,115,21.04.2019 21:00,14,0,Vinnitsa
720,708,20,302,398,20,418,0,418,6,235,177,21.04.2019 22:18,14,0,Vinnitsa
544,540,52,180,312,52,364,0,364,4,237,123,21.04.2019 21:21,14,0,Vinnitsa
160,159,36,49,77,34,111,0,111,1,68,42,21.04.2019 21:30,14,0,Vinnitsa
544,526,33,98,413,33,446,0,446,3,263,180,21.04.2019 22:00,14,0,Vinnitsa
320,315,17,67,236,17,253,0,253,3,146,104,21.04.2019 21:00,14,0,Vinnitsa
432,416,41,177,216,39,255,0,255,3,168,84,21.04.2019 23:00,14,0,Vinnitsa
880,868,32,410,438,32,470,0,470,8,321,141,22.04.2019 00:40,14,0,Vinnitsa
480,467,24,221,235,24,259,0,259,6,160,93,22.04.2019 01:30,14,0,Vinnitsa
288,293,25,101,166,21,187,0,187,1,124,62,21.04.2019 23:00,14,0,Vinnitsa
752,733,11,318,423,11,434,0,434,4,273,157,21.04.2019 22:00,14,0,Vinnitsa
368,348,2,145,221,2,223,0,223,9,135,79,21.04.2019 22:55,14,0,Vinnitsa
256,242,10,59,187,10,197,0,197,0,135,62,22.04.2019 00:20,14,0,Vinnitsa
464,451,5,230,229,5,234,0,234,4,151,79,22.04.2019 02:40,14,0,Vinnitsa
240,222,0,116,124,0,124,0,124,1,69,54,22.04.2019 00:20,14,0,Vinnitsa
240,39,11,219,13,8,21,0,21,2,12,7,21.04.2019 21:40,14,0,Vinnitsa
1360,1357,15,600,749,11,760,0,760,18,486,256,21.04.2019 23:00,14,0,Vinnitsa
1168,1199,40,458,673,37,710,0,710,31,406,273,22.04.2019 00:00,14,0,Vinnitsa
1504,1484,71,691,747,66,813,0,813,16,519,278,22.04.2019 00:10,14,0,Vinnitsa
288,303,16,90,183,15,198,0,198,5,128,65,21.04.2019 21:08,14,0,Vinnitsa
464,452,20,120,324,20,344,0,344,7,171,166,21.04.2019 21:40,14,0,Vinnitsa
352,358,27,84,242,26,268,0,268,6,181,81,21.04.2019 21:00,14,0,Vinnitsa
240,234,18,58,164,18,182,0,182,4,121,57,21.04.2019 22:00,14,0,Vinnitsa
528,531,12,87,429,12,441,0,441,8,291,142,21.04.2019 21:00,14,0,Vinnitsa
592,612,37,230,329,33,362,0,362,12,208,142,22.04.2019 00:40,14,0,Vinnitsa
1088,1119,49,405,634,49,683,0,683,20,370,293,22.04.2019 01:40,14,0,Vinnitsa
400,389,38,128,234,38,272,0,272,4,112,156,22.04.2019 00:00,14,0,Vinnitsa
656,687,41,162,453,41,494,0,494,8,294,192,22.04.2019 00:20,14,0,Vinnitsa
272,257,18,94,160,18,178,0,178,5,121,52,21.04.2019 21:00,14,0,Vinnitsa
256,256,18,80,158,18,176,0,176,0,90,86,21.04.2019 21:00,14,0,Vinnitsa
64,60,6,22,36,6,42,0,42,0,22,20,22.04.2019 00:01,14,0,Vinnitsa
448,439,50,166,233,49,282,0,282,3,186,93,21.04.2019 22:00,14,0,Vinnitsa
192,185,23,83,87,22,109,0,109,1,65,43,22.04.2019 00:20,14,0,Vinnitsa
528,510,17,139,372,17,389,0,389,2,211,176,21.04.2019 22:00,14,0,Vinnitsa
96,91,9,30,58,8,66,0,66,0,26,40,21.04.2019 21:00,14,0,Vinnitsa
608,603,56,190,373,45,418,0,418,11,203,204,21.04.2019 22:00,14,0,Vinnitsa
432,450,6,182,245,5,250,0,250,5,160,85,21.04.2019 21:00,14,0,Vinnitsa
96,97,12,25,60,11,71,0,71,0,36,35,21.04.2019 21:25,14,0,Vinnitsa
96,92,5,41,52,3,55,0,55,1,35,19,21.04.2019 21:00,14,0,Vinnitsa
240,228,18,68,154,18,172,0,172,2,114,56,22.04.2019 00:30,14,0,Vinnitsa
208,201,23,44,142,22,164,0,164,3,76,85,21.04.2019 22:50,14,0,Vinnitsa
656,678,7,181,470,5,475,0,475,6,312,157,21.04.2019 23:00,14,0,Vinnitsa
688,665,3,335,350,3,353,0,353,7,290,56,21.04.2019 23:00,14,0,Vinnitsa
240,230,10,81,149,10,159,0,159,2,121,36,21.04.2019 21:18,14,0,Vinnitsa
240,263,12,52,178,10,188,0,188,2,113,73,21.04.2019 22:00,14,0,Vinnitsa
208,207,22,80,111,17,128,0,128,0,63,65,21.04.2019 21:05,14,0,Vinnitsa
480,469,35,207,244,29,273,0,273,4,196,73,21.04.2019 21:00,14,0,Vinnitsa
368,363,35,150,183,35,218,0,218,2,113,103,21.04.2019 21:00,14,0,Vinnitsa
80,64,3,39,38,3,41,0,41,1,23,17,21.04.2019 21:22,14,0,Vinnitsa
336,327,25,95,216,25,241,0,241,7,136,98,22.04.2019 01:00,14,0,Vinnitsa
1072,1033,42,471,559,42,601,0,601,8,397,196,22.04.2019 01:30,14,0,Vinnitsa
832,810,59,270,505,57,562,0,562,11,320,231,22.04.2019 02:00,14,0,Vinnitsa
608,610,42,176,390,42,432,0,432,10,243,179,22.04.2019 01:00,14,0,Vinnitsa
368,364,47,108,224,36,260,0,260,6,160,94,21.04.2019 23:45,14,0,Vinnitsa
176,169,3,70,104,2,106,0,106,0,64,42,22.04.2019 00:02,14,0,Vinnitsa
464,459,35,70,359,35,394,0,394,3,199,192,21.04.2019 21:00,14,0,Vinnitsa
160,149,21,34,105,21,126,0,126,4,76,46,21.04.2019 23:00,14,0,Vinnitsa
528,521,20,182,326,20,346,0,346,4,230,112,21.04.2019 21:25,14,0,Vinnitsa
224,225,20,111,95,18,113,0,113,4,76,33,21.04.2019 21:05,14,0,Vinnitsa
1392,1418,44,606,746,40,786,0,786,14,485,287,22.04.2019 00:00,14,0,Vinnitsa
128,125,10,21,97,10,107,0,107,0,77,30,21.04.2019 21:00,14,0,Vinnitsa
816,795,50,346,421,49,470,0,470,7,327,136,22.04.2019 01:00,14,0,Vinnitsa
384,425,19,126,240,18,258,0,258,1,162,95,21.04.2019 21:30,14,0,Vinnitsa
1072,1080,20,467,585,20,605,0,605,9,463,133,21.04.2019 22:00,14,0,Vinnitsa
1024,1030,24,464,538,22,560,0,560,4,427,129,21.04.2019 22:00,14,0,Vinnitsa
464,442,25,161,279,24,303,0,303,9,171,123,22.04.2019 00:49,14,0,Vinnitsa
176,176,10,44,122,10,132,0,132,4,49,79,21.04.2019 21:01,14,0,Vinnitsa
400,395,46,133,227,40,267,0,267,3,169,95,22.04.2019 00:20,14,0,Vinnitsa
384,375,39,150,195,39,234,0,234,3,184,47,21.04.2019 23:05,14,0,Vinnitsa
192,180,16,69,108,15,123,0,123,4,86,33,21.04.2019 21:20,14,0,Vinnitsa
320,303,28,85,207,28,235,0,235,18,107,110,22.04.2019 00:20,14,0,Vinnitsa
912,896,52,354,509,49,558,0,558,12,385,161,21.04.2019 23:20,14,0,Vinnitsa
160,159,3,46,113,1,114,0,114,4,73,37,21.04.2019 22:00,14,0,Vinnitsa
352,343,42,78,234,40,274,0,274,7,180,87,21.04.2019 21:35,14,0,Vinnitsa
2234,2208,39,801,1399,34,1433,0,1433,49,831,553,22.04.2019 02:20,14,0,Vinnitsa
1376,1359,14,533,829,14,843,0,843,20,560,263,22.04.2019 00:40,14,0,Vinnitsa
2064,2029,30,749,1294,21,1315,0,1315,55,829,431,22.04.2019 01:30,14,0,Vinnitsa
608,601,39,228,342,38,380,0,380,5,206,169,22.04.2019 01:02,14,0,Vinnitsa
656,638,29,278,349,29,378,0,378,3,204,171,22.04.2019 00:55,14,0,Vinnitsa
96,82,9,40,49,7,56,0,56,0,30,26,22.04.2019 00:20,14,0,Vinnitsa
416,405,44,142,234,40,274,0,274,10,165,99,22.04.2019 00:18,14,0,Vinnitsa
160,147,35,73,61,26,87,0,87,1,57,29,22.04.2019 00:00,14,0,Vinnitsa
672,648,61,213,401,58,459,0,459,5,192,262,22.04.2019 00:00,14,0,Vinnitsa
288,282,27,96,169,23,192,0,192,2,107,83,21.04.2019 23:00,14,0,Vinnitsa
256,248,24,99,133,24,157,0,157,5,84,68,22.04.2019 02:00,14,0,Vinnitsa
240,215,22,87,134,19,153,0,153,2,68,83,22.04.2019 00:20,14,0,Vinnitsa
144,140,17,59,70,15,85,0,85,0,31,54,22.04.2019 00:38,14,0,Vinnitsa
64,57,11,30,26,8,34,0,34,0,25,9,21.04.2019 21:10,14,0,Vinnitsa
352,344,25,124,203,25,228,0,228,2,115,111,22.04.2019 00:10,14,0,Vinnitsa
272,252,27,102,147,23,170,0,170,2,92,76,22.04.2019 00:58,14,0,Vinnitsa
816,795,26,283,513,20,533,0,533,7,329,197,22.04.2019 00:50,14,0,Vinnitsa
752,746,30,315,407,30,437,0,437,9,251,177,22.04.2019 01:00,14,0,Vinnitsa
176,161,18,40,118,18,136,0,136,1,56,79,22.04.2019 01:10,14,0,Vinnitsa
544,539,17,135,393,16,409,0,409,8,243,158,22.04.2019 01:05,14,0,Vinnitsa
864,884,90,302,480,82,562,0,562,13,262,287,22.04.2019 02:20,14,0,Vinnitsa
80,75,7,27,47,6,53,0,53,3,21,29,21.04.2019 21:20,14,0,Vinnitsa
880,866,54,351,479,50,529,0,529,8,321,200,22.04.2019 01:00,14,0,Vinnitsa
272,266,42,75,155,42,197,0,197,1,109,87,21.04.2019 22:55,14,0,Vinnitsa
704,701,68,254,389,61,450,0,450,9,233,208,22.04.2019 01:00,14,0,Vinnitsa
304,300,25,93,186,25,211,0,211,4,118,89,21.04.2019 23:00,14,0,Vinnitsa
816,802,54,336,434,46,480,0,480,9,314,157,22.04.2019 02:20,14,0,Vinnitsa
96,88,20,51,28,17,45,0,45,0,28,17,22.04.2019 01:30,14,0,Vinnitsa
288,283,25,82,183,23,206,0,206,2,120,84,21.04.2019 23:05,14,0,Vinnitsa
112,106,16,24,72,16,88,0,88,1,23,64,22.04.2019 00:20,14,0,Vinnitsa
512,494,39,180,295,37,332,0,332,7,174,151,22.04.2019 01:05,14,0,Vinnitsa
80,62,7,38,36,6,42,0,42,0,20,22,22.04.2019 00:20,14,0,Vinnitsa
496,492,53,186,257,53,310,0,310,4,179,127,21.04.2019 22:10,14,0,Vinnitsa
368,350,39,66,265,37,302,0,302,9,169,124,21.04.2019 21:00,14,0,Vinnitsa
112,116,13,20,79,13,92,0,92,1,54,37,21.04.2019 21:25,14,0,Vinnitsa
576,560,14,216,348,12,360,0,360,9,189,162,22.04.2019 00:00,14,0,Vinnitsa
480,470,41,129,313,38,351,0,351,9,174,168,22.04.2019 00:17,14,0,Vinnitsa
224,228,21,58,146,20,166,0,166,6,101,59,22.04.2019 00:00,14,0,Vinnitsa
320,310,43,95,186,39,225,0,225,6,125,94,21.04.2019 21:10,14,0,Vinnitsa
80,76,6,33,41,6,47,0,47,0,17,30,21.04.2019 23:00,14,0,Vinnitsa
288,274,18,100,172,16,188,0,188,5,126,57,22.04.2019 02:20,14,0,Vinnitsa
768,744,80,214,477,77,554,0,554,4,213,337,22.04.2019 02:00,14,0,Vinnitsa
224,222,22,53,149,22,171,0,171,3,71,97,22.04.2019 01:00,14,0,Vinnitsa
400,387,16,157,227,16,243,0,243,2,122,119,22.04.2019 02:20,14,0,Vinnitsa
208,193,22,85,101,22,123,0,123,0,50,73,22.04.2019 00:10,14,0,Vinnitsa
1312,1277,43,541,732,39,771,0,771,20,445,306,22.04.2019 00:20,14,0,Vinnitsa
592,578,72,230,297,65,362,0,361,6,186,169,22.04.2019 02:00,14,0,Vinnitsa
720,705,51,248,429,43,472,0,472,8,279,185,22.04.2019 01:30,14,0,Vinnitsa
832,819,44,279,513,40,553,0,553,8,380,165,22.04.2019 00:20,14,0,Vinnitsa
352,347,9,96,247,9,256,0,256,6,145,105,22.04.2019 00:45,14,0,Vinnitsa
208,190,22,78,113,17,130,0,130,6,67,57,21.04.2019 23:00,14,0,Vinnitsa
208,197,11,76,121,11,132,0,132,5,76,51,21.04.2019 23:00,14,0,Vinnitsa
112,103,14,41,58,13,71,0,71,2,33,36,21.04.2019 23:00,14,0,Vinnitsa
64,56,5,22,38,4,42,0,42,1,20,21,21.04.2019 22:40,14,0,Vinnitsa
800,787,55,351,395,54,449,0,449,5,296,148,22.04.2019 02:00,14,0,Vinnitsa
640,612,30,300,312,28,340,0,340,9,236,95,22.04.2019 00:10,14,0,Vinnitsa
272,259,16,101,156,15,171,0,171,7,110,54,21.04.2019 22:30,14,0,Vinnitsa
160,161,19,43,99,18,117,0,117,0,66,51,21.04.2019 23:25,14,0,Vinnitsa
528,516,32,217,280,31,311,0,311,5,188,118,22.04.2019 00:20,14,0,Vinnitsa
80,88,9,27,44,9,53,0,53,1,28,24,22.04.2019 01:30,14,0,Vinnitsa
80,69,9,36,35,9,44,0,44,0,23,21,22.04.2019 00:20,14,0,Vinnitsa
352,345,37,118,204,30,234,0,234,8,122,104,22.04.2019 00:00,14,0,Vinnitsa
96,29,4,67,25,4,29,0,29,0,7,22,21.04.2019 21:00,14,0,Vinnitsa
672,236,0,437,235,0,235,0,235,8,137,90,22.04.2019 02:00,14,0,Vinnitsa
1392,1369,3,545,844,3,847,0,847,23,490,334,22.04.2019 01:30,14,0,Vinnitsa
1488,1472,11,658,820,10,830,0,830,13,492,325,22.04.2019 02:20,14,0,Vinnitsa
944,932,11,364,569,11,580,0,580,15,320,245,22.04.2019 02:20,14,0,Vinnitsa
1664,1634,9,691,964,9,973,0,973,15,595,363,22.04.2019 01:30,14,0,Vinnitsa
1120,1102,11,421,690,9,699,0,699,14,445,240,22.04.2019 02:20,14,0,Vinnitsa
1056,1040,6,424,626,6,632,0,632,17,410,205,22.04.2019 02:00,14,0,Vinnitsa
768,751,12,318,438,12,450,0,450,7,250,193,22.04.2019 02:20,14,0,Vinnitsa
1248,1218,12,542,694,12,706,0,706,20,412,274,22.04.2019 02:20,14,0,Vinnitsa
544,538,5,209,330,5,335,0,335,7,239,89,22.04.2019 00:30,14,0,Vinnitsa
1104,1082,17,483,604,17,621,0,621,9,442,170,22.04.2019 02:40,14,0,Vinnitsa
1216,1192,28,520,672,24,696,0,696,23,454,219,22.04.2019 02:40,14,0,Vinnitsa
1200,1185,24,451,726,23,749,0,749,10,475,264,22.04.2019 00:25,14,0,Vinnitsa
1104,1095,23,455,626,23,649,0,649,7,415,227,22.04.2019 02:00,14,0,Vinnitsa
1216,1211,13,380,823,13,836,0,836,12,424,400,21.04.2019 22:25,14,0,Vinnitsa
1024,1002,11,390,623,11,634,0,634,22,380,232,22.04.2019 00:20,14,0,Vinnitsa
1024,1004,9,383,634,7,641,0,641,11,377,253,22.04.2019 00:00,14,0,Vinnitsa
208,195,110,25,78,105,183,0,183,3,44,136,21.04.2019 21:50,14,0,Vinnitsa
304,298,25,110,169,25,194,0,194,0,101,93,22.04.2019 01:00,14,0,Vinnitsa
336,331,20,101,217,18,235,0,235,4,116,115,22.04.2019 02:00,14,0,Vinnitsa
160,164,13,52,95,13,108,0,108,1,49,58,22.04.2019 01:30,14,0,Vinnitsa
448,432,0,168,280,0,280,0,280,2,134,144,22.04.2019 00:20,14,0,Vinnitsa
224,213,0,106,118,0,118,0,118,2,58,58,21.04.2019 22:35,14,0,Vinnitsa
880,874,25,361,494,25,519,0,519,6,315,198,22.04.2019 02:00,14,0,Vinnitsa
112,103,6,41,65,6,71,0,71,1,53,17,21.04.2019 22:23,14,0,Vinnitsa
224,211,1,125,98,1,99,0,99,1,68,30,22.04.2019 01:04,14,0,Vinnitsa
224,220,17,68,142,14,156,0,156,5,116,35,21.04.2019 21:30,14,0,Vinnitsa
144,129,8,31,106,7,113,0,113,1,76,36,21.04.2019 21:20,14,0,Vinnitsa
208,208,14,75,122,11,133,0,133,4,66,63,21.04.2019 22:30,14,0,Vinnitsa
368,363,21,128,224,16,240,0,240,1,138,101,22.04.2019 01:00,14,0,Vinnitsa
112,106,5,50,57,5,62,0,62,2,36,24,21.04.2019 22:55,14,0,Vinnitsa
176,175,6,62,108,6,114,0,114,1,82,31,22.04.2019 00:00,14,0,Vinnitsa
224,215,8,80,137,7,144,0,144,2,97,45,21.04.2019 23:10,14,0,Vinnitsa
112,112,2,33,77,2,79,0,79,1,50,28,21.04.2019 22:00,14,0,Vinnitsa
304,293,9,136,166,2,168,0,168,2,120,46,21.04.2019 22:00,14,0,Vinnitsa
160,152,8,71,82,7,89,0,89,1,54,34,21.04.2019 21:35,14,0,Vinnitsa
80,81,2,23,55,2,57,0,57,1,35,21,21.04.2019 22:12,14,0,Vinnitsa
48,41,2,16,30,2,32,0,32,0,9,23,21.04.2019 21:32,14,0,Vinnitsa
192,191,3,86,103,3,106,0,106,3,68,35,22.04.2019 00:20,14,0,Vinnitsa
176,171,18,59,101,16,117,0,117,3,65,49,22.04.2019 02:00,14,0,Vinnitsa
128,115,13,36,79,13,92,0,92,0,44,48,22.04.2019 00:00,14,0,Vinnitsa
176,167,6,63,107,6,113,0,113,0,81,32,22.04.2019 01:15,14,0,Vinnitsa
208,196,13,86,112,10,122,0,122,5,68,49,22.04.2019 00:05,14,0,Vinnitsa
80,76,6,14,60,6,66,0,66,1,28,37,22.04.2019 00:15,14,0,Vinnitsa
512,511,58,196,260,56,316,0,316,8,218,90,22.04.2019 01:30,14,0,Vinnitsa
784,788,34,280,470,34,504,0,504,18,329,157,21.04.2019 23:44,14,0,Vinnitsa
592,585,19,249,327,16,343,0,343,9,178,156,22.04.2019 00:15,14,0,Vinnitsa
192,179,16,65,112,15,127,0,127,1,56,70,21.04.2019 23:00,14,0,Vinnitsa
112,108,10,51,53,8,61,0,61,0,31,30,21.04.2019 22:00,14,0,Vinnitsa
1744,1725,32,679,1036,29,1065,0,1065,29,625,411,22.04.2019 01:10,14,0,Vinnitsa
208,201,10,70,128,10,138,0,138,1,64,73,22.04.2019 01:30,14,0,Vinnitsa
432,426,11,181,243,8,251,0,251,4,140,107,22.04.2019 01:13,14,0,Vinnitsa
1039,1013,38,450,556,33,589,0,589,4,464,121,22.04.2019 02:40,14,0,Vinnitsa
160,145,6,74,80,6,86,0,86,1,42,43,22.04.2019 01:02,14,0,Vinnitsa
736,716,37,308,394,34,428,0,428,6,236,186,22.04.2019 01:12,14,0,Vinnitsa
320,301,13,122,186,12,198,0,198,6,145,47,21.04.2019 23:00,14,0,Vinnitsa
400,392,25,125,250,25,275,0,275,3,172,100,22.04.2019 00:15,14,0,Vinnitsa
272,262,24,100,148,24,172,0,172,2,94,76,22.04.2019 02:35,14,0,Vinnitsa
640,625,35,270,339,31,370,0,370,4,233,133,22.04.2019 02:20,14,0,Vinnitsa
928,904,29,390,511,27,538,0,538,7,354,177,22.04.2019 01:00,14,0,Vinnitsa
96,88,9,45,43,8,51,0,51,0,22,29,22.04.2019 02:00,14,0,Vinnitsa
1552,1555,7,580,967,5,972,0,972,20,740,212,22.04.2019 00:10,14,0,Vinnitsa
1600,1588,6,640,954,6,960,0,960,25,745,190,21.04.2019 22:00,14,0,Vinnitsa
2144,2128,15,896,1234,14,1248,0,1248,35,944,269,22.04.2019 01:00,14,0,Vinnitsa
1632,1594,14,672,950,10,960,0,960,14,770,176,22.04.2019 01:00,14,0,Vinnitsa
2240,2214,10,1012,1220,8,1228,0,1228,30,997,201,22.04.2019 01:00,14,0,Vinnitsa
2320,2265,16,1076,1229,15,1244,0,1244,32,977,235,22.04.2019 00:13,14,0,Vinnitsa
2134,2185,17,792,1336,6,1342,0,1342,49,1026,267,21.04.2019 22:00,14,0,Vinnitsa
2224,2212,21,832,1374,18,1392,0,1392,55,1066,271,21.04.2019 23:00,14,0,Vinnitsa
1424,1443,10,644,770,10,780,0,780,36,528,216,21.04.2019 22:20,14,0,Vinnitsa
2080,2041,13,877,1195,8,1203,0,1203,36,891,276,21.04.2019 23:58,14,0,Vinnitsa
1984,1969,7,757,1224,3,1227,0,1227,40,899,288,21.04.2019 21:20,14,0,Vinnitsa
1824,1823,8,726,1091,7,1098,0,1098,22,840,236,21.04.2019 21:00,14,0,Vinnitsa
1392,1429,9,471,913,8,921,0,921,32,710,179,22.04.2019 01:00,14,0,Vinnitsa
1280,1263,12,523,749,8,757,0,757,27,605,125,22.04.2019 00:01,14,0,Vinnitsa
1680,1651,5,675,1000,5,1005,0,1005,29,745,231,21.04.2019 22:05,14,0,Vinnitsa
1456,1447,10,599,850,7,857,0,857,20,644,193,21.04.2019 21:00,14,0,Vinnitsa
256,103,4,166,86,4,90,0,90,1,31,58,22.04.2019 01:30,14,0,Vinnitsa
304,292,21,100,183,21,204,0,204,0,117,87,22.04.2019 01:05,15,0,Vinnitsa
128,122,7,53,68,7,75,0,75,0,53,22,22.04.2019 00:25,15,0,Vinnitsa
64,59,0,24,40,0,40,0,40,7,18,15,22.04.2019 00:45,15,0,Vinnitsa
368,357,25,155,192,21,213,0,213,3,143,67,22.04.2019 00:40,15,0,Vinnitsa
336,323,21,159,157,20,177,0,177,1,105,71,22.04.2019 00:15,15,0,Vinnitsa
848,819,44,355,450,43,493,0,493,8,302,183,21.04.2019 20:58,15,0,Vinnitsa
528,519,18,220,290,18,308,0,308,3,175,130,22.04.2019 00:50,15,0,Vinnitsa
608,585,45,202,364,42,406,0,406,3,214,189,22.04.2019 01:37,15,0,Vinnitsa
80,76,4,12,64,4,68,0,68,0,31,37,22.04.2019 00:20,15,0,Vinnitsa
352,339,5,131,216,5,221,0,221,0,156,65,22.04.2019 00:35,15,0,Vinnitsa
288,270,1,110,177,1,178,0,178,3,68,107,22.04.2019 01:40,15,0,Vinnitsa
96,82,0,42,54,0,54,0,54,0,29,25,22.04.2019 01:10,15,0,Vinnitsa
544,538,2,211,331,2,333,0,333,0,235,98,22.04.2019 00:10,15,0,Vinnitsa
608,592,14,226,368,14,382,0,382,5,252,125,22.04.2019 00:15,15,0,Vinnitsa
272,254,9,91,172,9,181,0,181,2,109,70,22.04.2019 03:15,15,0,Vinnitsa
80,69,4,37,39,4,43,0,43,0,21,22,22.04.2019 00:39,15,0,Vinnitsa
688,666,43,218,429,41,470,0,470,14,214,242,22.04.2019 00:37,15,0,Vinnitsa
400,388,12,169,219,12,231,0,231,2,116,113,22.04.2019 00:20,15,0,Vinnitsa
176,163,11,64,101,11,112,0,112,4,65,43,22.04.2019 01:20,15,0,Vinnitsa
496,481,44,182,275,39,314,0,314,5,179,130,21.04.2019 20:55,15,0,Vinnitsa
528,521,9,247,272,9,281,0,281,6,202,73,22.04.2019 00:30,15,0,Vinnitsa
656,653,47,258,353,45,398,0,398,12,271,115,22.04.2019 02:45,15,0,Vinnitsa
448,432,13,174,261,13,274,0,274,20,148,106,22.04.2019 01:20,15,0,Vinnitsa
1504,1466,16,794,696,14,710,0,710,18,409,283,22.04.2019 00:15,15,0,Vinnitsa
1696,1665,12,741,944,11,955,0,955,22,573,360,22.04.2019 01:20,15,0,Vinnitsa
1520,1488,5,614,901,5,906,0,906,21,535,350,22.04.2019 02:10,15,0,Vinnitsa
528,515,45,231,264,33,297,0,297,4,191,102,22.04.2019 01:05,15,0,Vinnitsa
544,531,21,277,248,19,267,0,267,11,151,105,22.04.2019 00:50,15,0,Vinnitsa
192,188,16,36,140,16,156,0,156,0,82,74,22.04.2019 01:15,15,0,Vinnitsa
800,778,35,379,390,31,421,0,421,9,279,133,22.04.2019 00:15,15,0,Vinnitsa
192,191,20,37,135,20,155,0,155,1,68,86,22.04.2019 00:30,15,0,Vinnitsa
336,319,26,153,157,26,183,0,183,4,96,83,22.04.2019 00:05,15,0,Vinnitsa
128,130,10,38,81,9,90,0,90,1,60,29,21.04.2019 21:30,15,0,Vinnitsa
176,177,11,54,111,11,122,0,122,1,70,51,22.04.2019 01:10,15,0,Vinnitsa
64,57,15,16,36,12,48,0,48,0,32,16,21.04.2019 21:05,15,0,Vinnitsa
128,116,10,36,82,10,92,0,92,0,60,32,22.04.2019 00:45,15,0,Vinnitsa
128,125,6,19,103,6,109,0,109,3,57,49,22.04.2019 00:30,15,0,Vinnitsa
272,252,13,111,149,12,161,0,161,2,82,77,22.04.2019 01:25,15,0,Vinnitsa
144,141,8,49,88,7,95,0,95,4,64,27,22.04.2019 00:10,15,0,Vinnitsa
640,621,26,228,386,26,412,0,412,1,268,143,22.04.2019 00:45,15,0,Vinnitsa
240,227,11,113,118,9,127,0,127,2,82,43,22.04.2019 00:05,15,0,Vinnitsa
544,533,19,179,346,19,365,0,365,7,236,122,22.04.2019 00:25,15,0,Vinnitsa
464,445,23,172,271,21,292,0,292,6,199,87,22.04.2019 00:30,15,0,Vinnitsa
240,239,2,54,184,2,186,0,186,6,100,80,22.04.2019 01:30,15,0,Vinnitsa
480,466,28,186,269,25,294,0,294,3,117,174,22.04.2019 01:00,15,0,Vinnitsa
288,282,24,121,144,23,167,0,167,2,75,90,22.04.2019 00:15,15,0,Vinnitsa
160,157,18,64,79,17,96,0,96,1,57,38,22.04.2019 00:05,15,0,Vinnitsa
112,18,6,98,12,2,14,0,14,0,8,6,22.04.2019 00:10,15,0,Vinnitsa
2096,2054,26,824,1254,18,1272,0,1272,34,965,273,22.04.2019 03:30,15,0,Vinnitsa
1200,1187,7,497,698,5,703,0,703,12,512,179,22.04.2019 03:20,15,0,Vinnitsa
1248,1217,6,580,664,4,668,0,668,11,522,135,22.04.2019 00:15,15,0,Vinnitsa
2128,2115,14,934,1182,12,1194,0,1194,14,919,261,22.04.2019 00:35,15,0,Vinnitsa
1216,1191,15,550,653,13,666,0,666,15,483,168,22.04.2019 01:15,15,0,Vinnitsa
912,878,46,378,495,39,534,0,534,6,349,179,22.04.2019 00:35,15,0,Vinnitsa
912,893,23,469,420,23,443,0,443,12,311,120,22.04.2019 02:10,15,0,Vinnitsa
352,341,23,118,214,20,234,0,234,2,147,85,22.04.2019 00:25,15,0,Vinnitsa
592,581,19,243,332,17,349,0,349,7,231,111,22.04.2019 00:25,15,0,Vinnitsa
592,577,18,184,390,18,408,0,408,12,235,161,21.04.2019 21:55,15,0,Vinnitsa
1296,1270,31,529,737,30,767,0,767,14,520,232,22.04.2019 01:10,15,0,Vinnitsa
272,269,15,119,139,14,153,0,153,5,114,34,22.04.2019 00:10,15,0,Vinnitsa
160,158,12,54,97,9,106,0,106,1,73,32,22.04.2019 01:15,15,0,Vinnitsa
400,389,13,178,210,12,222,0,222,2,158,62,22.04.2019 00:15,15,0,Vinnitsa
992,968,7,418,567,7,574,0,574,10,462,102,22.04.2019 00:05,15,0,Vinnitsa
288,273,8,91,189,8,197,0,197,19,109,69,22.04.2019 00:25,15,0,Vinnitsa
512,498,28,193,291,28,319,0,319,8,165,146,22.04.2019 00:30,15,0,Vinnitsa
384,376,20,194,170,20,190,0,190,6,123,61,22.04.2019 00:30,15,0,Vinnitsa
320,303,5,149,167,4,171,0,171,4,131,36,21.04.2019 22:10,15,0,Vinnitsa
448,433,19,145,286,17,303,0,303,1,221,81,22.04.2019 01:00,15,0,Vinnitsa
320,305,24,86,214,20,234,0,234,6,166,62,22.04.2019 00:30,15,0,Vinnitsa
368,358,16,144,210,14,224,0,224,4,186,34,22.04.2019 00:00,15,0,Vinnitsa
160,157,10,55,97,8,105,0,105,2,68,35,22.04.2019 00:25,15,0,Vinnitsa
720,713,30,295,395,30,425,0,425,7,329,89,22.04.2019 01:25,15,0,Vinnitsa
752,739,12,329,412,11,423,0,423,10,321,92,22.04.2019 01:46,15,0,Vinnitsa
592,582,28,228,336,28,364,0,364,5,198,161,22.04.2019 03:50,15,0,Vinnitsa
944,921,11,397,536,11,547,0,547,11,335,201,22.04.2019 02:20,15,0,Vinnitsa
64,15,0,49,15,0,15,0,15,0,10,5,22.04.2019 00:32,15,0,Vinnitsa
2160,2139,20,871,1275,14,1289,0,1289,33,900,356,22.04.2019 00:01,15,0,Vinnitsa
1760,1747,28,660,1078,22,1100,0,1100,25,728,347,22.04.2019 00:58,15,0,Vinnitsa
2128,2077,14,934,1180,14,1194,0,1194,29,858,307,21.04.2019 21:06,15,0,Vinnitsa
2128,2097,22,962,1145,21,1166,0,1166,25,826,315,22.04.2019 00:10,15,0,Vinnitsa
1712,1679,23,674,1016,22,1038,0,1038,23,689,326,22.04.2019 01:02,15,0,Vinnitsa
2032,2000,12,765,1255,12,1267,0,1267,27,873,367,22.04.2019 00:10,15,0,Vinnitsa
1392,1369,48,633,716,43,759,0,759,12,493,254,22.04.2019 00:55,15,0,Vinnitsa
1375,1363,34,587,758,30,788,0,788,9,517,262,22.04.2019 00:00,15,0,Vinnitsa
496,484,42,155,303,38,341,0,341,6,220,115,22.04.2019 03:00,15,0,Vinnitsa
848,835,73,287,492,69,561,0,561,14,323,224,21.04.2019 21:31,15,0,Vinnitsa
448,446,31,173,246,29,275,0,275,5,172,98,21.04.2019 20:45,15,0,Vinnitsa
944,929,23,383,539,22,561,0,561,9,383,169,21.04.2019 21:30,15,0,Vinnitsa
320,313,30,104,189,27,216,0,216,2,113,101,22.04.2019 00:30,15,0,Vinnitsa
800,774,48,331,421,48,469,0,469,6,297,166,21.04.2019 20:30,15,0,Vinnitsa
576,560,24,196,356,24,380,0,380,6,264,110,22.04.2019 00:49,15,0,Vinnitsa
640,625,57,169,414,57,471,0,471,6,349,116,22.04.2019 00:43,15,0,Vinnitsa
960,938,41,413,506,41,547,0,547,6,354,187,22.04.2019 01:30,15,0,Vinnitsa
1536,1505,28,737,777,22,799,0,799,16,565,218,22.04.2019 02:35,15,0,Vinnitsa
1776,1747,27,792,957,27,984,0,984,15,695,274,22.04.2019 01:45,15,0,Vinnitsa
1504,1480,22,653,830,21,851,0,851,15,532,304,22.04.2019 00:30,15,0,Vinnitsa
112,108,15,39,58,15,73,0,73,1,36,36,21.04.2019 21:30,15,0,Vinnitsa
976,965,41,388,547,41,588,0,588,25,383,180,21.04.2019 21:30,15,0,Vinnitsa
512,508,28,126,359,27,386,0,386,6,258,122,21.04.2019 21:30,15,0,Vinnitsa
384,377,47,106,231,47,278,0,278,6,156,116,22.04.2019 00:30,15,0,Vinnitsa
128,117,8,51,71,6,77,0,77,2,48,27,22.04.2019 00:10,15,0,Vinnitsa
688,682,30,251,407,30,437,0,437,13,271,153,22.04.2019 00:05,15,0,Vinnitsa
304,286,14,50,240,14,254,0,254,3,149,102,22.04.2019 00:45,15,0,Vinnitsa
320,319,21,101,202,17,219,0,219,2,110,107,21.04.2019 22:12,15,0,Vinnitsa
464,443,18,189,257,18,275,0,275,4,172,99,22.04.2019 00:40,15,0,Vinnitsa
752,741,46,333,374,45,419,0,419,6,305,108,22.04.2019 02:30,15,0,Vinnitsa
896,886,52,292,552,52,604,0,604,21,379,204,22.04.2019 01:30,15,0,Vinnitsa
544,529,29,162,356,26,382,0,382,5,250,127,22.04.2019 00:20,15,0,Vinnitsa
624,611,73,253,304,67,371,0,371,7,211,153,21.04.2019 21:50,15,0,Vinnitsa
672,655,26,312,343,17,360,0,360,12,240,108,21.04.2019 21:00,15,0,Vinnitsa
720,699,15,370,337,13,350,0,350,7,241,102,22.04.2019 00:03,15,0,Vinnitsa
864,847,6,383,475,6,481,0,481,6,336,139,22.04.2019 00:20,15,0,Vinnitsa
1328,1304,2,600,726,2,728,0,728,4,506,218,22.04.2019 00:20,15,0,Vinnitsa
928,910,3,440,485,3,488,0,488,14,285,189,22.04.2019 00:06,15,0,Vinnitsa
96,92,1,26,69,1,70,0,70,0,45,25,22.04.2019 00:45,15,0,Vinnitsa
384,378,30,170,189,25,214,0,214,1,135,78,22.04.2019 00:20,15,0,Vinnitsa
480,469,21,218,243,19,262,0,262,7,152,103,22.04.2019 00:25,15,0,Vinnitsa
800,783,61,345,400,55,455,0,455,3,242,210,22.04.2019 00:15,15,0,Vinnitsa
160,149,13,67,81,12,93,0,93,2,63,28,22.04.2019 01:35,15,0,Vinnitsa
48,47,5,25,20,3,23,0,23,1,13,9,22.04.2019 00:20,15,0,Vinnitsa
560,556,24,172,364,24,388,0,388,6,260,122,22.04.2019 00:01,15,0,Vinnitsa
736,726,48,276,415,45,460,0,460,8,355,97,22.04.2019 00:03,15,0,Vinnitsa
240,230,25,65,150,25,175,0,175,1,133,41,22.04.2019 00:05,15,0,Vinnitsa
496,486,53,75,368,53,421,0,421,1,277,143,22.04.2019 01:30,15,0,Vinnitsa
512,498,54,154,304,54,358,0,358,6,222,130,22.04.2019 02:10,15,0,Vinnitsa
1312,1284,28,638,646,28,674,0,674,9,438,227,22.04.2019 00:30,15,0,Vinnitsa
912,888,16,414,482,16,498,0,498,11,302,185,22.04.2019 00:45,15,0,Vinnitsa
160,142,1,69,90,1,91,0,91,0,51,40,22.04.2019 00:30,15,0,Vinnitsa
256,247,4,125,127,4,131,0,131,0,104,27,22.04.2019 01:03,15,0,Vinnitsa
208,201,17,89,102,17,119,0,119,1,96,22,21.04.2019 22:15,15,0,Vinnitsa
528,514,50,158,320,50,370,0,370,3,229,138,22.04.2019 03:05,15,0,Vinnitsa
192,185,15,60,117,15,132,0,132,6,91,35,22.04.2019 00:20,15,0,Vinnitsa
704,674,47,318,350,36,386,0,386,7,271,108,22.04.2019 00:25,15,0,Vinnitsa
64,54,8,25,31,8,39,0,39,0,26,13,22.04.2019 00:35,15,0,Vinnitsa
80,77,5,28,47,5,52,0,52,1,32,19,22.04.2019 00:30,15,0,Vinnitsa
1536,1512,8,727,803,6,809,0,809,18,519,272,22.04.2019 00:08,15,0,Vinnitsa
800,777,3,398,399,3,402,0,402,10,279,113,22.04.2019 00:05,15,0,Vinnitsa
208,200,25,48,135,25,160,0,160,5,96,59,21.04.2019 22:00,15,0,Vinnitsa
144,135,15,67,62,15,77,0,77,0,46,31,21.04.2019 21:40,15,0,Vinnitsa
512,498,46,178,288,46,334,0,334,6,178,150,22.04.2019 00:30,15,0,Vinnitsa
896,879,36,337,525,34,559,0,559,8,409,142,22.04.2019 00:10,15,0,Vinnitsa
96,92,4,33,59,4,63,0,63,0,49,14,21.04.2019 23:20,15,0,Vinnitsa
96,28,0,73,23,0,23,0,23,0,15,8,22.04.2019 00:15,15,0,Vinnitsa
1712,1676,25,726,962,24,986,0,986,28,703,255,22.04.2019 02:30,15,0,Vinnitsa
624,611,40,232,361,31,392,0,392,8,329,55,22.04.2019 00:05,15,0,Vinnitsa
640,616,22,323,295,22,317,0,317,6,187,124,22.04.2019 00:10,15,0,Vinnitsa
1008,993,61,495,467,46,513,0,513,3,345,165,22.04.2019 00:20,15,0,Vinnitsa
640,620,52,326,273,41,314,0,314,5,218,91,22.04.2019 01:30,15,0,Vinnitsa
240,230,17,108,117,15,132,0,132,0,84,48,22.04.2019 00:40,15,0,Vinnitsa
176,166,19,63,94,19,113,0,113,1,66,46,22.04.2019 00:20,15,0,Vinnitsa
1216,1211,63,560,605,51,656,0,656,15,490,151,22.04.2019 00:06,15,0,Vinnitsa
1232,1206,74,628,545,59,604,0,603,11,456,136,22.04.2019 00:20,15,0,Vinnitsa
832,820,47,267,518,47,565,0,565,16,376,173,22.04.2019 01:30,15,0,Vinnitsa
1056,1036,89,420,560,76,636,0,636,12,454,170,22.04.2019 01:20,15,0,Vinnitsa
496,477,21,170,306,20,326,0,326,4,218,104,22.04.2019 00:10,15,0,Vinnitsa
464,451,19,192,255,17,272,0,272,13,167,92,22.04.2019 00:10,15,0,Vinnitsa
784,784,36,235,514,35,549,0,549,7,276,266,21.04.2019 20:55,15,0,Vinnitsa
528,519,34,213,282,33,315,0,315,7,222,86,22.04.2019 00:30,15,0,Vinnitsa
608,590,37,257,317,34,351,0,351,6,266,79,22.04.2019 00:05,15,0,Vinnitsa
1728,1708,34,678,1024,26,1050,0,1050,36,745,269,21.04.2019 23:00,15,0,Vinnitsa
800,782,34,340,427,33,460,0,460,10,333,117,22.04.2019 00:10,15,0,Vinnitsa
224,207,15,92,117,15,132,0,132,1,83,48,22.04.2019 00:05,15,0,Vinnitsa
2064,2027,65,919,1096,49,1145,0,1145,33,841,271,22.04.2019 01:35,15,0,Vinnitsa
672,659,32,214,428,30,458,0,458,2,365,91,22.04.2019 01:35,15,0,Vinnitsa
1264,1246,69,519,679,66,745,0,745,10,550,185,22.04.2019 00:25,15,0,Vinnitsa
544,533,19,234,291,19,310,0,310,6,163,141,22.04.2019 00:05,15,0,Vinnitsa
192,180,13,78,101,13,114,0,114,0,65,49,22.04.2019 00:20,15,0,Vinnitsa
560,545,26,230,309,21,330,0,330,6,264,60,22.04.2019 00:40,15,0,Vinnitsa
704,695,49,288,375,41,416,0,416,12,279,125,22.04.2019 00:05,15,0,Vinnitsa
480,474,29,215,237,28,265,0,265,4,151,110,22.04.2019 00:25,15,0,Vinnitsa
1248,1239,48,274,926,48,974,0,974,19,578,377,22.04.2019 01:40,15,0,Vinnitsa
240,237,16,68,157,15,172,0,172,1,126,45,22.04.2019 00:05,15,0,Vinnitsa
464,472,45,146,278,40,318,0,318,6,184,128,22.04.2019 00:15,15,0,Vinnitsa
720,703,46,319,358,43,401,0,401,7,228,166,22.04.2019 00:15,15,0,Vinnitsa
1824,1796,10,856,958,10,968,0,968,9,629,330,22.04.2019 00:07,15,0,Vinnitsa
1792,1767,9,865,918,9,927,0,927,29,566,332,22.04.2019 00:19,15,0,Vinnitsa
368,355,26,138,212,18,230,0,230,5,122,103,22.04.2019 00:30,15,0,Vinnitsa
672,653,37,195,447,30,477,0,477,3,257,217,22.04.2019 00:59,15,0,Vinnitsa
2048,2014,90,828,1149,71,1220,0,1220,21,928,271,22.04.2019 00:15,15,0,Vinnitsa
432,417,20,137,276,19,295,0,295,6,208,81,22.04.2019 00:15,15,0,Vinnitsa
656,648,26,273,363,20,383,0,383,6,253,124,21.04.2019 22:00,15,0,Vinnitsa
144,138,15,56,73,15,88,0,88,1,56,31,21.04.2019 22:03,15,0,Vinnitsa
576,566,32,206,340,30,370,0,370,8,276,86,22.04.2019 00:05,15,0,Vinnitsa
1712,1686,58,826,831,55,886,0,886,28,628,230,22.04.2019 00:10,15,0,Vinnitsa
128,116,13,52,64,12,76,0,76,0,52,24,21.04.2019 20:58,15,0,Vinnitsa
320,303,15,77,231,12,243,0,243,0,170,73,22.04.2019 00:20,15,0,Vinnitsa
832,823,1,200,631,1,632,0,632,24,417,191,22.04.2019 00:10,15,0,Vinnitsa
1664,1661,18,649,1000,15,1015,0,1015,24,739,252,22.04.2019 00:10,15,0,Vinnitsa
1552,1531,13,558,983,11,994,0,994,21,738,235,22.04.2019 00:30,15,0,Vinnitsa
2240,2205,42,915,1283,42,1325,0,1325,43,996,286,22.04.2019 00:20,15,0,Vinnitsa
208,77,38,149,29,30,59,0,59,0,47,12,22.04.2019 00:20,15,0,Vinnitsa
400,382,23,165,219,16,235,0,235,1,176,58,22.04.2019 00:05,16,0,Vinnitsa
64,59,7,26,33,5,38,0,38,1,29,8,21.04.2019 21:10,16,0,Vinnitsa
736,709,41,326,380,30,410,0,410,12,271,127,22.04.2019 00:15,16,0,Vinnitsa
1040,1019,80,525,457,58,515,0,515,7,358,150,21.04.2019 21:50,16,0,Vinnitsa
1408,1390,110,508,816,84,900,0,900,12,678,210,22.04.2019 00:09,16,0,Vinnitsa
1088,1067,69,421,609,58,667,0,667,10,489,168,22.04.2019 00:20,16,0,Vinnitsa
304,291,20,123,166,15,181,0,181,1,148,32,21.04.2019 23:05,16,0,Vinnitsa
1904,1897,158,755,1040,109,1149,0,1149,22,898,229,22.04.2019 00:30,16,0,Vinnitsa
1280,1219,12,585,687,8,695,0,695,15,503,177,22.04.2019 00:20,16,0,Vinnitsa
1280,1259,66,566,653,61,714,0,714,15,551,148,22.04.2019 01:12,16,0,Vinnitsa
208,199,20,88,102,18,120,0,120,0,72,48,22.04.2019 00:10,16,0,Vinnitsa
96,96,9,28,59,9,68,0,68,1,55,12,21.04.2019 23:15,16,0,Vinnitsa
224,207,22,86,123,15,138,0,138,3,112,23,21.04.2019 21:01,16,0,Vinnitsa
192,188,14,60,118,14,132,0,132,0,109,23,22.04.2019 00:17,16,0,Vinnitsa
96,99,15,40,48,8,56,0,56,0,32,24,21.04.2019 20:40,16,0,Vinnitsa
1296,1274,47,449,803,44,847,0,847,19,514,314,22.04.2019 00:10,16,0,Vinnitsa
608,606,24,215,372,21,393,0,393,3,292,98,21.04.2019 21:30,16,0,Vinnitsa
272,269,17,81,177,14,191,0,191,1,124,66,22.04.2019 00:10,16,0,Vinnitsa
384,381,37,148,202,34,236,0,236,4,150,82,22.04.2019 00:15,16,0,Vinnitsa
400,398,42,82,278,40,318,0,318,2,215,101,21.04.2019 21:10,16,0,Vinnitsa
768,753,19,314,442,12,454,0,454,5,343,106,22.04.2019 02:00,16,0,Vinnitsa
160,157,4,68,89,3,92,0,92,2,63,27,22.04.2019 00:45,16,0,Vinnitsa
384,377,31,143,214,27,241,0,241,2,148,91,22.04.2019 00:05,16,0,Vinnitsa
288,276,17,111,168,9,177,0,177,5,122,50,21.04.2019 20:30,16,0,Vinnitsa
608,607,59,246,313,49,362,0,362,7,238,117,22.04.2019 00:20,16,0,Vinnitsa
432,431,8,185,239,8,247,0,247,8,195,44,21.04.2019 20:31,16,0,Vinnitsa
688,676,37,264,391,33,424,0,424,7,316,101,22.04.2019 01:10,16,0,Vinnitsa
2480,2456,41,966,1482,32,1514,0,1514,30,1101,383,22.04.2019 00:30,16,0,Vinnitsa
2448,2398,30,952,1471,25,1496,0,1496,35,1099,362,22.04.2019 01:40,16,0,Vinnitsa
2384,2331,22,966,1399,19,1418,0,1418,30,1022,366,22.04.2019 00:01,16,0,Vinnitsa
112,100,0,16,96,0,96,0,96,5,86,5,22.04.2019 00:05,16,0,Vinnitsa
1376,1352,51,683,648,45,693,0,693,13,488,192,21.04.2019 21:40,16,0,Vinnitsa
1632,1598,37,812,786,34,820,0,820,12,592,216,21.04.2019 23:05,16,0,Vinnitsa
240,233,7,110,124,6,130,0,130,1,76,53,21.04.2019 21:30,16,0,Vinnitsa
624,601,52,257,315,52,367,0,367,1,274,92,22.04.2019 01:05,16,0,Vinnitsa
128,123,13,56,59,13,72,0,72,3,52,17,22.04.2019 00:50,16,0,Vinnitsa
432,421,26,166,242,24,266,0,266,2,196,68,21.04.2019 21:15,16,0,Vinnitsa
1088,999,71,419,611,58,669,0,669,13,504,152,22.04.2019 00:20,16,0,Vinnitsa
304,294,21,150,140,14,154,0,154,5,116,33,22.04.2019 00:10,16,0,Vinnitsa
384,365,24,147,216,21,237,0,237,5,178,54,21.04.2019 21:50,16,0,Vinnitsa
288,280,21,122,147,19,166,0,166,9,114,43,22.04.2019 00:15,16,0,Vinnitsa
240,239,12,68,161,11,172,0,172,0,126,46,22.04.2019 00:16,16,0,Vinnitsa
304,300,24,97,184,23,207,0,207,6,136,65,21.04.2019 21:20,16,0,Vinnitsa
240,233,15,91,134,15,149,0,149,1,105,43,21.04.2019 21:05,16,0,Vinnitsa
64,63,5,26,33,5,38,0,38,1,21,16,21.04.2019 20:30,16,0,Vinnitsa
592,588,23,241,328,23,351,0,351,9,284,58,22.04.2019 00:30,16,0,Vinnitsa
416,402,34,121,261,34,295,0,295,7,222,66,21.04.2019 21:41,16,0,Vinnitsa
384,381,18,109,257,18,275,0,275,9,149,117,22.04.2019 00:10,16,0,Vinnitsa
160,153,11,59,90,11,101,0,101,2,64,35,21.04.2019 22:30,16,0,Vinnitsa
160,160,16,59,89,12,101,0,101,1,70,30,22.04.2019 00:15,16,0,Vinnitsa
448,433,21,226,204,18,222,0,222,6,156,60,21.04.2019 20:55,16,0,Vinnitsa
384,368,9,159,219,6,225,0,225,13,136,76,21.04.2019 20:54,16,0,Vinnitsa
752,740,35,321,400,31,431,0,431,10,295,126,21.04.2019 23:30,16,0,Vinnitsa
160,152,15,56,89,15,104,0,104,0,44,60,21.04.2019 23:15,16,0,Vinnitsa
224,208,28,122,75,27,102,0,102,1,50,51,21.04.2019 22:46,16,0,Vinnitsa
224,212,22,94,113,17,130,0,130,1,107,22,22.04.2019 01:00,16,0,Vinnitsa
1680,1635,45,761,882,37,919,0,919,22,751,146,21.04.2019 21:00,16,0,Vinnitsa
1104,1081,53,364,695,45,740,0,740,12,388,340,21.04.2019 22:30,16,0,Vinnitsa
240,233,25,109,112,19,131,0,131,2,76,53,22.04.2019 00:30,16,0,Vinnitsa
160,149,9,78,76,6,82,0,82,0,59,23,21.04.2019 22:10,16,0,Vinnitsa
304,313,36,87,181,36,217,0,217,0,165,52,21.04.2019 23:10,16,0,Vinnitsa
2080,2042,52,943,1085,52,1137,0,1137,16,893,228,22.04.2019 00:15,16,0,Vinnitsa
432,420,45,166,223,43,266,0,266,6,209,51,22.04.2019 00:30,16,0,Vinnitsa
240,227,17,84,141,15,156,0,156,5,120,31,21.04.2019 21:15,16,0,Vinnitsa
400,383,23,185,192,23,215,0,215,2,138,75,22.04.2019 00:15,16,0,Vinnitsa
384,380,22,190,172,22,194,0,194,2,136,56,21.04.2019 21:00,16,0,Vinnitsa
80,71,4,33,43,4,47,0,47,0,28,19,21.04.2019 21:15,16,0,Vinnitsa
320,315,26,123,174,23,197,0,197,6,144,47,21.04.2019 20:45,16,0,Vinnitsa
288,274,19,141,135,12,147,0,147,0,114,33,22.04.2019 00:15,16,0,Vinnitsa
592,570,38,235,325,32,357,0,357,8,219,130,21.04.2019 23:55,16,0,Vinnitsa
1232,1208,93,593,564,75,639,0,639,11,518,110,21.04.2019 21:38,16,0,Vinnitsa
416,406,33,146,237,33,270,0,270,1,204,65,21.04.2019 21:00,16,0,Vinnitsa
432,425,46,194,196,42,238,0,238,3,155,80,21.04.2019 21:00,16,0,Vinnitsa
288,275,20,101,168,19,187,0,187,5,148,34,21.04.2019 21:00,16,0,Vinnitsa
656,215,0,441,215,0,215,0,215,6,139,70,21.04.2019 21:50,16,0,Vinnitsa
1424,1405,50,565,815,44,859,0,859,19,633,207,21.04.2019 21:35,16,0,Vinnitsa
1504,1475,54,682,776,46,822,0,822,29,659,134,22.04.2019 01:00,16,0,Vinnitsa
304,291,5,134,166,4,170,0,170,0,139,31,22.04.2019 00:20,16,0,Vinnitsa
896,878,45,350,511,35,546,0,546,14,399,133,21.04.2019 21:00,16,0,Vinnitsa
816,797,46,355,423,38,461,0,461,14,362,85,21.04.2019 23:00,16,0,Vinnitsa
496,488,44,209,243,44,287,0,287,3,217,67,21.04.2019 20:45,16,0,Vinnitsa
112,102,2,49,62,1,63,0,63,2,45,16,21.04.2019 22:10,16,0,Vinnitsa
384,376,71,135,183,66,249,0,249,5,184,60,22.04.2019 00:10,16,0,Vinnitsa
288,291,17,152,123,13,136,0,136,1,91,44,22.04.2019 00:15,16,0,Vinnitsa
1056,1026,53,508,503,45,548,0,548,17,426,105,22.04.2019 01:05,16,0,Vinnitsa
176,171,1,51,125,0,125,0,125,2,88,35,21.04.2019 22:40,16,0,Vinnitsa
560,544,38,246,279,35,314,0,314,5,246,63,22.04.2019 00:10,16,0,Vinnitsa
736,723,56,267,415,54,469,0,469,8,378,83,22.04.2019 00:17,16,0,Vinnitsa
432,418,34,188,210,34,244,0,244,6,154,84,21.04.2019 20:50,16,0,Vinnitsa
496,481,38,194,266,36,302,0,302,14,214,74,21.04.2019 21:08,16,0,Vinnitsa
704,682,19,190,495,19,514,0,514,11,381,122,22.04.2019 00:15,16,0,Vinnitsa
704,692,39,171,494,39,533,0,533,6,434,93,22.04.2019 00:10,16,0,Vinnitsa
144,140,26,37,84,23,107,0,107,0,86,21,21.04.2019 23:00,16,0,Vinnitsa
496,490,17,214,265,17,282,0,282,4,185,93,22.04.2019 00:30,16,0,Vinnitsa
48,49,7,20,25,3,28,0,28,0,10,18,22.04.2019 00:20,16,0,Vinnitsa
528,520,53,187,291,50,341,0,341,5,254,82,21.04.2019 21:00,16,0,Vinnitsa
128,52,14,77,37,14,51,0,51,3,33,15,22.04.2019 00:10,16,0,Vinnitsa
544,524,32,240,272,32,304,0,304,8,183,113,22.04.2019 00:45,16,0,Vinnitsa
384,382,20,104,260,20,280,0,280,5,194,81,22.04.2019 02:10,16,0,Vinnitsa
512,496,27,183,303,26,329,0,329,10,177,142,22.04.2019 01:30,16,0,Vinnitsa
112,98,4,55,53,4,57,0,57,1,41,15,22.04.2019 00:30,16,0,Vinnitsa
1376,1337,16,745,621,10,631,0,631,10,391,230,22.04.2019 03:50,16,0,Vinnitsa
48,47,4,15,29,4,33,0,33,0,17,16,22.04.2019 00:10,16,0,Vinnitsa
960,956,59,478,424,58,482,0,482,11,311,160,22.04.2019 01:20,16,0,Vinnitsa
432,421,38,171,223,38,261,0,261,2,165,94,22.04.2019 01:30,16,0,Vinnitsa
336,321,14,98,224,14,238,0,238,6,161,71,22.04.2019 00:25,16,0,Vinnitsa
480,474,42,175,263,42,305,0,305,11,173,121,21.04.2019 23:40,16,0,Vinnitsa
1456,1434,7,774,675,7,682,0,682,15,450,217,22.04.2019 01:30,16,0,Vinnitsa
640,621,42,258,341,41,382,0,382,5,182,195,21.04.2019 20:23,16,0,Vinnitsa
16,15,5,5,6,5,11,0,11,0,1,10,21.04.2019 20:57,16,0,Vinnitsa
768,752,17,346,408,14,422,0,422,5,269,148,22.04.2019 01:22,16,0,Vinnitsa
784,772,2,354,428,2,430,0,430,3,292,135,22.04.2019 00:35,16,0,Vinnitsa
704,679,3,323,378,3,381,0,381,11,248,122,22.04.2019 00:10,16,0,Vinnitsa
2064,2028,21,1036,1011,17,1028,0,1028,29,629,370,21.04.2019 21:55,16,0,Vinnitsa
96,46,36,55,10,31,41,0,41,3,23,15,22.04.2019 00:20,16,0,Vinnitsa
2512,2456,17,1342,1155,15,1170,0,1170,30,827,313,22.04.2019 00:35,16,0,Vinnitsa
2192,2146,27,1084,1082,26,1108,0,1108,34,743,331,22.04.2019 00:14,16,0,Vinnitsa
2016,1987,36,979,1004,33,1037,0,1037,27,693,317,22.04.2019 00:25,16,0,Vinnitsa
2208,2154,30,1087,1096,25,1121,0,1121,27,823,271,22.04.2019 00:15,16,0,Vinnitsa
528,512,26,189,318,21,339,0,339,4,269,66,21.04.2019 21:21,16,0,Vinnitsa
560,541,27,276,263,21,284,0,284,6,228,50,21.04.2019 23:15,16,0,Vinnitsa
272,269,17,140,117,15,132,0,132,1,96,35,21.04.2019 20:58,16,0,Vinnitsa
960,938,44,436,480,44,524,0,524,10,369,145,21.04.2019 20:53,16,0,Vinnitsa
1024,999,65,459,506,59,565,0,565,4,405,156,21.04.2019 21:00,16,0,Vinnitsa
912,902,38,447,429,36,465,0,465,6,332,127,21.04.2019 21:59,16,0,Vinnitsa
576,559,39,288,253,35,288,0,288,1,213,74,21.04.2019 23:20,16,0,Vinnitsa
80,68,5,36,39,5,44,0,44,1,27,16,21.04.2019 21:50,16,0,Vinnitsa
864,853,15,396,453,15,468,0,468,11,333,124,22.04.2019 00:20,16,0,Vinnitsa
784,738,33,380,376,28,404,0,404,11,302,91,22.04.2019 00:15,16,0,Vinnitsa
592,579,11,294,288,10,298,0,298,2,231,65,22.04.2019 00:10,16,0,Vinnitsa
1136,1117,39,494,608,34,642,0,642,14,354,274,21.04.2019 22:00,16,0,Vinnitsa
1120,1116,106,443,590,87,677,0,677,11,295,371,22.04.2019 00:10,16,0,Vinnitsa
480,458,24,254,203,23,226,0,226,3,154,69,22.04.2019 01:15,16,0,Vinnitsa
928,909,39,409,485,34,519,0,519,12,360,147,22.04.2019 00:20,16,0,Vinnitsa
912,899,54,434,430,48,478,0,478,8,336,134,22.04.2019 00:59,16,0,Vinnitsa
640,628,57,271,312,57,369,0,369,8,298,63,21.04.2019 22:30,16,0,Vinnitsa
368,353,37,165,170,33,203,0,203,2,147,54,21.04.2019 21:30,16,0,Vinnitsa
448,426,33,218,199,31,230,0,230,3,177,50,21.04.2019 23:15,16,0,Vinnitsa
1120,1081,51,524,552,44,596,0,596,15,452,129,22.04.2019 00:45,16,0,Vinnitsa
608,596,41,229,341,38,379,0,379,2,282,95,22.04.2019 00:30,16,0,Vinnitsa
336,321,25,136,175,25,200,0,200,0,153,47,21.04.2019 20:58,16,0,Vinnitsa
400,379,23,167,212,21,233,0,233,8,150,75,21.04.2019 21:15,16,0,Vinnitsa
816,797,48,352,416,48,464,0,464,12,311,141,21.04.2019 21:20,16,0,Vinnitsa
208,208,17,58,133,17,150,0,150,2,80,68,22.04.2019 00:06,16,0,Vinnitsa
512,503,23,218,271,23,294,0,294,5,223,66,22.04.2019 00:40,16,0,Vinnitsa
176,169,7,97,73,6,79,0,79,0,55,24,22.04.2019 00:02,16,0,Vinnitsa
320,298,6,172,142,6,148,0,148,3,116,29,22.04.2019 00:47,16,0,Vinnitsa
352,337,6,192,154,6,160,0,160,0,96,64,21.04.2019 23:05,16,0,Vinnitsa
336,324,17,181,141,14,155,0,155,2,102,51,22.04.2019 00:15,16,0,Vinnitsa
592,568,57,264,274,54,328,0,328,6,251,71,21.04.2019 22:30,16,0,Vinnitsa
640,615,38,320,284,36,320,0,320,3,254,63,22.04.2019 00:20,16,0,Vinnitsa
240,223,15,116,112,12,124,0,124,3,86,35,22.04.2019 00:15,16,0,Vinnitsa
1280,1267,71,645,575,60,635,0,635,17,525,93,22.04.2019 00:30,16,0,Vinnitsa
128,76,15,54,59,15,74,0,74,0,36,38,21.04.2019 23:45,16,0,Vinnitsa
1104,1076,18,551,536,17,553,0,553,14,427,112,21.04.2019 22:00,16,0,Vinnitsa
896,875,9,387,500,9,509,0,509,12,397,100,22.04.2019 00:45,16,0,Vinnitsa
1680,1641,15,741,927,12,939,0,939,19,740,180,21.04.2019 22:00,16,0,Vinnitsa
1632,1593,23,759,856,17,873,0,873,20,676,177,22.04.2019 00:50,16,0,Vinnitsa
1520,1487,23,666,839,15,854,0,854,24,657,173,22.04.2019 00:20,16,0,Vinnitsa
1744,1707,14,770,966,8,974,0,974,28,729,217,22.04.2019 00:05,16,0,Vinnitsa
1648,1614,19,768,867,13,880,0,880,16,641,223,22.04.2019 00:05,16,0,Vinnitsa
1856,1829,17,805,1038,13,1051,0,1051,28,792,231,22.04.2019 01:10,16,0,Vinnitsa
1664,1632,23,733,911,20,931,0,931,17,738,176,21.04.2019 22:00,16,0,Vinnitsa
1392,1368,12,700,681,11,692,0,692,17,519,156,21.04.2019 22:00,16,0,Vinnitsa
1296,1272,16,613,671,12,683,0,683,29,517,137,22.04.2019 01:20,16,0,Vinnitsa
2256,2206,40,954,1265,37,1302,0,1302,35,994,273,22.04.2019 00:20,16,0,Vinnitsa
1792,1740,6,772,1014,6,1020,0,1020,21,732,267,22.04.2019 00:15,16,0,Vinnitsa
1232,1187,34,607,598,27,625,0,625,9,473,143,22.04.2019 01:20,16,0,Vinnitsa
1648,1619,14,736,900,12,912,0,912,19,673,220,22.04.2019 00:05,16,0,Vinnitsa
240,226,8,94,138,8,146,0,146,1,113,32,21.04.2019 21:05,16,0,Vinnitsa
272,44,22,234,19,19,38,0,38,0,34,4,22.04.2019 00:30,16,0,Vinnitsa
64,36,0,28,36,0,36,0,36,2,25,9,21.04.2019 22:20,16,0,Vinnitsa
2480,2446,12,1124,1344,12,1356,0,1356,29,868,459,22.04.2019 02:10,17,0,Vinnitsa
1312,1278,8,606,700,6,706,0,706,22,465,219,22.04.2019 02:20,17,0,Vinnitsa
2000,1972,17,949,1040,11,1051,0,1051,31,780,240,22.04.2019 01:05,17,0,Vinnitsa
1584,1560,15,755,821,8,829,0,829,10,536,283,22.04.2019 00:40,17,0,Vinnitsa
912,894,9,461,442,9,451,0,451,9,301,141,22.04.2019 00:15,17,0,Vinnitsa
1680,1649,31,684,966,30,996,0,996,21,624,351,22.04.2019 00:20,17,0,Vinnitsa
1376,1352,50,580,747,49,796,0,796,6,492,298,22.04.2019 00:10,17,0,Vinnitsa
512,499,46,200,267,45,312,0,312,2,214,96,22.04.2019 00:10,17,0,Vinnitsa
336,320,42,134,163,39,202,0,202,4,166,32,22.04.2019 01:18,17,0,Vinnitsa
432,422,10,137,285,10,295,0,295,2,185,108,22.04.2019 00:31,17,0,Vinnitsa
1360,1333,29,574,758,28,786,0,786,11,490,285,22.04.2019 00:15,17,0,Vinnitsa
768,749,16,246,506,16,522,0,522,6,344,172,22.04.2019 01:05,17,0,Vinnitsa
240,228,2,102,137,1,138,0,138,0,91,47,22.04.2019 00:10,17,0,Vinnitsa
1088,1089,51,390,648,50,698,0,698,16,501,181,22.04.2019 00:25,17,0,Vinnitsa
768,760,10,213,547,8,555,0,555,6,410,139,22.04.2019 01:20,17,0,Vinnitsa
448,436,12,143,293,12,305,0,305,8,220,77,22.04.2019 00:35,17,0,Vinnitsa
512,500,57,186,269,57,326,0,326,5,232,89,22.04.2019 05:30,17,0,Vinnitsa
160,158,19,19,122,19,141,0,141,2,86,53,21.04.2019 23:55,17,0,Vinnitsa
592,573,26,264,309,19,328,0,328,9,248,71,22.04.2019 01:10,17,0,Vinnitsa
272,266,7,43,222,7,229,0,229,2,178,49,22.04.2019 00:25,17,0,Vinnitsa
848,848,51,366,433,49,482,0,482,5,343,134,22.04.2019 00:30,17,0,Vinnitsa
128,123,12,38,78,12,90,0,90,0,72,18,22.04.2019 00:30,17,0,Vinnitsa
464,453,42,157,265,42,307,0,307,4,211,92,22.04.2019 00:40,17,0,Vinnitsa
1136,1118,47,493,596,47,643,0,643,8,416,219,22.04.2019 01:08,17,0,Vinnitsa
160,158,13,28,119,13,132,0,132,2,96,34,22.04.2019 00:05,17,0,Vinnitsa
304,298,13,112,179,13,192,0,192,4,113,75,22.04.2019 01:00,17,0,Vinnitsa
320,316,10,145,165,10,175,0,175,4,130,41,22.04.2019 01:20,17,0,Vinnitsa
896,880,20,359,517,20,537,0,537,12,318,207,21.04.2019 23:40,17,0,Vinnitsa
368,355,21,147,200,21,221,0,221,4,146,71,22.04.2019 01:25,17,0,Vinnitsa
736,718,73,201,469,66,535,0,535,13,331,191,22.04.2019 01:02,17,0,Vinnitsa
736,722,49,345,343,48,391,0,391,6,255,130,22.04.2019 01:05,17,0,Vinnitsa
2416,2404,16,1051,1351,14,1365,0,1365,30,935,400,22.04.2019 00:30,17,0,Vinnitsa
864,844,34,416,414,34,448,0,448,10,317,121,22.04.2019 06:20,17,0,Vinnitsa
368,365,32,144,192,32,224,0,224,3,138,83,22.04.2019 00:20,17,0,Vinnitsa
1456,1441,92,560,805,91,896,0,896,21,603,272,22.04.2019 00:53,17,0,Vinnitsa
128,127,16,44,68,16,84,0,84,0,63,21,22.04.2019 00:25,17,0,Vinnitsa
352,341,27,114,211,27,238,0,238,6,176,56,22.04.2019 01:00,17,0,Vinnitsa
1504,1479,37,494,976,34,1010,0,1010,18,606,386,22.04.2019 00:10,17,0,Vinnitsa
800,1060,0,89,711,0,711,0,711,17,473,221,22.04.2019 00:38,17,0,Vinnitsa
2000,1965,11,941,1050,9,1059,0,1059,28,766,265,22.04.2019 00:10,17,0,Vinnitsa
1376,1350,10,565,802,9,811,0,811,17,615,179,22.04.2019 00:15,17,0,Vinnitsa
1200,1184,10,504,687,9,696,0,696,15,519,162,21.04.2019 23:55,17,0,Vinnitsa
1392,1349,8,586,801,5,806,0,806,21,542,243,22.04.2019 00:30,17,0,Vinnitsa
1184,1165,3,471,710,3,713,0,713,24,506,183,22.04.2019 00:15,17,0,Vinnitsa
1744,1725,7,706,1034,4,1038,0,1038,31,780,227,22.04.2019 00:34,17,0,Vinnitsa
1584,1563,6,663,915,6,921,0,921,31,649,241,22.04.2019 00:20,17,0,Vinnitsa
1840,1838,5,678,1158,4,1162,0,1162,39,831,292,22.04.2019 01:25,17,0,Vinnitsa
1040,1024,7,451,584,5,589,0,589,6,418,165,22.04.2019 00:10,17,0,Vinnitsa
1440,1413,10,587,845,8,853,0,853,15,610,228,22.04.2019 00:10,17,0,Vinnitsa
464,453,41,176,247,41,288,0,288,3,196,89,22.04.2019 01:15,17,0,Vinnitsa
224,216,27,69,128,27,155,0,155,2,91,62,22.04.2019 00:10,17,0,Vinnitsa
688,681,16,208,464,16,480,0,480,11,244,225,22.04.2019 00:08,17,0,Vinnitsa
192,187,1,65,126,1,127,0,127,1,78,48,22.04.2019 01:10,17,0,Vinnitsa
64,55,4,25,35,4,39,0,39,2,20,17,22.04.2019 01:10,17,0,Vinnitsa
640,620,38,243,359,38,397,0,397,10,314,73,22.04.2019 00:15,17,0,Vinnitsa
608,593,39,279,293,36,329,0,329,4,235,90,22.04.2019 00:20,17,0,Vinnitsa
496,480,30,205,261,30,291,0,291,4,226,61,22.04.2019 00:15,17,0,Vinnitsa
416,404,24,160,233,23,256,0,256,9,181,66,22.04.2019 00:14,17,0,Vinnitsa
1360,1336,40,627,695,38,733,0,733,18,453,262,22.04.2019 00:30,17,0,Vinnitsa
368,362,16,160,194,14,208,0,208,0,133,75,22.04.2019 00:11,17,0,Vinnitsa
160,152,10,52,98,10,108,0,108,2,74,32,22.04.2019 00:20,17,0,Vinnitsa
480,479,31,206,243,31,274,0,274,6,171,97,22.04.2019 00:04,17,0,Vinnitsa
192,188,9,75,108,9,117,0,117,2,56,59,21.04.2019 22:00,17,0,Vinnitsa
784,775,60,328,396,60,456,0,456,11,282,163,22.04.2019 00:15,17,0,Vinnitsa
160,153,7,66,88,6,94,0,94,5,65,24,22.04.2019 00:05,17,0,Vinnitsa
48,43,4,25,19,4,23,0,23,0,8,15,22.04.2019 00:30,17,0,Vinnitsa
720,710,31,268,422,30,452,0,452,6,322,124,21.04.2019 23:40,17,0,Vinnitsa
752,741,38,209,505,38,543,0,543,15,400,128,22.04.2019 00:05,17,0,Vinnitsa
448,447,19,158,272,18,290,0,290,0,240,50,22.04.2019 00:45,17,0,Vinnitsa
240,229,11,123,106,11,117,0,117,3,73,41,22.04.2019 00:20,17,0,Vinnitsa
1072,1054,86,221,768,83,851,0,851,19,603,229,22.04.2019 00:10,17,0,Vinnitsa
544,534,45,211,289,44,333,0,333,6,212,115,22.04.2019 01:10,17,0,Vinnitsa
80,79,6,21,53,6,59,0,59,0,36,23,22.04.2019 00:19,17,0,Vinnitsa
240,234,24,87,131,22,153,0,153,2,98,53,22.04.2019 00:05,17,0,Vinnitsa
1376,1359,15,523,844,9,853,0,853,22,543,288,22.04.2019 00:10,17,0,Vinnitsa
160,154,13,48,103,9,112,0,112,2,74,36,22.04.2019 00:56,17,0,Vinnitsa
384,379,19,146,220,18,238,0,238,5,129,104,22.04.2019 00:07,17,0,Vinnitsa
720,698,12,284,426,10,436,0,436,15,288,133,22.04.2019 00:40,17,0,Vinnitsa
432,420,19,152,261,19,280,0,280,5,181,94,22.04.2019 01:00,17,0,Vinnitsa
224,207,14,72,138,14,152,0,152,0,119,33,22.04.2019 01:30,17,0,Vinnitsa
336,321,13,93,230,13,243,0,243,3,145,95,21.04.2019 23:55,17,0,Vinnitsa
432,423,7,195,231,6,237,0,237,8,142,87,22.04.2019 00:10,17,0,Vinnitsa
448,446,26,177,245,26,271,0,271,0,180,91,22.04.2019 00:10,17,0,Vinnitsa
144,126,13,64,67,13,80,0,80,3,52,25,22.04.2019 00:07,17,0,Vinnitsa
1024,1007,76,291,657,76,733,0,733,11,451,271,22.04.2019 00:10,17,0,Vinnitsa
544,531,24,150,372,22,394,0,394,4,307,83,22.04.2019 01:40,17,0,Vinnitsa
80,74,0,21,59,0,59,0,59,1,36,22,22.04.2019 00:05,17,0,Vinnitsa
688,682,58,238,397,53,450,0,450,9,318,123,22.04.2019 00:28,17,0,Vinnitsa
608,594,48,145,418,45,463,0,463,5,283,175,22.04.2019 01:10,17,0,Vinnitsa
480,471,35,176,269,35,304,0,304,4,224,76,22.04.2019 00:20,17,0,Vinnitsa
224,217,18,83,123,18,141,0,141,1,90,50,21.04.2019 23:50,17,0,Vinnitsa
272,333,32,59,181,32,213,0,213,5,145,63,21.04.2019 21:45,17,0,Vinnitsa
496,501,41,148,308,40,348,0,348,9,230,109,22.04.2019 00:03,17,0,Vinnitsa
656,636,8,245,405,6,411,0,411,9,304,98,22.04.2019 00:01,17,0,Vinnitsa
768,763,32,268,468,32,500,0,500,9,358,133,22.04.2019 00:20,17,0,Vinnitsa
384,370,25,127,233,24,257,0,257,9,162,86,22.04.2019 00:40,17,0,Vinnitsa
288,278,13,77,199,12,211,0,211,3,151,57,22.04.2019 00:10,17,0,Vinnitsa
624,603,18,275,332,17,349,0,349,9,263,77,22.04.2019 00:09,17,0,Vinnitsa
240,236,8,100,135,5,140,0,140,2,87,51,22.04.2019 00:15,17,0,Vinnitsa
304,82,58,237,12,55,67,0,67,1,28,38,22.04.2019 00:20,17,0,Vinnitsa
1776,1736,18,713,1048,15,1063,0,1063,24,746,293,22.04.2019 03:05,17,0,Vinnitsa
1552,1516,16,647,894,11,905,0,905,23,645,237,22.04.2019 00:22,17,0,Vinnitsa
1856,1827,17,751,1089,16,1105,0,1105,22,782,301,22.04.2019 01:30,17,0,Vinnitsa
752,737,17,293,442,17,459,0,459,8,320,131,22.04.2019 00:35,17,0,Vinnitsa
128,120,8,36,87,5,92,0,92,1,60,31,22.04.2019 00:02,17,0,Vinnitsa
432,427,4,189,239,4,243,0,243,4,149,90,22.04.2019 00:30,17,0,Vinnitsa
560,543,23,240,303,17,320,0,320,7,174,139,22.04.2019 00:25,17,0,Vinnitsa
448,436,21,234,196,18,214,0,214,2,141,71,22.04.2019 00:15,17,0,Vinnitsa
560,550,7,237,316,7,323,0,323,3,270,50,22.04.2019 01:50,17,0,Vinnitsa
384,370,17,154,214,16,230,0,230,4,168,58,22.04.2019 00:05,17,0,Vinnitsa
656,638,2,236,418,2,420,0,420,8,323,89,22.04.2019 01:00,17,0,Vinnitsa
480,478,15,177,288,15,303,0,303,6,205,92,22.04.2019 00:10,17,0,Vinnitsa
128,126,0,53,75,0,75,0,75,1,47,27,22.04.2019 01:00,17,0,Vinnitsa
176,168,5,85,89,2,91,0,91,6,56,29,22.04.2019 00:45,17,0,Vinnitsa
272,271,11,100,161,11,172,0,172,7,127,38,22.04.2019 00:40,17,0,Vinnitsa
800,790,21,337,443,20,463,0,463,5,310,148,22.04.2019 00:02,17,0,Vinnitsa
208,203,23,82,106,20,126,0,126,1,84,41,22.04.2019 00:05,17,0,Vinnitsa
624,606,17,142,466,16,482,0,482,6,334,142,22.04.2019 00:30,17,0,Vinnitsa
464,448,34,134,296,34,330,0,330,9,211,110,22.04.2019 00:25,17,0,Vinnitsa
480,466,3,209,268,3,271,0,271,6,171,94,22.04.2019 00:10,17,0,Vinnitsa
352,340,34,102,218,32,250,0,250,3,172,75,22.04.2019 00:30,17,0,Vinnitsa
96,90,3,30,65,1,66,0,66,1,42,23,22.04.2019 01:10,17,0,Vinnitsa
480,470,9,195,276,9,285,0,285,5,220,60,22.04.2019 00:30,17,0,Vinnitsa
160,158,23,31,107,22,129,0,129,2,90,37,22.04.2019 01:20,17,0,Vinnitsa
288,273,11,121,158,9,167,0,167,1,112,54,22.04.2019 00:15,17,0,Vinnitsa
832,819,19,453,364,15,379,0,379,2,253,124,22.04.2019 01:15,17,0,Vinnitsa
704,683,8,324,373,7,380,0,380,7,249,124,22.04.2019 00:05,17,0,Vinnitsa
752,731,11,333,408,11,419,0,419,7,284,128,22.04.2019 00:40,17,0,Vinnitsa
176,169,5,33,138,5,143,0,143,1,92,50,22.04.2019 01:00,17,0,Vinnitsa
256,250,10,48,201,7,208,0,208,2,149,57,22.04.2019 02:00,17,0,Vinnitsa
688,670,10,309,369,10,379,0,379,4,293,82,22.04.2019 01:30,17,0,Vinnitsa
256,244,11,91,156,9,165,0,165,2,101,62,22.04.2019 00:20,17,0,Vinnitsa
416,397,16,130,270,16,286,0,286,6,240,40,22.04.2019 00:15,17,0,Vinnitsa
272,261,3,105,164,3,167,0,167,4,117,46,22.04.2019 00:45,17,0,Vinnitsa
176,159,0,56,120,0,120,0,120,6,89,25,22.04.2019 00:10,17,0,Vinnitsa
544,539,12,199,333,12,345,0,345,2,218,125,22.04.2019 01:00,17,0,Vinnitsa
416,403,9,164,247,5,252,0,252,5,140,107,22.04.2019 00:45,17,0,Vinnitsa
624,601,32,293,301,30,331,0,331,8,252,71,22.04.2019 01:15,17,0,Vinnitsa
288,276,16,121,153,14,167,0,167,4,111,52,22.04.2019 00:25,17,0,Vinnitsa
128,39,4,92,32,4,36,0,36,0,26,10,22.04.2019 00:55,17,0,Vinnitsa
48,11,8,37,3,8,11,0,11,0,5,6,22.04.2019 00:40,17,0,Vinnitsa
1776,1753,19,737,1021,18,1039,0,1039,23,709,307,22.04.2019 00:56,17,0,Vinnitsa
2112,2077,12,871,1232,9,1241,0,1241,26,891,324,22.04.2019 00:05,17,0,Vinnitsa
2208,2152,5,918,1285,5,1290,0,1290,30,873,387,22.04.2019 01:25,17,0,Vinnitsa
544,539,37,188,319,37,356,0,356,3,183,170,22.04.2019 00:25,17,0,Vinnitsa
144,133,9,63,73,8,81,0,81,1,41,39,22.04.2019 00:15,17,0,Vinnitsa
912,894,53,264,595,53,648,0,648,14,467,167,22.04.2019 00:50,17,0,Vinnitsa
1120,1104,43,283,797,40,837,0,837,8,553,276,22.04.2019 01:45,17,0,Vinnitsa
912,901,63,298,553,61,614,0,614,13,432,169,22.04.2019 00:10,17,0,Vinnitsa
512,490,37,176,300,36,336,0,336,4,257,75,22.04.2019 00:20,17,0,Vinnitsa
1424,1401,11,638,775,11,786,0,786,10,545,231,22.04.2019 00:35,17,0,Vinnitsa
720,696,8,329,383,8,391,0,391,4,301,86,22.04.2019 00:20,17,0,Vinnitsa
672,654,25,297,352,23,375,0,375,9,247,119,22.04.2019 01:30,17,0,Vinnitsa
208,203,7,53,148,7,155,0,155,2,65,88,21.04.2019 21:10,17,0,Vinnitsa
144,135,4,61,79,4,83,0,83,0,58,25,22.04.2019 00:25,17,0,Vinnitsa
576,559,32,231,315,30,345,0,345,11,184,150,22.04.2019 00:20,17,0,Vinnitsa
1200,1183,3,545,652,3,655,0,655,16,426,213,22.04.2019 01:30,17,0,Vinnitsa
784,766,5,360,419,5,424,0,424,5,324,95,22.04.2019 01:20,17,0,Vinnitsa
480,472,14,109,357,14,371,0,371,3,226,142,22.04.2019 02:20,17,0,Vinnitsa
336,329,16,125,195,16,211,0,211,2,123,86,22.04.2019 00:15,17,0,Vinnitsa
896,884,7,351,538,7,545,0,545,8,385,152,22.04.2019 00:12,17,0,Vinnitsa
736,722,11,248,477,11,488,0,488,3,341,144,22.04.2019 00:04,17,0,Vinnitsa
80,72,5,27,49,4,53,0,53,1,40,12,22.04.2019 00:15,17,0,Vinnitsa
1264,1238,84,566,621,77,698,0,698,13,539,146,21.04.2019 21:00,17,0,Vinnitsa
976,959,41,355,580,41,621,0,621,15,452,154,22.04.2019 00:30,17,0,Vinnitsa
128,119,0,52,76,0,76,0,76,0,62,14,22.04.2019 00:05,17,0,Vinnitsa
576,569,11,178,387,11,398,0,398,8,217,173,22.04.2019 00:30,17,0,Vinnitsa
464,459,5,217,243,4,247,0,247,5,165,77,22.04.2019 00:25,17,0,Vinnitsa
624,620,19,284,321,19,340,0,340,5,233,102,22.04.2019 00:20,17,0,Vinnitsa
240,232,11,78,151,11,162,0,162,4,79,79,22.04.2019 00:05,17,0,Vinnitsa
144,42,25,112,15,17,32,0,32,1,23,8,22.04.2019 00:35,17,0,Vinnitsa
2224,2196,41,757,1436,31,1467,0,1467,38,1086,343,22.04.2019 00:20,17,0,Vinnitsa
2416,2412,41,822,1563,31,1594,0,1594,27,1156,411,22.04.2019 01:45,17,0,Vinnitsa
896,866,19,363,516,17,533,0,533,14,378,141,22.04.2019 00:35,17,0,Vinnitsa
1760,1727,47,701,1029,30,1059,0,1059,25,818,216,22.04.2019 00:10,17,0,Vinnitsa
592,581,29,250,315,27,342,0,342,11,260,71,22.04.2019 00:20,17,0,Vinnitsa
288,278,3,107,178,3,181,0,181,4,124,53,22.04.2019 00:30,17,0,Vinnitsa
1536,1531,14,559,966,11,977,0,977,26,694,257,22.04.2019 00:16,17,0,Vinnitsa
2032,2025,27,690,1327,15,1342,0,1342,38,965,339,22.04.2019 00:06,17,0,Vinnitsa
2144,2088,14,779,1354,11,1365,0,1365,41,949,375,22.04.2019 01:30,17,0,Vinnitsa
2176,2142,17,857,1309,10,1319,0,1319,37,952,330,22.04.2019 00:41,17,0,Vinnitsa
1104,1092,8,381,718,5,723,0,723,17,517,189,22.04.2019 00:15,17,0,Vinnitsa
112,10,9,103,1,8,9,0,9,0,6,3,22.04.2019 00:20,17,0,Vinnitsa
448,427,25,145,279,24,303,0,303,11,222,70,22.04.2019 00:30,18,0,Vinnitsa
752,745,40,258,461,33,494,0,494,9,349,136,22.04.2019 02:05,18,0,Vinnitsa
1104,1082,9,352,744,8,752,0,752,15,499,238,22.04.2019 00:20,18,0,Vinnitsa
1376,1340,6,503,868,5,873,0,873,24,589,260,22.04.2019 00:09,18,0,Vinnitsa
2096,2070,31,826,1239,31,1270,0,1270,35,849,386,22.04.2019 00:20,18,0,Vinnitsa
1088,1067,22,405,668,15,683,0,683,19,442,222,22.04.2019 00:15,18,0,Vinnitsa
800,787,27,303,478,19,497,0,497,17,299,181,22.04.2019 00:50,18,0,Vinnitsa
304,300,17,111,176,17,193,0,193,4,133,56,22.04.2019 00:40,18,0,Vinnitsa
928,908,36,392,503,33,536,0,536,10,345,181,22.04.2019 00:35,18,0,Vinnitsa
896,874,61,357,482,57,539,0,539,8,339,192,21.04.2019 20:33,18,0,Vinnitsa
448,446,39,160,249,39,288,0,288,6,202,80,22.04.2019 00:23,18,0,Vinnitsa
432,420,31,168,233,31,264,0,264,5,161,98,22.04.2019 00:08,18,0,Vinnitsa
192,189,5,66,123,3,126,0,126,0,81,45,22.04.2019 00:45,18,0,Vinnitsa
336,328,18,128,191,17,208,0,208,6,164,38,22.04.2019 00:06,18,0,Vinnitsa
368,359,37,129,207,32,239,0,239,7,122,110,22.04.2019 00:40,18,0,Vinnitsa
528,526,31,240,258,30,288,0,288,6,188,94,22.04.2019 00:47,18,0,Vinnitsa
576,558,39,251,292,33,325,0,325,8,226,91,22.04.2019 00:55,18,0,Vinnitsa
720,702,39,302,381,37,418,0,418,5,299,114,22.04.2019 00:05,18,0,Vinnitsa
80,68,4,31,46,3,49,0,49,0,37,12,22.04.2019 00:02,18,0,Vinnitsa
512,493,23,209,281,22,303,0,303,6,169,128,22.04.2019 00:10,18,0,Vinnitsa
256,252,22,73,163,20,183,0,183,2,109,72,22.04.2019 00:10,18,0,Vinnitsa
880,859,39,318,525,37,562,0,562,5,381,176,22.04.2019 00:40,18,0,Vinnitsa
208,205,15,68,125,15,140,0,140,1,107,32,22.04.2019 00:15,18,0,Vinnitsa
432,411,28,192,214,26,240,0,240,4,130,106,22.04.2019 05:58,18,0,Vinnitsa
640,623,23,259,358,23,381,0,381,9,278,94,22.04.2019 00:30,18,0,Vinnitsa
384,373,41,137,209,38,247,0,247,5,147,95,22.04.2019 03:10,18,0,Vinnitsa
112,109,19,48,51,13,64,0,64,0,42,22,22.04.2019 00:15,18,0,Vinnitsa
416,411,24,133,262,21,283,0,283,8,181,94,22.04.2019 00:15,18,0,Vinnitsa
272,269,23,69,181,22,203,0,203,1,147,55,22.04.2019 00:10,18,0,Vinnitsa
304,296,29,108,170,26,196,0,196,3,128,65,21.04.2019 23:35,18,0,Vinnitsa
144,135,7,59,78,7,85,0,85,2,49,34,22.04.2019 00:15,18,0,Vinnitsa
320,317,33,105,182,33,215,0,215,6,120,89,22.04.2019 01:05,18,0,Vinnitsa
432,413,37,153,249,30,279,0,279,6,190,83,22.04.2019 00:30,18,0,Vinnitsa
80,68,4,34,43,3,46,0,46,0,24,22,22.04.2019 00:05,18,0,Vinnitsa
320,312,27,129,165,26,191,0,191,4,89,98,22.04.2019 00:40,18,0,Vinnitsa
928,913,60,205,669,54,723,0,723,12,513,198,22.04.2019 00:40,18,0,Vinnitsa
416,436,47,147,229,40,269,0,269,7,165,97,22.04.2019 01:20,18,0,Vinnitsa
208,200,12,87,110,11,121,0,121,0,88,33,22.04.2019 00:20,18,0,Vinnitsa
448,432,21,141,286,21,307,0,307,9,215,83,22.04.2019 00:05,18,0,Vinnitsa
256,239,11,126,121,9,130,0,130,0,95,35,22.04.2019 01:05,18,0,Vinnitsa
336,326,32,127,179,30,209,0,209,0,144,65,22.04.2019 00:10,18,0,Vinnitsa
672,656,52,213,410,49,459,0,459,2,298,159,21.04.2019 23:15,18,0,Vinnitsa
384,385,19,131,238,15,253,0,253,2,167,84,22.04.2019 00:20,18,0,Vinnitsa
256,249,29,66,161,29,190,0,190,1,137,52,22.04.2019 00:30,18,0,Vinnitsa
448,439,30,173,247,28,275,0,275,5,182,88,22.04.2019 00:20,18,0,Vinnitsa
272,265,17,85,170,17,187,0,187,0,127,60,22.04.2019 00:05,18,0,Vinnitsa
288,284,15,108,165,15,180,0,180,1,107,72,22.04.2019 00:05,18,0,Vinnitsa
64,56,5,16,43,5,48,0,48,0,34,14,22.04.2019 00:10,18,0,Vinnitsa
144,143,7,40,97,7,104,0,104,2,44,58,22.04.2019 00:30,18,0,Vinnitsa
160,19,15,148,3,9,12,0,12,0,10,2,22.04.2019 00:15,18,0,Vinnitsa
32,25,19,11,4,17,21,0,21,0,17,4,21.04.2019 20:50,18,0,Vinnitsa
1472,1429,16,598,859,15,874,0,874,21,551,302,22.04.2019 01:00,18,0,Vinnitsa
1136,1116,11,425,701,10,711,0,711,17,465,229,22.04.2019 00:45,18,0,Vinnitsa
400,388,23,141,236,23,259,0,259,7,154,98,22.04.2019 00:05,18,0,Vinnitsa
1920,1884,16,727,1184,9,1193,0,1193,21,797,375,22.04.2019 00:35,18,0,Vinnitsa
1360,1335,21,613,730,17,747,0,747,20,522,205,22.04.2019 00:05,18,0,Vinnitsa
1088,1066,12,423,654,11,665,0,665,17,433,215,22.04.2019 01:50,18,0,Vinnitsa
176,181,13,46,117,13,130,0,130,0,62,68,22.04.2019 00:05,18,0,Vinnitsa
288,251,22,85,181,22,203,0,203,8,115,80,22.04.2019 00:20,18,0,Vinnitsa
272,268,22,106,147,19,166,0,166,6,87,73,22.04.2019 00:15,18,0,Vinnitsa
32,25,8,17,7,8,15,0,15,0,7,8,22.04.2019 00:29,18,0,Vinnitsa
288,267,28,113,148,27,175,0,175,1,109,65,22.04.2019 00:50,18,0,Vinnitsa
192,184,22,80,91,21,112,0,112,1,82,29,22.04.2019 00:05,18,0,Vinnitsa
320,311,9,139,173,8,181,0,181,3,101,77,22.04.2019 00:30,18,0,Vinnitsa
528,522,21,185,322,21,343,0,343,4,223,116,22.04.2019 00:20,18,0,Vinnitsa
144,142,1,47,96,1,97,0,97,4,57,36,22.04.2019 07:10,18,0,Vinnitsa
336,328,21,101,214,21,235,0,235,1,123,111,22.04.2019 00:15,18,0,Vinnitsa
1600,1582,49,658,896,46,942,0,942,14,573,355,22.04.2019 00:25,18,0,Vinnitsa
320,314,6,149,166,5,171,0,171,2,116,53,22.04.2019 00:15,18,0,Vinnitsa
400,380,36,156,210,34,244,0,244,3,154,87,22.04.2019 00:10,18,0,Vinnitsa
352,333,28,125,200,27,227,0,227,6,112,109,22.04.2019 00:05,18,0,Vinnitsa
320,314,10,129,181,10,191,0,191,0,141,50,22.04.2019 00:25,18,0,Vinnitsa
96,91,6,41,49,6,55,0,55,2,26,27,22.04.2019 00:25,18,0,Vinnitsa
64,54,2,18,45,1,46,0,46,0,20,26,22.04.2019 01:05,18,0,Vinnitsa
368,360,41,137,194,37,231,0,231,3,140,88,22.04.2019 00:10,18,0,Vinnitsa
656,636,10,289,358,9,367,0,367,5,140,222,22.04.2019 00:10,18,0,Vinnitsa
128,122,5,61,62,5,67,0,67,2,32,33,22.04.2019 00:05,18,0,Vinnitsa
208,200,16,72,125,11,136,0,136,1,87,48,22.04.2019 00:30,18,0,Vinnitsa
128,113,14,55,61,12,73,0,73,1,37,35,22.04.2019 00:07,18,0,Vinnitsa
304,321,22,55,228,21,249,0,249,7,119,123,22.04.2019 01:30,18,0,Vinnitsa
864,840,32,414,420,30,450,0,450,10,231,209,22.04.2019 00:45,18,0,Vinnitsa
304,303,7,114,184,6,190,0,190,7,112,71,22.04.2019 06:05,18,0,Vinnitsa
304,289,8,126,171,7,178,0,178,6,89,83,22.04.2019 00:30,18,0,Vinnitsa
256,242,13,92,151,13,164,0,164,4,98,62,22.04.2019 00:05,18,0,Vinnitsa
304,287,17,99,188,17,205,0,205,3,144,58,22.04.2019 07:00,18,0,Vinnitsa
256,241,27,95,136,25,161,0,161,1,83,77,22.04.2019 00:25,18,0,Vinnitsa
432,417,43,170,225,37,262,0,262,3,109,150,21.04.2019 23:45,18,0,Vinnitsa
64,57,7,26,33,5,38,0,38,0,31,7,21.04.2019 23:55,18,0,Vinnitsa
80,75,4,27,49,4,53,0,53,0,35,18,22.04.2019 00:06,18,0,Vinnitsa
240,239,10,84,147,9,156,0,156,6,103,47,22.04.2019 00:10,18,0,Vinnitsa
768,758,33,309,426,33,459,0,459,8,262,189,22.04.2019 04:51,18,0,Vinnitsa
144,46,11,108,25,11,36,0,36,1,27,8,22.04.2019 00:15,18,0,Vinnitsa
1760,1760,23,624,1113,23,1136,0,1136,33,781,322,22.04.2019 00:10,18,0,Vinnitsa
1744,1760,10,632,1106,6,1112,0,1112,29,752,331,22.04.2019 01:45,18,0,Vinnitsa
1360,1348,22,434,905,21,926,0,926,32,627,267,22.04.2019 00:50,18,0,Vinnitsa
1696,1669,17,542,1137,17,1154,0,1154,19,711,424,22.04.2019 00:45,18,0,Vinnitsa
1872,1810,8,739,1125,8,1133,0,1133,27,712,394,22.04.2019 00:05,18,0,Vinnitsa
1120,1100,55,520,569,31,600,0,600,39,400,161,22.04.2019 00:10,18,0,Vinnitsa
1456,1423,13,614,831,11,842,0,842,8,572,262,22.04.2019 00:15,18,0,Vinnitsa
1120,1100,25,462,633,25,658,0,658,10,492,156,22.04.2019 00:10,18,0,Vinnitsa
928,923,45,345,538,45,583,0,583,10,361,212,22.04.2019 00:30,18,0,Vinnitsa
816,788,28,393,397,26,423,0,423,4,282,137,22.04.2019 00:05,18,0,Vinnitsa
80,80,19,23,38,19,57,0,57,2,25,30,22.04.2019 02:45,18,0,Vinnitsa
128,115,24,32,72,24,96,0,96,3,47,46,21.04.2019 23:56,18,0,Vinnitsa
304,297,18,86,200,18,218,0,218,4,102,112,22.04.2019 01:55,18,0,Vinnitsa
240,231,34,67,139,34,173,0,173,1,82,90,22.04.2019 00:30,18,0,Vinnitsa
400,401,32,144,224,32,256,0,256,6,135,115,22.04.2019 00:10,18,0,Vinnitsa
400,388,27,149,225,26,251,0,251,4,121,126,22.04.2019 00:10,18,0,Vinnitsa
624,621,46,194,384,46,430,0,430,5,270,155,22.04.2019 01:05,18,0,Vinnitsa
144,137,19,38,88,18,106,0,106,0,59,47,22.04.2019 00:30,18,0,Vinnitsa
288,309,29,45,215,28,243,0,243,5,145,93,22.04.2019 00:45,18,0,Vinnitsa
256,247,23,76,159,21,180,0,180,1,114,65,22.04.2019 00:21,18,0,Vinnitsa
320,315,22,106,192,22,214,0,214,3,124,87,22.04.2019 00:15,18,0,Vinnitsa
384,369,26,197,162,25,187,0,187,1,120,66,22.04.2019 00:10,18,0,Vinnitsa
272,258,27,85,161,26,187,0,187,6,133,48,22.04.2019 00:30,18,0,Vinnitsa
256,253,32,84,147,25,172,0,172,3,104,65,22.04.2019 03:15,18,0,Vinnitsa
224,222,16,59,151,14,165,0,165,2,92,71,22.04.2019 00:05,18,0,Vinnitsa
192,191,20,44,128,20,148,0,148,2,100,46,22.04.2019 00:10,18,0,Vinnitsa
192,182,15,63,114,15,129,0,129,2,70,57,22.04.2019 00:10,18,0,Vinnitsa
160,160,8,50,102,8,110,0,110,0,61,49,22.04.2019 00:05,18,0,Vinnitsa
192,193,9,64,119,9,128,0,128,5,72,51,22.04.2019 00:10,18,0,Vinnitsa
64,75,8,15,41,8,49,0,49,1,28,20,22.04.2019 00:20,18,0,Vinnitsa
1104,1093,31,443,632,29,661,0,661,12,413,236,22.04.2019 00:05,18,0,Vinnitsa
496,491,34,139,323,34,357,0,357,6,200,151,22.04.2019 00:20,18,0,Vinnitsa
1056,1036,18,440,599,17,616,0,616,17,372,227,22.04.2019 00:15,18,0,Vinnitsa
1536,1510,20,662,854,20,874,0,874,23,560,291,22.04.2019 00:20,18,0,Vinnitsa
160,151,16,51,93,16,109,0,109,0,59,50,22.04.2019 00:10,18,0,Vinnitsa
176,168,23,58,96,22,118,0,118,1,83,34,22.04.2019 00:10,18,0,Vinnitsa
320,319,37,104,180,36,216,0,216,8,133,75,22.04.2019 01:05,18,0,Vinnitsa
160,163,16,22,122,16,138,0,138,0,90,48,22.04.2019 03:45,18,0,Vinnitsa
240,232,22,80,140,20,160,0,160,1,62,97,22.04.2019 00:10,18,0,Vinnitsa
256,252,21,72,163,21,184,0,184,1,89,94,22.04.2019 01:20,18,0,Vinnitsa
640,622,57,222,362,56,418,0,418,6,263,149,22.04.2019 00:20,18,0,Vinnitsa
416,408,30,70,316,30,346,0,346,6,221,119,21.04.2019 20:40,18,0,Vinnitsa
272,263,27,87,158,27,185,0,185,1,124,60,22.04.2019 00:30,18,0,Vinnitsa
240,228,29,89,122,29,151,0,151,4,72,75,22.04.2019 00:40,18,0,Vinnitsa
400,391,37,128,235,37,272,0,272,8,147,117,22.04.2019 00:10,18,0,Vinnitsa
1120,1100,35,430,659,31,690,0,690,15,460,215,22.04.2019 01:05,18,0,Vinnitsa
96,83,7,37,53,6,59,0,59,1,24,34,22.04.2019 00:44,18,0,Vinnitsa
320,316,32,112,176,32,208,0,208,3,97,108,21.04.2019 23:05,18,0,Vinnitsa
192,190,17,74,103,15,118,0,118,1,52,65,22.04.2019 00:45,18,0,Vinnitsa
496,497,52,182,266,48,314,0,314,5,167,142,22.04.2019 00:01,18,0,Vinnitsa
224,217,35,59,133,32,165,0,165,0,128,37,22.04.2019 00:30,18,0,Vinnitsa
352,342,22,80,250,22,272,0,272,3,162,107,22.04.2019 00:40,18,0,Vinnitsa
416,401,40,144,234,38,272,0,272,3,163,106,22.04.2019 00:01,18,0,Vinnitsa
736,709,36,267,440,29,469,0,469,4,313,152,21.04.2019 23:50,18,0,Vinnitsa
160,152,11,42,107,11,118,0,118,0,74,44,22.04.2019 00:30,18,0,Vinnitsa
528,518,40,173,316,39,355,0,355,4,178,173,22.04.2019 00:30,18,0,Vinnitsa
96,89,6,29,61,6,67,0,67,0,39,28,22.04.2019 00:40,18,0,Vinnitsa
128,119,4,37,87,4,91,0,91,0,38,53,22.04.2019 00:18,18,0,Vinnitsa
656,640,56,240,360,56,416,0,416,7,274,135,22.04.2019 02:10,18,0,Vinnitsa
480,473,63,168,253,59,312,0,312,8,176,128,22.04.2019 00:30,18,0,Vinnitsa
672,655,29,197,446,29,475,0,475,7,326,142,22.04.2019 00:18,18,0,Vinnitsa
144,145,17,38,90,16,106,0,106,2,66,38,22.04.2019 00:50,18,0,Vinnitsa
96,93,12,26,58,12,70,0,70,1,38,31,22.04.2019 00:11,18,0,Vinnitsa
496,484,30,195,273,28,301,0,301,5,152,144,22.04.2019 00:45,18,0,Vinnitsa
208,194,25,74,111,23,134,0,134,2,99,33,22.04.2019 00:11,18,0,Vinnitsa
496,484,30,102,365,29,394,0,394,9,265,120,22.04.2019 00:10,18,0,Vinnitsa
128,125,11,43,74,11,85,0,85,3,52,30,22.04.2019 00:10,18,0,Vinnitsa
192,26,21,176,5,11,16,0,16,0,11,5,22.04.2019 00:45,18,0,Vinnitsa
1456,1429,48,517,893,46,939,0,939,14,602,323,22.04.2019 00:10,18,0,Vinnitsa
144,138,5,53,87,4,91,0,91,1,53,37,22.04.2019 00:10,18,0,Vinnitsa
720,717,50,233,440,47,487,0,487,10,322,155,22.04.2019 02:10,18,0,Vinnitsa
528,522,51,177,301,50,351,0,351,7,179,165,22.04.2019 00:15,18,0,Vinnitsa
464,459,38,130,299,35,334,0,334,4,207,123,22.04.2019 00:10,18,0,Vinnitsa
208,208,9,87,114,7,121,0,121,0,87,34,22.04.2019 00:15,18,0,Vinnitsa
368,363,48,136,190,42,232,0,232,2,162,68,22.04.2019 00:05,18,0,Vinnitsa
240,235,18,64,160,16,176,0,176,3,114,59,22.04.2019 02:05,18,0,Vinnitsa
208,199,10,83,117,8,125,0,125,4,84,37,22.04.2019 00:15,18,0,Vinnitsa
416,395,29,161,229,26,255,0,255,6,188,61,22.04.2019 00:18,18,0,Vinnitsa
464,457,37,108,320,36,356,0,356,9,214,133,22.04.2019 00:05,18,0,Vinnitsa
944,928,79,349,522,73,595,0,595,12,348,235,22.04.2019 00:10,18,0,Vinnitsa
576,562,8,217,352,7,359,0,359,12,246,101,22.04.2019 00:45,18,0,Vinnitsa
416,400,17,170,230,16,246,0,246,6,166,74,22.04.2019 00:05,18,0,Vinnitsa
304,285,25,141,144,19,163,0,163,2,92,69,22.04.2019 00:15,18,0,Vinnitsa
128,131,12,49,67,12,79,0,79,0,51,28,22.04.2019 00:10,18,0,Vinnitsa
320,305,28,111,186,23,209,0,209,5,107,97,22.04.2019 00:25,18,0,Vinnitsa
160,147,9,57,96,7,103,0,103,1,65,37,22.04.2019 00:15,18,0,Vinnitsa
336,333,13,119,205,12,217,0,217,2,101,114,22.04.2019 00:45,18,0,Vinnitsa
448,433,42,66,340,42,382,0,382,5,241,136,22.04.2019 00:10,18,0,Vinnitsa
768,766,61,363,357,48,405,0,405,7,309,89,22.04.2019 00:40,18,0,Vinnitsa
176,166,16,46,117,13,130,0,130,3,74,53,22.04.2019 00:35,18,0,Vinnitsa
352,345,34,109,212,31,243,0,243,5,139,99,22.04.2019 00:30,18,0,Vinnitsa
176,164,23,55,99,22,121,0,121,2,82,37,22.04.2019 00:20,18,0,Vinnitsa
224,212,15,70,139,15,154,0,154,0,124,30,22.04.2019 00:20,18,0,Vinnitsa
240,228,37,85,122,33,155,0,155,3,60,92,22.04.2019 00:10,18,0,Vinnitsa
432,416,64,172,196,64,260,0,260,8,138,114,22.04.2019 00:10,18,0,Vinnitsa
608,606,52,177,386,45,431,0,431,6,249,176,22.04.2019 00:15,18,0,Vinnitsa
144,141,16,41,87,16,103,0,103,1,61,41,22.04.2019 00:10,18,0,Vinnitsa
304,295,22,110,172,22,194,0,194,3,128,63,22.04.2019 01:40,18,0,Vinnitsa
688,673,70,164,454,70,524,0,524,8,297,219,22.04.2019 00:22,18,0,Vinnitsa
464,451,43,100,321,43,364,0,364,1,163,200,22.04.2019 00:15,18,0,Vinnitsa
64,61,12,17,36,11,47,0,47,0,26,21,22.04.2019 00:10,18,0,Vinnitsa
336,328,28,104,205,27,232,0,232,1,139,92,22.04.2019 00:55,18,0,Vinnitsa
208,198,23,72,115,21,136,0,136,2,77,57,22.04.2019 01:45,18,0,Vinnitsa
48,44,7,21,20,7,27,0,27,0,15,12,22.04.2019 00:02,18,0,Vinnitsa
880,871,78,278,540,62,602,0,602,14,376,212,22.04.2019 00:30,18,0,Vinnitsa
176,164,18,69,94,13,107,0,107,2,59,46,22.04.2019 00:20,18,0,Vinnitsa
96,23,12,74,11,11,22,0,22,0,11,11,22.04.2019 00:10,18,0,Vinnitsa
1936,1904,16,758,1163,15,1178,0,1178,43,747,388,22.04.2019 01:20,18,0,Vinnitsa
2064,2026,7,880,1180,4,1184,0,1184,29,825,330,22.04.2019 05:41,18,0,Vinnitsa
1744,1719,9,837,898,9,907,0,907,22,637,248,22.04.2019 00:35,18,0,Vinnitsa
512,497,1,220,291,1,292,0,292,4,212,76,22.04.2019 00:45,18,0,Vinnitsa
1328,1303,5,550,773,5,778,0,778,20,512,246,22.04.2019 00:40,18,0,Vinnitsa
384,375,36,153,197,34,231,0,231,2,134,95,22.04.2019 02:30,18,0,Vinnitsa
416,399,19,170,229,17,246,0,246,11,162,73,22.04.2019 04:00,18,0,Vinnitsa
688,668,46,249,393,46,439,0,439,8,231,200,22.04.2019 01:40,18,0,Vinnitsa
80,69,10,32,38,10,48,0,48,0,22,26,22.04.2019 00:30,18,0,Vinnitsa
352,337,41,122,189,41,230,0,230,3,101,126,22.04.2019 00:15,18,0,Vinnitsa
32,23,6,13,13,6,19,0,19,1,5,13,22.04.2019 00:30,18,0,Vinnitsa
144,142,11,55,80,9,89,0,89,1,66,22,21.04.2019 22:00,18,0,Vinnitsa
336,332,30,112,196,28,224,0,224,3,126,95,22.04.2019 00:40,18,0,Vinnitsa
160,145,21,56,83,21,104,0,104,0,64,40,22.04.2019 00:10,18,0,Vinnitsa
1056,1040,9,478,569,9,578,0,578,15,389,174,22.04.2019 00:05,18,0,Vinnitsa
400,384,48,176,177,47,224,0,224,3,143,78,22.04.2019 01:05,18,0,Vinnitsa
304,287,15,121,170,13,183,0,183,3,130,50,22.04.2019 00:40,18,0,Vinnitsa
64,56,7,22,35,7,42,0,42,0,30,12,22.04.2019 00:47,18,0,Vinnitsa
304,287,22,144,138,22,160,0,160,4,84,72,22.04.2019 00:05,18,0,Vinnitsa
400,388,39,150,214,36,250,0,250,5,158,87,22.04.2019 01:10,18,0,Vinnitsa
448,436,29,178,242,28,270,0,270,4,150,116,22.04.2019 00:20,18,0,Vinnitsa
192,185,11,67,114,11,125,0,125,8,69,48,22.04.2019 01:45,18,0,Vinnitsa
336,320,5,181,151,4,155,0,155,3,85,67,22.04.2019 01:10,18,0,Vinnitsa
624,609,52,182,393,49,442,0,442,6,300,136,22.04.2019 00:40,18,0,Vinnitsa
256,257,22,94,141,21,162,0,162,3,108,51,22.04.2019 00:40,18,0,Vinnitsa
224,214,17,84,123,17,140,0,140,4,105,31,22.04.2019 00:15,18,0,Vinnitsa
976,938,19,542,416,18,434,0,433,17,253,163,22.04.2019 04:55,18,0,Vinnitsa
256,241,27,76,153,27,180,0,180,2,118,60,22.04.2019 00:40,18,0,Vinnitsa
32,31,5,8,19,5,24,0,24,1,5,18,22.04.2019 00:10,18,0,Vinnitsa
160,159,19,51,90,19,109,0,109,1,50,58,22.04.2019 00:20,18,0,Vinnitsa
128,112,16,53,59,16,75,0,75,1,28,46,22.04.2019 00:07,18,0,Vinnitsa
368,351,43,127,201,40,241,0,241,3,164,74,21.04.2019 21:50,18,0,Vinnitsa
64,53,0,17,47,0,47,0,47,0,16,31,22.04.2019 01:45,18,0,Vinnitsa
32,24,2,15,15,2,17,0,17,1,7,9,22.04.2019 02:10,18,0,Vinnitsa
256,239,24,102,130,24,154,0,154,1,100,53,22.04.2019 01:35,18,0,Vinnitsa
352,338,25,134,194,24,218,0,218,3,120,95,22.04.2019 00:15,18,0,Vinnitsa
144,137,18,51,75,18,93,0,93,0,59,34,22.04.2019 00:05,18,0,Vinnitsa
352,360,43,102,207,43,250,0,250,4,160,86,22.04.2019 00:15,18,0,Vinnitsa
32,23,3,11,18,3,21,0,21,0,6,15,22.04.2019 00:05,18,0,Vinnitsa
224,216,16,58,150,16,166,0,166,3,60,103,22.04.2019 01:05,18,0,Vinnitsa
224,210,26,104,95,25,120,0,120,3,71,46,22.04.2019 00:15,18,0,Vinnitsa
80,78,1,33,46,1,47,0,47,0,20,27,22.04.2019 00:30,18,0,Vinnitsa
112,102,12,34,66,12,78,0,78,0,40,38,22.04.2019 01:10,18,0,Vinnitsa
368,350,34,128,206,34,240,0,240,2,124,114,22.04.2019 00:10,18,0,Vinnitsa
112,102,12,50,50,12,62,0,62,1,36,25,22.04.2019 00:50,18,0,Vinnitsa
96,94,13,29,54,13,67,0,67,0,50,17,21.04.2019 22:40,18,0,Vinnitsa
128,47,20,91,17,20,37,0,37,0,19,18,22.04.2019 00:05,18,0,Vinnitsa
48,40,13,8,27,13,40,0,40,0,7,33,22.04.2019 00:05,18,0,Vinnitsa
1728,1687,60,673,1002,53,1055,0,1055,29,675,351,22.04.2019 00:45,19,1,Volyn
208,191,6,86,117,5,122,0,122,2,79,41,22.04.2019 00:10,19,1,Volyn
144,143,2,44,98,2,100,0,100,5,74,21,22.04.2019 00:45,19,1,Volyn
512,490,32,154,329,29,358,0,358,4,195,159,22.04.2019 00:15,19,1,Volyn
256,245,9,114,135,7,142,0,142,1,110,31,22.04.2019 00:15,19,1,Volyn
80,81,2,20,58,2,60,0,60,4,22,34,22.04.2019 00:15,19,1,Volyn
112,111,2,40,70,2,72,0,72,0,43,29,22.04.2019 00:05,19,1,Volyn
320,308,10,118,193,9,202,0,202,6,162,34,22.04.2019 01:50,19,1,Volyn
64,62,2,17,45,2,47,0,47,1,32,14,22.04.2019 01:10,19,1,Volyn
256,245,8,106,144,6,150,0,150,4,114,32,22.04.2019 00:45,19,1,Volyn
448,434,20,190,241,17,258,0,258,3,144,111,22.04.2019 01:55,19,1,Volyn
208,192,9,100,101,7,108,0,108,1,56,51,21.04.2019 21:40,19,1,Volyn
112,109,9,39,67,6,73,0,73,2,44,27,22.04.2019 00:15,19,1,Volyn
64,61,2,31,31,2,33,0,33,2,16,15,21.04.2019 22:00,19,1,Volyn
272,264,16,119,139,14,153,0,153,5,102,46,22.04.2019 00:12,19,1,Volyn
272,260,23,86,165,21,186,0,186,6,112,68,21.04.2019 22:10,19,1,Volyn
1296,1273,67,454,780,62,842,0,842,21,571,250,22.04.2019 00:10,19,1,Volyn
240,234,7,97,136,7,143,0,143,5,108,30,22.04.2019 00:40,19,1,Volyn
432,412,20,175,238,19,257,0,257,11,176,70,22.04.2019 00:04,19,1,Volyn
688,673,24,294,370,24,394,0,394,14,256,124,22.04.2019 00:20,19,1,Volyn
448,437,24,168,256,24,280,0,280,4,211,65,22.04.2019 00:05,19,1,Volyn
704,679,25,258,425,21,446,0,446,14,310,122,22.04.2019 00:04,19,1,Volyn
144,145,13,21,110,13,123,0,123,4,89,30,22.04.2019 00:04,19,1,Volyn
160,158,16,58,88,14,102,0,102,4,60,38,22.04.2019 00:15,19,1,Volyn
128,129,8,41,81,6,87,0,87,4,62,21,22.04.2019 00:10,19,1,Volyn
256,251,20,90,149,17,166,0,166,1,120,45,22.04.2019 00:05,19,1,Volyn
64,63,0,19,45,0,45,0,45,2,30,13,21.04.2019 20:45,19,1,Volyn
64,56,5,20,39,5,44,0,44,0,33,11,21.04.2019 22:15,19,1,Volyn
368,359,23,143,202,23,225,0,225,4,155,66,22.04.2019 00:10,19,1,Volyn
496,482,21,232,245,19,264,0,264,12,164,88,22.04.2019 01:05,19,1,Volyn
176,169,12,61,106,9,115,0,115,1,76,38,22.04.2019 00:05,19,1,Volyn
368,356,20,134,219,15,234,0,234,1,114,119,22.04.2019 00:10,19,1,Volyn
192,189,7,62,123,7,130,0,130,1,91,38,22.04.2019 00:05,19,1,Volyn
128,118,11,40,77,11,88,0,88,0,53,35,22.04.2019 00:20,19,1,Volyn
128,114,7,42,80,6,86,0,86,1,45,40,21.04.2019 23:20,19,1,Volyn
976,986,78,347,557,72,629,0,629,5,479,145,21.04.2019 22:30,19,1,Volyn
224,216,8,92,126,6,132,0,132,3,101,28,22.04.2019 00:05,19,1,Volyn
224,211,15,76,133,15,148,0,148,2,100,46,22.04.2019 00:05,19,1,Volyn
160,157,2,51,107,2,109,0,109,3,79,27,21.04.2019 21:50,19,1,Volyn
272,257,10,82,180,10,190,0,190,2,121,67,22.04.2019 00:15,19,1,Volyn
240,219,19,111,114,15,129,0,129,3,76,50,22.04.2019 00:10,19,1,Volyn
48,50,4,13,32,3,35,0,35,0,21,14,22.04.2019 00:28,19,1,Volyn
848,822,43,310,496,42,538,0,538,19,362,157,22.04.2019 00:15,19,1,Volyn
432,419,15,181,238,13,251,0,251,9,150,92,22.04.2019 00:25,19,1,Volyn
592,570,35,225,337,30,367,0,367,6,213,148,21.04.2019 22:10,19,1,Volyn
64,60,2,27,35,2,37,0,37,1,27,9,22.04.2019 00:35,19,1,Volyn
640,631,22,237,382,21,403,0,403,5,299,99,22.04.2019 00:05,19,1,Volyn
288,282,8,89,191,8,199,0,199,3,120,76,22.04.2019 00:10,19,1,Volyn
128,116,4,43,81,4,85,0,85,2,56,27,22.04.2019 00:10,19,1,Volyn
144,144,11,50,83,11,94,0,94,0,82,12,22.04.2019 00:10,19,1,Volyn
64,58,8,23,35,6,41,0,41,0,34,7,22.04.2019 00:20,19,1,Volyn
352,335,27,120,212,20,232,0,232,2,158,72,22.04.2019 01:10,19,1,Volyn
128,112,16,61,56,11,67,0,67,3,43,21,21.04.2019 23:15,19,1,Volyn
208,198,10,75,123,10,133,0,133,0,104,29,22.04.2019 00:05,19,1,Volyn
144,141,14,49,84,11,95,0,95,4,67,24,21.04.2019 21:32,19,1,Volyn
160,154,11,60,89,11,100,0,100,2,84,14,22.04.2019 00:10,19,1,Volyn
544,535,36,178,333,33,366,0,366,6,236,124,22.04.2019 00:10,19,1,Volyn
304,291,32,97,176,31,207,0,207,2,166,39,21.04.2019 21:00,19,1,Volyn
128,125,2,46,81,1,82,0,82,3,53,26,22.04.2019 00:05,19,1,Volyn
304,298,20,88,196,20,216,0,216,4,155,57,22.04.2019 00:05,19,1,Volyn
48,49,6,4,38,6,44,0,44,0,29,15,22.04.2019 00:05,19,1,Volyn
1552,1508,24,714,815,23,838,0,838,33,504,301,22.04.2019 00:20,19,1,Volyn
992,977,14,416,563,13,576,0,576,16,348,212,22.04.2019 00:10,19,1,Volyn
1232,1210,19,534,681,17,698,0,698,18,418,262,22.04.2019 00:10,19,1,Volyn
256,252,9,100,148,8,156,0,156,1,113,42,22.04.2019 00:25,19,1,Volyn
624,605,12,204,408,12,420,0,420,6,276,138,22.04.2019 00:20,19,1,Volyn
352,337,15,125,212,15,227,0,227,3,163,61,22.04.2019 01:10,19,1,Volyn
224,220,11,49,164,11,175,0,175,7,118,50,22.04.2019 00:05,19,1,Volyn
640,623,45,221,378,41,419,0,419,8,251,160,22.04.2019 00:10,19,1,Volyn
816,808,58,281,487,48,535,0,535,6,300,229,22.04.2019 01:00,19,1,Volyn
608,601,40,188,382,38,420,0,420,5,281,134,22.04.2019 01:10,19,1,Volyn
688,669,39,249,400,39,439,0,439,6,307,126,22.04.2019 00:15,19,1,Volyn
384,366,43,102,246,36,282,0,282,6,176,100,22.04.2019 00:05,19,1,Volyn
528,511,46,165,318,45,363,0,363,8,183,172,22.04.2019 00:20,19,1,Volyn
704,688,30,195,482,27,509,0,509,10,309,190,22.04.2019 01:30,19,1,Volyn
992,978,29,405,562,25,587,0,587,11,380,196,21.04.2019 23:20,19,1,Volyn
256,250,14,88,154,14,168,0,168,2,109,57,22.04.2019 00:50,19,1,Volyn
144,146,6,47,92,5,97,0,97,1,73,23,22.04.2019 00:10,19,1,Volyn
288,281,8,130,150,8,158,0,158,4,114,40,22.04.2019 01:10,19,1,Volyn
448,439,22,155,274,19,293,0,293,5,128,160,22.04.2019 00:10,19,1,Volyn
208,205,14,77,118,13,131,0,131,1,68,62,22.04.2019 00:30,19,1,Volyn
592,579,32,209,351,32,383,0,383,9,257,117,22.04.2019 00:30,19,1,Volyn
432,426,15,132,286,14,300,0,300,5,176,119,22.04.2019 00:10,19,1,Volyn
288,272,8,99,181,8,189,0,189,7,113,69,21.04.2019 21:00,19,1,Volyn
176,174,15,33,128,15,143,0,143,5,83,55,22.04.2019 00:20,19,1,Volyn
400,390,13,177,213,10,223,0,223,5,129,89,21.04.2019 22:00,19,1,Volyn
784,774,34,265,487,32,519,0,519,14,388,117,22.04.2019 00:10,19,1,Volyn
656,645,15,254,388,14,402,0,402,10,231,161,22.04.2019 01:01,19,1,Volyn
288,278,5,82,201,5,206,0,206,1,134,71,22.04.2019 00:35,19,1,Volyn
272,251,3,104,166,2,168,0,168,5,106,57,21.04.2019 23:50,19,1,Volyn
448,429,14,170,264,14,278,0,278,7,184,87,22.04.2019 01:05,19,1,Volyn
336,331,28,114,195,27,222,0,222,2,145,75,21.04.2019 21:50,19,1,Volyn
592,582,26,132,434,26,460,0,460,23,308,129,22.04.2019 00:15,19,1,Volyn
416,406,17,78,321,17,338,0,338,9,273,56,22.04.2019 00:50,19,1,Volyn
160,146,11,57,92,11,103,0,103,6,65,32,22.04.2019 00:05,19,1,Volyn
336,323,7,150,179,7,186,0,186,4,127,55,21.04.2019 21:50,19,1,Volyn
176,174,4,56,116,4,120,0,120,1,61,58,21.04.2019 23:15,19,1,Volyn
688,665,36,273,379,36,415,0,415,10,255,150,22.04.2019 00:22,19,1,Volyn
416,400,31,150,237,29,266,0,266,4,163,99,22.04.2019 00:20,19,1,Volyn
336,311,16,119,202,15,217,0,217,4,87,126,22.04.2019 00:06,19,1,Volyn
592,574,23,266,303,23,326,0,326,7,222,97,22.04.2019 00:02,19,1,Volyn
320,300,29,95,196,29,225,0,225,2,128,95,21.04.2019 23:10,19,1,Volyn
208,201,11,62,138,8,146,0,146,3,83,60,21.04.2019 23:36,19,1,Volyn
320,313,5,84,232,4,236,0,236,4,107,125,21.04.2019 23:59,19,1,Volyn
1888,1876,30,797,1068,23,1091,0,1091,41,758,292,22.04.2019 00:30,19,1,Volyn
1904,1888,27,758,1126,20,1146,0,1146,33,827,286,22.04.2019 00:20,19,1,Volyn
2272,2227,24,945,1308,19,1327,0,1327,43,990,294,22.04.2019 02:10,19,1,Volyn
2000,1977,36,884,1087,29,1116,0,1116,35,837,244,22.04.2019 06:00,19,1,Volyn
2112,2081,55,1040,1027,45,1072,0,1072,33,857,182,22.04.2019 01:30,19,1,Volyn
384,370,13,174,197,13,210,0,210,3,157,50,22.04.2019 00:19,19,1,Volyn
128,118,4,65,60,3,63,0,63,2,48,13,22.04.2019 00:40,19,1,Volyn
80,72,4,36,42,2,44,0,44,0,33,11,22.04.2019 00:45,19,1,Volyn
608,591,19,229,361,18,379,0,379,5,315,59,22.04.2019 00:50,19,1,Volyn
400,395,22,172,207,21,228,0,228,5,155,68,22.04.2019 00:20,19,1,Volyn
912,892,33,301,582,29,611,0,611,19,424,168,22.04.2019 00:45,19,1,Volyn
256,246,7,86,164,6,170,0,170,3,135,32,22.04.2019 00:01,19,1,Volyn
576,582,47,212,320,44,364,0,364,7,270,87,22.04.2019 00:40,19,1,Volyn
144,134,15,45,86,13,99,0,99,1,61,37,22.04.2019 00:45,19,1,Volyn
80,69,7,25,48,7,55,0,55,0,38,17,22.04.2019 00:30,19,1,Volyn
64,50,7,23,35,6,41,0,41,3,27,11,22.04.2019 00:40,19,1,Volyn
432,417,17,161,256,15,271,0,271,11,190,70,22.04.2019 01:20,19,1,Volyn
304,287,16,114,174,16,190,0,190,4,124,62,21.04.2019 22:30,19,1,Volyn
80,73,3,28,51,1,52,0,52,6,30,16,22.04.2019 01:25,19,1,Volyn
464,454,17,202,249,13,262,0,262,4,182,76,22.04.2019 00:10,19,1,Volyn
112,102,5,46,61,5,66,0,66,0,48,18,22.04.2019 00:20,19,1,Volyn
96,90,5,26,66,4,70,0,70,2,57,11,22.04.2019 01:10,19,1,Volyn
384,382,16,130,238,16,254,0,254,5,174,75,22.04.2019 00:35,19,1,Volyn
192,188,6,56,130,6,136,0,136,3,91,42,22.04.2019 00:50,19,1,Volyn
1040,1014,48,421,580,39,619,0,619,7,420,192,22.04.2019 01:30,19,1,Volyn
304,298,32,118,155,31,186,0,186,3,132,51,22.04.2019 02:15,19,1,Volyn
224,220,12,89,123,12,135,0,135,3,82,50,22.04.2019 00:15,19,1,Volyn
240,226,9,111,124,5,129,0,129,1,106,22,22.04.2019 00:25,19,1,Volyn
384,370,20,147,220,17,237,0,237,2,187,48,22.04.2019 00:15,19,1,Volyn
528,520,28,185,316,27,343,0,343,5,203,135,22.04.2019 00:10,19,1,Volyn
192,186,18,42,132,18,150,0,150,1,100,49,22.04.2019 00:05,19,1,Volyn
192,183,14,71,107,14,121,0,121,2,87,32,22.04.2019 00:20,19,1,Volyn
512,506,47,221,250,41,291,0,291,3,232,56,22.04.2019 00:40,19,1,Volyn
144,128,6,87,51,6,57,0,57,5,31,21,22.04.2019 00:05,19,1,Volyn
240,233,12,125,106,9,115,0,115,4,75,36,22.04.2019 00:15,19,1,Volyn
560,551,62,180,319,61,380,0,380,5,284,91,22.04.2019 02:20,19,1,Volyn
160,152,20,60,85,15,100,0,100,2,67,31,22.04.2019 01:25,19,1,Volyn
688,684,51,258,382,48,430,0,430,8,307,115,22.04.2019 00:16,19,1,Volyn
96,85,0,45,51,0,51,0,51,0,39,12,22.04.2019 00:30,19,1,Volyn
272,263,24,90,158,24,182,0,182,3,120,59,22.04.2019 00:20,19,1,Volyn
128,123,8,24,97,7,104,0,104,1,84,19,22.04.2019 00:10,19,1,Volyn
112,110,2,39,71,2,73,0,73,0,43,30,22.04.2019 00:10,19,1,Volyn
400,380,19,172,210,18,228,0,228,6,166,56,22.04.2019 00:25,19,1,Volyn
480,462,31,173,279,28,307,0,307,11,203,93,22.04.2019 02:30,19,1,Volyn
128,124,20,30,80,18,98,0,98,4,70,24,22.04.2019 00:05,19,1,Volyn
208,201,26,59,124,25,149,0,149,1,96,52,22.04.2019 00:30,19,1,Volyn
736,728,23,339,378,19,397,0,397,9,271,117,22.04.2019 01:20,19,1,Volyn
512,505,32,217,266,29,295,0,295,4,223,68,22.04.2019 00:40,19,1,Volyn
640,645,30,249,363,28,391,0,391,1,330,60,22.04.2019 00:03,19,1,Volyn
176,169,18,54,105,17,122,0,122,0,94,28,22.04.2019 00:45,19,1,Volyn
192,178,17,57,118,17,135,0,135,0,105,30,22.04.2019 00:10,19,1,Volyn
448,440,21,126,305,17,322,0,322,4,278,40,22.04.2019 00:37,19,1,Volyn
144,132,15,34,95,15,110,0,110,0,80,30,22.04.2019 01:30,19,1,Volyn
128,127,15,27,86,15,101,0,101,1,67,33,22.04.2019 00:01,19,1,Volyn
128,119,10,44,74,10,84,0,84,1,53,30,22.04.2019 00:10,19,1,Volyn
384,368,15,134,238,12,250,0,250,14,181,55,22.04.2019 00:30,19,1,Volyn
304,298,27,110,167,27,194,0,194,4,139,51,22.04.2019 01:10,19,1,Volyn
448,438,38,166,244,38,282,0,282,3,172,107,22.04.2019 00:15,19,1,Volyn
208,203,7,43,158,7,165,0,165,5,125,35,22.04.2019 00:13,19,1,Volyn
144,131,6,52,86,6,92,0,92,0,56,36,22.04.2019 00:10,19,1,Volyn
80,74,5,22,53,5,58,0,58,0,38,20,22.04.2019 00:30,19,1,Volyn
1312,1289,16,455,844,13,857,0,857,27,639,191,22.04.2019 00:32,19,1,Volyn
1632,1586,28,624,987,21,1008,0,1008,38,714,256,22.04.2019 00:02,19,1,Volyn
1456,1413,16,626,817,13,830,0,830,26,562,242,22.04.2019 01:30,19,1,Volyn
1664,1637,17,603,1045,16,1061,0,1061,26,774,261,22.04.2019 00:10,19,1,Volyn
1920,1945,13,763,1146,11,1157,0,1157,36,810,311,22.04.2019 00:10,19,1,Volyn
1856,1762,13,704,1142,10,1152,0,1152,32,819,301,22.04.2019 01:20,19,1,Volyn
1680,1643,27,585,1074,21,1095,0,1095,23,776,296,22.04.2019 00:02,19,1,Volyn
1472,1439,32,518,923,31,954,0,954,37,692,225,22.04.2019 00:10,19,1,Volyn
1584,1541,25,587,980,17,997,0,997,22,712,263,22.04.2019 00:20,19,1,Volyn
1360,1328,49,542,779,39,818,0,818,26,610,182,22.04.2019 00:05,19,1,Volyn
1376,1350,22,511,845,20,865,0,865,30,593,242,22.04.2019 01:00,19,1,Volyn
1392,1365,18,479,900,13,913,0,913,26,637,250,22.04.2019 00:05,19,1,Volyn
1200,1182,18,424,763,13,776,0,776,28,535,213,22.04.2019 00:45,19,1,Volyn
1344,1324,31,540,782,22,804,0,804,28,557,219,22.04.2019 00:17,19,1,Volyn
1520,1482,17,611,894,15,909,0,909,24,642,243,22.04.2019 00:20,19,1,Volyn
304,63,44,255,12,37,49,0,49,3,27,19,22.04.2019 00:03,19,1,Volyn
2048,2010,17,882,1149,17,1166,0,1166,38,762,366,22.04.2019 00:48,19,1,Volyn
1984,1931,14,857,1117,10,1127,0,1127,32,755,340,22.04.2019 00:10,19,1,Volyn
1712,1670,18,745,952,15,967,0,967,27,651,289,22.04.2019 00:50,19,1,Volyn
2048,2007,18,839,1196,13,1209,0,1209,41,840,328,22.04.2019 01:00,19,1,Volyn
2160,2108,18,901,1242,17,1259,0,1259,50,858,351,22.04.2019 00:45,19,1,Volyn
2048,2013,13,843,1199,6,1205,0,1205,37,801,367,22.04.2019 01:30,19,1,Volyn
2096,2055,9,900,1189,7,1196,0,1196,34,771,391,22.04.2019 00:03,19,1,Volyn
2224,2214,14,900,1315,9,1324,0,1324,61,900,363,21.04.2019 23:42,19,1,Volyn
1920,1909,23,833,1066,21,1087,0,1087,38,770,279,22.04.2019 01:10,19,1,Volyn
2096,2035,30,865,1204,27,1231,0,1231,41,858,332,22.04.2019 04:15,19,1,Volyn
2000,1956,20,868,1117,15,1132,0,1132,27,761,344,22.04.2019 01:26,19,1,Volyn
2000,1977,14,919,1070,11,1081,0,1081,39,728,314,22.04.2019 00:20,19,1,Volyn
1840,1809,9,826,1006,8,1014,0,1014,38,664,312,22.04.2019 01:05,19,1,Volyn
1616,1588,14,636,971,9,980,0,980,46,686,248,22.04.2019 00:10,19,1,Volyn
2048,1996,10,839,1200,9,1209,0,1209,39,802,368,22.04.2019 00:06,19,1,Volyn
1968,1920,10,758,1201,9,1210,0,1210,31,822,357,22.04.2019 01:10,19,1,Volyn
1696,1663,58,726,920,50,970,0,970,26,685,259,22.04.2019 00:15,19,1,Volyn
320,157,63,173,93,54,147,0,147,4,105,38,21.04.2019 20:48,19,1,Volyn
64,45,16,19,29,16,45,0,45,0,12,33,22.04.2019 00:20,20,1,Volyn
1952,1928,56,812,1090,50,1140,0,1140,36,711,393,22.04.2019 00:05,20,1,Volyn
1280,1265,22,577,687,16,703,20,703,20,422,261,21.04.2019 23:45,20,1,Volyn
1168,1140,8,517,645,6,651,0,651,14,405,232,22.04.2019 00:30,20,1,Volyn
1248,1231,22,531,703,14,717,0,717,24,385,308,22.04.2019 00:10,20,1,Volyn
1120,1103,8,448,664,8,672,0,672,14,384,274,22.04.2019 01:10,20,1,Volyn
2048,2004,68,901,1093,54,1147,0,1147,25,714,408,22.04.2019 00:10,20,1,Volyn
880,874,62,320,509,51,560,0,560,17,324,219,22.04.2019 00:25,20,1,Volyn
384,372,26,146,215,23,238,0,238,4,145,89,21.04.2019 23:00,20,1,Volyn
496,487,39,190,269,37,306,0,306,7,176,123,22.04.2019 00:12,20,1,Volyn
352,342,35,92,225,35,260,0,260,8,151,101,22.04.2019 00:50,20,1,Volyn
416,402,15,127,274,15,289,0,289,3,166,120,22.04.2019 00:15,20,1,Volyn
720,712,41,218,461,41,502,0,502,6,190,306,22.04.2019 01:45,20,1,Volyn
400,384,30,122,248,30,278,0,278,5,161,112,22.04.2019 01:15,20,1,Volyn
224,209,5,83,136,5,141,0,141,7,73,61,22.04.2019 00:10,20,1,Volyn
112,100,0,42,70,0,70,0,70,3,24,43,22.04.2019 00:20,20,1,Volyn
560,552,25,159,377,24,401,0,401,11,172,218,22.04.2019 00:35,20,1,Volyn
320,307,21,133,169,18,187,0,187,4,87,96,22.04.2019 00:02,20,1,Volyn
512,505,34,155,323,34,357,0,357,1,198,158,22.04.2019 00:10,20,1,Volyn
80,67,4,30,46,4,50,0,50,0,38,12,22.04.2019 00:05,20,1,Volyn
160,157,9,54,97,9,106,0,106,1,72,33,22.04.2019 00:03,20,1,Volyn
192,184,15,67,111,14,125,0,125,6,77,42,22.04.2019 00:04,20,1,Volyn
272,270,26,72,174,26,200,0,200,2,140,58,22.04.2019 00:05,20,1,Volyn
320,309,39,107,175,38,213,0,213,0,103,110,22.04.2019 00:50,20,1,Volyn
352,341,18,127,209,16,225,0,225,2,122,101,22.04.2019 00:10,20,1,Volyn
96,79,9,28,59,9,68,0,68,0,47,21,22.04.2019 00:30,20,1,Volyn
320,307,27,110,184,26,210,0,210,3,115,92,22.04.2019 01:30,20,1,Volyn
608,599,51,174,385,49,434,0,434,6,229,199,22.04.2019 00:10,20,1,Volyn
208,191,18,39,151,18,169,0,169,1,86,82,22.04.2019 00:15,20,1,Volyn
768,756,63,191,517,60,577,0,577,13,339,225,22.04.2019 00:15,20,1,Volyn
208,196,9,46,153,9,162,0,162,3,70,89,22.04.2019 00:15,20,1,Volyn
352,339,28,124,205,23,228,0,228,2,130,96,22.04.2019 00:01,20,1,Volyn
384,382,19,162,205,17,222,0,222,3,127,92,22.04.2019 00:05,20,1,Volyn
416,402,25,172,226,18,244,0,244,6,123,115,22.04.2019 00:05,20,1,Volyn
128,117,3,52,73,3,76,0,76,2,35,39,22.04.2019 00:15,20,1,Volyn
352,343,25,92,235,25,260,0,260,8,175,77,22.04.2019 00:20,20,1,Volyn
160,153,12,56,92,12,104,0,104,4,46,54,22.04.2019 00:10,20,1,Volyn
576,560,27,202,349,25,374,0,374,3,197,174,22.04.2019 00:03,20,1,Volyn
240,222,11,64,165,11,176,0,176,1,89,86,21.04.2019 21:30,20,1,Volyn
176,162,16,68,92,16,108,0,108,2,69,37,22.04.2019 00:26,20,1,Volyn
384,372,18,108,258,18,276,0,276,3,125,148,22.04.2019 00:00,20,1,Volyn
256,240,15,74,167,15,182,0,182,5,65,112,22.04.2019 00:15,20,1,Volyn
192,190,12,68,112,12,124,0,124,2,59,63,22.04.2019 00:30,20,1,Volyn
480,465,38,142,302,36,338,0,338,7,196,135,22.04.2019 00:15,20,1,Volyn
336,320,14,151,172,13,185,0,185,1,119,65,21.04.2019 22:10,20,1,Volyn
400,387,23,128,251,21,272,0,272,5,160,107,22.04.2019 00:10,20,1,Volyn
240,232,16,101,123,16,139,0,139,3,88,48,22.04.2019 00:20,20,1,Volyn
720,709,77,197,446,77,523,0,523,5,313,205,22.04.2019 00:47,20,1,Volyn
96,86,3,24,69,3,72,0,72,2,53,17,22.04.2019 01:00,20,1,Volyn
208,202,15,70,124,14,138,0,138,1,99,38,22.04.2019 00:10,20,1,Volyn
416,411,9,123,284,9,293,0,293,11,141,141,22.04.2019 00:25,20,1,Volyn
672,662,61,234,378,60,438,0,438,2,258,178,22.04.2019 00:25,20,1,Volyn
256,239,15,98,143,15,158,0,158,5,68,85,22.04.2019 00:50,20,1,Volyn
688,674,47,269,374,45,419,0,419,18,253,148,22.04.2019 00:25,20,1,Volyn
480,473,30,149,301,30,331,0,331,11,223,97,22.04.2019 00:10,20,1,Volyn
112,110,10,48,54,10,64,0,64,0,36,28,21.04.2019 22:45,20,1,Volyn
416,404,27,183,206,27,233,0,233,3,117,113,22.04.2019 00:05,20,1,Volyn
208,192,17,65,126,17,143,0,143,2,51,90,21.04.2019 21:45,20,1,Volyn
416,399,23,143,250,23,273,0,273,4,127,142,21.04.2019 20:55,20,1,Volyn
384,380,40,123,221,40,261,0,261,5,137,119,21.04.2019 22:00,20,1,Volyn
1168,1153,38,429,705,34,739,0,739,13,453,273,22.04.2019 00:05,20,1,Volyn
192,189,4,78,112,2,114,0,114,2,58,54,22.04.2019 00:05,20,1,Volyn
240,231,13,78,149,13,162,0,162,2,98,62,22.04.2019 02:20,20,1,Volyn
224,216,17,80,128,16,144,0,144,2,71,71,22.04.2019 00:33,20,1,Volyn
176,171,20,73,86,17,103,0,103,1,61,41,22.04.2019 00:39,20,1,Volyn
336,329,24,76,236,24,260,0,260,4,126,130,22.04.2019 01:15,20,1,Volyn
352,348,8,91,253,8,261,0,261,3,167,91,22.04.2019 00:02,20,1,Volyn
336,331,15,76,246,14,260,0,260,6,150,104,22.04.2019 00:10,20,1,Volyn
544,539,22,165,357,22,379,0,379,14,253,112,22.04.2019 00:05,20,1,Volyn
112,99,2,32,79,1,80,0,80,0,51,29,22.04.2019 00:10,20,1,Volyn
768,747,60,257,452,59,511,0,511,12,358,141,22.04.2019 00:50,20,1,Volyn
736,718,27,309,400,27,427,0,427,8,299,120,22.04.2019 00:35,20,1,Volyn
528,519,46,169,316,43,359,0,359,3,196,160,21.04.2019 21:30,20,1,Volyn
320,305,26,95,199,26,225,0,225,3,129,93,22.04.2019 00:08,20,1,Volyn
672,658,32,236,405,31,436,0,436,7,241,188,22.04.2019 00:50,20,1,Volyn
96,89,0,30,66,0,66,0,66,0,40,26,21.04.2019 23:50,20,1,Volyn
224,35,20,195,15,14,29,0,29,0,21,8,22.04.2019 00:30,20,1,Volyn
128,38,24,90,14,24,38,0,38,0,8,30,21.04.2019 20:40,20,1,Volyn
960,937,17,427,522,11,533,0,533,19,335,179,22.04.2019 00:33,20,1,Volyn
800,787,9,280,513,7,520,0,520,14,342,164,22.04.2019 00:15,20,1,Volyn
928,917,4,363,561,4,565,0,565,10,353,202,21.04.2019 21:35,20,1,Volyn
256,247,5,99,152,5,157,0,157,1,111,45,22.04.2019 01:05,20,1,Volyn
64,48,5,29,32,3,35,0,35,1,27,7,21.04.2019 23:50,20,1,Volyn
256,249,22,99,138,19,157,0,157,3,78,76,22.04.2019 00:30,20,1,Volyn
224,217,4,62,158,4,162,0,162,4,89,69,21.04.2019 21:00,20,1,Volyn
464,444,5,164,296,4,300,0,300,3,195,102,22.04.2019 00:52,20,1,Volyn
416,410,31,99,288,29,317,0,317,5,188,124,22.04.2019 00:02,20,1,Volyn
112,102,8,40,66,6,72,0,72,0,41,31,22.04.2019 00:05,20,1,Volyn
304,291,11,83,210,11,221,0,221,6,141,74,22.04.2019 00:10,20,1,Volyn
224,224,8,96,120,8,128,0,128,1,82,45,22.04.2019 00:25,20,1,Volyn
128,124,5,39,84,5,89,0,89,0,55,34,22.04.2019 00:15,20,1,Volyn
192,177,12,79,104,9,113,0,113,2,60,51,22.04.2019 00:25,20,1,Volyn
352,334,13,157,184,11,195,0,195,5,121,69,21.04.2019 23:50,20,1,Volyn
64,60,3,16,45,3,48,0,48,0,26,22,21.04.2019 20:30,20,1,Volyn
160,144,11,60,90,10,100,0,100,0,59,41,22.04.2019 00:10,20,1,Volyn
352,342,15,90,247,15,262,0,262,4,180,78,22.04.2019 01:50,20,1,Volyn
240,233,13,49,179,12,191,0,191,1,98,92,21.04.2019 20:45,20,1,Volyn
448,432,29,120,301,27,328,0,328,4,148,176,22.04.2019 00:25,20,1,Volyn
64,53,6,22,36,6,42,0,42,1,16,25,21.04.2019 21:10,20,1,Volyn
240,228,4,108,129,3,132,0,132,3,82,47,22.04.2019 00:10,20,1,Volyn
112,96,3,38,72,2,74,0,74,1,45,28,22.04.2019 00:15,20,1,Volyn
336,323,6,129,202,5,207,0,207,3,141,63,22.04.2019 00:10,20,1,Volyn
192,173,7,87,98,7,105,0,105,5,59,41,22.04.2019 01:00,20,1,Volyn
160,149,7,76,77,7,84,0,84,0,51,33,22.04.2019 00:03,20,1,Volyn
416,401,21,150,245,21,266,0,266,5,178,83,22.04.2019 00:20,20,1,Volyn
560,558,17,88,455,17,472,0,472,12,288,172,22.04.2019 00:15,20,1,Volyn
480,475,28,135,321,24,345,0,345,3,211,131,22.04.2019 00:15,20,1,Volyn
256,240,14,82,163,11,174,0,174,5,104,65,22.04.2019 03:35,20,1,Volyn
64,53,3,21,40,3,43,0,43,1,19,23,22.04.2019 00:15,20,1,Volyn
272,259,6,116,150,6,156,0,156,0,70,86,21.04.2019 21:10,20,1,Volyn
80,76,4,37,39,4,43,0,43,0,25,18,22.04.2019 01:52,20,1,Volyn
928,904,60,336,538,54,592,0,592,20,340,232,22.04.2019 00:30,20,1,Volyn
432,423,26,167,239,26,265,0,265,0,150,115,22.04.2019 00:03,20,1,Volyn
384,368,24,119,241,24,265,0,265,6,128,131,22.04.2019 02:30,20,1,Volyn
256,247,19,98,140,18,158,0,158,5,103,50,22.04.2019 00:50,20,1,Volyn
496,479,21,233,248,15,263,0,263,5,167,91,22.04.2019 00:05,20,1,Volyn
64,54,1,28,35,1,36,0,36,1,14,21,22.04.2019 00:10,20,1,Volyn
640,625,41,294,314,32,346,0,346,0,211,135,22.04.2019 00:10,20,1,Volyn
128,124,10,37,81,10,91,0,91,0,47,44,22.04.2019 00:15,20,1,Volyn
400,395,26,144,233,23,256,0,256,2,120,134,22.04.2019 02:45,20,1,Volyn
272,259,30,103,142,27,169,0,169,0,87,82,21.04.2019 23:56,20,1,Volyn
144,131,15,56,75,13,88,0,88,0,52,36,22.04.2019 00:35,20,1,Volyn
128,28,5,105,19,4,23,0,23,0,10,13,22.04.2019 00:53,20,1,Volyn
288,275,6,94,188,6,194,0,194,2,146,46,22.04.2019 00:20,20,1,Volyn
752,747,23,199,533,20,553,0,553,10,348,195,22.04.2019 00:15,20,1,Volyn
304,296,10,101,196,7,203,0,203,4,132,67,22.04.2019 00:48,20,1,Volyn
208,204,6,59,143,6,149,0,149,5,90,54,22.04.2019 00:15,20,1,Volyn
480,462,38,188,258,34,292,0,292,4,196,92,22.04.2019 00:10,20,1,Volyn
192,185,11,47,134,11,145,0,145,3,107,35,21.04.2019 23:40,20,1,Volyn
976,962,12,301,664,11,675,0,675,21,357,297,22.04.2019 00:05,20,1,Volyn
1168,1161,37,399,733,36,769,0,769,27,438,304,22.04.2019 00:20,20,1,Volyn
736,716,27,254,457,25,482,0,482,8,298,176,22.04.2019 00:10,20,1,Volyn
416,401,31,145,244,27,271,0,271,5,169,97,22.04.2019 00:30,20,1,Volyn
608,591,53,248,313,47,360,0,360,11,236,113,22.04.2019 00:20,20,1,Volyn
816,803,33,308,479,29,508,0,508,10,305,193,22.04.2019 00:16,20,1,Volyn
848,833,18,279,551,18,569,0,569,9,332,228,22.04.2019 01:30,20,1,Volyn
992,973,15,302,676,14,690,0,690,11,377,302,21.04.2019 21:30,20,1,Volyn
448,439,12,162,276,10,286,0,286,8,159,119,22.04.2019 00:30,20,1,Volyn
336,323,8,130,199,7,206,0,206,7,122,77,22.04.2019 00:30,20,1,Volyn
512,508,22,169,322,21,343,0,343,5,230,108,22.04.2019 00:50,20,1,Volyn
1680,1649,28,530,1127,23,1150,0,1150,24,673,453,22.04.2019 00:10,20,1,Volyn
2000,1971,19,614,1370,16,1386,0,1386,31,797,558,22.04.2019 00:15,20,1,Volyn
1760,1727,30,688,1047,25,1072,0,1072,25,637,410,22.04.2019 00:30,20,1,Volyn
672,656,26,247,404,21,425,0,425,7,257,161,22.04.2019 00:10,20,1,Volyn
1808,1781,21,703,1090,15,1105,0,1105,44,605,456,22.04.2019 00:25,20,1,Volyn
880,865,16,316,548,16,564,0,564,18,341,205,22.04.2019 03:05,20,1,Volyn
544,528,21,200,326,18,344,0,344,11,220,113,22.04.2019 00:50,20,1,Volyn
464,444,14,163,287,14,301,0,301,7,189,105,22.04.2019 02:30,20,1,Volyn
320,311,28,113,181,26,207,0,207,3,124,80,21.04.2019 23:58,20,1,Volyn
1872,1838,28,658,1190,24,1214,0,1214,31,706,477,22.04.2019 01:35,20,1,Volyn
1424,1401,32,465,931,28,959,0,959,25,578,356,22.04.2019 00:05,20,1,Volyn
1488,1485,13,527,952,9,961,0,961,28,572,361,22.04.2019 00:10,20,1,Volyn
928,916,34,301,599,28,627,0,627,15,415,197,22.04.2019 00:40,20,1,Volyn
880,865,26,275,580,25,605,0,605,16,389,200,22.04.2019 00:50,20,1,Volyn
768,748,26,264,480,24,504,0,504,7,287,210,21.04.2019 23:40,20,1,Volyn
528,508,23,194,313,21,334,0,334,2,260,72,22.04.2019 01:30,20,1,Volyn
640,630,33,253,358,29,387,0,387,14,228,145,22.04.2019 00:05,20,1,Volyn
192,28,14,168,14,10,24,0,24,0,12,12,22.04.2019 00:02,20,1,Volyn
64,22,6,44,16,4,20,0,20,0,7,13,22.04.2019 00:10,20,1,Volyn
1696,1682,35,683,980,33,1013,0,1013,33,697,283,22.04.2019 00:57,20,1,Volyn
1968,1932,37,772,1163,33,1196,0,1196,27,863,306,22.04.2019 00:10,20,1,Volyn
192,190,20,63,109,20,129,0,129,1,67,61,22.04.2019 00:05,20,1,Volyn
192,189,10,66,116,10,126,0,126,1,83,42,22.04.2019 00:30,20,1,Volyn
80,77,5,25,50,5,55,0,55,1,43,11,22.04.2019 00:40,20,1,Volyn
432,426,20,192,221,19,240,0,240,6,155,79,22.04.2019 01:10,20,1,Volyn
288,284,17,118,155,15,170,0,170,7,90,73,22.04.2019 00:30,20,1,Volyn
352,344,23,121,209,22,231,0,231,2,134,95,22.04.2019 00:10,20,1,Volyn
256,252,15,102,139,15,154,0,154,2,109,43,22.04.2019 00:11,20,1,Volyn
672,664,62,269,344,59,403,0,403,12,241,150,22.04.2019 00:10,20,1,Volyn
240,227,15,77,149,14,163,0,163,3,93,67,22.04.2019 00:10,20,1,Volyn
464,448,37,156,273,35,308,0,308,8,188,112,21.04.2019 21:05,20,1,Volyn
208,198,22,53,139,16,155,0,155,1,116,38,22.04.2019 00:10,20,1,Volyn
144,136,13,59,73,12,85,0,85,0,60,25,22.04.2019 00:05,20,1,Volyn
208,197,4,73,131,4,135,0,135,3,99,33,22.04.2019 01:40,20,1,Volyn
176,171,13,54,111,11,122,0,122,4,75,43,22.04.2019 00:05,20,1,Volyn
208,193,18,65,127,16,143,0,143,0,111,32,22.04.2019 00:05,20,1,Volyn
752,732,40,282,430,40,470,0,470,13,332,125,22.04.2019 00:30,20,1,Volyn
320,307,22,115,185,20,205,0,205,8,135,62,22.04.2019 01:30,20,1,Volyn
192,183,14,69,112,11,123,0,123,4,88,31,22.04.2019 00:30,20,1,Volyn
496,486,31,210,255,31,286,0,286,4,215,67,22.04.2019 00:30,20,1,Volyn
416,402,57,149,210,57,267,0,267,2,161,104,22.04.2019 00:10,20,1,Volyn
320,305,13,92,216,12,228,0,228,2,150,76,22.04.2019 00:10,20,1,Volyn
176,175,7,49,121,6,127,0,127,2,67,58,22.04.2019 00:30,20,1,Volyn
304,300,19,116,172,16,188,0,188,9,143,36,22.04.2019 00:05,20,1,Volyn
144,136,8,53,84,7,91,0,91,1,51,39,22.04.2019 00:05,20,1,Volyn
272,267,16,101,157,14,171,0,171,0,128,43,22.04.2019 00:10,20,1,Volyn
240,239,12,77,151,12,163,0,163,6,121,36,21.04.2019 21:15,20,1,Volyn
208,195,10,96,105,7,112,0,112,2,74,36,22.04.2019 00:25,20,1,Volyn
176,162,9,73,94,9,103,0,103,7,62,34,22.04.2019 00:05,20,1,Volyn
480,474,35,189,257,34,291,0,291,4,194,93,22.04.2019 00:10,20,1,Volyn
240,239,15,101,124,15,139,0,139,1,107,31,22.04.2019 00:20,20,1,Volyn
576,561,32,169,379,28,407,0,407,8,267,132,22.04.2019 00:05,20,1,Volyn
288,274,16,110,164,14,178,0,178,2,104,72,22.04.2019 00:20,20,1,Volyn
800,787,48,317,445,38,483,0,483,11,347,125,22.04.2019 00:20,20,1,Volyn
416,397,24,164,230,22,252,0,252,1,150,101,22.04.2019 00:30,20,1,Volyn
176,170,9,85,86,5,91,0,91,3,64,24,22.04.2019 00:10,20,1,Volyn
224,215,15,83,126,15,141,0,141,3,103,35,22.04.2019 00:26,20,1,Volyn
1056,1042,44,389,628,39,667,0,667,18,514,135,22.04.2019 00:14,20,1,Volyn
240,223,12,127,104,9,113,0,113,3,90,20,22.04.2019 00:05,20,1,Volyn
384,374,17,130,238,16,254,0,254,3,151,100,22.04.2019 00:53,20,1,Volyn
464,457,23,170,271,23,294,0,294,4,187,103,21.04.2019 21:10,20,1,Volyn
320,310,29,137,160,23,183,0,183,6,96,81,22.04.2019 01:15,20,1,Volyn
224,207,17,112,95,17,112,0,112,1,65,46,21.04.2019 23:55,20,1,Volyn
160,37,9,129,25,6,31,0,31,2,19,10,22.04.2019 00:10,20,1,Volyn
784,777,20,236,529,19,548,0,548,15,434,99,22.04.2019 00:15,20,1,Volyn
224,212,9,98,122,4,126,0,126,1,78,47,22.04.2019 00:15,20,1,Volyn
176,159,11,63,105,8,113,0,113,4,68,41,22.04.2019 00:01,20,1,Volyn
352,348,19,84,252,16,268,0,268,6,171,91,22.04.2019 00:45,20,1,Volyn
160,151,14,65,85,10,95,0,95,4,50,41,22.04.2019 01:00,20,1,Volyn
224,212,15,77,132,15,147,0,147,3,96,48,22.04.2019 00:35,20,1,Volyn
256,247,18,67,171,18,189,0,189,7,86,96,22.04.2019 00:05,20,1,Volyn
192,174,14,80,98,14,112,0,112,5,64,43,22.04.2019 00:15,20,1,Volyn
480,468,38,171,277,32,309,0,309,5,178,126,21.04.2019 22:25,20,1,Volyn
144,132,12,40,93,11,104,0,104,4,46,54,22.04.2019 00:10,20,1,Volyn
240,222,10,109,121,10,131,0,131,5,81,45,22.04.2019 00:35,20,1,Volyn
160,152,10,59,91,10,101,0,101,3,67,31,22.04.2019 00:55,20,1,Volyn
240,230,29,118,99,23,122,0,122,4,75,43,22.04.2019 00:10,20,1,Volyn
144,139,19,63,65,16,81,0,81,0,42,39,22.04.2019 00:45,20,1,Volyn
576,557,48,224,310,42,352,0,352,4,253,95,22.04.2019 00:20,20,1,Volyn
128,112,7,57,65,6,71,0,71,2,47,22,22.04.2019 00:10,20,1,Volyn
96,86,11,39,47,10,57,0,57,1,42,14,22.04.2019 00:15,20,1,Volyn
384,366,27,164,195,25,220,0,220,3,117,100,22.04.2019 00:10,20,1,Volyn
80,78,11,31,39,10,49,0,49,2,24,23,22.04.2019 02:40,20,1,Volyn
128,117,19,50,60,18,78,0,78,4,38,36,22.04.2019 00:10,20,1,Volyn
336,331,38,119,180,37,217,0,217,3,156,58,22.04.2019 00:20,20,1,Volyn
160,154,1,69,91,0,91,0,91,5,47,39,21.04.2019 20:20,20,1,Volyn
112,107,3,40,69,3,72,0,72,2,23,47,22.04.2019 00:55,20,1,Volyn
304,300,20,88,197,19,216,0,216,5,117,94,22.04.2019 00:09,20,1,Volyn
160,165,6,59,95,6,101,0,101,1,74,26,22.04.2019 00:20,20,1,Volyn
464,453,4,149,312,3,315,0,315,11,191,113,22.04.2019 00:15,20,1,Volyn
208,202,5,62,141,5,146,0,146,3,108,35,22.04.2019 00:50,20,1,Volyn
464,460,28,184,255,25,280,0,280,9,182,89,22.04.2019 00:32,20,1,Volyn
336,112,0,227,109,0,109,0,109,8,52,49,22.04.2019 00:05,20,1,Volyn
736,724,33,285,421,30,451,0,451,6,299,146,22.04.2019 00:40,21,1,Volyn
896,884,47,361,493,42,535,0,535,17,372,146,22.04.2019 00:10,21,1,Volyn
272,265,12,21,240,11,251,0,251,6,137,108,22.04.2019 00:05,21,1,Volyn
208,197,14,46,148,14,162,0,162,2,123,37,22.04.2019 00:24,21,1,Volyn
48,46,0,22,26,0,26,0,26,0,19,7,22.04.2019 00:05,21,1,Volyn
112,100,9,51,54,7,61,0,61,0,42,19,22.04.2019 00:00,21,1,Volyn
160,158,15,48,98,14,112,0,112,0,88,24,22.04.2019 01:00,21,1,Volyn
1152,1123,6,424,722,6,728,0,728,14,527,187,21.04.2019 23:55,21,1,Volyn
1104,1073,5,409,690,5,695,0,695,12,499,184,22.04.2019 05:12,21,1,Volyn
976,953,3,409,564,3,567,0,567,9,415,143,22.04.2019 00:05,21,1,Volyn
240,228,1,83,156,1,157,0,157,7,113,37,21.04.2019 23:55,21,1,Volyn
320,306,25,108,190,22,212,0,212,4,121,87,22.04.2019 00:15,21,1,Volyn
144,135,14,50,81,13,94,0,94,0,68,26,22.04.2019 04:00,21,1,Volyn
80,80,13,23,46,11,57,0,57,0,38,19,22.04.2019 00:30,21,1,Volyn
224,219,13,95,116,13,129,0,129,4,79,46,21.04.2019 22:45,21,1,Volyn
448,424,21,111,317,20,337,0,337,6,215,116,22.04.2019 00:15,21,1,Volyn
256,240,8,97,153,6,159,0,159,6,83,70,22.04.2019 00:05,21,1,Volyn
176,172,11,58,109,9,118,0,118,0,64,54,22.04.2019 00:10,21,1,Volyn
96,95,8,20,68,8,76,0,76,3,29,44,22.04.2019 00:10,21,1,Volyn
64,67,6,18,41,5,46,0,46,0,27,19,22.04.2019 00:10,21,1,Volyn
496,492,27,168,301,27,328,0,328,14,212,102,22.04.2019 06:40,21,1,Volyn
80,74,5,26,49,5,54,0,54,0,25,29,22.04.2019 00:05,21,1,Volyn
448,447,12,134,304,10,314,0,314,5,228,81,22.04.2019 00:37,21,1,Volyn
960,934,22,338,600,22,622,0,622,14,416,192,22.04.2019 00:20,21,1,Volyn
800,780,14,317,473,10,483,0,483,13,327,143,22.04.2019 00:05,21,1,Volyn
784,760,10,240,537,7,544,0,544,16,324,204,22.04.2019 00:30,21,1,Volyn
592,568,25,189,382,21,403,0,403,12,280,111,22.04.2019 04:25,21,1,Volyn
432,420,27,161,249,22,271,0,271,4,173,94,22.04.2019 00:10,21,1,Volyn
96,85,6,53,39,4,43,0,43,2,25,16,22.04.2019 00:05,21,1,Volyn
384,362,38,145,204,35,239,0,239,1,158,80,22.04.2019 01:35,21,1,Volyn
176,169,3,74,99,3,102,0,102,0,54,48,21.04.2019 23:45,21,1,Volyn
176,170,8,80,89,7,96,0,96,1,57,38,21.04.2019 21:15,21,1,Volyn
48,37,1,19,28,1,29,0,29,0,15,14,22.04.2019 04:00,21,1,Volyn
528,512,35,179,316,33,349,0,349,7,201,141,22.04.2019 00:02,21,1,Volyn
160,151,20,59,83,18,101,0,101,1,64,36,22.04.2019 00:03,21,1,Volyn
512,498,33,206,275,31,306,0,306,4,203,99,21.04.2019 23:30,21,1,Volyn
544,530,25,194,325,25,350,0,350,8,216,126,22.04.2019 00:10,21,1,Volyn
288,282,14,102,172,14,186,0,186,0,135,51,22.04.2019 00:11,21,1,Volyn
160,153,14,45,101,14,115,0,115,2,66,47,22.04.2019 00:10,21,1,Volyn
256,251,16,103,137,16,153,0,153,3,115,35,21.04.2019 20:54,21,1,Volyn
128,114,10,63,58,7,65,0,65,5,29,31,22.04.2019 00:05,21,1,Volyn
352,333,18,145,193,14,207,0,207,4,132,71,22.04.2019 00:07,21,1,Volyn
112,98,10,39,64,9,73,0,73,1,39,33,22.04.2019 00:15,21,1,Volyn
64,66,9,14,46,4,50,0,50,2,22,26,22.04.2019 00:05,21,1,Volyn
80,72,18,30,35,15,50,0,50,1,15,34,21.04.2019 20:05,21,1,Volyn
448,439,20,137,291,20,311,0,311,3,192,116,22.04.2019 02:30,21,1,Volyn
224,199,5,109,111,4,115,0,115,2,85,28,22.04.2019 00:10,21,1,Volyn
160,143,12,48,100,12,112,0,112,0,61,51,22.04.2019 00:15,21,1,Volyn
96,80,11,43,43,10,53,0,53,1,35,17,22.04.2019 00:15,21,1,Volyn
352,335,17,112,223,17,240,0,240,1,190,49,22.04.2019 00:10,21,1,Volyn
48,42,9,15,24,9,33,0,33,1,22,10,21.04.2019 23:30,21,1,Volyn
704,715,61,211,437,56,493,0,493,9,275,209,22.04.2019 00:05,21,1,Volyn
464,459,29,167,270,27,297,0,297,6,179,112,22.04.2019 01:05,21,1,Volyn
272,257,35,113,128,31,159,0,159,1,87,71,22.04.2019 00:02,21,1,Volyn
496,493,46,120,333,43,376,0,376,8,249,119,21.04.2019 21:30,21,1,Volyn
1312,1276,84,410,827,75,902,0,902,16,583,303,22.04.2019 03:35,21,1,Volyn
160,153,3,49,108,3,111,0,111,7,70,34,22.04.2019 03:25,21,1,Volyn
96,79,12,39,46,11,57,0,57,1,35,21,22.04.2019 00:16,21,1,Volyn
224,204,13,66,145,13,158,0,158,3,111,44,22.04.2019 00:05,21,1,Volyn
256,238,6,86,166,4,170,0,170,3,108,59,21.04.2019 21:17,21,1,Volyn
112,96,7,35,70,7,77,0,77,3,52,22,22.04.2019 04:30,21,1,Volyn
176,158,13,76,88,12,100,0,100,3,68,29,22.04.2019 04:02,21,1,Volyn
208,190,16,67,126,15,141,0,141,1,84,56,22.04.2019 00:10,21,1,Volyn
176,161,12,57,108,11,119,0,119,3,73,43,21.04.2019 21:40,21,1,Volyn
336,324,18,117,202,17,219,0,219,4,134,81,22.04.2019 00:10,21,1,Volyn
192,188,18,54,124,14,138,0,138,1,66,71,22.04.2019 00:10,21,1,Volyn
160,158,12,60,89,11,100,0,100,3,65,32,22.04.2019 00:15,21,1,Volyn
48,34,5,21,22,5,27,0,27,1,17,9,22.04.2019 00:40,21,1,Volyn
192,190,17,47,131,14,145,0,145,4,81,60,22.04.2019 00:10,21,1,Volyn
48,36,4,15,29,4,33,0,33,0,13,20,22.04.2019 00:01,21,1,Volyn
704,703,42,238,428,38,466,0,466,15,310,141,22.04.2019 00:20,21,1,Volyn
304,297,28,113,166,25,191,0,191,6,106,79,22.04.2019 02:10,21,1,Volyn
192,181,21,27,144,21,165,0,165,4,67,94,22.04.2019 00:20,21,1,Volyn
176,163,11,73,93,10,103,0,103,2,40,61,22.04.2019 00:45,21,1,Volyn
160,151,15,46,102,12,114,0,114,0,62,52,22.04.2019 00:15,21,1,Volyn
368,353,24,144,202,22,224,0,224,9,138,77,22.04.2019 00:10,21,1,Volyn
160,158,16,55,92,13,105,0,105,1,77,27,22.04.2019 00:20,21,1,Volyn
96,87,3,29,64,3,67,0,67,1,43,23,22.04.2019 01:40,21,1,Volyn
576,563,42,178,357,41,398,0,398,21,225,152,22.04.2019 00:10,21,1,Volyn
432,421,30,162,240,30,270,0,270,9,151,110,22.04.2019 00:05,21,1,Volyn
96,14,6,83,7,6,13,0,13,0,11,2,22.04.2019 00:05,21,1,Volyn
560,545,42,197,330,33,363,0,363,14,223,126,22.04.2019 01:05,21,1,Volyn
112,107,9,37,67,8,75,0,75,2,49,24,22.04.2019 00:10,21,1,Volyn
1200,1160,79,437,694,69,763,0,763,12,468,283,22.04.2019 00:05,21,1,Volyn
480,460,34,157,289,34,323,0,323,2,226,95,22.04.2019 00:25,21,1,Volyn
160,147,23,47,91,22,113,0,113,3,72,38,22.04.2019 01:40,21,1,Volyn
352,336,22,125,206,21,227,0,227,4,161,62,22.04.2019 00:05,21,1,Volyn
2144,2110,12,849,1284,11,1295,0,1295,42,912,341,22.04.2019 00:35,21,1,Volyn
2000,1977,14,762,1226,12,1238,0,1238,47,880,311,22.04.2019 00:30,21,1,Volyn
336,314,4,131,202,3,205,0,205,4,149,52,22.04.2019 00:30,21,1,Volyn
512,505,4,173,336,3,339,0,339,12,237,90,22.04.2019 00:17,21,1,Volyn
304,287,12,102,190,12,202,0,202,14,149,39,22.04.2019 00:20,21,1,Volyn
128,114,9,52,68,8,76,0,76,1,64,11,22.04.2019 00:45,21,1,Volyn
528,519,12,220,296,12,308,0,308,4,222,82,22.04.2019 00:05,21,1,Volyn
496,475,10,242,246,8,254,0,254,4,176,74,22.04.2019 00:10,21,1,Volyn
352,335,14,149,189,14,203,0,203,6,84,113,22.04.2019 00:30,21,1,Volyn
1360,1346,70,490,801,69,870,0,870,21,620,229,21.04.2019 23:57,21,1,Volyn
368,362,30,90,248,30,278,0,278,9,180,89,22.04.2019 00:10,21,1,Volyn
416,405,30,153,236,27,263,0,263,7,190,66,22.04.2019 00:50,21,1,Volyn
176,164,19,59,98,19,117,0,117,4,56,57,22.04.2019 00:15,21,1,Volyn
304,290,9,103,193,8,201,0,201,1,128,72,22.04.2019 00:45,21,1,Volyn
208,201,10,75,125,8,133,0,133,6,86,41,22.04.2019 00:25,21,1,Volyn
432,416,16,150,266,16,282,0,282,11,186,85,22.04.2019 00:05,21,1,Volyn
176,170,7,56,114,6,120,0,120,1,88,31,22.04.2019 00:15,21,1,Volyn
176,173,9,47,120,9,129,0,129,5,87,37,22.04.2019 01:20,21,1,Volyn
96,87,0,42,54,0,54,0,54,1,32,21,22.04.2019 00:50,21,1,Volyn
496,483,14,177,306,13,319,0,319,9,189,121,22.04.2019 03:10,21,1,Volyn
112,106,5,51,56,5,61,0,61,1,48,12,22.04.2019 00:30,21,1,Volyn
400,397,23,130,247,23,270,0,270,12,179,79,22.04.2019 00:15,21,1,Volyn
576,565,32,178,367,31,398,0,398,16,256,126,21.04.2019 21:10,21,1,Volyn
192,179,21,38,133,21,154,0,154,5,84,65,22.04.2019 00:29,21,1,Volyn
384,375,34,149,202,33,235,0,235,6,149,80,22.04.2019 00:10,21,1,Volyn
176,164,3,60,114,2,116,0,116,4,71,41,22.04.2019 00:15,21,1,Volyn
240,234,8,86,147,7,154,0,154,1,117,36,22.04.2019 05:50,21,1,Volyn
160,153,14,71,75,14,89,0,89,0,64,25,22.04.2019 00:20,21,1,Volyn
96,91,6,33,57,6,63,0,63,1,41,21,22.04.2019 00:05,21,1,Volyn
112,99,8,48,56,8,64,0,64,0,35,29,22.04.2019 00:10,21,1,Volyn
160,146,14,69,79,12,91,0,91,0,52,39,22.04.2019 00:05,21,1,Volyn
160,155,13,34,113,13,126,0,126,4,60,62,22.04.2019 00:02,21,1,Volyn
224,214,16,89,122,13,135,0,135,1,102,32,22.04.2019 00:10,21,1,Volyn
784,765,9,324,452,8,460,0,460,21,341,98,22.04.2019 00:30,21,1,Volyn
240,224,6,102,132,6,138,0,138,2,110,26,22.04.2019 00:20,21,1,Volyn
1408,1381,15,490,904,14,918,0,918,23,599,296,22.04.2019 01:40,21,1,Volyn
1600,1566,18,596,986,18,1004,0,1004,23,707,274,22.04.2019 00:50,21,1,Volyn
320,304,21,111,190,19,209,0,209,2,167,40,22.04.2019 00:45,21,1,Volyn
176,168,1,55,120,1,121,0,121,0,73,48,22.04.2019 00:15,21,1,Volyn
784,776,44,327,414,43,457,0,457,8,275,174,21.04.2019 21:50,21,1,Volyn
304,295,23,104,177,23,200,0,200,3,126,71,22.04.2019 00:20,21,1,Volyn
416,413,3,191,222,3,225,0,225,4,168,53,22.04.2019 07:26,21,1,Volyn
160,155,2,54,104,2,106,0,106,4,77,25,22.04.2019 07:40,21,1,Volyn
80,75,1,30,50,0,50,0,50,2,35,13,22.04.2019 00:10,21,1,Volyn
992,968,60,345,590,57,647,0,647,21,419,207,22.04.2019 00:05,21,1,Volyn
320,313,3,119,199,2,201,0,201,7,126,68,22.04.2019 01:12,21,1,Volyn
208,199,4,71,133,4,137,0,137,4,74,59,22.04.2019 00:10,21,1,Volyn
176,165,6,46,124,6,130,0,130,5,77,48,22.04.2019 07:20,21,1,Volyn
384,370,5,161,218,5,223,0,223,4,177,42,22.04.2019 00:05,21,1,Volyn
1312,1284,5,535,772,5,777,0,777,24,509,244,22.04.2019 00:35,21,1,Volyn
1952,1917,8,848,1096,8,1104,0,1104,33,702,369,22.04.2019 05:10,21,1,Volyn
1760,1739,11,689,1060,11,1071,0,1071,33,705,333,22.04.2019 00:05,21,1,Volyn
960,925,8,415,537,8,545,0,545,24,335,186,22.04.2019 00:04,21,1,Volyn
1056,1029,16,433,614,9,623,0,623,27,425,171,22.04.2019 00:15,21,1,Volyn
1168,1188,6,380,784,4,788,0,788,25,527,236,22.04.2019 07:10,21,1,Volyn
2176,2139,18,852,1308,16,1324,0,1324,52,867,405,22.04.2019 00:20,21,1,Volyn
2192,2177,12,758,1423,11,1434,0,1434,38,998,398,21.04.2019 22:10,21,1,Volyn
1040,1029,8,433,599,8,607,0,607,13,399,195,22.04.2019 00:30,21,1,Volyn
848,853,4,279,565,4,569,0,569,24,350,195,22.04.2019 00:30,21,1,Volyn
1072,1042,15,453,606,13,619,0,619,27,404,188,22.04.2019 00:02,21,1,Volyn
1232,1194,5,476,752,4,756,0,756,9,512,235,22.04.2019 00:15,21,1,Volyn
1536,1499,14,629,896,11,907,0,907,22,574,311,22.04.2019 00:05,21,1,Volyn
1904,1867,4,654,1247,3,1250,0,1250,34,854,362,22.04.2019 00:05,21,1,Volyn
1584,1553,6,595,983,6,989,0,989,32,699,258,22.04.2019 00:50,21,1,Volyn
1584,1569,26,557,1003,24,1027,0,1027,28,669,330,22.04.2019 00:03,21,1,Volyn
1792,1783,10,693,1089,10,1099,0,1099,32,723,344,22.04.2019 00:50,21,1,Volyn
2432,2398,10,934,1489,9,1498,0,1498,49,990,459,22.04.2019 01:20,21,1,Volyn
1312,1286,9,526,778,8,786,0,786,16,517,253,22.04.2019 00:45,21,1,Volyn
1968,1950,11,761,1199,8,1207,0,1207,43,830,334,22.04.2019 00:15,21,1,Volyn
1984,1962,6,838,1140,6,1146,0,1146,29,811,306,22.04.2019 02:21,21,1,Volyn
2400,2360,1,972,1427,1,1428,0,1428,50,963,415,22.04.2019 00:02,21,1,Volyn
1776,1765,6,727,1044,5,1049,0,1049,30,695,324,22.04.2019 00:05,21,1,Volyn
1440,1427,3,510,927,3,930,0,930,29,641,260,22.04.2019 04:20,21,1,Volyn
144,40,40,111,0,33,33,0,33,0,19,14,22.04.2019 00:10,21,1,Volyn
624,159,97,482,51,91,142,0,142,5,101,36,22.04.2019 00:57,21,1,Volyn
208,18,0,190,18,0,18,0,18,0,17,1,22.04.2019 05:00,21,1,Volyn
352,276,3,82,267,3,270,0,270,23,216,31,22.04.2019 00:03,22,1,Volyn
1360,1341,16,426,922,12,934,0,934,17,558,359,22.04.2019 01:10,22,1,Volyn
1520,1497,7,574,939,7,946,0,946,21,590,335,22.04.2019 00:20,22,1,Volyn
2368,2315,14,748,1607,13,1620,0,1620,36,971,613,22.04.2019 01:40,22,1,Volyn
2304,2253,4,782,1519,3,1522,0,1522,55,884,583,22.04.2019 00:20,22,1,Volyn
2240,2214,8,804,1429,7,1436,0,1436,55,866,515,22.04.2019 00:20,22,1,Volyn
1808,1778,10,610,1193,5,1198,0,1198,34,675,489,22.04.2019 01:25,22,1,Volyn
2080,2049,13,736,1331,13,1344,0,1344,44,810,490,22.04.2019 00:12,22,1,Volyn
2320,2281,8,820,1492,8,1500,0,1500,35,866,599,22.04.2019 00:14,22,1,Volyn
2192,2168,22,832,1344,16,1360,0,1360,46,781,533,22.04.2019 00:10,22,1,Volyn
2000,1976,12,756,1236,8,1244,0,1244,33,745,466,22.04.2019 00:05,22,1,Volyn
2320,2308,12,722,1588,10,1598,0,1598,55,897,646,22.04.2019 00:30,22,1,Volyn
2416,2397,15,784,1617,15,1632,0,1632,45,920,667,22.04.2019 03:32,22,1,Volyn
2320,2299,16,813,1494,13,1507,0,1507,53,877,577,22.04.2019 00:40,22,1,Volyn
1600,1581,8,536,1056,8,1064,0,1064,28,629,407,22.04.2019 00:10,22,1,Volyn
2336,2313,23,779,1536,21,1557,0,1557,57,890,610,22.04.2019 00:20,22,1,Volyn
2400,2378,18,902,1482,16,1498,0,1498,53,846,599,22.04.2019 00:45,22,1,Volyn
2256,2236,20,853,1388,15,1403,0,1403,39,858,506,22.04.2019 00:08,22,1,Volyn
1680,1682,15,637,1031,12,1043,0,1043,35,603,405,22.04.2019 00:10,22,1,Volyn
2192,2185,13,843,1341,8,1349,0,1349,36,813,500,22.04.2019 00:20,22,1,Volyn
2096,2093,27,665,1407,24,1431,0,1431,44,764,623,22.04.2019 00:20,22,1,Volyn
1216,1199,13,427,779,10,789,0,789,34,439,316,22.04.2019 00:30,22,1,Volyn
2368,2361,21,854,1496,18,1514,0,1514,53,925,536,22.04.2019 00:35,22,1,Volyn
2368,2352,15,841,1516,11,1527,0,1527,39,897,591,22.04.2019 00:45,22,1,Volyn
2288,2174,8,918,1364,6,1370,0,1370,40,773,557,22.04.2019 00:40,22,1,Volyn
2032,2004,9,649,1374,9,1383,0,1383,31,871,481,22.04.2019 00:30,22,1,Volyn
2144,2109,13,708,1425,11,1436,0,1436,35,957,444,22.04.2019 00:03,22,1,Volyn
2208,2170,11,778,1422,8,1430,0,1430,38,891,501,22.04.2019 00:10,22,1,Volyn
2112,2018,10,818,1287,7,1294,0,1294,44,743,507,22.04.2019 00:25,22,1,Volyn
2144,2140,14,756,1376,12,1388,0,1388,42,838,508,22.04.2019 00:10,22,1,Volyn
2176,2162,14,724,1440,12,1452,0,1452,52,882,518,22.04.2019 00:03,22,1,Volyn
2272,2227,20,740,1514,18,1532,0,1532,52,864,616,22.04.2019 00:10,22,1,Volyn
1952,1923,12,738,1206,8,1214,0,1214,37,696,481,22.04.2019 02:50,22,1,Volyn
2096,2067,9,780,1308,8,1316,0,1316,43,807,466,22.04.2019 00:13,22,1,Volyn
1792,1759,20,584,1191,17,1208,0,1208,47,669,492,22.04.2019 00:01,22,1,Volyn
1856,1841,9,651,1196,9,1205,0,1205,44,695,466,22.04.2019 00:03,22,1,Volyn
1680,1657,11,618,1054,8,1062,0,1062,47,629,386,22.04.2019 00:10,22,1,Volyn
1424,1401,6,495,925,4,929,0,929,37,507,385,22.04.2019 00:10,22,1,Volyn
1776,1750,15,612,1150,14,1164,0,1164,42,675,447,22.04.2019 00:05,22,1,Volyn
2352,2315,5,814,1534,4,1538,0,1538,35,930,573,22.04.2019 00:25,22,1,Volyn
2080,2049,15,748,1320,12,1332,0,1332,39,769,524,22.04.2019 00:15,22,1,Volyn
2080,2056,7,806,1270,4,1274,0,1274,46,756,472,22.04.2019 00:10,22,1,Volyn
2224,2192,10,793,1423,8,1431,0,1431,52,851,528,22.04.2019 00:57,22,1,Volyn
1584,1572,6,540,1039,5,1044,0,1044,43,612,389,22.04.2019 04:36,22,1,Volyn
2400,2361,6,894,1502,4,1506,0,1506,44,947,515,22.04.2019 00:25,22,1,Volyn
1504,1484,8,643,855,6,861,0,861,24,521,316,22.04.2019 00:10,22,1,Volyn
1408,1382,6,519,886,3,889,0,889,37,522,330,22.04.2019 00:31,22,1,Volyn
2320,2304,10,815,1496,9,1505,0,1505,32,851,622,22.04.2019 00:05,22,1,Volyn
144,139,63,10,75,59,134,0,134,6,105,23,22.04.2019 00:05,22,1,Volyn
2304,2279,6,718,1581,5,1586,0,1586,62,940,584,22.04.2019 00:15,22,1,Volyn
2112,2082,13,660,1441,11,1452,0,1452,43,820,589,22.04.2019 00:02,22,1,Volyn
2176,2134,11,784,1381,11,1392,0,1392,45,897,450,22.04.2019 00:05,22,1,Volyn
2368,2311,3,861,1505,2,1507,0,1507,48,821,638,22.04.2019 00:05,22,1,Volyn
2272,2261,7,896,1370,6,1376,0,1376,34,923,419,22.04.2019 00:30,22,1,Volyn
2320,2297,15,762,1547,11,1558,0,1558,59,869,630,22.04.2019 00:55,22,1,Volyn
2288,2265,9,728,1554,6,1560,0,1560,56,888,616,22.04.2019 00:30,22,1,Volyn
2288,2264,19,727,1548,13,1561,0,1561,69,987,505,22.04.2019 00:20,22,1,Volyn
1920,1911,5,569,1347,4,1351,0,1351,47,741,563,22.04.2019 00:15,22,1,Volyn
2400,2361,6,777,1620,3,1623,0,1623,48,950,625,22.04.2019 00:25,22,1,Volyn
2240,2186,6,727,1509,4,1513,0,1513,50,867,596,22.04.2019 00:30,22,1,Volyn
2320,2292,8,725,1589,6,1595,0,1595,42,950,603,22.04.2019 00:15,22,1,Volyn
2368,2343,8,767,1596,5,1601,0,1601,58,967,576,22.04.2019 00:41,22,1,Volyn
2368,2333,8,746,1616,6,1622,0,1622,48,938,636,22.04.2019 00:50,22,1,Volyn
2416,2414,6,791,1619,6,1625,0,1625,48,897,680,22.04.2019 00:28,22,1,Volyn
2368,2336,8,743,1617,8,1625,0,1625,51,923,651,22.04.2019 04:50,22,1,Volyn
2144,2113,14,677,1453,14,1467,0,1467,37,867,563,22.04.2019 00:10,22,1,Volyn
2288,2247,6,752,1531,5,1536,0,1536,41,926,569,22.04.2019 00:04,22,1,Volyn
2208,2178,3,692,1513,3,1516,0,1516,47,899,570,22.04.2019 00:20,22,1,Volyn
2336,2310,11,787,1542,7,1549,0,1549,45,932,572,22.04.2019 00:15,22,1,Volyn
2384,2367,10,817,1558,9,1567,0,1567,50,913,604,22.04.2019 00:01,22,1,Volyn
2368,2338,20,825,1527,16,1543,0,1542,51,950,541,22.04.2019 04:17,22,1,Volyn
2192,2182,16,692,1490,10,1500,0,1500,55,862,583,22.04.2019 00:05,22,1,Volyn
2016,2019,12,867,1140,9,1149,0,1149,26,698,425,22.04.2019 00:10,22,1,Volyn
2352,2321,24,896,1436,20,1456,0,1456,45,785,626,22.04.2019 00:07,22,1,Volyn
208,109,32,102,75,31,106,0,106,7,57,42,22.04.2019 00:15,22,1,Volyn
272,76,76,200,0,72,72,0,72,1,51,20,22.04.2019 00:55,22,1,Volyn
224,117,24,112,88,24,112,0,112,5,75,32,22.04.2019 00:08,22,1,Volyn
80,26,0,56,24,0,24,0,24,1,14,9,22.04.2019 00:10,22,1,Volyn
224,71,0,153,71,0,71,0,71,0,56,15,22.04.2019 01:20,22,1,Volyn
752,257,125,514,122,116,238,0,238,5,158,75,22.04.2019 00:20,22,1,Volyn
720,284,132,459,145,116,261,0,261,7,172,82,22.04.2019 00:05,22,1,Volyn
128,35,0,94,34,0,34,0,34,0,26,8,22.04.2019 00:05,22,1,Volyn
128,47,2,82,44,2,46,0,46,2,29,15,22.04.2019 00:17,22,1,Volyn
2032,2021,2,599,1432,1,1433,0,1433,36,800,597,22.04.2019 00:31,22,1,Volyn
64,16,0,48,16,0,16,0,16,1,11,4,21.04.2019 23:45,23,1,Volyn
1920,1863,9,838,1075,7,1082,0,1082,29,733,320,21.04.2019 22:08,23,1,Volyn
1776,1752,6,708,1062,6,1068,0,1068,28,741,299,21.04.2019 22:40,23,1,Volyn
1120,1105,5,415,700,5,705,0,705,22,481,202,21.04.2019 23:20,23,1,Volyn
608,598,1,227,380,1,381,0,381,5,213,163,22.04.2019 00:45,23,1,Volyn
384,371,5,188,191,5,196,0,196,1,122,73,22.04.2019 01:03,23,1,Volyn
1440,1424,14,704,723,13,736,0,736,7,354,375,22.04.2019 00:25,23,1,Volyn
800,789,22,266,512,22,534,0,534,16,412,106,21.04.2019 22:15,23,1,Volyn
400,381,22,142,236,22,258,0,258,6,188,64,22.04.2019 00:30,23,1,Volyn
448,434,43,192,219,37,256,0,256,8,171,77,22.04.2019 01:35,23,1,Volyn
32,32,0,9,23,0,23,0,23,0,16,7,22.04.2019 00:30,23,1,Volyn
384,378,7,148,230,6,236,0,236,5,148,83,21.04.2019 21:20,23,1,Volyn
1552,1514,41,690,821,41,862,0,862,32,605,225,22.04.2019 00:21,23,1,Volyn
496,487,19,166,313,17,330,0,330,7,217,106,22.04.2019 00:42,23,1,Volyn
352,334,13,152,187,13,200,0,200,5,147,48,22.04.2019 00:20,23,1,Volyn
1200,1176,10,517,674,9,683,0,683,23,402,258,22.04.2019 00:15,23,1,Volyn
1280,1245,34,542,705,33,738,0,738,23,507,208,22.04.2019 01:30,23,1,Volyn
736,729,13,252,472,12,484,0,484,5,341,138,22.04.2019 00:05,23,1,Volyn
192,188,2,96,95,1,96,0,96,0,78,18,22.04.2019 00:10,23,1,Volyn
480,463,16,189,275,16,291,0,291,7,171,113,22.04.2019 00:10,23,1,Volyn
480,474,25,187,268,25,293,0,293,4,144,145,22.04.2019 00:15,23,1,Volyn
560,552,43,164,353,43,396,0,396,7,198,191,22.04.2019 00:10,23,1,Volyn
64,55,1,28,35,1,36,0,36,0,28,8,21.04.2019 23:25,23,1,Volyn
128,114,14,40,79,9,88,0,88,1,48,39,22.04.2019 00:30,23,1,Volyn
368,357,5,124,239,5,244,0,244,3,177,64,21.04.2019 22:10,23,1,Volyn
464,447,23,163,279,22,301,0,301,4,168,129,22.04.2019 01:35,23,1,Volyn
512,491,2,174,336,2,338,0,338,9,221,108,21.04.2019 22:00,23,1,Volyn
480,486,3,122,355,3,358,0,358,1,274,83,21.04.2019 22:10,23,1,Volyn
832,839,68,247,518,67,585,0,585,4,294,287,21.04.2019 23:05,23,1,Volyn
416,404,29,137,250,29,279,0,279,6,219,54,22.04.2019 00:25,23,1,Volyn
1184,1160,7,638,539,7,546,0,546,16,321,209,22.04.2019 00:14,23,1,Volyn
752,748,2,442,308,2,310,0,310,9,201,100,22.04.2019 00:10,23,1,Volyn
896,885,34,419,443,34,477,0,477,10,286,181,22.04.2019 00:35,23,1,Volyn
624,615,3,326,295,3,298,0,298,2,204,92,22.04.2019 00:04,23,1,Volyn
368,360,4,170,194,4,198,0,198,3,135,60,22.04.2019 00:28,23,1,Volyn
480,465,2,251,227,2,229,0,229,13,150,66,22.04.2019 00:35,23,1,Volyn
496,486,12,181,303,12,315,0,315,11,152,152,21.04.2019 22:00,23,1,Volyn
288,285,7,85,196,7,203,0,203,9,98,96,21.04.2019 21:40,23,1,Volyn
1264,1237,4,457,803,4,807,0,807,17,519,271,22.04.2019 00:55,23,1,Volyn
432,419,3,173,257,2,259,0,259,11,117,131,22.04.2019 01:20,23,1,Volyn
1472,1460,57,659,767,46,813,0,813,18,487,308,21.04.2019 21:46,23,1,Volyn
160,147,16,55,89,16,105,0,105,2,62,41,22.04.2019 00:30,23,1,Volyn
704,688,1,348,355,1,356,0,356,24,136,196,22.04.2019 00:55,23,1,Volyn
144,133,1,56,87,1,88,0,88,2,39,47,21.04.2019 21:20,23,1,Volyn
784,763,49,265,470,49,519,0,519,17,364,138,21.04.2019 23:45,23,1,Volyn
288,277,10,88,191,9,200,0,200,1,134,65,21.04.2019 23:30,23,1,Volyn
1168,1143,10,168,990,10,1000,0,1000,22,648,330,22.04.2019 00:40,23,1,Volyn
160,148,0,30,130,0,130,0,130,1,71,58,22.04.2019 00:10,23,1,Volyn
384,368,16,107,261,16,277,0,277,9,187,81,22.04.2019 00:01,23,1,Volyn
320,89,48,238,38,44,82,0,82,3,50,29,21.04.2019 22:20,23,1,Volyn
1856,1833,28,682,1153,21,1174,0,1174,23,809,342,22.04.2019 03:00,23,1,Volyn
1728,1717,11,675,1042,11,1053,0,1053,25,670,358,22.04.2019 00:20,23,1,Volyn
1616,1594,19,697,901,18,919,0,919,19,634,266,22.04.2019 00:30,23,1,Volyn
1760,1740,18,701,1041,18,1059,0,1059,29,701,329,21.04.2019 23:55,23,1,Volyn
2368,2336,18,923,1430,15,1445,0,1445,38,980,427,22.04.2019 01:00,23,1,Volyn
1584,1560,20,600,967,17,984,0,984,28,647,309,22.04.2019 00:35,23,1,Volyn
1824,1800,19,675,1135,14,1149,0,1149,28,761,360,22.04.2019 02:20,23,1,Volyn
1872,1858,41,857,977,38,1015,0,1015,35,676,304,22.04.2019 00:30,23,1,Volyn
496,484,43,199,256,41,297,0,297,4,189,104,22.04.2019 00:05,23,1,Volyn
288,273,23,112,154,22,176,0,176,1,118,57,21.04.2019 22:00,23,1,Volyn
688,684,16,269,404,15,419,0,419,7,228,184,22.04.2019 02:00,23,1,Volyn
928,924,7,280,641,7,648,0,648,8,412,228,22.04.2019 00:45,23,1,Volyn
1424,1414,19,555,850,19,869,0,869,39,529,301,22.04.2019 02:00,23,1,Volyn
1232,1225,26,461,745,26,771,0,771,18,506,247,22.04.2019 00:10,23,1,Volyn
336,328,20,132,184,20,204,0,204,5,110,89,22.04.2019 00:10,23,1,Volyn
640,637,56,231,359,50,409,0,409,9,198,202,21.04.2019 20:57,23,1,Volyn
880,867,55,274,552,54,606,0,606,16,350,240,21.04.2019 23:00,23,1,Volyn
640,625,10,279,352,9,361,0,361,2,237,122,22.04.2019 00:55,23,1,Volyn
720,721,18,217,489,14,503,0,503,13,247,243,22.04.2019 00:22,23,1,Volyn
288,281,19,82,190,16,206,0,206,3,80,123,22.04.2019 00:15,23,1,Volyn
1232,1210,83,488,668,76,744,0,744,21,431,292,21.04.2019 23:22,23,1,Volyn
304,295,30,129,148,27,175,0,175,3,109,63,22.04.2019 00:10,23,1,Volyn
256,253,9,67,180,9,189,0,189,1,133,55,22.04.2019 00:05,23,1,Volyn
272,265,18,64,190,18,208,0,208,7,83,118,22.04.2019 00:50,23,1,Volyn
720,707,42,273,405,42,447,0,447,12,297,138,21.04.2019 23:15,23,1,Volyn
736,724,48,248,440,48,488,0,488,27,298,163,22.04.2019 03:45,23,1,Volyn
112,111,6,25,82,5,87,0,87,3,64,20,22.04.2019 00:10,23,1,Volyn
208,202,20,77,112,19,131,0,131,2,84,45,22.04.2019 01:30,23,1,Volyn
736,722,24,332,385,19,404,0,404,16,230,158,22.04.2019 01:10,23,1,Volyn
224,214,7,88,129,7,136,0,136,0,92,44,22.04.2019 00:12,23,1,Volyn
1152,1132,9,384,761,7,768,0,768,15,415,338,21.04.2019 21:30,23,1,Volyn
752,747,5,257,490,5,495,0,495,10,308,177,22.04.2019 00:20,23,1,Volyn
448,430,13,144,291,13,304,0,304,6,151,147,22.04.2019 00:10,23,1,Volyn
672,665,55,215,403,54,457,0,457,23,243,191,22.04.2019 00:35,23,1,Volyn
288,286,18,89,182,17,199,0,199,2,133,64,21.04.2019 22:40,23,1,Volyn
224,207,24,65,137,22,159,0,159,0,91,68,22.04.2019 00:40,23,1,Volyn
864,845,71,273,523,68,591,0,591,10,358,223,22.04.2019 00:48,23,1,Volyn
160,158,17,45,101,14,115,0,115,4,50,61,21.04.2019 23:25,23,1,Volyn
112,99,13,48,51,13,64,0,64,2,45,17,22.04.2019 00:05,23,1,Volyn
272,262,19,107,147,18,165,0,165,2,106,57,22.04.2019 00:35,23,1,Volyn
272,267,18,98,158,16,174,0,174,3,110,61,21.04.2019 22:10,23,1,Volyn
512,510,25,169,318,25,343,0,343,10,198,135,22.04.2019 00:15,23,1,Volyn
336,321,21,124,192,20,212,0,212,2,158,52,22.04.2019 00:19,23,1,Volyn
1216,1197,23,502,691,23,714,0,714,33,302,379,22.04.2019 00:21,23,1,Volyn
1248,1229,73,497,678,73,751,0,751,13,319,419,21.04.2019 22:43,23,1,Volyn
560,547,42,243,275,42,317,0,317,12,211,94,22.04.2019 00:05,23,1,Volyn
352,345,11,113,228,11,239,0,239,3,131,105,21.04.2019 22:50,23,1,Volyn
320,308,19,92,209,19,228,0,228,5,157,66,22.04.2019 00:10,23,1,Volyn
336,332,4,107,225,4,229,0,229,6,161,62,22.04.2019 00:10,23,1,Volyn
336,325,20,109,210,17,227,0,227,3,95,129,21.04.2019 22:05,23,1,Volyn
512,504,46,201,272,39,311,0,311,4,194,113,22.04.2019 00:02,23,1,Volyn
464,453,15,107,342,15,357,0,357,6,216,135,22.04.2019 00:23,23,1,Volyn
272,185,6,87,179,6,185,0,185,3,121,61,22.04.2019 00:15,23,1,Volyn
1792,1782,36,665,1092,35,1127,0,1127,22,686,419,22.04.2019 01:06,23,1,Volyn
832,813,15,298,520,14,534,0,534,16,319,199,22.04.2019 00:20,23,1,Volyn
160,151,10,68,82,10,92,0,92,2,60,30,22.04.2019 00:50,23,1,Volyn
368,360,24,157,189,22,211,0,211,0,88,123,22.04.2019 00:10,23,1,Volyn
544,533,34,192,320,32,352,0,352,8,190,154,21.04.2019 22:06,23,1,Volyn
96,91,3,31,62,3,65,0,65,0,41,24,22.04.2019 00:30,23,1,Volyn
720,709,30,300,390,30,420,0,420,10,282,128,21.04.2019 21:30,23,1,Volyn
528,517,18,220,290,18,308,0,308,3,241,64,21.04.2019 21:30,23,1,Volyn
464,433,29,135,300,29,329,0,329,3,223,103,22.04.2019 00:05,23,1,Volyn
352,346,15,145,192,15,207,0,207,5,133,69,22.04.2019 00:30,23,1,Volyn
240,226,6,56,178,6,184,0,184,1,74,109,21.04.2019 23:15,23,1,Volyn
272,259,21,113,138,21,159,0,159,0,90,69,21.04.2019 21:05,23,1,Volyn
80,77,0,35,45,0,45,0,45,2,29,14,21.04.2019 20:50,23,1,Volyn
752,724,85,288,379,85,464,0,464,8,247,209,21.04.2019 21:30,23,1,Volyn
208,203,20,79,111,18,129,0,129,1,79,49,21.04.2019 21:00,23,1,Volyn
144,136,15,45,84,15,99,0,99,0,80,19,21.04.2019 22:40,23,1,Volyn
784,763,65,211,508,65,573,0,573,14,287,272,22.04.2019 00:10,23,1,Volyn
192,181,13,32,147,13,160,0,160,1,73,86,22.04.2019 00:47,23,1,Volyn
288,286,16,109,165,14,179,0,179,2,115,62,22.04.2019 00:30,23,1,Volyn
256,38,15,224,20,12,32,0,32,1,19,12,22.04.2019 00:10,23,1,Volyn
272,192,0,80,192,0,192,0,192,12,151,29,22.04.2019 00:10,23,1,Volyn
2208,2157,23,958,1229,21,1250,0,1250,25,844,381,22.04.2019 00:17,23,1,Volyn
304,294,5,117,182,5,187,0,187,6,145,36,22.04.2019 00:30,23,1,Volyn
176,168,7,89,80,7,87,0,87,0,46,41,22.04.2019 00:10,23,1,Volyn
144,140,4,65,75,4,79,0,79,1,31,47,22.04.2019 00:05,23,1,Volyn
1184,1170,38,510,639,35,674,0,674,15,434,225,22.04.2019 00:45,23,1,Volyn
208,203,2,87,119,2,121,0,121,1,89,31,21.04.2019 22:10,23,1,Volyn
1248,1216,48,567,636,45,681,0,681,13,454,214,22.04.2019 00:10,23,1,Volyn
384,369,10,114,260,10,270,0,270,7,150,113,22.04.2019 00:30,23,1,Volyn
544,539,13,188,343,13,356,0,356,3,249,104,22.04.2019 00:25,23,1,Volyn
368,356,3,154,211,3,214,0,214,3,148,63,22.04.2019 02:30,23,1,Volyn
640,624,33,241,371,28,399,0,399,7,250,142,22.04.2019 00:50,23,1,Volyn
1440,1415,19,633,793,14,807,0,807,11,539,257,22.04.2019 00:30,23,1,Volyn
1440,1430,60,654,737,49,786,0,786,15,664,107,21.04.2019 23:17,23,1,Volyn
1024,996,7,420,598,6,604,0,604,13,469,122,21.04.2019 21:17,23,1,Volyn
592,575,9,280,303,9,312,0,312,2,247,63,22.04.2019 00:15,23,1,Volyn
48,39,3,17,29,2,31,0,31,0,23,8,21.04.2019 23:30,23,1,Volyn
400,399,9,111,280,9,289,0,289,3,203,83,22.04.2019 01:30,23,1,Volyn
992,971,40,319,636,37,673,0,673,10,309,354,22.04.2019 00:10,23,1,Volyn
416,411,36,138,245,33,278,0,278,7,164,107,22.04.2019 00:05,23,1,Volyn
736,725,60,262,419,55,474,0,474,6,337,131,22.04.2019 00:55,23,1,Volyn
208,195,11,53,144,11,155,0,155,2,80,73,22.04.2019 00:30,23,1,Volyn
848,841,21,399,429,20,449,0,449,9,216,224,22.04.2019 00:34,23,1,Volyn
336,333,3,131,203,2,205,0,205,4,111,90,22.04.2019 00:35,23,1,Volyn
1568,1525,9,592,967,9,976,0,976,23,639,314,22.04.2019 00:15,23,1,Volyn
1424,1404,20,623,787,14,801,0,801,16,513,272,22.04.2019 00:05,23,1,Volyn
1408,1379,11,607,790,11,801,0,801,26,514,261,22.04.2019 00:40,23,1,Volyn
1504,1485,44,620,848,36,884,0,884,21,609,254,21.04.2019 23:06,23,1,Volyn
1952,1929,15,704,1239,9,1248,0,1248,34,818,396,22.04.2019 00:10,23,1,Volyn
1296,1281,28,553,719,24,743,0,743,9,462,272,22.04.2019 00:25,23,1,Volyn
1488,1466,32,569,896,23,919,0,919,29,600,290,22.04.2019 00:50,23,1,Volyn
656,642,45,274,339,43,382,0,382,9,152,221,22.04.2019 00:10,23,1,Volyn
464,447,23,152,289,23,312,0,312,8,154,150,21.04.2019 23:50,23,1,Volyn
464,456,8,211,245,8,253,0,253,3,159,91,22.04.2019 00:30,23,1,Volyn
224,213,5,66,153,5,158,0,158,3,89,66,22.04.2019 00:05,23,1,Volyn
192,180,11,46,136,10,146,0,146,0,84,62,22.04.2019 00:15,23,1,Volyn
256,249,2,89,165,2,167,0,167,6,88,73,22.04.2019 00:10,23,1,Volyn
432,420,21,186,225,21,246,0,246,5,123,118,22.04.2019 01:50,23,1,Volyn
240,225,9,55,176,9,185,0,185,5,97,83,22.04.2019 00:05,23,1,Volyn
240,227,7,120,113,7,120,0,120,11,62,47,22.04.2019 00:05,23,1,Volyn
496,489,21,155,322,19,341,0,341,16,224,101,21.04.2019 22:15,23,1,Volyn
560,548,30,199,334,27,361,0,361,11,163,187,22.04.2019 00:15,23,1,Volyn
912,894,31,432,453,27,480,0,480,10,203,267,21.04.2019 22:00,23,1,Volyn
256,247,14,96,149,11,160,0,160,1,69,90,21.04.2019 23:30,23,1,Volyn
768,753,18,269,482,17,499,0,499,16,291,192,22.04.2019 00:55,23,1,Volyn
272,264,4,84,185,3,188,0,188,8,120,60,22.04.2019 00:10,23,1,Volyn
592,574,35,150,409,33,442,0,442,4,297,141,22.04.2019 00:15,23,1,Volyn
400,393,24,90,286,24,310,0,310,9,194,107,21.04.2019 23:55,23,1,Volyn
80,71,1,26,53,1,54,0,54,0,35,19,21.04.2019 23:30,23,1,Volyn
80,77,4,29,47,4,51,0,51,3,23,25,22.04.2019 00:30,23,1,Volyn
480,468,11,195,274,11,285,0,285,6,181,98,21.04.2019 23:20,23,1,Volyn
208,193,11,67,130,11,141,0,141,1,73,67,21.04.2019 23:00,23,1,Volyn
608,591,40,238,334,36,370,0,370,9,188,173,21.04.2019 23:30,23,1,Volyn
272,266,27,122,126,24,150,0,150,0,78,72,22.04.2019 00:10,23,1,Volyn
592,577,47,216,337,39,376,0,376,11,230,135,22.04.2019 00:02,23,1,Volyn
416,404,12,148,258,10,268,0,268,4,154,110,22.04.2019 00:01,23,1,Volyn
240,234,4,88,148,4,152,0,152,1,72,79,22.04.2019 00:05,23,1,Volyn
272,269,12,107,156,9,165,0,165,5,95,65,21.04.2019 22:55,23,1,Volyn
544,535,29,202,313,29,342,0,342,6,141,195,22.04.2019 00:10,23,1,Volyn
368,354,11,136,223,9,232,0,232,7,136,89,22.04.2019 00:15,23,1,Volyn
304,292,13,74,219,11,230,0,230,3,110,117,21.04.2019 22:30,23,1,Volyn
208,192,13,85,111,12,123,0,123,5,42,76,22.04.2019 00:15,23,1,Volyn
384,378,14,125,245,14,259,0,259,3,122,134,22.04.2019 00:20,23,1,Volyn
592,574,10,260,323,9,332,0,332,9,180,143,21.04.2019 23:55,23,1,Volyn
160,142,10,74,77,9,86,0,86,0,48,38,21.04.2019 23:10,23,1,Volyn
528,511,12,201,317,10,327,0,327,9,120,198,22.04.2019 00:15,23,1,Volyn
352,342,13,138,204,10,214,0,214,11,120,83,22.04.2019 00:35,23,1,Volyn
368,353,13,171,184,13,197,0,197,5,110,82,21.04.2019 22:10,23,1,Volyn
240,223,1,80,159,1,160,0,160,5,90,65,22.04.2019 00:27,23,1,Volyn
368,350,4,140,224,4,228,0,228,5,144,79,22.04.2019 00:30,23,1,Volyn
208,201,7,74,128,6,134,0,134,4,58,72,22.04.2019 00:40,23,1,Volyn
112,98,1,51,60,1,61,0,61,0,22,39,21.04.2019 20:30,23,1,Volyn
928,915,7,339,583,6,589,0,589,14,433,142,22.04.2019 00:27,23,1,Volyn
1936,1906,48,728,1160,48,1208,0,1208,33,908,267,22.04.2019 00:15,23,1,Volyn
992,972,54,334,604,54,658,0,658,13,346,299,22.04.2019 00:40,23,1,Volyn
112,102,5,49,58,5,63,0,63,2,19,42,22.04.2019 00:30,23,1,Volyn
64,50,0,30,34,0,34,0,34,1,25,8,22.04.2019 00:15,23,1,Volyn
160,148,1,61,98,1,99,0,99,1,51,47,22.04.2019 00:10,23,1,Volyn
160,151,15,52,94,14,108,0,108,2,66,40,22.04.2019 00:30,23,1,Volyn
352,347,25,127,200,25,225,0,225,5,89,131,22.04.2019 00:30,23,1,Volyn
1168,1165,116,434,626,108,734,0,734,18,406,310,22.04.2019 00:10,23,1,Volyn
1056,1036,27,494,541,21,562,0,562,9,367,186,22.04.2019 00:20,23,1,Volyn
560,557,9,259,294,7,301,0,301,6,182,113,22.04.2019 00:34,23,1,Volyn
128,116,7,31,90,7,97,0,97,2,69,26,21.04.2019 22:40,23,1,Volyn
400,393,15,165,224,11,235,0,235,4,160,71,22.04.2019 02:15,23,1,Volyn
576,565,45,176,360,40,400,0,400,6,236,158,22.04.2019 00:10,23,1,Volyn
336,325,7,119,212,5,217,0,217,11,106,100,22.04.2019 00:10,23,1,Volyn
112,109,5,37,72,3,75,0,75,1,35,39,22.04.2019 00:20,23,1,Volyn
336,324,25,92,219,25,244,0,244,5,163,76,22.04.2019 00:30,23,1,Volyn
640,643,46,184,413,43,456,0,456,3,211,242,21.04.2019 23:05,23,1,Volyn
272,269,25,96,151,25,176,0,176,8,81,87,22.04.2019 00:14,23,1,Volyn
96,90,8,27,61,8,69,0,69,0,30,39,21.04.2019 22:40,23,1,Volyn
96,96,4,23,69,4,73,0,73,1,23,49,22.04.2019 00:35,23,1,Volyn
464,469,34,116,318,30,348,0,348,3,182,163,21.04.2019 21:50,23,1,Volyn
688,670,17,257,417,14,431,0,431,4,257,170,21.04.2019 23:20,23,1,Volyn
48,43,4,13,33,2,35,0,35,0,15,20,21.04.2019 22:00,23,1,Volyn
880,868,37,245,598,37,635,0,635,18,342,275,21.04.2019 23:15,23,1,Volyn
352,334,24,139,190,23,213,0,213,7,112,94,21.04.2019 23:15,23,1,Volyn
1072,1056,60,434,578,60,638,0,638,20,300,318,21.04.2019 23:20,23,1,Volyn
224,21,12,206,8,10,18,0,18,2,13,3,22.04.2019 00:03,23,1,Volyn
80,26,0,56,24,0,24,0,24,1,15,8,22.04.2019 00:20,23,1,Volyn
1072,490,0,591,481,0,481,0,481,29,412,40,22.04.2019 00:15,23,1,Volyn
1488,1472,5,639,846,3,849,0,849,14,618,217,21.04.2019 23:50,23,1,Volyn
1296,1269,7,477,813,6,819,0,819,14,555,250,22.04.2019 00:10,23,1,Volyn
2032,2031,10,589,1434,9,1443,0,1443,21,1261,161,22.04.2019 00:27,24,2,Dnepr
2032,2030,15,653,1371,8,1379,0,1379,29,1217,133,22.04.2019 00:15,24,2,Dnepr
2080,2061,18,731,1339,10,1349,0,1349,21,1156,172,22.04.2019 00:10,24,2,Dnepr
1456,1448,5,455,999,2,1001,0,1001,22,865,114,22.04.2019 00:40,24,2,Dnepr
1568,1551,12,437,1122,9,1131,0,1131,21,993,117,22.04.2019 00:10,24,2,Dnepr
1920,1898,13,569,1341,10,1351,0,1351,34,1143,174,22.04.2019 00:10,24,2,Dnepr
1920,1908,11,608,1303,9,1312,0,1312,25,1138,149,22.04.2019 00:16,24,2,Dnepr
1600,1571,4,502,1094,4,1098,0,1098,27,939,132,22.04.2019 00:12,24,2,Dnepr
1680,1655,7,515,1162,3,1165,0,1165,37,956,172,22.04.2019 00:15,24,2,Dnepr
2144,2128,7,690,1450,4,1454,0,1454,47,1175,232,22.04.2019 00:30,24,2,Dnepr
2128,2161,7,638,1484,6,1490,0,1490,26,1270,194,22.04.2019 01:30,24,2,Dnepr
2352,2337,13,704,1637,11,1648,0,1648,32,1327,289,22.04.2019 00:30,24,2,Dnepr
2128,2120,9,627,1495,6,1501,0,1501,18,1268,215,22.04.2019 00:07,24,2,Dnepr
2224,2187,9,719,1496,9,1505,0,1505,31,1292,182,22.04.2019 00:55,24,2,Dnepr
2192,2144,3,626,1563,3,1566,0,1566,22,1341,203,22.04.2019 00:50,24,2,Dnepr
1984,1955,7,593,1386,5,1391,0,1391,39,1183,169,22.04.2019 00:07,24,2,Dnepr
1760,1743,2,579,1179,2,1181,0,1181,20,1046,115,22.04.2019 00:15,24,2,Dnepr
2208,2186,12,719,1483,6,1489,0,1489,32,1261,196,22.04.2019 01:10,24,2,Dnepr
2176,2152,9,631,1539,6,1545,0,1545,32,1355,158,22.04.2019 00:14,24,2,Dnepr
2144,2108,3,651,1490,3,1493,0,1493,35,1307,151,22.04.2019 01:05,24,2,Dnepr
1600,1576,0,511,1089,0,1089,0,1089,16,942,131,22.04.2019 00:30,24,2,Dnepr
2224,2207,10,717,1497,10,1507,0,1507,30,1290,187,22.04.2019 00:45,24,2,Dnepr
2176,2168,6,703,1467,6,1473,0,1473,36,1235,202,22.04.2019 00:16,24,2,Dnepr
2128,2111,11,662,1456,10,1466,0,1466,27,1265,174,22.04.2019 00:17,24,2,Dnepr
2224,2225,11,703,1513,8,1521,0,1521,38,1265,218,21.04.2019 22:20,24,2,Dnepr
1840,1808,9,575,1258,7,1265,0,1265,32,1077,156,22.04.2019 00:10,24,2,Dnepr
2400,2383,14,820,1569,11,1580,0,1580,26,1362,192,22.04.2019 00:10,24,2,Dnepr
2256,2234,5,812,1439,5,1444,0,1444,35,1237,172,22.04.2019 03:17,24,2,Dnepr
2048,2023,2,814,1232,2,1234,0,1234,33,1047,154,22.04.2019 00:20,24,2,Dnepr
1232,1215,32,387,821,24,845,0,845,21,742,82,22.04.2019 00:10,24,2,Dnepr
1520,1494,19,585,919,16,935,0,935,18,842,75,22.04.2019 00:35,24,2,Dnepr
2320,2278,6,876,1440,4,1444,0,1444,34,1225,185,22.04.2019 00:10,24,2,Dnepr
2288,2262,9,940,1339,9,1348,0,1348,29,1171,148,22.04.2019 00:05,24,2,Dnepr
1456,1437,9,439,1010,7,1017,0,1017,25,887,105,22.04.2019 01:00,24,2,Dnepr
2000,1973,6,742,1254,4,1258,0,1258,35,1064,159,22.04.2019 00:30,24,2,Dnepr
2096,2090,16,629,1457,10,1467,0,1467,40,1231,196,22.04.2019 00:30,24,2,Dnepr
1840,1824,13,558,1273,9,1282,0,1282,28,1072,182,22.04.2019 00:17,24,2,Dnepr
2176,2157,16,665,1499,12,1511,0,1511,45,1252,214,22.04.2019 03:48,24,2,Dnepr
2112,2100,11,785,1321,6,1327,0,1327,24,1109,194,22.04.2019 00:10,24,2,Dnepr
2144,2131,20,706,1426,12,1438,0,1438,42,1252,144,22.04.2019 00:10,24,2,Dnepr
2144,2142,16,667,1466,11,1477,0,1477,32,1239,206,22.04.2019 00:20,24,2,Dnepr
2208,2179,14,764,1436,8,1444,0,1444,35,1242,167,22.04.2019 01:37,24,2,Dnepr
2128,2129,21,635,1478,15,1493,0,1493,27,1263,203,22.04.2019 00:10,24,2,Dnepr
1648,1625,11,675,969,4,973,0,973,25,842,106,22.04.2019 00:15,24,2,Dnepr
1520,1511,18,543,961,16,977,0,977,28,828,121,22.04.2019 00:20,24,2,Dnepr
2096,2081,25,711,1367,18,1385,0,1385,46,1145,194,22.04.2019 02:30,24,2,Dnepr
1952,1934,10,654,1290,8,1298,0,1298,18,1094,186,22.04.2019 00:35,24,2,Dnepr
1744,1796,11,525,1211,8,1219,0,1219,22,1025,172,22.04.2019 00:10,24,2,Dnepr
1472,1495,8,434,1032,6,1038,0,1038,28,845,165,22.04.2019 00:05,24,2,Dnepr
496,180,40,326,130,40,170,0,170,5,148,17,22.04.2019 00:35,24,2,Dnepr
192,90,0,102,90,0,90,0,90,1,74,15,22.04.2019 00:15,24,2,Dnepr
64,32,0,36,28,0,28,0,28,1,24,3,22.04.2019 00:07,24,2,Dnepr
1984,1964,10,694,1284,6,1290,0,1290,37,1100,153,22.04.2019 00:10,24,2,Dnepr
2096,2057,12,759,1326,11,1337,0,1337,20,1180,137,22.04.2019 00:10,24,2,Dnepr
1632,1606,5,538,1091,3,1094,0,1094,24,915,155,22.04.2019 00:25,24,2,Dnepr
1952,1919,7,617,1331,4,1335,0,1335,27,1170,138,22.04.2019 00:30,24,2,Dnepr
2080,2063,4,645,1431,4,1435,0,1435,34,1261,140,22.04.2019 06:15,24,2,Dnepr
1856,1827,11,643,1203,10,1213,0,1213,27,1045,141,22.04.2019 00:05,24,2,Dnepr
1664,1639,12,552,1105,7,1112,0,1112,14,1005,93,22.04.2019 00:50,24,2,Dnepr
1424,1406,6,498,921,5,926,0,926,18,824,84,22.04.2019 02:00,24,2,Dnepr
1872,1846,11,641,1224,7,1231,0,1231,34,1053,144,22.04.2019 00:10,24,2,Dnepr
2000,1993,13,654,1337,9,1346,0,1346,23,1157,166,22.04.2019 02:00,24,2,Dnepr
1472,1468,14,545,917,10,927,0,927,19,788,120,22.04.2019 00:40,24,2,Dnepr
1872,1841,8,697,1168,7,1175,0,1175,24,1005,146,21.04.2019 20:40,24,2,Dnepr
1664,1662,12,624,1032,8,1040,0,1040,21,921,98,22.04.2019 00:15,24,2,Dnepr
1696,1681,11,626,1064,6,1070,0,1070,41,913,116,22.04.2019 00:02,24,2,Dnepr
1520,1507,18,536,972,12,984,0,984,24,799,161,22.04.2019 00:30,24,2,Dnepr
1664,1647,11,643,1015,6,1021,0,1021,16,870,135,21.04.2019 22:52,24,2,Dnepr
2352,2319,13,888,1454,10,1464,0,1464,35,1252,177,22.04.2019 00:05,24,2,Dnepr
2384,2370,13,921,1456,7,1463,0,1463,24,1297,142,22.04.2019 05:05,24,2,Dnepr
1344,1329,7,449,889,6,895,0,895,18,779,98,22.04.2019 01:00,24,2,Dnepr
2000,1986,12,682,1307,11,1318,0,1318,16,1157,145,22.04.2019 00:05,24,2,Dnepr
1392,1383,20,454,923,15,938,0,938,16,807,115,22.04.2019 00:30,24,2,Dnepr
2192,2162,20,742,1436,14,1450,0,1450,24,1283,143,22.04.2019 00:15,24,2,Dnepr
2064,2039,12,663,1392,9,1401,0,1401,22,1209,170,22.04.2019 00:15,24,2,Dnepr
2112,2095,12,692,1409,11,1420,0,1420,37,1206,177,22.04.2019 00:10,24,2,Dnepr
2080,2074,16,615,1453,12,1465,0,1465,31,1251,183,22.04.2019 00:25,24,2,Dnepr
1936,1936,11,570,1359,7,1366,0,1366,30,1147,189,22.04.2019 00:15,24,2,Dnepr
2160,2144,13,718,1430,12,1442,0,1441,44,1178,219,22.04.2019 00:15,24,2,Dnepr
2128,2122,11,709,1412,7,1419,0,1419,23,1212,184,22.04.2019 00:13,24,2,Dnepr
624,611,127,139,377,108,485,0,485,45,335,105,22.04.2019 00:30,24,2,Dnepr
1696,1231,815,592,409,695,1104,0,1104,58,890,156,22.04.2019 00:28,24,2,Dnepr
48,31,0,18,30,0,30,0,30,0,23,7,22.04.2019 00:05,24,2,Dnepr
384,135,30,256,101,27,128,0,128,3,121,4,21.04.2019 22:30,24,2,Dnepr
496,155,0,348,148,0,148,0,148,6,139,3,21.04.2019 21:15,24,2,Dnepr
96,35,0,62,34,0,34,0,34,1,33,0,22.04.2019 00:15,24,2,Dnepr
912,896,0,37,875,0,875,0,875,114,743,18,22.04.2019 00:05,25,2,Dnepr
864,785,0,86,778,0,778,0,778,51,692,35,22.04.2019 00:10,25,2,Dnepr
2336,2317,10,940,1388,8,1396,0,1396,19,1241,136,22.04.2019 00:10,25,2,Dnepr
2256,2234,17,873,1372,11,1383,0,1383,33,1232,118,22.04.2019 00:05,25,2,Dnepr
2288,2269,17,810,1463,15,1478,0,1478,26,1250,202,22.04.2019 01:00,25,2,Dnepr
2240,2214,12,755,1473,12,1485,0,1485,22,1275,188,22.04.2019 00:10,25,2,Dnepr
1952,1939,13,650,1293,9,1302,0,1302,31,1097,174,22.04.2019 00:01,25,2,Dnepr
1840,1821,6,613,1223,4,1227,0,1227,23,1066,138,22.04.2019 00:12,25,2,Dnepr
2304,2296,18,719,1571,14,1585,0,1585,41,1336,208,22.04.2019 00:10,25,2,Dnepr
2288,2258,12,779,1502,7,1509,0,1509,19,1300,190,22.04.2019 00:08,25,2,Dnepr
2256,2238,12,763,1486,7,1493,0,1493,21,1256,216,22.04.2019 00:10,25,2,Dnepr
2000,1980,12,637,1356,7,1363,0,1363,25,1184,154,22.04.2019 00:10,25,2,Dnepr
2144,2132,18,667,1461,16,1477,0,1477,26,1270,181,22.04.2019 00:05,25,2,Dnepr
1824,1798,8,581,1238,5,1243,0,1243,22,1041,180,22.04.2019 00:17,25,2,Dnepr
960,948,4,280,679,1,680,0,680,19,571,90,22.04.2019 00:15,25,2,Dnepr
2144,2108,22,636,1491,17,1508,0,1508,45,1243,220,22.04.2019 00:25,25,2,Dnepr
2224,2235,7,660,1557,7,1564,0,1564,24,1301,239,22.04.2019 00:20,25,2,Dnepr
2208,2183,21,670,1522,16,1538,0,1538,36,1295,207,22.04.2019 00:05,25,2,Dnepr
2256,2222,6,781,1471,4,1475,0,1474,26,1236,212,22.04.2019 00:51,25,2,Dnepr
2176,2190,19,671,1496,9,1505,0,1505,43,1224,238,22.04.2019 00:10,25,2,Dnepr
1968,1960,27,631,1312,25,1337,0,1337,41,1100,196,22.04.2019 00:22,25,2,Dnepr
2080,2070,18,680,1393,7,1400,0,1400,35,1124,241,22.04.2019 00:20,25,2,Dnepr
2288,2276,28,709,1563,16,1579,0,1579,38,1287,254,22.04.2019 01:15,25,2,Dnepr
1840,1824,8,568,1267,5,1272,0,1272,26,1069,177,22.04.2019 00:03,25,2,Dnepr
384,299,53,91,247,46,293,0,293,7,256,30,22.04.2019 00:10,25,2,Dnepr
2208,2207,13,804,1395,9,1404,0,1404,30,1119,255,22.04.2019 00:07,25,2,Dnepr
1792,1709,7,715,1071,6,1077,0,1077,25,922,130,22.04.2019 00:12,25,2,Dnepr
2192,2153,17,919,1264,9,1273,0,1273,32,1023,218,22.04.2019 00:55,25,2,Dnepr
1824,1797,8,761,1059,4,1063,0,1063,27,889,147,22.04.2019 00:25,25,2,Dnepr
1648,1622,7,623,1020,5,1025,0,1025,25,792,208,22.04.2019 00:20,25,2,Dnepr
2288,2216,19,881,1395,12,1407,0,1407,30,1195,181,22.04.2019 00:35,25,2,Dnepr
1456,1438,11,594,854,8,862,0,862,20,716,126,22.04.2019 06:50,25,2,Dnepr
2128,2097,12,887,1235,6,1241,0,1241,30,1042,169,22.04.2019 00:20,25,2,Dnepr
1056,1035,7,402,648,6,654,0,654,13,571,70,22.04.2019 00:25,25,2,Dnepr
1984,1961,11,709,1265,10,1275,0,1275,26,1073,176,22.04.2019 00:15,25,2,Dnepr
2112,2083,24,817,1280,15,1295,0,1295,35,1095,165,22.04.2019 00:12,25,2,Dnepr
1344,1336,12,486,849,9,858,0,858,13,720,125,22.04.2019 00:19,25,2,Dnepr
2192,2169,15,776,1407,9,1416,0,1416,38,1228,150,22.04.2019 00:18,25,2,Dnepr
1280,1259,4,507,770,3,773,0,773,13,682,78,22.04.2019 00:19,25,2,Dnepr
1104,1087,4,388,713,3,716,0,716,14,629,73,22.04.2019 00:20,25,2,Dnepr
1088,1064,5,360,723,5,728,0,728,24,624,80,22.04.2019 00:20,25,2,Dnepr
2192,2162,12,815,1366,11,1377,0,1377,31,1146,200,22.04.2019 00:11,25,2,Dnepr
1760,1734,9,543,1212,5,1217,0,1217,31,995,191,22.04.2019 00:30,25,2,Dnepr
2064,2039,5,633,1429,2,1431,0,1431,44,1127,260,22.04.2019 00:10,25,2,Dnepr
2080,2057,14,660,1411,9,1420,0,1420,19,1199,202,22.04.2019 00:05,25,2,Dnepr
2096,2052,5,581,1510,5,1515,0,1515,27,1206,282,22.04.2019 00:20,25,2,Dnepr
2192,2157,11,599,1585,8,1593,0,1593,36,1330,227,22.04.2019 00:20,25,2,Dnepr
2144,2121,11,646,1490,8,1498,0,1498,34,1243,221,22.04.2019 00:50,25,2,Dnepr
2272,2247,3,791,1479,2,1481,0,1481,22,1262,197,22.04.2019 00:30,25,2,Dnepr
1744,1723,4,540,1200,4,1204,0,1204,32,998,174,22.04.2019 00:10,25,2,Dnepr
1376,1378,7,396,976,4,980,0,980,23,801,156,22.04.2019 00:15,25,2,Dnepr
1904,1889,7,566,1332,6,1338,0,1338,27,1082,229,22.04.2019 00:15,25,2,Dnepr
1728,1711,8,571,1151,6,1157,0,1157,19,949,189,22.04.2019 00:02,25,2,Dnepr
1888,1862,7,608,1273,7,1280,0,1280,21,1095,164,22.04.2019 00:15,25,2,Dnepr
1680,1654,12,584,1087,9,1096,0,1096,27,878,191,22.04.2019 00:12,25,2,Dnepr
1680,1666,4,599,1077,4,1081,0,1081,21,906,154,22.04.2019 00:15,25,2,Dnepr
2096,2080,12,641,1447,8,1455,0,1455,36,1238,181,22.04.2019 02:00,25,2,Dnepr
1504,1487,2,473,1029,2,1031,0,1031,26,838,167,22.04.2019 01:35,25,2,Dnepr
1632,1590,8,548,1078,6,1084,0,1084,19,921,144,22.04.2019 00:20,25,2,Dnepr
1276,1271,5,386,886,4,890,0,890,21,723,146,22.04.2019 00:05,25,2,Dnepr
1376,1355,3,464,909,3,912,0,912,12,771,129,22.04.2019 00:19,25,2,Dnepr
1904,1875,13,692,1202,10,1212,0,1212,25,1035,152,22.04.2019 00:10,25,2,Dnepr
1936,1904,12,754,1175,7,1182,0,1182,22,1054,106,22.04.2019 00:25,25,2,Dnepr
2000,1998,6,770,1225,5,1230,0,1230,30,1073,127,22.04.2019 00:20,25,2,Dnepr
1776,1761,3,591,1182,3,1185,0,1185,29,1040,116,22.04.2019 00:30,25,2,Dnepr
1552,1522,3,628,921,3,924,0,924,17,810,97,22.04.2019 00:40,25,2,Dnepr
880,852,2,372,507,1,508,0,508,8,454,46,22.04.2019 00:11,25,2,Dnepr
1664,1643,5,579,1082,3,1085,0,1085,22,948,115,22.04.2019 00:25,25,2,Dnepr
576,542,122,42,417,117,534,0,534,8,442,84,22.04.2019 00:15,25,2,Dnepr
448,223,51,229,170,49,219,0,219,9,193,17,22.04.2019 00:10,25,2,Dnepr
192,174,1,21,170,1,171,0,171,2,148,21,22.04.2019 00:10,25,2,Dnepr
144,89,2,58,85,1,86,0,86,5,74,7,21.04.2019 21:30,25,2,Dnepr
720,696,139,34,555,131,686,0,686,27,570,89,22.04.2019 00:33,25,2,Dnepr
736,594,14,146,576,14,590,0,590,24,454,112,22.04.2019 00:05,25,2,Dnepr
320,168,10,152,158,10,168,0,168,9,149,10,22.04.2019 00:15,25,2,Dnepr
1248,1263,8,384,860,4,864,0,864,15,691,158,22.04.2019 00:10,25,2,Dnepr
48,43,0,5,43,0,43,0,43,0,39,4,21.04.2019 20:35,26,2,Dnepr
2016,1979,37,757,1237,22,1259,0,1259,35,965,259,22.04.2019 06:25,26,2,Dnepr
2016,1998,34,716,1276,24,1300,0,1300,22,993,285,22.04.2019 00:25,26,2,Dnepr
2212,2211,26,770,1429,13,1442,0,1442,45,1093,304,22.04.2019 00:20,26,2,Dnepr
1824,1860,18,672,1136,16,1152,0,1152,24,904,224,22.04.2019 00:02,26,2,Dnepr
2128,2143,35,795,1309,24,1333,0,1333,36,1037,260,22.04.2019 02:13,26,2,Dnepr
1952,1951,26,765,1171,16,1187,0,1187,24,950,213,22.04.2019 00:03,26,2,Dnepr
2384,2350,13,970,1402,12,1414,0,1414,28,1141,245,22.04.2019 00:10,26,2,Dnepr
2272,2257,27,840,1418,14,1432,0,1432,38,1148,246,22.04.2019 05:10,26,2,Dnepr
2352,2409,18,755,1584,13,1597,0,1597,30,1231,336,21.04.2019 22:43,26,2,Dnepr
2128,2106,15,768,1347,13,1360,0,1360,48,1075,237,22.04.2019 00:05,26,2,Dnepr
1952,1927,15,677,1265,10,1275,0,1275,37,1021,217,22.04.2019 00:10,26,2,Dnepr
2128,2112,9,767,1356,5,1361,0,1361,27,1175,159,22.04.2019 00:05,26,2,Dnepr
2064,2067,18,609,1441,14,1455,0,1455,36,1182,237,22.04.2019 00:10,26,2,Dnepr
2016,2001,18,575,1426,15,1441,0,1441,43,1179,219,22.04.2019 00:20,26,2,Dnepr
2256,2228,20,681,1557,18,1575,0,1575,31,1324,220,22.04.2019 00:10,26,2,Dnepr
2096,2091,23,609,1470,17,1487,0,1487,33,1235,219,22.04.2019 00:25,26,2,Dnepr
2240,2222,14,677,1552,11,1563,0,1563,38,1275,250,22.04.2019 01:00,26,2,Dnepr
1968,1953,14,581,1378,9,1387,0,1387,31,1152,204,22.04.2019 00:10,26,2,Dnepr
2048,2016,16,602,1440,6,1446,0,1446,25,1198,223,22.04.2019 00:03,26,2,Dnepr
1728,1726,10,575,1145,8,1153,0,1153,19,969,165,22.04.2019 00:05,26,2,Dnepr
1728,1711,9,597,1124,7,1131,0,1131,25,940,166,22.04.2019 00:07,26,2,Dnepr
1776,1762,9,549,1221,6,1227,0,1227,20,1050,157,22.04.2019 03:20,26,2,Dnepr
1856,1826,27,627,1209,20,1229,0,1229,30,1019,180,22.04.2019 00:03,26,2,Dnepr
2000,2000,15,615,1373,12,1385,0,1385,33,1118,234,22.04.2019 00:01,26,2,Dnepr
2240,2218,16,739,1490,11,1501,0,1501,30,1258,213,22.04.2019 01:15,26,2,Dnepr
1776,1748,7,664,1108,4,1112,0,1112,21,945,146,22.04.2019 00:25,26,2,Dnepr
2192,2178,27,681,1490,21,1511,0,1511,37,1257,217,22.04.2019 00:15,26,2,Dnepr
1776,1777,9,459,1309,8,1317,0,1317,33,1092,192,22.04.2019 00:04,26,2,Dnepr
2016,1987,14,628,1381,7,1388,0,1388,39,1134,215,22.04.2019 00:05,26,2,Dnepr
2128,2127,8,648,1476,4,1480,0,1480,28,1224,228,22.04.2019 00:10,26,2,Dnepr
2032,2021,15,569,1452,11,1463,0,1463,37,1200,226,22.04.2019 00:50,26,2,Dnepr
2144,2136,27,580,1550,14,1564,0,1564,31,1271,262,22.04.2019 00:10,26,2,Dnepr
2192,2175,19,631,1545,16,1561,0,1561,37,1251,273,21.04.2019 22:00,26,2,Dnepr
2336,2337,29,1073,1248,15,1263,0,1263,20,1055,188,22.04.2019 00:05,26,2,Dnepr
1952,1933,20,656,1282,14,1296,0,1295,25,1110,160,22.04.2019 02:30,26,2,Dnepr
2240,2206,29,700,1521,19,1540,0,1540,35,1291,214,22.04.2019 00:10,26,2,Dnepr
2208,2195,33,674,1508,26,1534,0,1534,24,1266,244,22.04.2019 00:17,26,2,Dnepr
1920,1899,36,626,1270,24,1294,0,1294,20,1113,161,22.04.2019 00:00,26,2,Dnepr
1824,1805,21,642,1169,13,1182,0,1182,30,1011,141,22.04.2019 00:15,26,2,Dnepr
1728,1703,21,560,1153,15,1168,0,1168,31,985,152,22.04.2019 00:10,26,2,Dnepr
2192,2188,38,617,1548,27,1575,0,1575,22,1332,221,22.04.2019 00:20,26,2,Dnepr
2240,2219,13,707,1526,7,1533,0,1533,42,1280,211,22.04.2019 01:52,26,2,Dnepr
2208,2213,23,681,1510,17,1527,0,1527,39,1271,217,22.04.2019 00:10,26,2,Dnepr
2112,2100,34,644,1443,25,1468,0,1468,29,1245,194,22.04.2019 00:25,26,2,Dnepr
2032,1996,20,788,1230,14,1244,0,1244,15,1065,164,22.04.2019 00:30,26,2,Dnepr
1728,1696,4,609,1116,3,1119,0,1119,21,993,105,21.04.2019 22:38,26,2,Dnepr
1856,1826,5,678,1175,3,1178,0,1178,22,1043,113,21.04.2019 21:08,26,2,Dnepr
1776,1756,5,606,1168,2,1170,0,1170,23,1031,116,22.04.2019 00:38,26,2,Dnepr
2112,2077,9,742,1364,6,1370,0,1370,27,1185,158,22.04.2019 00:47,26,2,Dnepr
1536,1535,9,561,969,6,975,0,975,21,842,112,22.04.2019 00:03,26,2,Dnepr
1792,1762,14,772,1012,8,1020,0,1020,24,915,81,22.04.2019 00:03,26,2,Dnepr
1648,1648,6,586,1060,2,1062,0,1062,18,920,124,22.04.2019 06:05,26,2,Dnepr
176,94,0,85,91,0,91,0,91,1,82,8,22.04.2019 00:10,26,2,Dnepr
432,414,59,26,347,59,406,0,406,8,353,45,22.04.2019 00:02,26,2,Dnepr
2094,2112,21,675,1403,16,1419,0,1419,33,1106,280,22.04.2019 00:22,26,2,Dnepr
2064,2065,30,642,1397,25,1422,0,1422,23,1184,215,22.04.2019 00:30,26,2,Dnepr
2288,2279,11,796,1482,10,1492,0,1492,25,1235,232,22.04.2019 01:05,26,2,Dnepr
2000,1974,20,766,1220,14,1234,0,1234,32,1037,165,22.04.2019 00:25,26,2,Dnepr
2080,2050,16,790,1277,13,1290,0,1290,26,1055,209,22.04.2019 00:26,26,2,Dnepr
1920,1898,12,725,1183,12,1195,0,1195,23,962,210,22.04.2019 00:15,26,2,Dnepr
2080,2079,13,794,1275,11,1286,0,1286,25,1067,194,22.04.2019 00:35,26,2,Dnepr
1408,1399,17,476,918,14,932,0,932,25,755,152,22.04.2019 06:55,26,2,Dnepr
1552,1520,9,599,946,7,953,0,953,26,758,169,22.04.2019 00:30,26,2,Dnepr
2144,2144,22,704,1424,16,1440,0,1440,32,1177,231,22.04.2019 00:07,26,2,Dnepr
1360,1323,8,479,873,8,881,0,881,26,716,139,22.04.2019 00:10,26,2,Dnepr
1392,1391,7,493,892,7,899,0,899,19,712,168,22.04.2019 00:18,26,2,Dnepr
1344,1329,13,581,751,12,763,0,763,15,649,99,22.04.2019 00:45,26,2,Dnepr
1680,1664,6,722,955,3,958,0,958,29,780,149,22.04.2019 00:15,26,2,Dnepr
2287,2237,13,956,1320,11,1331,0,1331,25,1095,211,22.04.2019 00:05,26,2,Dnepr
160,109,19,52,89,19,108,0,108,2,97,9,22.04.2019 00:45,26,2,Dnepr
144,123,36,25,83,36,119,0,119,5,106,8,22.04.2019 00:10,26,2,Dnepr
48,15,0,33,15,0,15,0,15,0,15,0,21.04.2019 21:00,27,2,Dnepr
1712,1715,19,543,1157,12,1169,0,1169,26,837,306,22.04.2019 04:20,27,2,Dnepr
1488,1498,11,495,984,9,993,0,993,23,769,201,22.04.2019 00:30,27,2,Dnepr
1632,1655,4,498,1130,4,1134,0,1134,37,831,266,22.04.2019 01:10,27,2,Dnepr
1952,1922,17,806,1131,15,1146,0,1146,25,921,200,22.04.2019 00:20,27,2,Dnepr
1152,1173,4,372,777,3,780,0,780,14,634,132,22.04.2019 00:49,27,2,Dnepr
1312,1303,11,392,909,11,920,0,920,22,689,209,22.04.2019 00:45,27,2,Dnepr
1520,1516,6,519,996,5,1001,0,1001,30,764,207,22.04.2019 00:02,27,2,Dnepr
1824,1841,21,649,1163,12,1175,0,1175,34,882,259,22.04.2019 00:06,27,2,Dnepr
1520,1535,10,589,923,8,931,0,931,23,727,181,22.04.2019 05:05,27,2,Dnepr
1440,1416,15,474,954,12,966,0,966,35,740,191,22.04.2019 00:15,27,2,Dnepr
1536,1615,32,466,1048,22,1070,0,1070,18,853,199,22.04.2019 00:15,27,2,Dnepr
1792,1769,23,606,1170,16,1186,0,1186,28,947,211,22.04.2019 00:28,27,2,Dnepr
1728,1728,32,615,1086,27,1113,0,1113,19,888,206,22.04.2019 00:30,27,2,Dnepr
1600,1588,10,606,986,8,994,0,994,29,793,172,22.04.2019 00:30,27,2,Dnepr
1712,1705,7,575,1132,5,1137,0,1137,26,927,184,22.04.2019 00:15,27,2,Dnepr
1584,1563,11,589,989,6,995,0,995,21,808,166,22.04.2019 00:15,27,2,Dnepr
1904,1890,25,667,1221,16,1237,0,1237,30,968,239,22.04.2019 00:20,27,2,Dnepr
1200,1180,6,398,797,5,802,0,802,18,651,133,22.04.2019 00:30,27,2,Dnepr
1472,1458,8,567,900,5,905,0,905,20,727,158,21.04.2019 23:52,27,2,Dnepr
1456,1437,0,881,575,0,575,0,575,9,527,39,22.04.2019 00:10,27,2,Dnepr
1920,1904,17,695,1217,8,1225,0,1225,53,917,255,22.04.2019 00:45,27,2,Dnepr
1984,1998,15,649,1327,8,1335,0,1335,32,972,331,22.04.2019 00:05,27,2,Dnepr
2064,2062,16,684,1365,15,1380,0,1380,27,1138,215,22.04.2019 00:15,27,2,Dnepr
2384,2365,10,788,1590,6,1596,0,1596,47,1313,236,22.04.2019 00:05,27,2,Dnepr
1712,1688,7,507,1201,4,1205,0,1205,31,940,234,22.04.2019 00:23,27,2,Dnepr
2032,2012,1,558,1473,1,1474,0,1474,30,1228,216,22.04.2019 00:15,27,2,Dnepr
1792,1774,10,587,1197,8,1205,0,1205,21,963,221,22.04.2019 00:02,27,2,Dnepr
1808,1782,9,596,1203,9,1212,0,1212,28,1009,175,22.04.2019 00:10,27,2,Dnepr
2128,2113,27,688,1416,24,1440,0,1440,42,1105,293,22.04.2019 00:30,27,2,Dnepr
2144,2131,11,577,1557,10,1567,0,1567,27,1249,291,22.04.2019 00:30,27,2,Dnepr
2064,2028,14,625,1427,12,1439,0,1439,37,1137,265,22.04.2019 00:42,27,2,Dnepr
1888,1879,19,550,1325,13,1338,0,1338,58,1040,240,22.04.2019 00:33,27,2,Dnepr
2176,2157,17,628,1536,12,1548,0,1548,52,1222,274,22.04.2019 00:37,27,2,Dnepr
1840,1825,18,561,1269,10,1279,0,1279,32,1026,221,22.04.2019 00:15,27,2,Dnepr
1920,1932,9,621,1295,4,1299,0,1299,34,1060,205,22.04.2019 00:17,27,2,Dnepr
2176,2156,6,737,1434,5,1439,0,1439,37,1138,264,22.04.2019 03:10,27,2,Dnepr
1696,1692,17,511,1177,8,1185,0,1185,21,962,202,22.04.2019 00:25,27,2,Dnepr
1872,1865,8,582,1286,4,1290,0,1290,22,1070,198,22.04.2019 00:35,27,2,Dnepr
1584,1571,3,453,1130,1,1131,0,1131,27,931,173,22.04.2019 00:15,27,2,Dnepr
1872,1865,11,651,1211,10,1221,0,1221,22,1019,180,22.04.2019 00:15,27,2,Dnepr
2160,2140,11,670,1482,8,1490,0,1490,25,1162,303,22.04.2019 00:15,27,2,Dnepr
1744,1739,19,534,1197,13,1210,0,1210,51,963,196,22.04.2019 00:04,27,2,Dnepr
1520,1510,5,457,1060,3,1063,0,1063,24,825,214,22.04.2019 00:15,27,2,Dnepr
2032,2013,14,706,1317,9,1326,0,1326,37,1059,230,22.04.2019 00:25,27,2,Dnepr
2128,2119,16,689,1427,12,1439,0,1439,51,1143,245,22.04.2019 00:05,27,2,Dnepr
1968,1945,17,587,1367,14,1381,0,1381,38,1094,249,22.04.2019 00:30,27,2,Dnepr
1872,1869,13,606,1256,10,1266,0,1266,21,1022,223,22.04.2019 00:05,27,2,Dnepr
2080,2064,14,611,1458,11,1469,0,1469,42,1147,280,22.04.2019 00:20,27,2,Dnepr
2064,2048,23,641,1406,17,1423,0,1423,41,1150,232,22.04.2019 01:00,27,2,Dnepr
544,541,0,219,325,0,325,0,325,11,267,47,22.04.2019 00:30,27,2,Dnepr
1200,533,148,672,383,145,528,0,528,8,469,51,22.04.2019 00:05,27,2,Dnepr
224,42,0,183,41,0,41,0,41,1,23,17,21.04.2019 21:55,27,2,Dnepr
176,131,0,46,130,0,130,0,130,4,119,7,22.04.2019 00:31,27,2,Dnepr
320,118,0,202,118,0,118,0,118,4,98,16,22.04.2019 00:20,27,2,Dnepr
112,20,0,92,20,0,20,0,20,0,17,3,22.04.2019 02:10,27,2,Dnepr
192,176,0,20,172,0,172,0,172,1,154,17,22.04.2019 00:10,27,2,Dnepr
160,144,0,17,143,0,143,0,143,2,121,20,22.04.2019 00:15,27,2,Dnepr
272,128,7,144,121,7,128,0,128,2,112,14,22.04.2019 00:15,27,2,Dnepr
1328,1311,7,393,930,5,935,0,935,17,743,175,22.04.2019 00:10,27,2,Dnepr
1296,1318,8,476,814,6,820,0,820,28,646,146,22.04.2019 00:10,27,2,Dnepr
1504,1502,8,522,974,8,982,0,982,20,771,191,22.04.2019 00:05,27,2,Dnepr
1408,1395,8,473,929,6,935,0,935,22,684,229,22.04.2019 00:15,27,2,Dnepr
2192,2186,28,806,1366,20,1386,0,1386,54,1032,300,22.04.2019 00:12,27,2,Dnepr
1088,1134,13,301,777,10,787,0,787,31,604,152,22.04.2019 00:01,27,2,Dnepr
1424,1496,14,349,1065,10,1075,0,1075,29,842,204,22.04.2019 00:26,27,2,Dnepr
2208,2200,11,828,1373,7,1380,0,1380,33,1115,232,22.04.2019 00:33,27,2,Dnepr
1904,1904,16,635,1260,9,1269,0,1269,34,999,236,22.04.2019 00:10,27,2,Dnepr
2272,2247,15,801,1461,10,1471,0,1471,41,1184,246,22.04.2019 00:10,27,2,Dnepr
1824,1811,4,628,1193,3,1196,0,1196,30,916,250,22.04.2019 00:34,27,2,Dnepr
128,112,13,18,97,13,110,0,110,3,81,26,22.04.2019 00:07,27,2,Dnepr
256,103,0,163,93,0,93,0,93,0,81,12,22.04.2019 00:10,27,2,Dnepr
2256,2249,17,718,1528,10,1538,0,1538,35,1293,210,22.04.2019 03:55,27,2,Dnepr
1664,1683,11,539,1121,4,1125,0,1125,22,944,159,22.04.2019 00:05,27,2,Dnepr
1760,1748,12,628,1125,7,1132,0,1132,24,960,148,22.04.2019 00:07,27,2,Dnepr
112,75,3,40,69,3,72,0,72,4,45,23,21.04.2019 20:50,27,2,Dnepr
2304,2274,10,686,1610,8,1618,0,1618,34,1329,255,22.04.2019 00:15,28,2,Dnepr
2192,2164,6,682,1505,5,1510,0,1510,33,1231,246,22.04.2019 00:20,28,2,Dnepr
2320,2296,11,645,1668,7,1675,0,1675,42,1387,246,22.04.2019 00:18,28,2,Dnepr
2288,2244,7,854,1429,5,1434,0,1434,28,1208,198,21.04.2019 22:30,28,2,Dnepr
2432,2393,18,984,1436,12,1448,0,1448,39,1278,131,22.04.2019 00:10,28,2,Dnepr
2032,2001,13,782,1243,7,1250,0,1250,19,1112,119,22.04.2019 00:05,28,2,Dnepr
2320,2286,22,971,1333,16,1349,0,1349,39,1148,162,22.04.2019 00:06,28,2,Dnepr
2112,2078,20,810,1288,14,1302,0,1302,28,1125,149,22.04.2019 00:44,28,2,Dnepr
2160,2128,4,900,1258,2,1260,0,1260,27,1095,138,22.04.2019 01:00,28,2,Dnepr
2304,2271,11,856,1437,11,1448,0,1448,33,1267,148,22.04.2019 01:00,28,2,Dnepr
1856,1799,9,1094,754,8,762,0,762,19,657,86,22.04.2019 00:27,28,2,Dnepr
1872,1847,12,780,1088,4,1092,0,1092,23,968,101,22.04.2019 00:15,28,2,Dnepr
2208,2193,12,773,1427,8,1435,0,1435,32,1278,125,22.04.2019 00:33,28,2,Dnepr
1568,1553,3,596,969,3,972,0,972,9,871,92,22.04.2019 00:15,28,2,Dnepr
2320,2289,16,887,1422,11,1433,0,1433,23,1251,159,22.04.2019 00:10,28,2,Dnepr
1968,1947,8,739,1222,7,1229,0,1229,19,1137,73,21.04.2019 23:50,28,2,Dnepr
1152,1120,2,443,708,1,709,0,709,10,625,74,22.04.2019 00:10,28,2,Dnepr
2384,2349,17,925,1445,14,1459,0,1459,18,1323,118,22.04.2019 00:05,28,2,Dnepr
2304,2282,16,811,1481,12,1493,0,1493,39,1277,177,22.04.2019 00:20,28,2,Dnepr
2176,2141,11,682,1488,6,1494,0,1494,40,1205,249,21.04.2019 21:45,28,2,Dnepr
2272,2255,10,931,1336,5,1341,0,1341,36,1168,137,21.04.2019 23:18,28,2,Dnepr
2128,2086,4,696,1429,3,1432,0,1432,28,1247,157,22.04.2019 00:05,28,2,Dnepr
1760,1738,5,624,1135,1,1136,0,1136,43,970,123,21.04.2019 22:15,28,2,Dnepr
1744,1736,6,684,1058,2,1060,0,1060,24,917,119,21.04.2019 21:30,28,2,Dnepr
2320,2276,9,735,1578,7,1585,0,1585,32,1390,163,22.04.2019 00:50,28,2,Dnepr
2224,2210,5,832,1388,4,1392,0,1392,29,1217,146,22.04.2019 01:10,28,2,Dnepr
1696,1692,0,739,957,0,957,0,957,25,840,92,22.04.2019 00:06,28,2,Dnepr
1264,1252,4,440,821,3,824,0,824,20,693,111,22.04.2019 00:20,28,2,Dnepr
1072,1056,3,400,669,3,672,0,672,10,576,86,21.04.2019 21:50,28,2,Dnepr
1824,1790,6,689,1130,5,1135,0,1135,16,1012,107,22.04.2019 00:10,28,2,Dnepr
1856,1836,6,599,1253,4,1257,0,1257,25,1054,178,22.04.2019 03:45,28,2,Dnepr
2064,2040,9,723,1334,7,1341,0,1341,15,1151,175,22.04.2019 00:15,28,2,Dnepr
1952,1925,13,646,1293,13,1306,0,1306,30,1116,160,22.04.2019 00:15,28,2,Dnepr
1520,1502,4,629,888,3,891,0,891,14,783,94,22.04.2019 00:05,28,2,Dnepr
1168,1158,3,391,775,2,777,0,777,15,684,78,22.04.2019 04:45,28,2,Dnepr
1936,1923,4,615,1317,4,1321,0,1321,29,1102,190,22.04.2019 00:30,28,2,Dnepr
1552,1524,5,509,1038,5,1043,0,1043,26,876,141,22.04.2019 00:15,28,2,Dnepr
1568,1541,8,484,1079,5,1084,0,1084,19,943,122,21.04.2019 21:52,28,2,Dnepr
1696,1666,2,610,1084,2,1086,0,1086,37,876,173,22.04.2019 00:25,28,2,Dnepr
2064,1975,4,709,1354,1,1355,0,1355,21,1196,138,22.04.2019 00:30,28,2,Dnepr
1328,1295,3,485,841,2,843,0,843,17,756,70,22.04.2019 00:30,28,2,Dnepr
2016,1984,5,844,1169,3,1172,0,1172,16,1016,140,22.04.2019 00:10,28,2,Dnepr
1178,1151,4,434,741,3,744,0,744,10,665,69,22.04.2019 00:10,28,2,Dnepr
1536,1506,8,637,895,4,899,0,899,19,791,89,22.04.2019 01:10,28,2,Dnepr
1872,1833,5,813,1055,4,1059,0,1059,26,937,96,22.04.2019 00:08,28,2,Dnepr
2192,2165,8,852,1333,7,1340,0,1340,23,1184,133,22.04.2019 00:31,28,2,Dnepr
1424,1438,13,410,1001,13,1014,0,1014,19,850,145,22.04.2019 00:15,28,2,Dnepr
2192,2187,6,847,1339,6,1345,0,1345,26,1165,154,22.04.2019 00:15,28,2,Dnepr
2272,2251,8,685,1584,3,1587,0,1587,32,1307,248,22.04.2019 03:22,28,2,Dnepr
2112,2073,6,620,1488,4,1492,0,1492,24,1212,256,22.04.2019 00:55,28,2,Dnepr
2256,2244,11,756,1493,7,1500,0,1500,32,1244,224,22.04.2019 00:07,28,2,Dnepr
2144,2129,18,729,1405,10,1415,0,1415,37,1149,229,21.04.2019 23:57,28,2,Dnepr
2288,2276,17,769,1512,7,1519,0,1519,34,1319,166,22.04.2019 00:07,28,2,Dnepr
2048,2029,11,558,1479,11,1490,0,1490,27,1197,266,21.04.2019 22:52,28,2,Dnepr
2256,2230,16,732,1514,10,1524,0,1524,35,1262,227,22.04.2019 00:05,28,2,Dnepr
2112,2079,16,629,1470,13,1483,0,1483,37,1254,192,22.04.2019 00:07,28,2,Dnepr
2176,2170,14,742,1426,8,1434,0,1434,20,1230,184,22.04.2019 00:15,28,2,Dnepr
2112,2065,22,691,1404,17,1421,0,1420,35,1178,207,22.04.2019 00:03,28,2,Dnepr
2192,2159,5,709,1479,4,1483,0,1483,37,1232,214,22.04.2019 00:02,28,2,Dnepr
2128,2090,8,740,1384,4,1388,0,1388,31,1153,204,21.04.2019 22:55,28,2,Dnepr
2192,2164,12,704,1479,9,1488,0,1488,30,1257,201,22.04.2019 00:15,28,2,Dnepr
2208,2173,16,683,1524,1,1525,0,1525,46,1291,188,22.04.2019 00:15,28,2,Dnepr
2016,1998,7,613,1398,5,1403,0,1403,42,1169,192,22.04.2019 00:05,28,2,Dnepr
1680,1650,8,503,1171,6,1177,0,1177,24,992,161,22.04.2019 00:35,28,2,Dnepr
2112,2077,13,653,1451,8,1459,0,1459,25,1197,237,22.04.2019 00:20,28,2,Dnepr
2032,1997,9,620,1407,5,1412,0,1412,30,1173,209,22.04.2019 00:10,28,2,Dnepr
2096,2080,6,639,1451,6,1457,0,1457,38,1191,228,22.04.2019 00:30,28,2,Dnepr
1872,1862,5,547,1321,4,1325,0,1325,28,1104,193,22.04.2019 00:10,28,2,Dnepr
2096,2078,4,643,1449,4,1453,0,1453,30,1186,237,21.04.2019 22:40,28,2,Dnepr
1215,1203,4,415,797,3,800,0,800,15,679,106,22.04.2019 00:10,28,2,Dnepr
224,130,89,100,41,83,124,0,124,6,110,8,21.04.2019 21:37,28,2,Dnepr
768,776,128,5,636,127,763,0,763,17,641,105,21.04.2019 23:30,28,2,Dnepr
224,211,43,14,167,43,210,0,210,3,184,23,21.04.2019 22:30,28,2,Dnepr
304,290,37,16,251,37,288,0,288,4,256,28,21.04.2019 21:20,28,2,Dnepr
1024,616,6,413,605,6,611,0,611,17,565,29,22.04.2019 00:05,28,2,Dnepr
2272,2268,17,849,1411,12,1423,0,1423,31,1261,131,22.04.2019 00:25,29,2,Dnepr
2464,2448,27,960,1485,19,1504,0,1504,27,1341,136,22.04.2019 06:20,29,2,Dnepr
2416,2401,22,1059,1339,18,1357,0,1357,24,1203,130,22.04.2019 00:58,29,2,Dnepr
2464,2468,19,895,1553,16,1569,0,1569,31,1347,191,21.04.2019 22:00,29,2,Dnepr
2400,2393,26,933,1445,22,1467,0,1467,36,1291,140,22.04.2019 00:10,29,2,Dnepr
2112,2112,45,774,1308,30,1338,0,1338,29,1181,128,22.04.2019 00:05,29,2,Dnepr
2368,2342,27,802,1545,21,1566,0,1566,37,1334,195,22.04.2019 01:00,29,2,Dnepr
1776,1751,18,637,1128,11,1139,0,1139,18,1011,110,22.04.2019 00:04,29,2,Dnepr
1088,1071,3,421,664,3,667,0,667,6,594,67,21.04.2019 23:15,29,2,Dnepr
2000,1987,6,777,1217,6,1223,0,1223,30,1040,153,22.04.2019 01:50,29,2,Dnepr
1024,999,15,347,662,15,677,0,677,21,572,84,22.04.2019 00:28,29,2,Dnepr
1008,1000,20,423,567,18,585,0,585,16,527,42,22.04.2019 00:30,29,2,Dnepr
1680,1714,5,472,1205,3,1208,0,1208,29,945,234,22.04.2019 00:16,29,2,Dnepr
1536,1543,15,424,1101,11,1112,0,1112,31,900,181,22.04.2019 00:10,29,2,Dnepr
1840,1838,13,512,1318,10,1328,0,1328,22,1082,224,22.04.2019 00:03,29,2,Dnepr
1600,1609,16,500,1088,12,1100,0,1100,34,903,163,21.04.2019 22:20,29,2,Dnepr
1392,1410,15,381,999,12,1011,0,1011,18,860,133,22.04.2019 00:03,29,2,Dnepr
720,722,23,200,497,23,520,0,520,14,457,49,22.04.2019 00:33,29,2,Dnepr
2256,2241,23,791,1443,22,1465,0,1465,29,1331,105,22.04.2019 00:20,29,2,Dnepr
1392,1375,18,579,797,16,813,0,813,23,720,70,22.04.2019 00:20,29,2,Dnepr
1216,1188,38,471,709,36,745,0,745,14,663,68,22.04.2019 00:17,29,2,Dnepr
1024,1003,40,444,549,31,580,0,580,11,518,51,22.04.2019 03:00,29,2,Dnepr
1024,995,45,467,516,41,557,0,557,10,511,36,22.04.2019 00:20,29,2,Dnepr
1072,1062,10,421,641,10,651,0,651,17,566,68,22.04.2019 00:15,29,2,Dnepr
1648,1627,16,579,1057,12,1069,0,1069,36,938,95,22.04.2019 00:51,29,2,Dnepr
944,934,19,326,600,18,618,0,618,6,573,39,22.04.2019 00:40,29,2,Dnepr
1632,1591,23,625,987,20,1007,0,1007,14,864,129,22.04.2019 00:45,29,2,Dnepr
864,852,11,323,530,11,541,0,541,11,465,65,22.04.2019 01:30,29,2,Dnepr
1328,1256,71,404,863,61,924,0,924,12,820,92,22.04.2019 00:04,29,2,Dnepr
464,456,35,171,263,30,293,0,293,3,267,23,22.04.2019 00:03,29,2,Dnepr
816,796,51,295,485,36,521,0,521,11,444,66,22.04.2019 00:22,29,2,Dnepr
960,944,48,361,556,43,599,0,599,8,531,60,22.04.2019 00:05,29,2,Dnepr
2096,2063,105,767,1230,99,1329,0,1329,15,1250,64,22.04.2019 00:15,29,2,Dnepr
1968,1964,40,721,1220,27,1247,0,1247,23,1121,103,22.04.2019 00:15,29,2,Dnepr
1104,1089,42,431,634,39,673,0,673,12,597,64,22.04.2019 00:05,29,2,Dnepr
864,849,84,344,447,73,520,0,520,5,479,36,22.04.2019 00:15,29,2,Dnepr
432,408,10,180,244,8,252,0,252,4,219,29,22.04.2019 00:45,29,2,Dnepr
656,647,61,245,352,59,411,0,411,13,341,57,22.04.2019 00:25,29,2,Dnepr
2448,2425,70,809,1590,49,1639,0,1639,24,1438,177,22.04.2019 01:15,29,2,Dnepr
2336,2303,57,823,1470,43,1513,0,1513,37,1292,184,22.04.2019 00:04,29,2,Dnepr
1648,1630,41,586,1021,41,1062,0,1062,26,901,135,22.04.2019 00:07,29,2,Dnepr
2048,2022,36,572,1451,25,1476,0,1476,36,1183,257,22.04.2019 02:20,29,2,Dnepr
1328,1314,39,432,861,35,896,0,896,18,753,125,22.04.2019 00:15,29,2,Dnepr
1328,1311,49,411,880,37,917,0,917,21,706,190,22.04.2019 00:14,29,2,Dnepr
1168,1156,36,406,729,33,762,0,762,14,632,116,22.04.2019 00:15,29,2,Dnepr
1536,1517,25,566,949,21,970,0,970,15,844,111,21.04.2019 21:38,29,2,Dnepr
1776,1747,54,716,1010,50,1060,0,1060,28,903,129,22.04.2019 00:20,29,2,Dnepr
640,613,19,313,312,15,327,0,327,9,282,36,22.04.2019 01:05,29,2,Dnepr
1040,1031,76,378,591,71,662,0,662,12,593,57,22.04.2019 00:45,29,2,Dnepr
1520,1499,66,488,968,64,1032,0,1032,17,820,195,21.04.2019 21:51,29,2,Dnepr
1504,1489,109,594,812,98,910,0,910,28,801,81,22.04.2019 00:15,29,2,Dnepr
304,284,33,94,179,31,210,0,210,3,182,25,22.04.2019 00:10,29,2,Dnepr
2400,2362,149,891,1367,142,1509,0,1509,37,1290,182,22.04.2019 00:33,29,2,Dnepr
2336,2312,88,815,1435,86,1521,0,1521,52,1255,214,22.04.2019 00:50,29,2,Dnepr
976,968,52,340,586,50,636,0,636,23,497,116,22.04.2019 01:48,29,2,Dnepr
2272,2242,149,746,1389,137,1526,0,1526,19,1272,235,22.04.2019 00:30,29,2,Dnepr
2128,2097,4,775,1350,3,1353,0,1353,25,1193,135,22.04.2019 00:05,29,2,Dnepr
1712,1694,9,679,1025,8,1033,0,1033,28,891,114,22.04.2019 00:05,29,2,Dnepr
2352,2312,9,876,1468,8,1476,0,1476,16,1333,127,22.04.2019 00:10,29,2,Dnepr
2224,2181,11,814,1401,9,1410,0,1410,24,1230,156,22.04.2019 00:50,29,2,Dnepr
2448,2431,9,897,1543,8,1551,0,1551,13,1305,233,22.04.2019 00:30,29,2,Dnepr
2320,2286,7,841,1474,5,1479,0,1479,35,1304,140,22.04.2019 00:26,29,2,Dnepr
2432,2390,10,950,1475,7,1482,0,1482,28,1331,123,22.04.2019 00:16,29,2,Dnepr
2304,2283,7,780,1517,7,1524,0,1524,25,1360,139,22.04.2019 00:30,29,2,Dnepr
2368,2336,7,931,1431,6,1437,0,1437,27,1250,160,22.04.2019 00:10,29,2,Dnepr
2304,2273,6,863,1435,6,1441,0,1441,25,1261,155,22.04.2019 00:11,29,2,Dnepr
2256,2232,7,683,1567,6,1573,0,1573,32,1279,262,22.04.2019 00:20,29,2,Dnepr
2208,2169,3,695,1511,2,1513,0,1513,30,1249,234,22.04.2019 00:15,29,2,Dnepr
2304,2266,6,651,1647,6,1653,0,1653,32,1346,275,22.04.2019 00:05,29,2,Dnepr
2208,2192,14,844,1353,11,1364,0,1364,34,1206,124,22.04.2019 00:31,29,2,Dnepr
2352,2320,8,782,1562,8,1570,0,1570,30,1348,192,22.04.2019 00:15,29,2,Dnepr
2256,2229,6,821,1429,6,1435,0,1435,46,1204,185,22.04.2019 00:09,29,2,Dnepr
2160,2133,6,765,1390,5,1395,0,1395,23,1260,112,22.04.2019 00:05,29,2,Dnepr
1888,1859,8,701,1180,7,1187,0,1187,25,1047,115,22.04.2019 00:47,29,2,Dnepr
1840,1822,9,556,1275,9,1284,0,1284,20,1101,163,22.04.2019 00:20,29,2,Dnepr
2192,2163,13,654,1526,12,1538,0,1538,32,1321,185,22.04.2019 00:10,29,2,Dnepr
2224,2206,9,693,1526,5,1531,0,1531,26,1287,218,22.04.2019 00:14,29,2,Dnepr
2096,2062,6,595,1498,3,1501,0,1501,30,1281,190,22.04.2019 00:15,29,2,Dnepr
2240,2205,16,721,1507,12,1519,0,1519,37,1307,175,22.04.2019 00:15,29,2,Dnepr
2080,2060,10,604,1467,9,1476,0,1476,36,1249,191,22.04.2019 00:15,29,2,Dnepr
2144,2118,10,614,1523,7,1530,0,1530,37,1301,192,22.04.2019 00:03,29,2,Dnepr
1872,1861,12,609,1251,12,1263,0,1263,18,1106,139,22.04.2019 00:25,29,2,Dnepr
784,790,2,227,556,1,557,0,557,14,473,70,22.04.2019 00:25,29,2,Dnepr
96,70,3,26,67,3,70,0,70,3,65,2,22.04.2019 00:20,29,2,Dnepr
1360,1355,22,557,789,14,803,0,803,31,683,89,22.04.2019 00:31,29,2,Dnepr
1728,1720,12,502,1220,6,1226,0,1226,29,987,210,22.04.2019 00:10,29,2,Dnepr
2368,2333,9,1003,1358,7,1365,0,1365,30,1218,117,22.04.2019 00:15,30,2,Dnepr
2448,2416,23,1027,1398,23,1421,0,1421,15,1303,103,22.04.2019 00:05,30,2,Dnepr
2112,2112,10,854,1251,7,1258,0,1258,21,1153,84,22.04.2019 00:30,30,2,Dnepr
2352,2272,32,968,1360,24,1384,0,1384,30,1256,98,22.04.2019 00:10,30,2,Dnepr
1200,1165,17,484,699,17,716,0,716,9,673,34,22.04.2019 00:01,30,2,Dnepr
1664,1633,6,697,962,5,967,0,967,23,873,71,22.04.2019 00:15,30,2,Dnepr
1920,1880,7,762,1154,4,1158,0,1158,27,1022,109,22.04.2019 00:08,30,2,Dnepr
2224,2180,9,858,1358,8,1366,0,1366,34,1227,105,22.04.2019 00:05,30,2,Dnepr
2112,2064,12,827,1275,10,1285,0,1285,28,1134,123,22.04.2019 00:05,30,2,Dnepr
2160,2124,7,855,1298,7,1305,0,1305,27,1174,104,22.04.2019 00:05,30,2,Dnepr
2224,2171,7,804,1414,6,1420,0,1420,31,1284,105,22.04.2019 00:10,30,2,Dnepr
2208,2172,8,881,1320,7,1327,0,1327,33,1166,128,22.04.2019 00:20,30,2,Dnepr
2176,2116,15,820,1344,12,1356,0,1356,29,1188,139,22.04.2019 00:20,30,2,Dnepr
2272,2232,14,836,1422,14,1436,0,1436,27,1308,101,22.04.2019 01:08,30,2,Dnepr
2272,2221,12,912,1350,10,1360,0,1360,18,1250,92,22.04.2019 00:05,30,2,Dnepr
2272,2233,17,946,1311,15,1326,0,1326,30,1211,85,22.04.2019 00:17,30,2,Dnepr
2320,2281,8,927,1386,7,1393,0,1393,20,1273,100,22.04.2019 00:10,30,2,Dnepr
2128,2110,15,722,1393,13,1406,0,1406,23,1244,139,22.04.2019 00:10,30,2,Dnepr
2144,2109,11,800,1337,7,1344,0,1344,34,1188,122,22.04.2019 00:50,30,2,Dnepr
2287,2247,9,812,1467,8,1475,0,1475,29,1341,105,22.04.2019 00:20,30,2,Dnepr
2016,1986,17,675,1328,13,1341,0,1341,27,1204,110,22.04.2019 00:10,30,2,Dnepr
1952,1917,21,694,1242,16,1258,0,1258,13,1122,123,22.04.2019 00:05,30,2,Dnepr
2240,2219,16,697,1533,10,1543,0,1543,35,1381,127,22.04.2019 00:05,30,2,Dnepr
1680,1643,9,614,1059,7,1066,0,1066,19,972,75,21.04.2019 22:16,30,2,Dnepr
1696,1666,5,623,1068,5,1073,0,1073,29,980,64,22.04.2019 00:08,30,2,Dnepr
1888,1863,64,693,1137,58,1195,0,1195,11,1097,87,22.04.2019 00:06,30,2,Dnepr
1808,1767,9,810,992,6,998,0,998,28,928,42,22.04.2019 00:10,30,2,Dnepr
1824,1795,9,696,1120,8,1128,0,1128,24,1015,89,22.04.2019 00:10,30,2,Dnepr
1696,1673,23,619,1062,15,1077,0,1077,18,978,81,22.04.2019 00:50,30,2,Dnepr
64,53,7,11,46,7,53,0,53,0,38,15,22.04.2019 00:10,30,2,Dnepr
240,118,55,130,59,51,110,0,110,6,91,13,22.04.2019 00:30,30,2,Dnepr
2368,2304,9,888,1472,8,1480,0,1480,30,1345,105,22.04.2019 00:25,30,2,Dnepr
1904,1877,8,694,1202,8,1210,0,1210,22,1100,88,21.04.2019 23:58,30,2,Dnepr
2368,2324,9,801,1560,7,1567,0,1567,28,1399,140,22.04.2019 00:05,30,2,Dnepr
1824,1779,8,640,1179,5,1184,0,1184,32,1045,107,22.04.2019 00:05,30,2,Dnepr
1872,1852,8,605,1261,6,1267,0,1267,34,1110,123,22.04.2019 00:15,30,2,Dnepr
2064,2035,7,748,1312,4,1316,0,1316,27,1151,138,22.04.2019 01:10,30,2,Dnepr
2368,2334,12,753,1607,8,1615,0,1615,41,1361,213,22.04.2019 00:05,30,2,Dnepr
2048,2020,9,642,1399,7,1406,0,1406,24,1256,126,22.04.2019 00:05,30,2,Dnepr
2144,2126,14,682,1450,12,1462,0,1462,43,1291,128,22.04.2019 00:15,30,2,Dnepr
2096,2095,8,712,1380,4,1384,0,1384,30,1185,169,22.04.2019 00:10,30,2,Dnepr
2160,2139,14,669,1480,11,1491,0,1491,26,1328,137,22.04.2019 00:20,30,2,Dnepr
1648,1624,9,570,1072,6,1078,0,1078,31,951,96,22.04.2019 00:15,30,2,Dnepr
1888,1870,5,579,1306,3,1309,0,1309,33,1182,94,22.04.2019 00:30,30,2,Dnepr
2000,1953,4,826,1172,2,1174,0,1174,26,1061,87,22.04.2019 00:20,30,2,Dnepr
1584,1574,8,524,1054,6,1060,0,1060,19,948,93,22.04.2019 01:00,30,2,Dnepr
1568,1543,7,574,990,4,994,0,994,20,907,67,22.04.2019 00:30,30,2,Dnepr
2032,1976,13,746,1277,9,1286,0,1286,26,1171,89,22.04.2019 00:01,30,2,Dnepr
2240,2193,7,800,1437,3,1440,0,1440,26,1296,118,21.04.2019 21:44,30,2,Dnepr
1968,1931,16,637,1317,14,1331,0,1331,20,1204,107,22.04.2019 00:03,30,2,Dnepr
1600,1574,12,519,1072,9,1081,0,1081,16,979,86,22.04.2019 00:25,30,2,Dnepr
1808,1765,5,663,1140,5,1145,0,1145,20,1017,108,22.04.2019 00:15,30,2,Dnepr
2128,2082,4,709,1415,4,1419,0,1419,27,1271,121,22.04.2019 00:04,30,2,Dnepr
1952,1918,4,648,1300,4,1304,0,1304,31,1178,95,22.04.2019 00:35,30,2,Dnepr
2032,1985,11,662,1362,8,1370,0,1370,31,1226,113,22.04.2019 00:04,30,2,Dnepr
2160,2122,12,802,1347,11,1358,0,1358,25,1188,145,22.04.2019 00:20,30,2,Dnepr
1776,1731,3,657,1118,1,1119,0,1119,10,988,121,22.04.2019 00:05,30,2,Dnepr
2208,2160,9,701,1502,5,1507,0,1507,29,1363,115,22.04.2019 00:02,30,2,Dnepr
2000,1965,6,652,1345,3,1348,0,1348,18,1206,124,22.04.2019 00:30,30,2,Dnepr
2160,2100,12,713,1437,10,1447,0,1447,17,1294,136,22.04.2019 00:40,30,2,Dnepr
1920,1883,2,688,1231,1,1232,0,1232,21,1096,115,22.04.2019 00:17,30,2,Dnepr
2256,2216,8,761,1489,6,1495,0,1495,40,1302,153,22.04.2019 00:30,30,2,Dnepr
2112,2088,8,711,1394,7,1401,0,1401,30,1250,121,22.04.2019 00:10,30,2,Dnepr
2144,2129,5,890,1250,4,1254,0,1254,26,1104,124,22.04.2019 00:28,30,2,Dnepr
2320,2284,6,1050,1266,4,1270,0,1270,44,1109,117,22.04.2019 00:10,30,2,Dnepr
2352,2295,11,946,1397,9,1406,0,1406,37,1248,121,22.04.2019 00:05,30,2,Dnepr
2288,2242,12,776,1503,9,1512,0,1512,33,1309,168,22.04.2019 00:07,30,2,Dnepr
2320,2310,9,829,1484,7,1491,0,1491,36,1307,148,22.04.2019 00:25,30,2,Dnepr
2144,2127,13,679,1456,9,1465,0,1465,47,1227,191,22.04.2019 00:05,30,2,Dnepr
2272,2236,21,803,1453,16,1469,0,1469,38,1272,159,22.04.2019 00:15,30,2,Dnepr
2112,2091,10,837,1269,6,1275,0,1275,29,1135,111,22.04.2019 00:12,30,2,Dnepr
2240,2178,7,956,1277,7,1284,0,1284,34,1141,109,22.04.2019 00:04,30,2,Dnepr
2192,2155,13,776,1410,6,1416,0,1416,39,1233,144,22.04.2019 00:30,30,2,Dnepr
2240,2195,12,857,1373,10,1383,0,1383,21,1262,100,22.04.2019 00:03,30,2,Dnepr
2144,2108,11,818,1317,9,1326,0,1326,35,1177,114,22.04.2019 00:26,30,2,Dnepr
2224,2186,10,845,1369,10,1379,0,1379,28,1254,97,22.04.2019 00:12,30,2,Dnepr
2304,2293,9,891,1408,5,1413,0,1413,22,1283,108,22.04.2019 00:15,30,2,Dnepr
1440,1401,11,537,893,10,903,0,903,21,822,60,22.04.2019 00:02,30,2,Dnepr
272,252,0,20,252,0,252,0,252,10,206,36,22.04.2019 00:15,30,2,Dnepr
96,93,13,3,80,13,93,0,93,5,84,4,22.04.2019 00:05,30,2,Dnepr
448,228,41,220,188,40,228,0,228,5,209,14,22.04.2019 00:20,30,2,Dnepr
128,67,14,64,50,14,64,0,64,1,57,6,22.04.2019 00:15,30,2,Dnepr
640,590,0,59,581,0,581,0,581,28,545,8,22.04.2019 00:25,31,2,Dnepr
2032,2005,40,685,1319,28,1347,0,1347,30,1200,117,22.04.2019 00:04,31,2,Dnepr
1632,1587,37,510,1093,29,1122,0,1122,17,1019,86,22.04.2019 00:20,31,2,Dnepr
1776,1748,24,541,1217,18,1235,0,1235,12,1127,96,22.04.2019 01:45,31,2,Dnepr
2256,2204,26,787,1449,20,1469,0,1469,24,1308,137,22.04.2019 00:24,31,2,Dnepr
1808,1773,23,578,1212,18,1230,0,1230,20,1127,83,22.04.2019 00:15,31,2,Dnepr
1840,1799,30,571,1250,19,1269,0,1269,14,1137,118,22.04.2019 00:01,31,2,Dnepr
1808,1776,31,598,1184,26,1210,0,1210,19,1080,111,22.04.2019 00:10,31,2,Dnepr
1696,1659,19,500,1184,12,1196,0,1196,16,1067,113,22.04.2019 01:00,31,2,Dnepr
1552,1512,15,476,1062,14,1076,0,1076,18,963,95,22.04.2019 00:33,31,2,Dnepr
1488,1447,41,462,996,30,1026,0,1026,9,940,77,22.04.2019 00:29,31,2,Dnepr
2096,2060,26,658,1415,23,1438,0,1438,23,1290,125,22.04.2019 00:20,31,2,Dnepr
1520,1479,34,458,1037,25,1062,0,1062,12,932,118,22.04.2019 01:00,31,2,Dnepr
1632,1588,23,570,1043,19,1062,0,1062,11,936,115,22.04.2019 00:18,31,2,Dnepr
1632,1582,21,528,1086,18,1104,0,1104,11,1019,74,21.04.2019 21:15,31,2,Dnepr
2000,1959,17,634,1355,11,1366,0,1366,24,1225,117,22.04.2019 00:36,31,2,Dnepr
1664,1639,46,498,1125,41,1166,0,1166,22,1019,125,22.04.2019 00:05,31,2,Dnepr
2048,2009,21,586,1444,18,1462,0,1462,27,1302,133,21.04.2019 23:11,31,2,Dnepr
1536,1498,22,468,1048,21,1069,0,1068,11,964,93,22.04.2019 00:07,31,2,Dnepr
1776,1749,18,523,1241,12,1253,0,1253,27,1126,100,22.04.2019 00:04,31,2,Dnepr
2096,2059,6,726,1364,6,1370,0,1370,12,1228,130,22.04.2019 00:20,31,2,Dnepr
2176,2132,10,699,1467,10,1477,0,1477,19,1339,119,21.04.2019 23:40,31,2,Dnepr
2096,2056,9,625,1463,8,1471,0,1471,21,1321,129,22.04.2019 00:35,31,2,Dnepr
2144,2090,15,699,1433,12,1445,0,1445,19,1286,140,22.04.2019 00:05,31,2,Dnepr
2144,2107,15,647,1486,11,1497,0,1497,25,1302,170,22.04.2019 00:01,31,2,Dnepr
1936,1897,17,650,1275,11,1286,0,1286,11,1165,110,22.04.2019 00:30,31,2,Dnepr
2096,2061,18,655,1425,16,1441,0,1441,41,1303,97,22.04.2019 00:08,31,2,Dnepr
1904,1869,25,566,1321,17,1338,0,1338,13,1197,128,22.04.2019 00:00,31,2,Dnepr
2160,2122,13,611,1538,11,1549,0,1549,24,1397,128,22.04.2019 00:30,31,2,Dnepr
2160,2145,28,719,1418,23,1441,0,1441,21,1287,133,22.04.2019 00:10,31,2,Dnepr
1696,1664,19,540,1146,10,1156,0,1156,28,1019,109,22.04.2019 00:15,31,2,Dnepr
1856,1835,16,637,1208,11,1219,0,1219,17,1085,117,22.04.2019 00:10,31,2,Dnepr
1824,1786,14,600,1213,11,1224,0,1224,13,1104,107,22.04.2019 00:45,31,2,Dnepr
1952,1921,24,638,1295,19,1314,0,1314,25,1193,96,22.04.2019 00:35,31,2,Dnepr
1760,1739,13,565,1189,6,1195,0,1195,30,1089,76,22.04.2019 00:27,31,2,Dnepr
2000,1969,11,578,1415,7,1422,0,1422,30,1254,138,22.04.2019 00:30,31,2,Dnepr
2112,2077,26,648,1446,18,1464,0,1464,24,1297,143,22.04.2019 01:02,31,2,Dnepr
1632,1598,19,492,1126,14,1140,0,1140,14,995,131,22.04.2019 00:15,31,2,Dnepr
1744,1706,11,575,1164,5,1169,0,1169,11,1052,106,22.04.2019 00:18,31,2,Dnepr
1840,1798,29,582,1234,24,1258,0,1258,20,1139,99,22.04.2019 01:10,31,2,Dnepr
2112,2081,44,682,1399,31,1430,0,1430,26,1262,142,22.04.2019 00:05,31,2,Dnepr
1536,1506,30,561,953,22,975,0,975,13,893,69,21.04.2019 23:55,31,2,Dnepr
1664,1638,13,563,1092,9,1101,0,1101,19,981,101,22.04.2019 00:10,31,2,Dnepr
1680,1653,18,534,1135,11,1146,0,1146,22,1036,88,22.04.2019 00:07,31,2,Dnepr
1904,1857,13,674,1220,10,1230,0,1230,20,1132,78,22.04.2019 00:10,31,2,Dnepr
1904,1854,23,638,1246,20,1266,0,1266,20,1142,104,22.04.2019 00:01,31,2,Dnepr
1952,1931,27,637,1296,19,1315,0,1315,21,1199,95,22.04.2019 00:05,31,2,Dnepr
2160,2121,30,701,1434,25,1459,0,1459,20,1332,107,22.04.2019 00:18,31,2,Dnepr
2064,2021,22,650,1394,20,1414,0,1414,21,1282,111,22.04.2019 00:05,31,2,Dnepr
2256,2203,13,805,1440,11,1451,0,1451,17,1315,119,21.04.2019 23:47,31,2,Dnepr
2256,2215,18,669,1571,16,1587,0,1587,27,1372,188,22.04.2019 00:45,31,2,Dnepr
2048,2025,12,561,1478,9,1487,0,1487,27,1309,151,22.04.2019 00:35,31,2,Dnepr
2192,2147,18,682,1497,13,1510,0,1510,30,1360,120,22.04.2019 06:31,31,2,Dnepr
2256,2225,4,688,1565,3,1568,0,1568,24,1400,144,22.04.2019 00:15,31,2,Dnepr
304,121,1,183,120,1,121,0,121,2,107,12,21.04.2019 23:15,31,2,Dnepr
128,93,0,36,92,0,92,0,92,2,87,3,21.04.2019 23:35,31,2,Dnepr
208,141,6,67,135,6,141,0,141,3,126,12,22.04.2019 00:10,31,2,Dnepr
304,221,0,84,220,0,220,0,220,16,183,21,22.04.2019 00:20,31,2,Dnepr
1744,1752,32,569,1149,26,1175,0,1175,20,1061,94,22.04.2019 04:13,31,2,Dnepr
1696,1676,19,607,1074,15,1089,0,1089,16,990,83,21.04.2019 22:20,31,2,Dnepr
1856,1825,22,627,1217,12,1229,0,1229,17,1120,92,22.04.2019 01:05,31,2,Dnepr
2192,2157,59,694,1456,42,1498,0,1498,27,1357,114,22.04.2019 00:15,31,2,Dnepr
2048,2012,51,615,1388,45,1433,0,1433,32,1292,109,22.04.2019 00:40,31,2,Dnepr
2064,2010,50,697,1333,34,1367,0,1367,22,1240,105,22.04.2019 01:01,31,2,Dnepr
2112,2088,56,660,1413,39,1452,0,1452,20,1300,132,22.04.2019 00:05,31,2,Dnepr
2240,2194,93,638,1526,76,1602,0,1602,37,1350,215,22.04.2019 00:05,31,2,Dnepr
2064,2027,44,588,1438,38,1476,0,1476,14,1322,140,22.04.2019 00:20,31,2,Dnepr
2224,2185,31,762,1438,24,1462,0,1462,27,1308,127,21.04.2019 23:55,31,2,Dnepr
1968,1936,28,560,1384,24,1408,0,1408,28,1267,113,22.04.2019 00:05,31,2,Dnepr
1904,1853,31,547,1336,21,1357,0,1357,38,1199,120,22.04.2019 00:05,31,2,Dnepr
1744,1701,18,551,1179,14,1193,0,1193,19,1068,106,22.04.2019 00:55,31,2,Dnepr
2064,2021,70,632,1369,63,1432,0,1432,35,1255,142,22.04.2019 00:07,31,2,Dnepr
2080,2031,13,615,1459,6,1465,0,1465,30,1310,125,22.04.2019 00:30,31,2,Dnepr
2144,2080,54,756,1352,36,1388,0,1388,30,1249,109,21.04.2019 22:55,31,2,Dnepr
1200,1186,27,396,782,22,804,0,804,11,725,68,22.04.2019 00:05,31,2,Dnepr
1584,1581,17,564,1004,16,1020,0,1020,17,923,80,22.04.2019 00:05,31,2,Dnepr
1536,1514,8,448,1082,6,1088,0,1088,15,982,91,22.04.2019 00:38,31,2,Dnepr
1520,1489,7,520,996,4,1000,0,1000,9,895,96,22.04.2019 01:12,31,2,Dnepr
1728,1704,4,519,1205,4,1209,0,1209,35,1077,97,22.04.2019 00:30,31,2,Dnepr
1664,1635,19,548,1104,12,1116,0,1116,17,1003,96,22.04.2019 00:10,31,2,Dnepr
1888,1861,21,573,1300,15,1315,0,1315,23,1155,137,22.04.2019 00:26,31,2,Dnepr
1104,1102,43,375,688,41,729,0,729,51,626,52,22.04.2019 00:15,31,2,Dnepr
1712,1688,20,576,1119,17,1136,0,1136,29,970,137,22.04.2019 03:50,31,2,Dnepr
1504,1475,23,457,1036,11,1047,0,1047,21,927,99,22.04.2019 00:30,31,2,Dnepr
2096,2069,26,744,1330,22,1352,0,1352,24,1216,112,22.04.2019 00:44,31,2,Dnepr
1840,1804,37,601,1213,26,1239,0,1239,21,1098,120,22.04.2019 00:02,31,2,Dnepr
2096,2046,36,634,1438,24,1462,0,1462,16,1302,144,22.04.2019 00:20,31,2,Dnepr
2128,2121,48,778,1308,42,1350,0,1350,17,1246,87,22.04.2019 04:45,31,2,Dnepr
464,456,7,216,241,7,248,0,248,2,226,20,22.04.2019 00:10,31,2,Dnepr
2128,2106,29,682,1423,23,1446,0,1446,24,1311,111,22.04.2019 02:50,31,2,Dnepr
2016,1983,35,704,1284,28,1312,0,1312,19,1179,114,22.04.2019 00:14,31,2,Dnepr
1968,1927,36,594,1341,33,1374,0,1374,24,1253,97,22.04.2019 00:28,31,2,Dnepr
1040,1028,19,342,684,14,698,0,698,7,603,88,22.04.2019 00:15,31,2,Dnepr
96,41,2,55,39,2,41,0,41,2,36,3,22.04.2019 00:25,31,2,Dnepr
256,143,35,114,107,35,142,0,142,2,130,10,22.04.2019 00:10,31,2,Dnepr
176,77,21,100,55,21,76,0,76,0,71,5,22.04.2019 00:02,31,2,Dnepr
208,51,1,157,50,1,51,0,51,0,48,3,22.04.2019 00:10,31,2,Dnepr
144,121,0,24,120,0,120,0,120,0,115,5,22.04.2019 00:10,31,2,Dnepr
2256,2224,46,739,1487,30,1517,0,1517,8,1409,100,21.04.2019 21:53,32,2,Dnepr
1632,1607,57,611,976,45,1021,0,1021,10,929,82,21.04.2019 21:45,32,2,Dnepr
1952,1894,34,746,1182,24,1206,0,1206,16,1116,74,21.04.2019 22:14,32,2,Dnepr
1904,1871,73,724,1114,66,1180,0,1180,15,1068,97,21.04.2019 23:25,32,2,Dnepr
1680,1660,89,567,1037,76,1113,0,1113,23,1013,77,21.04.2019 22:10,32,2,Dnepr
2272,2224,69,697,1519,56,1575,0,1575,22,1431,122,22.04.2019 02:41,32,2,Dnepr
2208,2163,52,569,1603,36,1639,0,1639,23,1503,113,21.04.2019 22:20,32,2,Dnepr
1840,1793,55,532,1269,39,1308,0,1308,24,1202,82,21.04.2019 22:05,32,2,Dnepr
1872,1830,85,559,1238,75,1313,0,1313,16,1208,89,21.04.2019 23:04,32,2,Dnepr
1808,1772,71,569,1188,51,1239,0,1239,36,1103,100,21.04.2019 22:30,32,2,Dnepr
1392,1361,62,425,912,55,967,0,967,16,855,96,21.04.2019 21:40,32,2,Dnepr
2064,2025,83,717,1297,50,1347,0,1347,20,1220,107,22.04.2019 00:00,32,2,Dnepr
2016,1976,82,703,1264,49,1313,0,1313,19,1197,97,21.04.2019 21:33,32,2,Dnepr
1552,1543,47,508,1009,35,1044,0,1044,10,950,84,22.04.2019 00:56,32,2,Dnepr
1728,1698,78,483,1185,59,1245,0,1244,16,1114,114,22.04.2019 00:03,32,2,Dnepr
2192,2142,80,650,1477,65,1542,0,1542,20,1397,125,22.04.2019 00:07,32,2,Dnepr
1952,1922,71,562,1344,46,1390,0,1390,30,1244,116,21.04.2019 23:00,32,2,Dnepr
1584,1560,61,480,1056,48,1104,0,1104,15,989,100,21.04.2019 22:26,32,2,Dnepr
1872,1848,77,539,1269,64,1333,0,1333,12,1220,101,21.04.2019 21:35,32,2,Dnepr
2096,2088,99,608,1406,82,1488,0,1488,18,1270,200,21.04.2019 22:00,32,2,Dnepr
2176,2127,90,716,1387,73,1460,0,1460,30,1292,138,21.04.2019 21:39,32,2,Dnepr
1104,1095,47,326,738,40,778,0,778,16,682,80,21.04.2019 21:08,32,2,Dnepr
1664,1644,65,479,1127,58,1185,0,1185,19,1055,111,22.04.2019 00:05,32,2,Dnepr
1280,1268,61,392,835,53,888,0,888,17,783,88,21.04.2019 21:45,32,2,Dnepr
1888,1864,88,604,1245,39,1284,0,1284,19,1148,117,22.04.2019 00:29,32,2,Dnepr
1152,1133,25,367,766,19,785,0,785,14,707,64,21.04.2019 22:25,32,2,Dnepr
2048,2021,73,657,1346,45,1391,0,1391,10,1262,119,22.04.2019 00:10,32,2,Dnepr
1120,1104,32,372,724,24,748,0,748,3,681,64,22.04.2019 00:05,32,2,Dnepr
1856,1817,23,584,1258,14,1272,0,1272,19,1159,94,21.04.2019 21:15,32,2,Dnepr
1952,1913,18,578,1360,14,1374,0,1374,17,1235,122,21.04.2019 21:30,32,2,Dnepr
1984,1945,24,597,1374,13,1387,0,1387,22,1241,124,22.04.2019 00:02,32,2,Dnepr
1936,1895,20,616,1305,15,1320,0,1320,21,1198,101,21.04.2019 21:15,32,2,Dnepr
1824,1809,15,554,1262,8,1270,0,1270,23,1162,85,21.04.2019 22:20,32,2,Dnepr
2288,2252,20,792,1484,12,1496,0,1496,16,1352,128,22.04.2019 00:07,32,2,Dnepr
2096,2046,23,653,1424,19,1443,0,1443,28,1283,132,22.04.2019 00:45,32,2,Dnepr
2256,2204,11,704,1545,7,1552,0,1552,25,1406,121,21.04.2019 23:40,32,2,Dnepr
2144,2089,19,655,1481,8,1489,0,1489,24,1370,95,22.04.2019 00:05,32,2,Dnepr
2304,2268,24,752,1539,13,1552,0,1552,17,1387,148,21.04.2019 22:25,32,2,Dnepr
2192,2143,30,665,1505,22,1527,0,1527,28,1376,123,21.04.2019 22:50,32,2,Dnepr
2192,2155,20,677,1503,12,1515,0,1515,30,1350,135,21.04.2019 22:55,32,2,Dnepr
176,61,7,115,54,7,61,0,61,4,50,7,21.04.2019 20:15,32,2,Dnepr
288,245,56,49,183,56,239,0,239,6,192,41,21.04.2019 21:20,32,2,Dnepr
1648,1616,18,499,1134,15,1149,0,1149,18,1044,87,21.04.2019 22:30,32,2,Dnepr
1664,1639,24,611,1033,20,1053,0,1053,14,941,98,22.04.2019 00:15,32,2,Dnepr
1616,1584,43,508,1079,29,1108,0,1108,25,994,89,21.04.2019 23:00,32,2,Dnepr
1728,1706,16,594,1123,11,1134,0,1134,22,1006,106,22.04.2019 00:15,32,2,Dnepr
1488,1473,20,538,933,17,950,0,950,13,869,68,21.04.2019 22:50,32,2,Dnepr
1984,1958,8,596,1381,7,1388,0,1388,19,1248,121,22.04.2019 00:05,32,2,Dnepr
1984,1950,15,580,1391,13,1404,0,1404,23,1238,143,22.04.2019 00:25,32,2,Dnepr
2176,2135,17,655,1504,17,1521,0,1521,25,1351,145,22.04.2019 00:09,32,2,Dnepr
1696,1672,26,517,1157,22,1179,0,1179,21,1031,127,22.04.2019 03:54,32,2,Dnepr
2160,2118,33,805,1328,27,1355,0,1355,18,1233,104,21.04.2019 21:20,32,2,Dnepr
2176,2136,29,693,1457,26,1483,0,1483,30,1317,136,22.04.2019 00:10,32,2,Dnepr
2048,2021,31,591,1431,26,1457,0,1457,20,1281,156,22.04.2019 00:20,32,2,Dnepr
2048,2010,18,666,1369,13,1382,0,1382,23,1237,122,21.04.2019 22:40,32,2,Dnepr
2016,2004,19,651,1351,14,1365,0,1365,36,1211,118,21.04.2019 23:50,32,2,Dnepr
1840,1848,27,554,1266,20,1286,0,1286,19,1140,127,21.04.2019 21:46,32,2,Dnepr
1776,1763,21,527,1231,18,1249,0,1249,19,1104,126,21.04.2019 23:10,32,2,Dnepr
1648,1610,10,487,1154,7,1161,0,1161,27,1039,95,21.04.2019 23:50,32,2,Dnepr
2016,1979,13,624,1381,11,1392,0,1392,37,1238,117,22.04.2019 00:30,32,2,Dnepr
1968,1908,8,652,1308,8,1316,0,1316,21,1162,133,22.04.2019 00:52,32,2,Dnepr
1952,1920,8,501,1445,6,1451,0,1451,26,1288,137,22.04.2019 00:05,32,2,Dnepr
1920,1894,14,569,1343,8,1351,0,1351,20,1232,99,21.04.2019 21:58,32,2,Dnepr
2176,2140,12,661,1513,2,1515,0,1515,18,1363,134,22.04.2019 00:10,32,2,Dnepr
2192,2186,18,629,1550,13,1563,0,1563,20,1398,145,21.04.2019 21:27,32,2,Dnepr
2016,1974,23,640,1358,18,1376,0,1376,17,1255,104,21.04.2019 22:40,32,2,Dnepr
2016,2000,7,575,1434,7,1441,0,1441,24,1311,106,21.04.2019 23:52,32,2,Dnepr
2112,2060,15,659,1438,15,1453,0,1453,27,1292,134,22.04.2019 00:21,32,2,Dnepr
2128,2086,16,675,1443,10,1453,0,1453,22,1299,132,22.04.2019 00:15,32,2,Dnepr
1920,1906,20,556,1347,17,1364,0,1364,27,1221,116,21.04.2019 22:00,32,2,Dnepr
1936,1884,34,627,1281,28,1309,0,1309,31,1180,98,21.04.2019 23:00,32,2,Dnepr
2000,1960,35,601,1368,31,1399,0,1399,28,1234,137,22.04.2019 00:52,32,2,Dnepr
2080,2044,32,616,1441,23,1464,0,1464,33,1308,123,21.04.2019 23:59,32,2,Dnepr
2080,2031,27,657,1405,18,1423,0,1423,29,1274,120,22.04.2019 00:20,32,2,Dnepr
2048,2013,25,633,1394,21,1415,0,1415,21,1279,115,22.04.2019 00:20,32,2,Dnepr
2080,2042,27,685,1372,23,1395,0,1395,20,1253,122,21.04.2019 23:00,32,2,Dnepr
2080,2035,29,622,1432,26,1458,0,1458,22,1335,101,21.04.2019 22:30,32,2,Dnepr
2224,2189,27,707,1492,25,1517,0,1517,15,1391,111,22.04.2019 00:10,32,2,Dnepr
2016,1990,44,671,1307,38,1345,0,1345,25,1226,94,22.04.2019 00:10,32,2,Dnepr
2128,2102,45,658,1431,39,1470,0,1470,21,1345,104,21.04.2019 22:10,32,2,Dnepr
1968,1945,35,609,1328,31,1359,0,1359,22,1233,104,21.04.2019 22:40,32,2,Dnepr
1888,1850,31,679,1189,20,1209,0,1209,28,1083,98,22.04.2019 00:15,32,2,Dnepr
1872,1834,55,562,1266,44,1310,0,1310,21,1195,94,21.04.2019 22:00,32,2,Dnepr
1824,1788,39,603,1190,31,1221,0,1221,21,1050,150,21.04.2019 21:49,32,2,Dnepr
2336,2268,28,730,1581,25,1606,0,1606,24,1425,157,21.04.2019 21:44,32,2,Dnepr
2192,2162,24,618,1554,20,1574,0,1574,21,1410,143,21.04.2019 22:15,32,2,Dnepr
1984,1958,36,624,1326,34,1360,0,1360,22,1213,125,21.04.2019 23:01,32,2,Dnepr
1696,1658,38,541,1119,36,1155,0,1155,22,1028,105,21.04.2019 23:03,32,2,Dnepr
304,80,26,224,54,26,80,0,80,0,75,5,21.04.2019 20:30,32,2,Dnepr
704,273,71,433,202,69,271,0,271,1,248,22,21.04.2019 21:23,32,2,Dnepr
144,120,58,24,62,58,120,0,120,2,110,8,21.04.2019 20:35,32,2,Dnepr
48,35,0,13,35,0,35,0,35,0,33,2,22.04.2019 00:05,32,2,Dnepr
80,67,0,13,67,0,67,0,67,1,58,8,21.04.2019 20:20,32,2,Dnepr
1744,1722,12,614,1121,9,1130,0,1130,28,1004,98,22.04.2019 00:05,33,2,Dnepr
1392,1354,10,500,885,7,892,0,892,16,795,81,22.04.2019 00:15,33,2,Dnepr
1568,1536,14,514,1046,8,1054,0,1054,13,958,83,22.04.2019 00:05,33,2,Dnepr
1520,1491,11,517,996,7,1003,0,1003,10,886,107,21.04.2019 21:50,33,2,Dnepr
1792,1749,23,562,1212,18,1230,0,1230,23,1086,121,22.04.2019 00:30,33,2,Dnepr
1872,1921,17,534,1325,13,1338,0,1338,26,1184,128,22.04.2019 04:25,33,2,Dnepr
1264,1261,22,390,854,20,874,0,874,18,758,98,21.04.2019 22:25,33,2,Dnepr
1952,1902,11,591,1353,8,1361,0,1361,31,1176,154,22.04.2019 00:05,33,2,Dnepr
1952,1905,26,572,1361,19,1380,0,1380,49,1179,152,22.04.2019 00:40,33,2,Dnepr
1600,1575,15,465,1123,12,1135,0,1135,20,1004,111,22.04.2019 05:20,33,2,Dnepr
2272,2224,25,802,1451,19,1470,0,1470,28,1311,131,22.04.2019 03:30,33,2,Dnepr
1936,1889,17,577,1345,14,1359,0,1359,22,1202,135,21.04.2019 22:22,33,2,Dnepr
1808,1789,18,522,1271,15,1286,0,1286,26,1120,140,22.04.2019 00:02,33,2,Dnepr
1728,1727,19,538,1180,10,1190,0,1190,26,1047,117,22.04.2019 00:20,33,2,Dnepr
1280,1263,28,408,855,17,872,0,872,13,770,89,21.04.2019 22:30,33,2,Dnepr
1168,1136,36,350,794,24,818,0,818,13,705,100,22.04.2019 01:20,33,2,Dnepr
1376,1361,14,444,921,11,932,0,932,11,836,85,22.04.2019 00:15,33,2,Dnepr
1440,1399,10,513,919,8,927,0,927,8,845,74,22.04.2019 00:10,33,2,Dnepr
2224,2175,11,843,1373,8,1381,0,1381,20,1238,123,22.04.2019 00:30,33,2,Dnepr
2208,2191,10,892,1310,6,1316,0,1316,26,1220,70,22.04.2019 00:10,33,2,Dnepr
912,915,53,243,619,50,669,0,669,3,633,33,21.04.2019 22:27,33,2,Dnepr
1488,1503,18,499,977,12,989,0,989,12,906,71,21.04.2019 21:40,33,2,Dnepr
2240,2219,36,710,1506,24,1530,0,1530,30,1400,100,22.04.2019 00:02,33,2,Dnepr
2256,2217,65,713,1486,57,1543,0,1543,24,1398,121,22.04.2019 00:10,33,2,Dnepr
1712,1675,43,562,1120,30,1150,0,1150,25,1026,99,22.04.2019 00:30,33,2,Dnepr
1920,1885,45,697,1191,32,1223,2,1221,21,1094,106,22.04.2019 00:05,33,2,Dnepr
208,64,24,144,40,24,64,0,64,1,55,8,21.04.2019 23:00,33,2,Dnepr
128,40,7,88,33,7,40,0,40,3,36,1,21.04.2019 23:43,33,2,Dnepr
160,28,2,132,26,2,28,0,28,0,21,7,22.04.2019 00:30,33,2,Dnepr
800,655,0,145,655,0,655,0,655,39,597,19,21.04.2019 23:58,33,2,Dnepr
2064,2018,34,663,1374,27,1401,0,1401,21,1298,82,21.04.2019 22:51,33,2,Dnepr
1952,1926,49,581,1329,42,1371,0,1371,19,1239,113,21.04.2019 22:20,33,2,Dnepr
1600,1571,21,470,1111,19,1130,0,1130,24,1011,95,22.04.2019 01:00,33,2,Dnepr
1648,1615,38,474,1143,31,1174,0,1174,24,1053,97,22.04.2019 00:30,33,2,Dnepr
1616,1595,33,474,1115,27,1142,0,1142,21,1014,107,22.04.2019 00:15,33,2,Dnepr
1712,1677,40,620,1061,31,1092,0,1092,15,1009,68,22.04.2019 00:15,33,2,Dnepr
1792,1781,29,539,1229,24,1253,0,1253,10,1160,83,22.04.2019 00:07,33,2,Dnepr
1904,1863,21,561,1330,13,1343,0,1343,13,1239,91,21.04.2019 21:55,33,2,Dnepr
2112,2058,47,769,1302,41,1343,0,1343,15,1243,85,22.04.2019 00:05,33,2,Dnepr
176,90,21,86,69,21,90,0,90,1,83,6,21.04.2019 21:00,33,2,Dnepr
1952,1918,44,630,1291,31,1322,0,1321,26,1150,145,22.04.2019 04:00,33,2,Dnepr
2064,2018,56,676,1350,38,1388,0,1388,23,1197,168,22.04.2019 01:15,33,2,Dnepr
1952,1908,35,635,1284,33,1317,0,1317,29,1144,144,22.04.2019 00:15,33,2,Dnepr
1536,1508,19,466,1054,16,1070,0,1070,27,912,131,21.04.2019 23:35,33,2,Dnepr
1568,1544,26,521,1030,17,1047,0,1047,23,901,123,22.04.2019 00:32,33,2,Dnepr
1568,1521,32,498,1044,26,1070,0,1070,26,921,123,22.04.2019 00:30,33,2,Dnepr
1088,1072,18,312,761,15,776,0,776,7,737,32,21.04.2019 23:20,33,2,Dnepr
1072,1047,18,451,611,10,621,0,621,5,566,50,21.04.2019 22:30,33,2,Dnepr
1680,1663,21,618,1044,18,1062,0,1062,18,975,69,22.04.2019 01:00,33,2,Dnepr
1840,1811,37,652,1162,26,1188,0,1188,29,1071,88,21.04.2019 21:26,33,2,Dnepr
1712,1669,39,513,1169,30,1199,0,1199,19,1080,100,22.04.2019 00:15,33,2,Dnepr
2048,2010,43,698,1314,36,1350,0,1350,29,1178,143,22.04.2019 01:59,33,2,Dnepr
1392,1375,30,516,849,27,876,0,876,15,780,81,21.04.2019 22:00,33,2,Dnepr
2032,1995,27,677,1330,25,1355,0,1355,18,1240,97,22.04.2019 00:03,33,2,Dnepr
1824,1812,31,560,1240,24,1264,0,1264,28,1087,149,21.04.2019 23:45,33,2,Dnepr
1792,1760,22,567,1209,16,1225,0,1225,19,1100,106,22.04.2019 00:20,33,2,Dnepr
1776,1741,33,520,1227,29,1256,0,1256,31,1085,140,22.04.2019 00:10,33,2,Dnepr
2304,2273,32,829,1454,21,1475,0,1475,27,1326,122,22.04.2019 00:00,33,2,Dnepr
1712,1683,20,455,1240,17,1257,0,1257,24,1122,111,22.04.2019 00:10,33,2,Dnepr
1792,1754,24,610,1163,19,1182,0,1182,17,1077,88,22.04.2019 00:02,33,2,Dnepr
1856,1810,12,569,1279,8,1287,0,1287,20,1170,97,21.04.2019 22:52,33,2,Dnepr
1952,1898,18,602,1336,14,1350,0,1350,22,1218,110,21.04.2019 23:42,33,2,Dnepr
2080,2048,37,607,1437,36,1473,0,1473,14,1339,120,21.04.2019 23:15,33,2,Dnepr
2080,2040,5,635,1442,3,1445,0,1445,27,1308,110,21.04.2019 22:00,33,2,Dnepr
2080,2041,22,712,1351,17,1368,0,1368,33,1256,79,22.04.2019 00:11,33,2,Dnepr
880,848,30,360,496,24,520,0,520,4,494,22,21.04.2019 22:05,33,2,Dnepr
1152,1111,56,440,668,44,712,0,712,7,662,43,21.04.2019 21:25,33,2,Dnepr
2128,2006,12,803,1315,10,1325,0,1325,26,1165,134,22.04.2019 00:09,33,2,Dnepr
2064,1974,3,702,1359,3,1362,0,1362,36,1164,162,22.04.2019 00:05,33,2,Dnepr
1968,1848,33,799,1144,25,1169,0,1168,27,1053,88,21.04.2019 23:54,33,2,Dnepr
2176,2144,42,742,1400,34,1434,0,1434,24,1289,121,22.04.2019 01:32,33,2,Dnepr
1776,1740,27,667,1084,25,1109,0,1109,24,1008,77,22.04.2019 00:10,33,2,Dnepr
1984,1941,24,640,1325,19,1344,0,1344,28,1193,123,22.04.2019 00:18,33,2,Dnepr
1472,1441,18,382,1074,16,1090,0,1090,25,960,105,22.04.2019 00:10,33,2,Dnepr
1440,1416,15,530,896,14,910,0,910,16,844,50,22.04.2019 00:05,33,2,Dnepr
1280,1256,48,464,771,45,816,0,816,6,770,40,21.04.2019 23:30,33,2,Dnepr
1744,1710,13,612,1122,10,1132,0,1132,20,957,155,22.04.2019 05:05,33,2,Dnepr
1808,1803,23,580,1208,20,1228,0,1228,11,1088,129,21.04.2019 23:15,33,2,Dnepr
1680,1641,26,544,1111,25,1136,0,1136,23,979,134,22.04.2019 00:10,33,2,Dnepr
1648,1607,23,618,1013,17,1030,0,1030,31,875,124,22.04.2019 00:15,33,2,Dnepr
1168,1175,17,385,770,13,783,0,783,21,657,105,21.04.2019 21:45,33,2,Dnepr
1456,1421,17,486,957,13,970,0,970,23,823,124,22.04.2019 00:15,33,2,Dnepr
1456,1450,14,550,897,9,906,0,906,11,825,70,22.04.2019 00:10,33,2,Dnepr
1840,1797,23,616,1206,18,1224,0,1224,19,1074,131,21.04.2019 23:49,33,2,Dnepr
1488,1448,24,478,987,23,1010,0,1010,21,853,136,21.04.2019 23:49,33,2,Dnepr
1776,1753,31,543,1202,31,1233,0,1233,26,1073,134,22.04.2019 00:05,33,2,Dnepr
160,68,0,93,67,0,67,0,67,1,64,2,21.04.2019 21:00,33,2,Dnepr
176,102,15,74,87,15,102,0,102,1,86,15,22.04.2019 00:03,33,2,Dnepr
1840,1797,32,765,1048,27,1075,0,1075,29,917,129,22.04.2019 00:10,34,2,Dnepr
1632,1624,32,537,1068,27,1095,0,1095,23,950,122,22.04.2019 00:01,34,2,Dnepr
2000,1973,28,762,1215,23,1238,0,1238,23,1091,124,21.04.2019 23:35,34,2,Dnepr
2112,2081,44,758,1326,28,1354,0,1354,29,1187,138,21.04.2019 23:30,34,2,Dnepr
688,676,19,279,393,16,409,0,409,7,364,38,21.04.2019 21:00,34,2,Dnepr
2224,2183,44,884,1308,32,1340,0,1338,25,1227,86,22.04.2019 00:10,34,2,Dnepr
1072,1049,10,409,657,6,663,0,663,8,609,46,21.04.2019 20:37,34,2,Dnepr
1008,982,10,427,573,8,581,0,581,12,512,57,21.04.2019 21:55,34,2,Dnepr
2256,2220,27,993,1242,21,1263,0,1263,23,1161,79,21.04.2019 21:25,34,2,Dnepr
2224,2185,23,1062,1145,17,1162,0,1162,20,1069,73,22.04.2019 00:05,34,2,Dnepr
1744,1722,24,737,988,19,1007,0,1007,15,893,99,21.04.2019 21:20,34,2,Dnepr
1120,1102,23,498,604,18,622,0,622,9,567,46,21.04.2019 22:00,34,2,Dnepr
240,224,20,101,120,19,139,0,139,3,122,14,21.04.2019 22:10,34,2,Dnepr
544,533,23,266,259,19,278,0,278,0,246,32,21.04.2019 21:05,34,2,Dnepr
1936,1908,43,682,1215,39,1254,0,1254,21,1137,96,21.04.2019 22:00,34,2,Dnepr
2064,2032,56,735,1284,45,1329,0,1329,22,1180,127,21.04.2019 23:01,34,2,Dnepr
1744,1731,42,731,975,38,1013,0,1013,7,943,63,22.04.2019 00:15,34,2,Dnepr
1520,1492,38,583,903,34,937,0,937,28,848,61,21.04.2019 21:30,34,2,Dnepr
976,957,98,516,366,94,460,0,460,7,415,38,21.04.2019 23:40,34,2,Dnepr
224,204,35,74,115,35,150,0,150,3,134,13,21.04.2019 23:55,34,2,Dnepr
352,345,22,135,199,18,217,0,217,2,194,21,21.04.2019 21:55,34,2,Dnepr
528,520,30,210,294,24,318,0,318,3,288,27,21.04.2019 21:50,34,2,Dnepr
736,722,47,318,374,44,418,0,418,7,380,31,21.04.2019 22:00,34,2,Dnepr
320,305,9,158,153,9,162,0,162,6,127,29,21.04.2019 22:30,34,2,Dnepr
464,457,39,156,270,38,308,0,308,4,253,51,21.04.2019 20:45,34,2,Dnepr
192,183,12,86,96,10,106,0,106,2,91,13,21.04.2019 20:50,34,2,Dnepr
656,648,73,286,299,71,370,0,370,6,324,40,21.04.2019 22:00,34,2,Dnepr
624,614,42,197,385,42,427,0,427,7,371,49,21.04.2019 20:45,34,2,Dnepr
592,576,56,225,316,51,367,0,367,3,332,32,21.04.2019 22:00,34,2,Dnepr
416,391,9,195,212,9,221,0,221,7,179,35,21.04.2019 21:00,34,2,Dnepr
256,236,31,128,100,28,128,0,128,0,111,17,22.04.2019 00:10,34,2,Dnepr
240,225,31,97,115,28,143,0,143,1,125,17,21.04.2019 21:00,34,2,Dnepr
384,370,31,184,172,28,200,0,200,2,189,9,21.04.2019 21:50,34,2,Dnepr
224,216,23,81,122,21,143,0,143,3,128,12,21.04.2019 22:55,34,2,Dnepr
1136,1113,82,463,595,78,673,0,673,4,626,43,21.04.2019 21:30,34,2,Dnepr
288,284,11,105,172,11,183,0,183,1,172,10,21.04.2019 20:30,34,2,Dnepr
448,425,22,237,194,17,211,0,211,7,185,19,21.04.2019 21:10,34,2,Dnepr
160,153,24,73,65,22,87,0,87,2,77,8,21.04.2019 21:43,34,2,Dnepr
1360,1347,43,519,801,40,841,0,841,17,760,64,22.04.2019 00:40,34,2,Dnepr
1152,1141,45,440,672,40,712,0,712,9,644,59,22.04.2019 03:16,34,2,Dnepr
208,98,16,123,71,14,85,0,85,0,74,11,22.04.2019 00:25,34,2,Dnepr
1328,1306,12,589,730,9,739,0,739,14,666,59,22.04.2019 00:18,34,2,Dnepr
1968,1931,24,806,1141,21,1162,0,1162,29,1019,114,22.04.2019 00:15,34,2,Dnepr
2032,1995,22,955,1058,19,1077,0,1077,20,958,99,21.04.2019 21:00,34,2,Dnepr
2000,1959,25,838,1144,18,1162,0,1162,25,1014,123,22.04.2019 00:13,34,2,Dnepr
2032,1989,8,804,1222,6,1228,0,1228,18,1090,120,22.04.2019 00:31,34,2,Dnepr
1936,1889,13,885,1040,11,1051,0,1051,17,976,58,22.04.2019 00:18,34,2,Dnepr
1760,1717,48,689,1025,46,1071,0,1071,15,982,74,22.04.2019 00:29,34,2,Dnepr
1472,1437,85,598,795,79,874,0,874,4,818,52,21.04.2019 21:50,34,2,Dnepr
400,381,17,175,209,16,225,0,225,9,195,21,21.04.2019 22:05,34,2,Dnepr
448,427,36,133,283,32,315,0,315,7,273,35,21.04.2019 21:35,34,2,Dnepr
448,434,49,175,225,48,273,0,273,2,242,29,21.04.2019 21:30,34,2,Dnepr
320,304,44,150,131,39,170,0,170,5,151,14,21.04.2019 22:00,34,2,Dnepr
272,272,22,71,179,22,201,0,201,7,166,28,21.04.2019 21:00,34,2,Dnepr
336,319,16,128,195,13,208,0,208,2,190,16,21.04.2019 21:05,34,2,Dnepr
208,199,4,72,132,4,136,0,136,0,126,10,21.04.2019 21:00,34,2,Dnepr
688,668,37,309,346,33,379,0,379,3,355,21,21.04.2019 21:45,34,2,Dnepr
656,643,39,303,314,39,353,0,353,2,304,47,21.04.2019 20:41,34,2,Dnepr
880,860,26,426,434,20,454,0,454,7,421,26,21.04.2019 23:00,34,2,Dnepr
544,536,21,152,371,21,392,0,392,9,360,23,21.04.2019 23:50,34,2,Dnepr
1248,1220,6,568,675,5,680,0,680,9,611,60,22.04.2019 05:28,34,2,Dnepr
624,607,45,288,292,44,336,0,336,5,305,26,21.04.2019 22:00,34,2,Dnepr
256,251,27,124,108,24,132,0,132,3,124,5,21.04.2019 22:01,34,2,Dnepr
784,770,55,350,382,52,434,0,434,9,396,29,21.04.2019 20:35,34,2,Dnepr
544,530,32,246,267,31,298,0,298,6,261,31,21.04.2019 21:34,34,2,Dnepr
464,458,21,173,271,20,291,0,291,2,260,29,21.04.2019 21:45,34,2,Dnepr
592,581,26,256,311,25,336,0,336,5,302,29,21.04.2019 20:45,34,2,Dnepr
400,389,40,158,206,36,242,0,242,5,223,14,21.04.2019 20:25,34,2,Dnepr
576,555,44,276,256,44,300,0,300,6,268,26,22.04.2019 00:30,34,2,Dnepr
688,675,8,315,366,7,373,0,373,8,342,23,21.04.2019 21:56,34,2,Dnepr
640,632,7,176,457,7,464,0,464,6,426,32,21.04.2019 21:05,34,2,Dnepr
1536,1502,70,694,776,66,842,0,842,13,742,87,22.04.2019 02:55,34,2,Dnepr
400,388,9,194,198,8,206,0,206,2,194,10,21.04.2019 23:45,34,2,Dnepr
240,232,12,88,141,11,152,0,152,3,127,22,21.04.2019 21:10,34,2,Dnepr
320,307,13,82,225,13,238,0,238,2,205,31,21.04.2019 21:20,34,2,Dnepr
192,176,8,62,122,8,130,0,130,1,122,7,21.04.2019 22:00,34,2,Dnepr
352,348,17,144,192,16,208,0,208,1,191,16,21.04.2019 21:31,34,2,Dnepr
256,248,12,75,171,10,181,0,181,0,164,17,21.04.2019 22:00,34,2,Dnepr
560,253,0,310,250,0,250,0,250,10,239,1,21.04.2019 21:40,34,2,Dnepr
1472,1453,34,463,975,34,1009,0,1009,18,892,99,22.04.2019 00:05,34,2,Dnepr
2016,1949,79,597,1354,65,1419,0,1419,27,1208,184,22.04.2019 00:30,34,2,Dnepr
1232,1222,42,399,793,40,833,0,833,18,727,88,22.04.2019 00:15,34,2,Dnepr
1280,1270,64,394,829,57,886,0,886,13,786,87,22.04.2019 00:15,34,2,Dnepr
576,575,71,198,318,60,378,0,378,6,345,27,22.04.2019 00:25,34,2,Dnepr
368,364,34,95,239,34,273,0,273,2,236,35,21.04.2019 23:40,34,2,Dnepr
1360,1352,82,439,842,79,921,0,921,13,798,110,21.04.2019 22:45,34,2,Dnepr
480,472,62,152,268,60,328,0,328,6,277,45,22.04.2019 00:02,34,2,Dnepr
976,963,31,420,530,26,556,0,556,13,497,46,22.04.2019 00:01,34,2,Dnepr
1072,1058,209,364,514,194,708,0,708,17,610,81,22.04.2019 00:30,34,2,Dnepr
800,785,102,286,423,91,514,0,514,7,437,70,22.04.2019 00:15,34,2,Dnepr
1264,1252,81,504,688,72,760,0,760,8,705,47,22.04.2019 00:10,34,2,Dnepr
528,508,55,105,373,50,423,0,423,3,352,68,22.04.2019 00:05,34,2,Dnepr
608,600,70,220,327,61,388,0,388,5,328,55,22.04.2019 00:10,34,2,Dnepr
416,415,58,121,241,54,295,0,295,5,255,35,21.04.2019 21:00,34,2,Dnepr
1104,1082,80,468,564,72,636,0,636,10,539,87,22.04.2019 00:05,34,2,Dnepr
672,661,81,230,371,71,442,0,442,8,394,40,22.04.2019 00:10,34,2,Dnepr
576,555,65,132,381,63,444,0,444,5,363,76,21.04.2019 21:45,34,2,Dnepr
656,647,58,183,422,51,473,0,473,4,424,45,21.04.2019 23:40,34,2,Dnepr
384,371,43,39,305,40,345,0,345,22,297,26,22.04.2019 00:15,34,2,Dnepr
992,983,117,327,556,109,665,0,665,7,585,73,22.04.2019 00:15,34,2,Dnepr
608,607,60,232,318,58,376,0,376,3,345,28,22.04.2019 00:30,34,2,Dnepr
544,511,29,255,260,29,289,0,289,4,269,16,22.04.2019 00:10,34,2,Dnepr
2160,2130,60,642,1467,51,1518,0,1518,29,1342,147,22.04.2019 00:12,34,2,Dnepr
2144,2111,41,782,1330,32,1362,0,1362,20,1205,137,22.04.2019 00:05,34,2,Dnepr
2288,2252,39,817,1439,32,1471,0,1471,20,1332,119,22.04.2019 00:15,34,2,Dnepr
2160,2142,58,663,1455,42,1497,0,1497,38,1347,112,22.04.2019 00:15,34,2,Dnepr
2160,2119,35,692,1441,27,1468,0,1468,35,1296,137,22.04.2019 00:28,34,2,Dnepr
2080,2043,23,691,1376,13,1389,0,1389,28,1240,121,22.04.2019 00:05,34,2,Dnepr
1808,1791,24,573,1218,17,1235,0,1235,28,1102,105,22.04.2019 00:05,34,2,Dnepr
2048,2015,32,687,1338,23,1361,0,1361,17,1232,112,22.04.2019 00:10,34,2,Dnepr
1248,1216,19,641,593,14,607,0,607,9,544,54,22.04.2019 01:05,34,2,Dnepr
2016,1972,22,1035,965,16,981,0,981,23,832,126,22.04.2019 00:05,34,2,Dnepr
2048,2016,23,810,1217,21,1238,0,1238,27,1045,166,22.04.2019 00:10,34,2,Dnepr
1888,1864,39,723,1136,29,1165,0,1165,31,1003,131,22.04.2019 00:51,34,2,Dnepr
1760,1720,36,681,1056,23,1079,0,1079,27,926,126,22.04.2019 00:55,34,2,Dnepr
1696,1666,28,680,993,23,1016,0,1016,13,907,96,22.04.2019 00:54,34,2,Dnepr
1920,1885,47,741,1140,39,1179,0,1179,18,1031,130,22.04.2019 00:30,34,2,Dnepr
1600,1586,39,616,960,24,984,0,984,11,866,107,22.04.2019 02:15,34,2,Dnepr
2112,2066,15,851,1249,12,1261,0,1261,22,1104,135,22.04.2019 01:00,34,2,Dnepr
1840,1793,34,714,1099,27,1126,0,1126,32,958,136,22.04.2019 00:25,34,2,Dnepr
2192,2136,29,763,1412,17,1429,0,1429,30,1215,184,22.04.2019 00:20,34,2,Dnepr
2064,2040,23,751,1292,21,1313,0,1313,24,1149,140,22.04.2019 00:11,34,2,Dnepr
1952,1930,33,713,1217,22,1239,0,1239,24,1072,143,22.04.2019 00:20,34,2,Dnepr
1696,1661,36,635,1036,25,1061,0,1061,17,936,108,22.04.2019 00:20,34,2,Dnepr
1744,1692,15,686,1047,11,1058,0,1058,25,914,119,22.04.2019 00:10,34,2,Dnepr
1936,1896,25,714,1199,23,1222,0,1222,27,1074,121,22.04.2019 00:25,34,2,Dnepr
2032,1988,17,733,1286,13,1299,0,1299,16,1160,123,22.04.2019 00:10,34,2,Dnepr
1952,1901,9,946,999,7,1006,0,1006,28,898,80,22.04.2019 00:50,34,2,Dnepr
1776,1734,12,682,1087,7,1094,0,1094,28,968,98,22.04.2019 01:00,34,2,Dnepr
1904,1870,6,689,1210,5,1215,0,1215,26,1067,122,22.04.2019 00:30,34,2,Dnepr
544,542,30,207,314,23,337,0,337,8,312,17,21.04.2019 21:23,34,2,Dnepr
224,44,34,180,10,34,44,0,44,2,40,2,22.04.2019 00:02,34,2,Dnepr
1568,585,0,989,579,0,579,0,579,42,514,23,22.04.2019 00:10,34,2,Dnepr
400,383,6,145,249,6,255,0,255,4,230,21,22.04.2019 00:35,34,2,Dnepr
992,981,26,255,711,26,737,0,737,9,654,74,22.04.2019 00:30,34,2,Dnepr
1264,1247,4,503,757,4,761,0,761,11,686,64,22.04.2019 00:15,35,2,Dnepr
1536,1508,3,608,925,3,928,0,928,23,814,91,22.04.2019 00:10,35,2,Dnepr
1808,1779,3,673,1132,3,1135,0,1135,23,1011,101,22.04.2019 00:02,35,2,Dnepr
272,270,3,99,170,3,173,0,173,0,162,11,22.04.2019 00:20,35,2,Dnepr
544,529,10,257,277,10,287,0,287,2,272,13,22.04.2019 00:20,35,2,Dnepr
416,414,8,167,242,7,249,0,249,0,244,5,22.04.2019 00:05,35,2,Dnepr
896,881,36,420,441,35,476,0,476,3,438,35,22.04.2019 00:15,35,2,Dnepr
576,565,5,282,291,3,294,0,294,2,256,36,22.04.2019 00:25,35,2,Dnepr
1008,986,13,482,513,13,526,0,526,5,476,45,21.04.2019 22:05,35,2,Dnepr
1088,1064,46,467,580,41,621,0,621,12,542,67,22.04.2019 00:10,35,2,Dnepr
1552,1530,24,609,921,22,943,0,943,20,830,93,22.04.2019 00:40,35,2,Dnepr
1168,1146,33,400,740,28,768,0,768,11,677,80,21.04.2019 23:00,35,2,Dnepr
1424,1399,21,556,848,20,868,0,868,17,792,59,22.04.2019 00:10,35,2,Dnepr
624,617,31,250,344,30,374,0,374,7,342,25,22.04.2019 00:35,35,2,Dnepr
192,193,9,81,103,8,111,0,111,1,95,15,22.04.2019 00:45,35,2,Dnepr
672,639,34,306,333,33,366,0,366,6,335,25,22.04.2019 00:20,35,2,Dnepr
832,801,37,332,463,37,500,0,500,6,461,33,22.04.2019 01:00,35,2,Dnepr
1136,1103,42,516,591,29,620,0,620,13,565,42,22.04.2019 00:45,35,2,Dnepr
976,964,19,396,563,17,580,0,580,7,534,39,22.04.2019 00:20,35,2,Dnepr
1424,1347,45,514,868,42,910,0,910,12,827,71,22.04.2019 00:40,35,2,Dnepr
1024,1007,27,428,569,27,596,0,596,5,534,57,22.04.2019 00:35,35,2,Dnepr
912,905,28,368,517,27,544,0,544,1,502,41,22.04.2019 00:07,35,2,Dnepr
224,219,1,72,151,1,152,0,152,1,137,14,22.04.2019 00:10,35,2,Dnepr
2208,2175,6,912,1290,6,1296,0,1296,26,1138,132,22.04.2019 00:15,35,2,Dnepr
1984,1955,29,733,1224,27,1251,0,1251,24,1119,108,22.04.2019 00:10,35,2,Dnepr
1504,1485,36,591,877,36,913,0,913,14,838,61,22.04.2019 00:30,35,2,Dnepr
512,502,58,215,241,56,297,0,297,7,268,22,22.04.2019 00:15,35,2,Dnepr
1136,1119,7,470,660,6,666,0,666,5,631,30,22.04.2019 00:12,35,2,Dnepr
352,341,3,121,228,3,231,0,231,2,224,5,22.04.2019 00:10,35,2,Dnepr
448,434,15,163,270,15,285,0,285,4,260,21,22.04.2019 00:20,35,2,Dnepr
272,256,19,75,178,19,197,0,197,5,177,15,22.04.2019 00:15,35,2,Dnepr
2272,2249,4,877,1391,4,1395,0,1395,35,1229,131,22.04.2019 00:20,35,2,Dnepr
1472,1453,3,602,868,2,870,0,870,13,769,88,22.04.2019 00:20,35,2,Dnepr
2176,2141,7,866,1303,7,1310,0,1310,22,1146,142,22.04.2019 00:15,35,2,Dnepr
2128,2103,6,826,1296,6,1302,0,1302,26,1136,140,22.04.2019 00:40,35,2,Dnepr
2208,2162,8,831,1369,8,1377,0,1377,27,1184,166,22.04.2019 01:20,35,2,Dnepr
2224,2188,5,894,1325,5,1330,0,1330,35,1151,144,22.04.2019 00:35,35,2,Dnepr
1888,1872,13,714,1162,12,1174,0,1174,24,972,178,22.04.2019 00:20,35,2,Dnepr
2176,2150,10,846,1324,6,1330,0,1330,25,1119,186,22.04.2019 00:30,35,2,Dnepr
1280,1236,16,532,735,13,748,0,748,24,610,114,22.04.2019 00:15,35,2,Dnepr
1696,1675,13,613,1071,12,1083,0,1083,34,886,163,22.04.2019 00:25,35,2,Dnepr
2128,2094,18,875,1240,13,1253,0,1253,15,1039,199,22.04.2019 03:33,35,2,Dnepr
2048,2008,9,783,1260,5,1265,0,1265,39,1047,179,22.04.2019 00:05,35,2,Dnepr
2144,2124,6,784,1357,3,1360,0,1360,37,1148,175,22.04.2019 02:40,35,2,Dnepr
1616,1589,8,582,1029,5,1034,0,1034,16,869,149,22.04.2019 00:05,35,2,Dnepr
1648,1642,6,657,985,6,991,0,991,37,823,131,22.04.2019 01:00,35,2,Dnepr
960,944,10,329,623,8,631,0,631,17,515,99,21.04.2019 22:18,35,2,Dnepr
1312,1290,6,511,796,5,801,0,801,30,650,121,22.04.2019 00:30,35,2,Dnepr
1792,1758,9,731,1052,9,1061,0,1061,33,900,128,22.04.2019 00:36,35,2,Dnepr
2016,1970,9,864,1143,9,1152,0,1152,28,978,146,22.04.2019 00:50,35,2,Dnepr
2144,2090,13,803,1332,9,1341,0,1341,32,1096,213,22.04.2019 00:45,35,2,Dnepr
1136,1107,7,481,650,5,655,0,655,16,548,91,22.04.2019 00:08,35,2,Dnepr
1152,1124,11,538,607,7,614,0,614,11,526,77,22.04.2019 00:25,35,2,Dnepr
1472,1449,11,559,906,7,913,0,913,29,794,90,22.04.2019 00:20,35,2,Dnepr
1008,995,4,412,593,3,596,0,596,16,508,72,22.04.2019 00:10,35,2,Dnepr
880,857,1,353,526,1,527,0,527,20,449,58,22.04.2019 00:07,35,2,Dnepr
1232,1207,12,521,702,9,711,0,711,17,617,77,22.04.2019 00:07,35,2,Dnepr
1280,1261,6,484,791,5,796,0,796,23,674,99,22.04.2019 00:10,35,2,Dnepr
1376,1328,8,581,790,5,795,0,795,13,686,96,22.04.2019 00:10,35,2,Dnepr
2016,1994,19,819,1184,13,1197,0,1197,29,987,181,22.04.2019 00:33,35,2,Dnepr
1968,1922,12,753,1205,10,1215,0,1215,31,1021,163,22.04.2019 00:05,35,2,Dnepr
2176,2139,8,878,1294,4,1298,0,1298,35,1102,161,22.04.2019 00:45,35,2,Dnepr
2096,2060,4,824,1269,3,1272,0,1272,26,1088,158,22.04.2019 00:30,35,2,Dnepr
2064,2019,5,762,1299,3,1302,0,1302,41,1061,200,22.04.2019 00:15,35,2,Dnepr
2080,2034,14,781,1289,10,1299,0,1299,24,1081,194,22.04.2019 00:20,35,2,Dnepr
1392,1360,3,578,813,1,814,0,814,8,673,133,22.04.2019 00:05,35,2,Dnepr
1696,1675,6,683,1008,5,1013,0,1013,26,856,131,22.04.2019 00:45,35,2,Dnepr
2128,2089,8,803,1319,6,1325,0,1325,29,1125,171,21.04.2019 23:16,35,2,Dnepr
2144,2103,21,811,1320,13,1333,0,1333,42,1117,174,22.04.2019 00:02,35,2,Dnepr
2000,1979,9,939,1054,7,1061,0,1061,23,894,144,22.04.2019 00:10,35,2,Dnepr
1776,1749,5,744,1029,3,1032,0,1032,28,873,131,22.04.2019 00:15,35,2,Dnepr
2240,2192,8,845,1388,7,1395,0,1395,42,1170,183,22.04.2019 00:30,35,2,Dnepr
2160,2109,10,852,1301,7,1308,0,1308,37,1085,186,22.04.2019 00:16,35,2,Dnepr
2048,2019,18,818,1220,10,1230,0,1230,38,1041,151,22.04.2019 00:40,35,2,Dnepr
2064,2036,7,805,1252,7,1259,0,1259,33,1076,150,22.04.2019 00:20,35,2,Dnepr
2000,1978,4,863,1134,3,1137,0,1137,18,986,133,22.04.2019 00:45,35,2,Dnepr
1344,1337,8,490,849,5,854,0,854,16,742,96,22.04.2019 00:15,35,2,Dnepr
2176,2129,13,952,1213,11,1224,0,1224,20,1054,150,21.04.2019 21:20,35,2,Dnepr
2160,2132,11,923,1228,9,1237,0,1237,27,1075,135,22.04.2019 02:00,35,2,Dnepr
1344,1327,11,489,845,10,855,0,855,11,764,80,22.04.2019 00:10,35,2,Dnepr
1584,1558,8,719,861,4,865,0,865,12,752,101,22.04.2019 01:00,35,2,Dnepr
2144,2144,1,734,1409,1,1410,0,1410,39,1228,143,22.04.2019 00:45,35,2,Dnepr
1984,1945,5,775,1204,5,1209,0,1209,27,1013,169,22.04.2019 00:20,35,2,Dnepr
1600,1575,6,584,1010,6,1016,0,1016,29,854,133,22.04.2019 00:22,35,2,Dnepr
1840,1800,9,754,1080,6,1086,0,1086,27,915,144,22.04.2019 00:45,35,2,Dnepr
1376,1334,6,474,896,6,902,0,902,15,735,152,22.04.2019 00:05,35,2,Dnepr
416,215,137,201,78,137,215,0,215,3,195,17,22.04.2019 00:05,35,2,Dnepr
128,27,0,101,27,0,27,0,27,0,24,3,22.04.2019 00:10,35,2,Dnepr
80,32,0,48,32,0,32,0,32,0,29,3,22.04.2019 00:20,35,2,Dnepr
128,64,5,65,59,4,63,0,63,2,51,10,21.04.2019 23:35,35,2,Dnepr
224,68,31,158,35,31,66,0,66,1,61,4,22.04.2019 00:15,35,2,Dnepr
1424,1400,24,609,795,20,815,0,815,9,749,57,22.04.2019 01:10,35,2,Dnepr
2192,2152,32,872,1298,22,1320,0,1320,31,1183,106,22.04.2019 00:40,35,2,Dnepr
1824,1808,24,694,1110,20,1130,0,1130,13,1022,95,22.04.2019 00:15,35,2,Dnepr
1120,1089,19,426,676,18,694,0,694,10,626,58,22.04.2019 00:30,35,2,Dnepr
400,395,18,170,214,16,230,0,230,2,199,29,22.04.2019 01:55,35,2,Dnepr
1296,1268,22,536,747,13,760,0,760,16,642,102,22.04.2019 00:30,35,2,Dnepr
1360,1318,26,566,771,23,794,0,794,11,696,87,22.04.2019 00:10,35,2,Dnepr
1264,1251,39,455,782,27,809,0,809,12,708,89,22.04.2019 00:07,35,2,Dnepr
2016,1967,41,855,1124,37,1161,0,1161,19,1003,139,22.04.2019 01:15,35,2,Dnepr
1360,1325,24,556,791,13,804,0,804,15,703,86,22.04.2019 02:00,35,2,Dnepr
1504,1461,46,636,831,37,868,0,868,8,765,95,22.04.2019 00:13,35,2,Dnepr
2160,2117,38,923,1215,22,1237,0,1237,21,1082,134,22.04.2019 00:55,35,2,Dnepr
1520,1483,18,580,926,14,940,0,940,8,832,100,22.04.2019 02:07,35,2,Dnepr
1664,1623,33,675,970,19,989,0,989,13,849,127,22.04.2019 01:15,35,2,Dnepr
1984,1923,22,764,1202,18,1220,0,1220,21,1082,117,22.04.2019 01:15,35,2,Dnepr
2144,2081,13,819,1316,9,1325,0,1325,16,1199,110,22.04.2019 00:15,35,2,Dnepr
2048,1969,17,907,1130,11,1141,0,1141,20,1012,109,22.04.2019 00:17,35,2,Dnepr
2128,2072,25,905,1209,14,1223,0,1223,28,1106,89,22.04.2019 00:15,35,2,Dnepr
1744,1684,9,766,974,4,978,0,978,11,864,103,22.04.2019 00:30,35,2,Dnepr
208,209,6,94,109,5,114,0,114,3,102,9,22.04.2019 00:30,35,2,Dnepr
224,155,7,69,148,7,155,0,155,2,78,75,22.04.2019 00:20,35,2,Dnepr
448,95,0,354,94,0,94,0,94,0,90,4,22.04.2019 00:15,35,2,Dnepr
2096,2042,36,738,1332,26,1358,0,1358,15,1268,75,22.04.2019 00:40,36,2,Dnepr
1600,1575,58,547,1002,51,1053,0,1053,9,985,59,22.04.2019 00:30,36,2,Dnepr
112,104,7,44,63,5,68,0,68,0,59,9,22.04.2019 00:10,36,2,Dnepr
144,137,4,48,93,3,96,0,96,0,85,11,22.04.2019 00:15,36,2,Dnepr
1408,1384,57,430,921,57,978,0,978,15,863,100,22.04.2019 00:04,36,2,Dnepr
1648,1594,39,515,1096,37,1133,0,1133,14,1031,88,22.04.2019 00:15,36,2,Dnepr
1680,1648,87,610,988,82,1070,0,1070,16,954,100,22.04.2019 00:05,36,2,Dnepr
1104,1078,63,348,709,47,756,0,756,8,673,75,22.04.2019 00:06,36,2,Dnepr
1680,1655,95,529,1080,71,1151,0,1151,10,1039,102,22.04.2019 00:10,36,2,Dnepr
336,323,11,98,227,11,238,0,238,3,208,27,22.04.2019 00:12,36,2,Dnepr
288,286,29,92,172,24,196,0,196,4,180,12,21.04.2019 22:00,36,2,Dnepr
736,715,50,272,417,47,464,0,464,4,422,38,22.04.2019 01:05,36,2,Dnepr
768,744,49,264,460,44,504,0,504,4,470,30,22.04.2019 00:11,36,2,Dnepr
736,719,27,281,433,22,455,0,455,5,404,46,22.04.2019 00:10,36,2,Dnepr
288,271,36,114,138,36,174,0,174,1,149,24,22.04.2019 00:25,36,2,Dnepr
608,596,54,218,341,49,390,0,390,5,349,36,22.04.2019 00:15,36,2,Dnepr
464,452,44,155,266,43,309,0,309,0,288,21,22.04.2019 00:15,36,2,Dnepr
1840,1803,73,611,1170,59,1229,0,1229,19,1104,106,22.04.2019 00:15,36,2,Dnepr
1424,1399,64,437,927,60,987,0,987,17,919,51,22.04.2019 00:25,36,2,Dnepr
240,218,31,117,97,26,123,0,123,1,112,10,22.04.2019 00:10,36,2,Dnepr
1168,1152,74,380,720,68,788,0,788,9,742,37,22.04.2019 00:15,36,2,Dnepr
544,543,56,213,278,53,331,0,331,4,310,17,22.04.2019 00:10,36,2,Dnepr
304,291,12,116,178,10,188,0,188,1,180,7,22.04.2019 00:25,36,2,Dnepr
624,599,47,170,410,44,454,0,454,4,419,31,22.04.2019 00:03,36,2,Dnepr
400,391,35,81,285,34,319,0,319,7,287,25,22.04.2019 00:07,36,2,Dnepr
1040,1036,111,349,590,101,691,0,691,14,573,104,22.04.2019 00:10,36,2,Dnepr
176,160,11,79,89,8,97,0,97,1,75,21,22.04.2019 00:19,36,2,Dnepr
2192,2153,12,688,1492,12,1504,0,1504,24,1338,142,22.04.2019 01:00,36,2,Dnepr
2176,2146,8,708,1460,8,1468,0,1468,24,1336,108,22.04.2019 00:40,36,2,Dnepr
1488,1465,5,532,951,5,956,0,956,13,872,71,22.04.2019 00:20,36,2,Dnepr
1968,1940,16,684,1271,13,1284,0,1284,24,1180,80,22.04.2019 00:10,36,2,Dnepr
1504,1462,6,489,1010,5,1015,0,1015,19,930,66,22.04.2019 00:02,36,2,Dnepr
2016,1981,25,672,1322,22,1344,0,1344,23,1175,146,22.04.2019 00:15,36,2,Dnepr
2272,2247,13,767,1494,11,1505,0,1505,29,1323,153,22.04.2019 00:10,36,2,Dnepr
2160,2151,8,663,1490,7,1497,0,1497,32,1282,183,22.04.2019 00:15,36,2,Dnepr
1824,1820,11,535,1280,9,1289,0,1289,29,1079,181,22.04.2019 00:30,36,2,Dnepr
2080,2023,9,631,1441,8,1449,0,1449,23,1273,153,22.04.2019 00:15,36,2,Dnepr
1728,1725,15,490,1223,15,1238,0,1238,28,1049,161,22.04.2019 00:15,36,2,Dnepr
2288,2283,13,748,1527,13,1540,0,1540,35,1285,220,22.04.2019 00:05,36,2,Dnepr
1216,1204,9,406,804,6,810,0,810,18,728,64,22.04.2019 00:05,36,2,Dnepr
1136,1130,11,398,729,9,738,0,738,9,650,79,22.04.2019 00:20,36,2,Dnepr
2240,2199,25,764,1452,24,1476,0,1476,22,1309,145,22.04.2019 00:30,36,2,Dnepr
2240,2220,9,689,1542,9,1551,0,1551,21,1363,167,22.04.2019 00:20,36,2,Dnepr
2272,2263,13,647,1616,9,1625,0,1625,31,1406,188,22.04.2019 01:47,36,2,Dnepr
2304,2309,18,666,1622,16,1638,0,1638,23,1438,177,22.04.2019 00:15,36,2,Dnepr
2160,2130,33,741,1394,25,1419,0,1419,25,1215,179,22.04.2019 00:20,36,2,Dnepr
2112,2077,8,695,1409,8,1417,0,1417,19,1261,137,22.04.2019 00:30,36,2,Dnepr
2064,2031,8,617,1439,8,1447,0,1447,33,1227,187,22.04.2019 00:12,36,2,Dnepr
2000,2001,19,607,1375,18,1393,0,1393,30,1200,163,22.04.2019 00:20,36,2,Dnepr
1568,1544,10,479,1079,10,1089,0,1089,11,978,100,22.04.2019 00:20,36,2,Dnepr
1376,1352,9,452,916,8,924,0,924,7,848,69,22.04.2019 00:03,36,2,Dnepr
1360,1331,6,485,871,4,875,0,875,20,768,87,22.04.2019 00:05,36,2,Dnepr
1776,1736,11,604,1165,7,1172,0,1172,14,1061,97,22.04.2019 00:20,36,2,Dnepr
1888,1872,5,650,1233,5,1238,0,1238,24,1082,132,22.04.2019 00:10,36,2,Dnepr
1632,1609,8,563,1065,4,1069,0,1069,30,944,95,22.04.2019 00:30,36,2,Dnepr
1344,1325,12,390,942,12,954,0,954,6,848,100,22.04.2019 00:31,36,2,Dnepr
1840,1809,3,575,1262,3,1265,0,1265,23,1134,108,22.04.2019 00:15,36,2,Dnepr
1520,1543,9,444,1068,8,1076,0,1076,13,951,112,22.04.2019 00:52,36,2,Dnepr
1792,1751,7,582,1205,5,1210,0,1210,12,1100,98,22.04.2019 00:15,36,2,Dnepr
1744,1711,5,628,1112,4,1116,0,1116,23,991,102,22.04.2019 00:30,36,2,Dnepr
2272,2214,10,713,1550,9,1559,0,1559,22,1373,164,22.04.2019 00:05,36,2,Dnepr
2192,2171,12,642,1539,11,1550,0,1550,33,1375,142,22.04.2019 00:05,36,2,Dnepr
2096,2089,10,636,1450,10,1460,0,1460,27,1286,147,22.04.2019 00:05,36,2,Dnepr
2240,2217,5,720,1515,5,1520,0,1520,39,1359,122,22.04.2019 00:10,36,2,Dnepr
2256,2214,18,769,1472,15,1487,0,1487,22,1318,147,22.04.2019 00:10,36,2,Dnepr
2272,2222,7,798,1467,7,1474,0,1474,17,1326,131,22.04.2019 00:28,36,2,Dnepr
2224,2207,9,739,1477,8,1485,0,1485,35,1315,135,22.04.2019 04:25,36,2,Dnepr
1952,1960,7,556,1389,7,1396,0,1396,20,1242,134,22.04.2019 00:17,36,2,Dnepr
1904,1884,11,632,1263,9,1272,0,1272,25,1151,96,22.04.2019 00:05,36,2,Dnepr
2256,2216,15,746,1498,12,1510,0,1510,31,1344,135,22.04.2019 01:50,36,2,Dnepr
2240,2237,11,713,1517,10,1527,0,1527,16,1368,143,22.04.2019 00:05,36,2,Dnepr
2192,2168,10,698,1485,9,1494,0,1494,37,1340,117,22.04.2019 00:30,36,2,Dnepr
144,53,0,94,50,0,50,0,50,5,38,7,22.04.2019 00:05,36,2,Dnepr
80,63,3,18,59,3,62,0,62,2,60,0,22.04.2019 03:30,36,2,Dnepr
160,55,10,105,45,10,55,0,55,2,44,9,22.04.2019 00:03,36,2,Dnepr
240,31,3,209,28,3,31,0,31,0,24,7,22.04.2019 00:08,36,2,Dnepr
1584,1561,17,573,1000,11,1011,0,1011,16,887,108,22.04.2019 00:07,36,2,Dnepr
1760,1736,8,633,1121,6,1127,0,1127,22,983,122,22.04.2019 00:02,36,2,Dnepr
1408,1396,16,478,921,9,930,0,930,15,805,110,22.04.2019 00:02,36,2,Dnepr
1584,1571,22,534,1032,18,1050,0,1050,17,915,118,22.04.2019 04:15,36,2,Dnepr
1680,1689,19,580,1083,17,1100,0,1100,25,970,105,22.04.2019 00:01,36,2,Dnepr
1792,1791,16,628,1151,13,1164,0,1164,16,1036,112,22.04.2019 00:30,36,2,Dnepr
1664,1642,7,530,1127,7,1134,0,1134,13,989,132,22.04.2019 00:00,36,2,Dnepr
1680,1657,12,566,1104,10,1114,0,1114,27,979,108,22.04.2019 00:05,36,2,Dnepr
2112,2062,10,660,1444,8,1452,0,1452,25,1287,140,22.04.2019 00:15,36,2,Dnepr
2272,2231,9,759,1507,6,1513,0,1513,29,1320,164,22.04.2019 00:05,36,2,Dnepr
2208,2151,12,775,1425,8,1433,0,1433,26,1236,171,22.04.2019 00:10,36,2,Dnepr
160,53,20,107,33,20,53,0,53,1,38,14,22.04.2019 00:20,36,2,Dnepr
2080,2058,21,614,1445,21,1466,0,1466,31,1324,111,22.04.2019 00:30,36,2,Dnepr
1792,1773,9,548,1239,5,1244,0,1244,26,1131,87,22.04.2019 00:15,36,2,Dnepr
2064,2038,16,550,1503,11,1514,0,1514,28,1351,135,22.04.2019 00:20,36,2,Dnepr
2016,1989,11,617,1388,11,1399,0,1399,19,1279,101,22.04.2019 00:20,36,2,Dnepr
1792,1761,16,551,1226,15,1241,0,1241,21,1116,104,22.04.2019 00:15,36,2,Dnepr
1984,1962,23,600,1361,23,1384,0,1384,19,1299,66,22.04.2019 00:30,36,2,Dnepr
2160,2154,17,581,1563,16,1579,0,1579,35,1444,100,22.04.2019 00:15,36,2,Dnepr
1968,1937,13,619,1344,5,1349,0,1349,32,1223,94,22.04.2019 00:15,36,2,Dnepr
2032,2009,17,645,1370,17,1387,0,1387,17,1249,121,22.04.2019 00:25,36,2,Dnepr
1328,1318,11,433,885,10,895,0,895,5,830,60,21.04.2019 21:25,36,2,Dnepr
1296,1286,10,459,827,10,837,0,837,16,786,35,22.04.2019 00:20,36,2,Dnepr
96,56,5,41,50,5,55,0,55,1,44,10,22.04.2019 00:03,36,2,Dnepr
64,40,0,24,40,0,40,0,40,1,35,4,21.04.2019 20:40,36,2,Dnepr
2080,2027,37,825,1227,28,1255,0,1255,19,1170,66,22.04.2019 02:20,37,2,Dnepr
2240,2178,52,846,1350,44,1394,0,1394,23,1265,106,22.04.2019 01:30,37,2,Dnepr
2176,2125,50,791,1343,42,1385,0,1385,28,1229,128,22.04.2019 01:00,37,2,Dnepr
2256,2214,27,870,1367,19,1386,0,1386,23,1270,93,22.04.2019 00:10,37,2,Dnepr
1744,1688,22,692,1032,20,1052,0,1052,11,936,105,22.04.2019 00:45,37,2,Dnepr
672,650,9,270,393,9,402,0,402,4,386,12,22.04.2019 00:25,37,2,Dnepr
2192,2151,32,789,1380,23,1403,0,1403,36,1217,150,22.04.2019 01:06,37,2,Dnepr
2192,2148,55,837,1310,45,1355,0,1355,22,1218,115,22.04.2019 01:15,37,2,Dnepr
2224,2174,65,808,1378,38,1416,0,1416,31,1264,121,22.04.2019 00:04,37,2,Dnepr
2288,2248,57,1059,1192,37,1229,0,1229,24,1125,80,22.04.2019 00:15,37,2,Dnepr
1936,1883,29,799,1120,17,1137,0,1137,16,1049,72,22.04.2019 00:35,37,2,Dnepr
624,613,39,329,263,32,295,0,295,0,269,26,22.04.2019 00:17,37,2,Dnepr
1024,1013,14,473,538,13,551,0,551,9,500,42,22.04.2019 01:10,37,2,Dnepr
1136,1111,53,556,530,50,580,0,580,12,520,48,22.04.2019 00:03,37,2,Dnepr
736,713,43,365,338,33,371,0,371,3,343,25,21.04.2019 21:13,37,2,Dnepr
480,459,51,178,256,46,302,0,302,6,274,22,21.04.2019 21:00,37,2,Dnepr
1840,1821,36,733,1072,35,1107,0,1107,10,1017,80,22.04.2019 00:25,37,2,Dnepr
1024,1004,29,478,519,27,546,0,546,8,506,32,22.04.2019 02:00,37,2,Dnepr
400,386,6,193,201,6,207,0,207,3,196,8,21.04.2019 22:30,37,2,Dnepr
240,226,17,102,121,17,138,0,138,1,126,11,22.04.2019 00:22,37,2,Dnepr
1072,1048,35,419,622,31,653,0,653,14,599,40,22.04.2019 00:40,37,2,Dnepr
1856,1823,41,919,901,36,937,0,937,21,862,54,22.04.2019 00:12,37,2,Dnepr
1024,998,41,494,494,36,530,0,530,6,483,41,22.04.2019 01:15,37,2,Dnepr
592,583,34,243,320,29,349,0,349,7,322,20,22.04.2019 00:20,37,2,Dnepr
464,446,15,199,250,15,265,0,265,3,233,29,22.04.2019 00:15,37,2,Dnepr
1776,1738,25,711,1040,25,1065,0,1065,20,973,72,22.04.2019 00:11,37,2,Dnepr
1712,1673,13,648,1051,13,1064,0,1064,17,996,51,22.04.2019 00:01,37,2,Dnepr
784,757,32,320,432,32,464,0,464,8,425,31,22.04.2019 00:40,37,2,Dnepr
896,866,39,354,504,38,542,0,542,5,495,42,21.04.2019 23:46,37,2,Dnepr
1232,1201,54,541,641,50,691,0,691,15,618,58,22.04.2019 00:17,37,2,Dnepr
768,747,53,333,383,52,435,0,435,4,398,33,22.04.2019 01:40,37,2,Dnepr
224,117,5,108,111,5,116,0,116,2,104,10,22.04.2019 00:05,37,2,Dnepr
976,947,29,392,557,27,584,0,584,4,530,50,22.04.2019 04:27,37,2,Dnepr
1696,1664,46,524,1130,42,1172,0,1172,17,1056,99,22.04.2019 00:05,37,2,Dnepr
1296,1247,56,549,693,54,747,0,747,10,690,47,22.04.2019 01:00,37,2,Dnepr
528,514,37,174,317,37,354,0,354,6,320,28,21.04.2019 23:45,37,2,Dnepr
272,253,20,119,136,17,153,0,153,2,148,3,22.04.2019 00:10,37,2,Dnepr
768,752,53,366,351,51,402,0,402,3,362,37,22.04.2019 00:40,37,2,Dnepr
576,547,35,210,334,32,366,0,366,5,338,23,21.04.2019 21:15,37,2,Dnepr
1328,1298,25,538,768,22,790,0,790,23,726,41,22.04.2019 01:35,37,2,Dnepr
1216,1188,14,456,747,13,760,0,760,12,680,68,22.04.2019 00:30,37,2,Dnepr
1536,1517,17,590,929,17,946,0,946,12,848,86,22.04.2019 01:00,37,2,Dnepr
1232,1204,35,488,711,33,744,0,744,15,678,51,22.04.2019 01:05,37,2,Dnepr
464,462,37,128,303,33,336,0,336,9,296,31,22.04.2019 00:02,37,2,Dnepr
832,817,50,288,494,50,544,0,544,6,499,39,22.04.2019 00:53,37,2,Dnepr
512,497,20,190,302,20,322,0,322,2,303,17,22.04.2019 00:10,37,2,Dnepr
2256,2219,29,705,1522,29,1551,0,1551,35,1369,147,22.04.2019 00:40,37,2,Dnepr
1072,1042,57,447,569,56,625,0,625,5,568,52,21.04.2019 23:57,37,2,Dnepr
1536,1519,115,534,896,106,1002,0,1002,18,908,76,21.04.2019 21:25,37,2,Dnepr
1792,1774,30,707,1059,26,1085,0,1085,14,948,123,22.04.2019 00:06,37,2,Dnepr
672,652,29,228,415,29,444,0,444,3,416,25,22.04.2019 00:20,37,2,Dnepr
256,251,0,138,118,0,118,0,118,1,110,7,21.04.2019 23:30,37,2,Dnepr
1072,1065,14,359,701,12,713,0,713,13,617,83,22.04.2019 00:04,37,2,Dnepr
928,898,43,351,536,41,577,0,577,4,538,35,22.04.2019 00:30,37,2,Dnepr
2048,2014,53,706,1297,45,1342,0,1342,27,1229,86,22.04.2019 00:10,37,2,Dnepr
1216,1192,32,453,738,25,763,0,763,6,703,54,21.04.2019 22:35,37,2,Dnepr
1136,1108,64,381,694,61,755,0,755,10,716,29,22.04.2019 00:55,37,2,Dnepr
592,574,72,132,388,72,460,0,460,31,373,56,22.04.2019 00:50,37,2,Dnepr
720,709,33,287,404,29,433,0,433,3,393,37,22.04.2019 00:25,37,2,Dnepr
240,235,9,95,136,9,145,0,145,1,137,7,22.04.2019 00:10,37,2,Dnepr
128,117,13,43,75,10,85,0,85,0,80,5,22.04.2019 01:10,37,2,Dnepr
1584,1555,15,662,912,10,922,0,922,11,842,69,22.04.2019 00:20,37,2,Dnepr
400,132,0,268,132,0,132,0,132,6,84,42,21.04.2019 21:10,37,2,Dnepr
192,46,24,146,22,24,46,0,46,1,39,6,22.04.2019 00:10,37,2,Dnepr
1072,1058,10,417,645,10,655,0,655,5,610,40,22.04.2019 00:15,37,2,Dnepr
688,671,37,311,342,35,377,0,377,3,336,38,21.04.2019 22:10,37,2,Dnepr
608,569,4,278,327,3,330,0,330,8,303,19,22.04.2019 06:00,37,2,Dnepr
512,515,42,186,290,36,326,0,326,3,292,31,22.04.2019 00:24,37,2,Dnepr
224,224,7,96,121,7,128,0,128,1,116,11,21.04.2019 22:00,37,2,Dnepr
112,101,0,41,71,0,71,0,71,0,57,14,22.04.2019 00:45,37,2,Dnepr
1248,1222,30,601,617,30,647,0,647,9,582,56,21.04.2019 22:15,37,2,Dnepr
432,412,28,191,213,28,241,0,241,2,221,18,21.04.2019 22:20,37,2,Dnepr
464,449,27,156,284,24,308,0,308,4,284,20,21.04.2019 22:15,37,2,Dnepr
400,387,19,151,230,19,249,0,249,3,232,14,22.04.2019 01:15,37,2,Dnepr
704,687,24,255,425,24,449,0,449,6,397,46,22.04.2019 01:30,37,2,Dnepr
640,616,12,250,378,12,390,0,390,8,343,39,22.04.2019 01:15,37,2,Dnepr
208,203,12,70,126,12,138,0,138,2,121,15,22.04.2019 02:24,37,2,Dnepr
480,461,45,201,239,40,279,0,279,4,247,28,22.04.2019 02:25,37,2,Dnepr
336,319,19,135,183,18,201,0,201,4,184,13,22.04.2019 04:25,37,2,Dnepr
432,422,37,177,226,29,255,0,255,1,232,22,21.04.2019 21:15,37,2,Dnepr
656,645,36,280,341,35,376,0,376,4,340,32,22.04.2019 00:13,37,2,Dnepr
624,605,30,212,386,26,412,0,412,6,384,22,22.04.2019 00:20,37,2,Dnepr
576,555,36,253,291,32,323,0,323,6,280,37,22.04.2019 00:10,37,2,Dnepr
848,816,19,356,476,16,492,0,492,9,448,35,21.04.2019 22:50,37,2,Dnepr
640,610,15,271,356,13,369,0,369,8,337,24,22.04.2019 05:12,37,2,Dnepr
496,473,20,192,285,19,304,0,304,7,270,27,21.04.2019 23:30,37,2,Dnepr
336,328,39,105,192,39,231,0,231,2,165,64,22.04.2019 00:35,37,2,Dnepr
336,321,7,107,223,6,229,0,229,2,214,13,21.04.2019 21:50,37,2,Dnepr
96,44,18,54,25,17,42,0,42,1,35,6,22.04.2019 00:07,37,2,Dnepr
928,265,34,670,224,34,258,0,258,10,238,10,22.04.2019 00:02,37,2,Dnepr
288,286,19,96,175,17,192,0,192,1,181,10,22.04.2019 00:10,37,2,Dnepr
960,948,48,387,532,41,573,0,573,4,531,38,22.04.2019 00:30,37,2,Dnepr
624,604,38,287,304,33,337,0,337,3,315,19,22.04.2019 00:40,37,2,Dnepr
416,415,21,115,280,21,301,0,301,7,283,11,22.04.2019 01:48,37,2,Dnepr
1184,1148,110,475,621,88,709,0,709,53,615,41,21.04.2019 21:30,37,2,Dnepr
448,426,52,153,244,51,295,0,295,5,278,12,22.04.2019 00:10,37,2,Dnepr
320,310,9,111,201,8,209,0,209,4,187,18,21.04.2019 20:40,37,2,Dnepr
336,330,18,161,157,18,175,0,175,1,163,11,22.04.2019 00:20,37,2,Dnepr
1024,1007,65,410,563,51,614,0,614,5,583,26,22.04.2019 00:15,37,2,Dnepr
672,655,54,230,392,50,442,0,442,8,410,24,22.04.2019 00:05,37,2,Dnepr
704,682,27,280,405,19,424,0,424,3,392,29,22.04.2019 00:05,37,2,Dnepr
832,813,63,253,526,53,579,0,579,8,540,31,21.04.2019 21:05,37,2,Dnepr
640,625,56,282,304,54,358,0,358,1,314,43,22.04.2019 00:20,37,2,Dnepr
576,566,40,191,354,31,385,0,385,6,362,17,22.04.2019 00:40,37,2,Dnepr
528,513,50,227,262,39,301,0,301,5,282,14,22.04.2019 00:10,37,2,Dnepr
816,799,64,294,458,64,522,0,522,7,486,29,22.04.2019 02:47,37,2,Dnepr
464,448,41,205,222,37,259,0,259,4,228,27,22.04.2019 00:02,37,2,Dnepr
384,374,14,163,209,12,221,0,221,3,204,14,22.04.2019 01:55,37,2,Dnepr
1472,1437,100,479,909,84,993,0,993,15,877,101,22.04.2019 00:15,37,2,Dnepr
560,540,45,245,276,39,315,0,315,5,280,30,22.04.2019 03:40,37,2,Dnepr
1120,1095,38,445,645,30,675,0,675,14,627,34,22.04.2019 00:40,37,2,Dnepr
592,580,23,215,356,21,377,0,377,8,345,24,22.04.2019 00:15,37,2,Dnepr
1040,1025,22,350,678,12,690,0,690,12,635,43,22.04.2019 00:15,37,2,Dnepr
1600,1555,43,601,967,32,999,0,999,11,932,56,22.04.2019 00:04,37,2,Dnepr
496,490,17,156,328,12,340,0,340,12,309,19,22.04.2019 00:20,37,2,Dnepr
1584,1559,54,590,948,46,994,0,994,23,906,65,22.04.2019 00:55,37,2,Dnepr
1904,1870,80,679,1160,65,1225,0,1225,9,1137,79,22.04.2019 00:15,37,2,Dnepr
128,60,26,72,31,25,56,0,56,0,53,3,21.04.2019 21:05,37,2,Dnepr
160,54,0,107,53,0,53,0,53,1,51,1,22.04.2019 01:10,37,2,Dnepr
1072,1054,16,355,705,12,717,0,717,13,660,44,21.04.2019 22:10,37,2,Dnepr
944,917,29,337,582,25,607,0,607,9,576,22,22.04.2019 00:05,37,2,Dnepr
976,954,18,288,672,16,688,0,688,2,630,56,22.04.2019 00:05,37,2,Dnepr
1936,1886,28,784,1128,24,1152,0,1152,16,1060,76,22.04.2019 00:10,37,2,Dnepr
1632,1602,22,555,1064,13,1077,0,1077,17,987,73,22.04.2019 00:30,37,2,Dnepr
1920,1889,51,637,1236,47,1283,0,1283,27,1173,83,22.04.2019 00:45,37,2,Dnepr
2048,2001,21,663,1370,15,1385,0,1385,18,1249,118,22.04.2019 00:03,37,2,Dnepr
1760,1717,24,572,1165,23,1188,0,1188,9,1068,111,22.04.2019 00:30,37,2,Dnepr
1968,1936,21,578,1378,12,1390,0,1390,22,1251,117,22.04.2019 00:45,37,2,Dnepr
1920,1877,19,569,1336,15,1351,0,1351,17,1239,95,21.04.2019 21:21,37,2,Dnepr
1840,1790,21,578,1242,20,1262,0,1262,20,1134,108,22.04.2019 00:30,37,2,Dnepr
1792,1740,13,560,1220,12,1232,0,1232,22,1122,88,22.04.2019 03:45,37,2,Dnepr
1792,1743,20,505,1271,16,1287,0,1287,14,1154,119,22.04.2019 02:30,37,2,Dnepr
1840,1802,12,583,1245,12,1257,0,1257,15,1141,101,22.04.2019 00:05,37,2,Dnepr
1808,1766,13,556,1239,13,1252,0,1252,19,1101,132,21.04.2019 22:15,37,2,Dnepr
224,102,26,122,76,26,102,0,102,0,97,5,22.04.2019 00:10,37,2,Dnepr
1360,1346,20,555,785,20,805,0,805,11,756,38,22.04.2019 00:10,37,2,Dnepr
496,480,24,219,254,23,277,0,277,5,239,33,22.04.2019 00:15,38,2,Dnepr
480,466,11,181,292,7,299,0,299,1,282,16,22.04.2019 00:15,38,2,Dnepr
160,156,7,45,108,7,115,0,115,0,98,17,22.04.2019 00:05,38,2,Dnepr
928,907,74,339,519,70,589,0,589,11,530,48,21.04.2019 21:05,38,2,Dnepr
880,866,90,336,459,85,544,0,544,8,505,31,22.04.2019 00:30,38,2,Dnepr
944,927,30,265,649,30,679,0,679,9,642,28,22.04.2019 00:40,38,2,Dnepr
320,317,13,66,242,12,254,0,254,0,233,21,22.04.2019 00:10,38,2,Dnepr
528,522,2,231,295,2,297,0,297,4,270,23,22.04.2019 00:10,38,2,Dnepr
304,289,3,150,151,3,154,0,154,3,142,9,22.04.2019 00:10,38,2,Dnepr
816,806,19,312,486,18,504,0,504,6,458,40,22.04.2019 00:10,38,2,Dnepr
1760,1735,54,552,1154,54,1208,0,1208,33,969,206,22.04.2019 00:45,38,2,Dnepr
1792,1770,72,594,1128,70,1198,0,1198,21,1133,44,22.04.2019 00:30,38,2,Dnepr
2336,2301,32,766,1546,24,1570,0,1570,32,1386,152,22.04.2019 01:30,38,2,Dnepr
2320,2286,10,855,1456,9,1465,0,1465,35,1330,100,22.04.2019 00:30,38,2,Dnepr
576,568,4,203,369,4,373,0,373,7,336,30,22.04.2019 00:17,38,2,Dnepr
320,309,10,64,246,10,256,0,256,3,202,51,22.04.2019 00:12,38,2,Dnepr
416,397,5,132,279,5,284,0,284,1,247,36,22.04.2019 00:10,38,2,Dnepr
800,792,31,289,481,30,511,0,511,4,464,43,21.04.2019 21:55,38,2,Dnepr
608,592,28,236,344,28,372,0,372,8,335,29,22.04.2019 00:05,38,2,Dnepr
416,411,19,150,247,19,266,0,266,2,235,29,21.04.2019 21:30,38,2,Dnepr
1024,992,66,202,756,66,822,0,822,7,708,107,22.04.2019 00:15,38,2,Dnepr
624,639,27,151,446,27,473,0,473,6,434,33,22.04.2019 00:27,38,2,Dnepr
512,504,34,186,293,33,326,0,326,6,299,21,22.04.2019 00:10,38,2,Dnepr
1056,1038,43,393,621,42,663,0,663,7,561,95,22.04.2019 00:07,38,2,Dnepr
624,616,47,197,380,47,427,0,427,6,375,46,22.04.2019 00:05,38,2,Dnepr
208,197,12,68,128,12,140,0,140,3,122,15,22.04.2019 00:05,38,2,Dnepr
496,485,38,195,265,36,301,0,301,4,277,20,21.04.2019 22:50,38,2,Dnepr
384,377,20,139,225,20,245,0,245,1,233,11,22.04.2019 00:17,38,2,Dnepr
800,772,25,329,446,25,471,0,471,5,452,14,22.04.2019 00:25,38,2,Dnepr
752,740,4,292,458,2,460,0,460,6,410,44,22.04.2019 00:15,38,2,Dnepr
864,843,63,296,505,63,568,0,568,8,526,34,21.04.2019 22:30,38,2,Dnepr
256,256,19,55,182,19,201,0,201,3,181,17,21.04.2019 22:40,38,2,Dnepr
352,341,40,93,219,40,259,0,259,3,233,23,22.04.2019 00:18,38,2,Dnepr
624,597,26,200,400,24,424,0,424,4,391,29,22.04.2019 00:10,38,2,Dnepr
688,662,184,193,312,183,495,0,495,7,406,82,22.04.2019 00:45,38,2,Dnepr
544,530,27,251,266,27,293,0,293,6,262,25,22.04.2019 00:30,38,2,Dnepr
368,365,11,128,229,11,240,0,240,2,224,14,22.04.2019 00:03,38,2,Dnepr
208,195,9,87,112,9,121,0,121,0,112,9,22.04.2019 00:15,38,2,Dnepr
1456,1412,46,674,739,43,782,0,782,10,704,68,22.04.2019 00:20,38,2,Dnepr
592,584,18,192,382,18,400,0,400,7,366,27,22.04.2019 00:03,38,2,Dnepr
2208,2071,8,969,1234,5,1239,0,1239,23,1028,188,22.04.2019 00:01,38,2,Dnepr
2016,1865,7,902,1111,3,1114,0,1114,19,959,136,22.04.2019 01:30,38,2,Dnepr
512,401,0,296,216,0,216,0,216,3,182,31,22.04.2019 02:08,38,2,Dnepr
1920,1883,53,881,997,42,1039,0,1039,22,928,89,22.04.2019 00:10,38,2,Dnepr
752,735,33,310,411,31,442,0,442,8,408,26,22.04.2019 01:13,38,2,Dnepr
272,263,17,107,149,16,165,0,165,3,152,10,22.04.2019 00:04,38,2,Dnepr
896,880,55,355,490,51,541,0,541,6,495,40,22.04.2019 00:15,38,2,Dnepr
1360,1337,19,607,735,18,753,0,753,15,688,50,21.04.2019 21:30,38,2,Dnepr
1600,1566,17,731,854,15,869,0,869,13,802,54,22.04.2019 00:00,38,2,Dnepr
1360,1344,14,475,876,9,885,0,885,14,794,77,22.04.2019 00:25,38,2,Dnepr
224,210,6,108,110,6,116,0,116,0,107,9,22.04.2019 00:55,38,2,Dnepr
496,506,1,163,332,1,333,0,333,2,292,39,22.04.2019 00:10,38,2,Dnepr
1536,1510,10,573,954,9,963,0,963,14,901,48,22.04.2019 00:30,38,2,Dnepr
1840,1796,18,732,1090,18,1108,0,1108,15,1033,60,22.04.2019 00:10,38,2,Dnepr
176,179,11,51,114,11,125,0,125,0,111,14,22.04.2019 00:20,38,2,Dnepr
800,788,61,314,434,52,486,0,486,8,445,33,22.04.2019 00:10,38,2,Dnepr
896,874,41,242,613,41,654,0,654,7,589,58,22.04.2019 00:10,38,2,Dnepr
2064,2039,15,756,1295,13,1308,0,1308,23,1194,91,22.04.2019 00:16,38,2,Dnepr
1248,1237,12,513,725,10,735,0,735,13,674,48,22.04.2019 00:04,38,2,Dnepr
736,726,19,264,453,19,472,0,472,15,414,43,22.04.2019 01:31,38,2,Dnepr
944,925,57,284,607,53,660,0,660,15,592,53,22.04.2019 00:10,38,2,Dnepr
1456,1422,20,587,853,16,869,0,869,11,767,91,22.04.2019 00:45,38,2,Dnepr
544,528,41,151,357,36,393,0,393,7,359,27,22.04.2019 03:35,38,2,Dnepr
624,621,41,256,333,35,368,0,368,4,341,23,22.04.2019 00:15,38,2,Dnepr
448,423,18,134,301,13,314,0,314,3,288,23,21.04.2019 23:20,38,2,Dnepr
240,226,14,88,139,13,152,0,152,2,134,16,22.04.2019 00:15,38,2,Dnepr
368,354,31,137,200,31,231,0,231,3,217,11,22.04.2019 00:15,38,2,Dnepr
128,127,14,24,90,14,104,0,104,1,92,11,22.04.2019 00:10,38,2,Dnepr
1072,1077,34,373,665,34,699,0,699,9,641,49,22.04.2019 00:05,38,2,Dnepr
1472,1446,29,563,881,28,909,0,909,18,810,81,22.04.2019 00:09,38,2,Dnepr
1360,1337,47,473,841,46,887,0,887,12,785,90,21.04.2019 21:40,38,2,Dnepr
2208,2166,21,903,1287,18,1305,0,1305,22,1192,91,22.04.2019 00:10,38,2,Dnepr
1664,1651,38,652,983,29,1012,0,1012,18,930,64,21.04.2019 23:05,38,2,Dnepr
1136,1108,27,451,658,27,685,0,685,3,646,36,22.04.2019 00:30,38,2,Dnepr
1488,1466,33,560,900,28,928,0,928,8,875,45,22.04.2019 00:23,38,2,Dnepr
896,879,79,352,468,76,544,0,544,12,518,14,22.04.2019 01:00,38,2,Dnepr
2032,2014,22,812,1201,19,1220,0,1220,30,1057,133,22.04.2019 00:30,38,2,Dnepr
1488,1464,29,551,918,19,937,0,937,19,844,74,22.04.2019 00:47,38,2,Dnepr
800,795,23,302,479,19,498,0,498,10,438,50,22.04.2019 00:05,38,2,Dnepr
368,360,15,138,215,15,230,0,230,6,205,19,22.04.2019 00:40,38,2,Dnepr
256,247,0,110,146,0,146,0,146,0,135,11,22.04.2019 00:40,38,2,Dnepr
832,823,51,347,434,51,485,0,485,6,431,48,22.04.2019 03:10,38,2,Dnepr
288,290,12,116,160,12,172,0,172,1,160,11,22.04.2019 00:10,38,2,Dnepr
1632,1605,38,579,1015,38,1053,0,1053,15,976,62,22.04.2019 00:10,38,2,Dnepr
912,897,18,344,554,14,568,0,568,7,525,36,22.04.2019 00:15,38,2,Dnepr
768,756,11,300,457,11,468,0,468,8,442,18,22.04.2019 00:20,38,2,Dnepr
2048,1883,15,885,1155,8,1163,0,1163,15,1018,130,22.04.2019 00:10,38,2,Dnepr
1776,1648,7,734,1035,7,1042,0,1042,16,896,130,22.04.2019 00:20,38,2,Dnepr
320,182,51,143,130,47,177,0,177,1,153,23,22.04.2019 00:30,38,2,Dnepr
736,722,16,293,429,14,443,0,443,4,390,49,22.04.2019 00:25,38,2,Dnepr
1232,1211,46,434,754,44,798,0,798,9,735,54,21.04.2019 22:05,38,2,Dnepr
1840,1812,43,612,1188,40,1228,0,1228,14,1139,75,22.04.2019 00:20,38,2,Dnepr
448,436,24,171,254,23,277,0,277,5,253,19,21.04.2019 20:52,38,2,Dnepr
528,516,21,165,342,21,363,0,363,2,336,25,21.04.2019 21:55,38,2,Dnepr
384,378,11,139,236,9,245,0,245,3,230,12,22.04.2019 00:05,38,2,Dnepr
304,297,12,122,170,12,182,0,182,1,170,11,22.04.2019 00:15,38,2,Dnepr
320,309,11,121,188,11,199,0,199,7,175,17,22.04.2019 00:10,38,2,Dnepr
608,589,18,271,320,17,337,0,337,5,312,20,21.04.2019 21:16,38,2,Dnepr
208,197,21,85,104,19,123,0,123,2,109,12,21.04.2019 21:10,38,2,Dnepr
528,509,19,234,280,14,294,0,294,1,253,40,22.04.2019 00:01,38,2,Dnepr
672,662,18,227,427,18,445,0,445,2,422,21,22.04.2019 00:25,38,2,Dnepr
688,676,60,263,365,60,425,0,425,2,392,31,22.04.2019 00:30,38,2,Dnepr
1232,1205,91,427,714,91,805,0,805,6,714,85,21.04.2019 22:35,38,2,Dnepr
368,355,22,114,232,22,254,0,254,1,236,17,22.04.2019 00:10,38,2,Dnepr
1504,1489,12,520,972,12,984,0,984,18,866,100,21.04.2019 22:25,38,2,Dnepr
1968,1950,29,691,1256,21,1277,0,1277,30,1091,156,22.04.2019 00:02,38,2,Dnepr
1888,1867,23,581,1292,15,1307,0,1307,35,1074,198,22.04.2019 00:12,38,2,Dnepr
2032,2007,25,584,1426,22,1448,0,1448,42,1201,205,22.04.2019 01:30,38,2,Dnepr
1296,1286,22,432,843,21,864,0,864,7,774,83,21.04.2019 22:10,38,2,Dnepr
896,886,17,277,607,12,619,0,619,13,515,91,22.04.2019 00:10,38,2,Dnepr
1584,1544,15,523,1049,12,1061,0,1061,24,909,128,22.04.2019 00:50,38,2,Dnepr
1296,1278,18,434,849,13,862,0,862,22,727,113,22.04.2019 00:04,38,2,Dnepr
2096,2073,36,698,1371,27,1398,0,1398,38,1149,211,22.04.2019 00:02,38,2,Dnepr
1936,1909,20,693,1228,15,1243,0,1243,31,1059,153,22.04.2019 00:15,38,2,Dnepr
1040,1026,7,317,718,5,723,0,722,18,580,124,22.04.2019 00:13,38,2,Dnepr
2064,2029,34,655,1383,26,1409,0,1409,30,1188,191,21.04.2019 23:30,38,2,Dnepr
2128,2106,38,675,1426,27,1453,0,1453,36,1250,167,22.04.2019 00:10,38,2,Dnepr
1376,1371,9,415,955,6,961,0,961,18,811,132,22.04.2019 00:17,38,2,Dnepr
1456,1446,20,427,1012,17,1029,0,1029,28,841,160,22.04.2019 00:07,38,2,Dnepr
2288,2263,20,695,1580,13,1593,0,1593,28,1381,184,21.04.2019 23:20,38,2,Dnepr
2256,2216,26,761,1473,22,1495,0,1495,50,1269,176,22.04.2019 00:30,38,2,Dnepr
2112,2077,32,812,1274,26,1300,0,1300,26,1147,127,21.04.2019 22:35,38,2,Dnepr
1744,1708,24,627,1096,21,1117,0,1117,19,979,119,21.04.2019 22:36,38,2,Dnepr
1232,1216,12,422,800,10,810,0,810,24,698,88,22.04.2019 00:10,38,2,Dnepr
2032,2001,40,728,1272,32,1304,0,1304,30,1150,124,22.04.2019 00:10,38,2,Dnepr
416,407,7,151,259,6,265,0,265,7,234,24,22.04.2019 01:20,38,2,Dnepr
1328,1316,20,494,816,18,834,0,834,17,725,92,22.04.2019 00:31,38,2,Dnepr
1376,1355,18,494,869,13,882,0,882,23,770,89,22.04.2019 00:22,38,2,Dnepr
1392,1367,21,534,841,17,858,0,858,18,758,82,22.04.2019 00:45,38,2,Dnepr
1264,1244,18,439,812,13,825,0,825,14,718,93,21.04.2019 21:37,38,2,Dnepr
2000,1963,9,807,1185,8,1193,0,1193,10,1090,93,22.04.2019 00:36,38,2,Dnepr
1456,1430,9,549,901,6,907,0,907,17,822,68,22.04.2019 00:10,38,2,Dnepr
2240,2214,26,831,1388,21,1409,0,1409,28,1272,109,22.04.2019 00:45,38,2,Dnepr
2432,2376,12,900,1521,11,1532,0,1532,29,1350,153,21.04.2019 21:50,38,2,Dnepr
1648,1631,6,722,921,5,926,0,926,8,848,70,22.04.2019 04:20,38,2,Dnepr
1888,1866,7,796,1085,7,1092,0,1092,26,972,94,22.04.2019 00:50,38,2,Dnepr
336,105,18,231,87,18,105,0,105,3,95,7,22.04.2019 00:15,38,2,Dnepr
2064,2046,74,745,1258,61,1319,0,1319,16,1189,114,22.04.2019 00:05,39,2,Dnepr
1936,1928,53,700,1191,45,1236,0,1236,25,1103,108,22.04.2019 00:40,39,2,Dnepr
1984,1950,69,759,1163,62,1225,0,1225,16,1093,116,22.04.2019 00:35,39,2,Dnepr
1840,1810,52,733,1064,43,1107,0,1107,20,1035,52,22.04.2019 00:10,39,2,Dnepr
1392,1372,52,552,793,47,840,0,840,14,784,42,22.04.2019 00:20,39,2,Dnepr
928,913,47,400,482,46,528,0,528,4,477,47,22.04.2019 00:26,39,2,Dnepr
1120,1111,56,523,546,51,597,0,597,14,535,48,22.04.2019 00:58,39,2,Dnepr
608,600,48,198,363,47,410,0,410,3,369,38,22.04.2019 00:05,39,2,Dnepr
816,801,32,319,468,29,497,0,497,7,466,24,21.04.2019 23:00,39,2,Dnepr
864,841,36,342,488,34,522,0,522,3,493,26,22.04.2019 02:20,39,2,Dnepr
992,966,27,370,596,26,622,0,622,12,569,41,21.04.2019 23:10,39,2,Dnepr
352,336,22,116,218,18,236,0,236,0,204,32,22.04.2019 00:20,39,2,Dnepr
416,406,35,138,248,30,278,0,278,1,256,21,22.04.2019 00:23,39,2,Dnepr
320,310,33,106,181,33,214,0,214,2,187,25,22.04.2019 00:05,39,2,Dnepr
1360,1336,70,445,846,69,915,0,915,29,685,201,22.04.2019 01:19,39,2,Dnepr
448,425,28,172,254,22,276,0,276,3,242,31,22.04.2019 00:05,39,2,Dnepr
656,641,32,265,360,31,391,0,391,10,355,26,22.04.2019 00:20,39,2,Dnepr
832,807,37,344,458,30,488,0,488,5,431,52,22.04.2019 00:10,39,2,Dnepr
400,387,21,161,220,19,239,0,239,3,209,27,22.04.2019 00:36,39,2,Dnepr
272,247,8,138,128,6,134,0,134,2,115,17,21.04.2019 21:03,39,2,Dnepr
592,589,91,194,311,87,398,0,398,7,340,51,21.04.2019 23:55,39,2,Dnepr
384,391,45,108,236,40,276,0,276,0,261,15,21.04.2019 23:25,39,2,Dnepr
944,932,243,260,459,225,684,0,684,15,544,125,22.04.2019 00:50,39,2,Dnepr
1280,1261,71,617,596,67,663,0,663,11,607,45,22.04.2019 00:03,39,2,Dnepr
320,303,19,59,242,19,261,0,261,2,229,30,22.04.2019 00:15,39,2,Dnepr
480,469,39,187,262,31,293,0,293,2,265,26,22.04.2019 00:15,39,2,Dnepr
320,303,23,77,222,21,243,0,243,2,213,28,21.04.2019 20:35,39,2,Dnepr
528,509,37,139,353,36,389,0,389,4,340,45,21.04.2019 20:45,39,2,Dnepr
1728,1677,23,700,1007,21,1028,0,1028,19,918,91,22.04.2019 00:05,39,2,Dnepr
1280,1246,9,504,767,9,776,0,776,9,691,76,22.04.2019 00:58,39,2,Dnepr
1344,1331,22,495,832,17,849,0,849,15,737,97,22.04.2019 00:25,39,2,Dnepr
1856,1815,39,755,1070,31,1101,0,1101,20,977,104,22.04.2019 02:45,39,2,Dnepr
784,761,28,330,434,20,454,0,454,6,418,30,22.04.2019 00:20,39,2,Dnepr
304,295,13,126,165,13,178,0,178,1,151,26,22.04.2019 00:03,39,2,Dnepr
1728,1694,43,754,938,36,974,0,974,16,885,73,21.04.2019 21:33,39,2,Dnepr
512,503,24,228,260,24,284,0,284,2,236,46,22.04.2019 00:30,39,2,Dnepr
736,733,39,302,402,32,434,0,434,5,392,37,22.04.2019 00:40,39,2,Dnepr
576,555,31,244,303,29,332,0,332,8,268,56,22.04.2019 00:50,39,2,Dnepr
464,455,22,176,267,21,288,0,288,2,208,78,22.04.2019 00:17,39,2,Dnepr
288,281,25,108,160,20,180,0,180,0,140,40,22.04.2019 00:45,39,2,Dnepr
784,775,31,357,409,18,427,0,427,5,372,50,22.04.2019 00:30,39,2,Dnepr
752,741,38,285,436,31,467,0,467,5,386,76,22.04.2019 03:30,39,2,Dnepr
1200,1179,63,477,663,60,723,0,723,17,589,117,22.04.2019 00:07,39,2,Dnepr
784,784,56,277,459,48,507,0,507,7,386,114,22.04.2019 00:55,39,2,Dnepr
544,526,8,241,295,8,303,0,303,1,252,50,22.04.2019 00:30,39,2,Dnepr
672,652,29,228,418,26,444,0,444,10,341,93,22.04.2019 01:53,39,2,Dnepr
592,581,32,241,320,31,351,0,351,10,313,28,22.04.2019 01:30,39,2,Dnepr
2192,2165,21,715,1460,17,1477,0,1477,23,1280,174,22.04.2019 00:05,39,2,Dnepr
2224,2216,29,728,1471,25,1496,0,1496,20,1367,109,22.04.2019 00:25,39,2,Dnepr
2192,2143,26,819,1348,25,1373,0,1373,18,1242,113,22.04.2019 00:35,39,2,Dnepr
448,441,6,130,312,6,318,0,318,4,278,36,22.04.2019 00:30,39,2,Dnepr
1360,1339,60,415,885,60,945,0,945,12,877,56,22.04.2019 02:10,39,2,Dnepr
1024,1010,63,380,588,56,644,0,644,3,597,44,21.04.2019 21:00,39,2,Dnepr
336,321,36,131,170,35,205,0,205,3,184,18,21.04.2019 22:00,39,2,Dnepr
1600,1570,74,537,991,72,1063,0,1063,8,932,123,21.04.2019 21:35,39,2,Dnepr
944,930,32,305,607,32,639,0,639,12,573,54,22.04.2019 00:40,39,2,Dnepr
624,608,37,205,382,37,419,0,419,5,377,37,22.04.2019 00:15,39,2,Dnepr
528,512,44,181,309,38,347,0,347,3,305,39,22.04.2019 00:15,39,2,Dnepr
1440,1417,9,509,922,9,931,0,931,7,803,121,22.04.2019 00:07,39,2,Dnepr
1616,1595,11,561,1045,10,1055,0,1055,20,887,148,22.04.2019 01:00,39,2,Dnepr
816,804,2,317,497,2,499,0,499,3,441,55,22.04.2019 03:40,39,2,Dnepr
576,561,16,221,343,12,355,0,355,0,314,41,21.04.2019 21:00,39,2,Dnepr
416,399,16,169,232,15,247,0,247,2,226,19,22.04.2019 00:12,39,2,Dnepr
256,247,29,70,160,26,186,0,186,0,170,16,22.04.2019 00:05,39,2,Dnepr
320,311,21,80,223,17,240,0,240,2,210,28,22.04.2019 00:30,39,2,Dnepr
544,531,38,149,360,35,395,0,395,5,351,39,22.04.2019 00:10,39,2,Dnepr
800,791,47,225,530,45,575,0,575,3,511,61,22.04.2019 00:30,39,2,Dnepr
656,640,15,232,409,15,424,0,424,0,400,24,22.04.2019 00:05,39,2,Dnepr
432,406,14,134,285,13,298,0,298,4,280,14,22.04.2019 00:03,39,2,Dnepr
896,875,44,329,532,35,567,0,567,6,509,52,22.04.2019 01:10,39,2,Dnepr
240,228,9,89,142,9,151,0,151,1,140,10,22.04.2019 00:48,39,2,Dnepr
784,771,57,257,475,52,527,0,527,5,493,29,22.04.2019 00:20,39,2,Dnepr
288,269,22,80,186,22,208,0,208,0,166,42,22.04.2019 00:35,39,2,Dnepr
1088,1058,80,419,589,80,669,0,669,12,597,60,22.04.2019 00:20,39,2,Dnepr
864,846,85,338,444,82,526,0,526,5,481,40,22.04.2019 00:20,39,2,Dnepr
960,974,66,348,546,66,612,0,612,13,554,45,22.04.2019 00:02,39,2,Dnepr
336,321,43,122,176,38,214,0,214,3,188,23,22.04.2019 00:10,39,2,Dnepr
1536,1507,117,582,842,112,954,0,954,22,859,73,22.04.2019 00:22,39,2,Dnepr
368,352,32,137,200,31,231,0,231,5,209,17,22.04.2019 00:30,39,2,Dnepr
1088,1070,63,334,691,63,754,0,754,10,672,72,22.04.2019 02:20,39,2,Dnepr
784,773,73,241,471,72,543,0,543,12,482,49,22.04.2019 00:05,39,2,Dnepr
1888,1860,106,773,1009,106,1115,0,1115,27,1018,70,21.04.2019 21:15,39,2,Dnepr
480,464,22,210,249,21,270,0,270,2,242,26,22.04.2019 00:20,39,2,Dnepr
1968,1933,43,666,1262,40,1302,0,1302,20,1177,105,21.04.2019 21:00,39,2,Dnepr
704,685,28,288,391,25,416,0,416,2,380,34,21.04.2019 22:05,39,2,Dnepr
1472,1452,8,495,970,7,977,0,977,18,861,98,21.04.2019 22:00,39,2,Dnepr
1504,1485,23,509,975,20,995,0,995,22,892,81,22.04.2019 00:10,39,2,Dnepr
1264,1242,27,395,842,27,869,0,869,19,758,92,22.04.2019 00:10,39,2,Dnepr
1248,1211,16,435,797,16,813,0,813,10,705,98,22.04.2019 00:25,39,2,Dnepr
1552,1523,45,564,954,34,988,0,988,13,916,59,21.04.2019 23:50,39,2,Dnepr
1616,1585,23,541,1052,23,1075,0,1075,13,954,108,22.04.2019 00:15,39,2,Dnepr
2000,1957,67,887,1046,67,1113,0,1113,7,1053,53,21.04.2019 22:40,39,2,Dnepr
2176,2136,68,940,1175,61,1236,0,1236,12,1165,59,21.04.2019 23:50,39,2,Dnepr
560,539,53,188,320,52,372,0,372,13,334,25,22.04.2019 00:10,39,2,Dnepr
1024,1004,33,368,630,26,656,0,656,14,600,42,22.04.2019 00:30,39,2,Dnepr
1232,1220,26,378,830,24,854,0,854,16,702,136,22.04.2019 00:20,39,2,Dnepr
1760,1734,39,669,1075,16,1091,0,1091,23,977,91,21.04.2019 22:02,39,2,Dnepr
1872,1862,65,501,1320,51,1371,0,1371,29,1094,248,21.04.2019 23:07,39,2,Dnepr
1824,1805,31,640,1153,31,1184,0,1184,28,977,179,22.04.2019 01:15,39,2,Dnepr
368,356,19,118,235,15,250,0,250,8,222,20,21.04.2019 22:10,39,2,Dnepr
1280,1262,14,525,743,12,755,0,755,9,687,59,22.04.2019 00:30,39,2,Dnepr
176,165,2,75,99,2,101,0,101,0,91,10,22.04.2019 00:05,39,2,Dnepr
1200,1176,34,347,821,32,853,0,853,6,789,58,22.04.2019 00:15,39,2,Dnepr
480,469,24,155,301,24,325,0,325,6,293,26,22.04.2019 01:50,39,2,Dnepr
480,467,34,167,279,34,313,0,313,2,293,18,22.04.2019 02:00,39,2,Dnepr
224,218,13,105,106,13,119,0,119,0,104,15,22.04.2019 00:30,39,2,Dnepr
544,534,9,221,314,9,323,0,323,2,275,46,22.04.2019 00:10,39,2,Dnepr
336,323,10,119,208,9,217,0,217,1,194,22,22.04.2019 00:10,39,2,Dnepr
608,598,23,262,326,20,346,0,346,13,299,34,22.04.2019 00:15,39,2,Dnepr
352,341,12,124,218,10,228,0,228,2,211,15,22.04.2019 00:10,39,2,Dnepr
560,542,3,220,337,3,340,0,340,5,306,29,22.04.2019 00:25,39,2,Dnepr
656,633,21,262,375,19,394,0,394,9,353,32,22.04.2019 00:30,39,2,Dnepr
720,710,11,254,455,11,466,0,466,3,421,42,22.04.2019 00:30,39,2,Dnepr
352,344,23,147,182,23,205,0,205,0,187,18,22.04.2019 00:05,39,2,Dnepr
848,837,46,308,494,46,540,0,540,10,440,90,22.04.2019 00:15,39,2,Dnepr
176,161,10,47,119,10,129,0,129,1,116,12,22.04.2019 02:45,39,2,Dnepr
800,782,15,341,449,10,459,0,459,10,425,24,22.04.2019 00:45,39,2,Dnepr
816,797,57,310,450,56,506,0,506,9,470,27,21.04.2019 23:55,39,2,Dnepr
928,909,43,374,512,42,554,0,554,12,491,51,22.04.2019 01:15,39,2,Dnepr
368,356,0,139,229,0,229,0,229,3,177,49,22.04.2019 00:40,39,2,Dnepr
1216,1198,25,474,720,22,742,0,742,12,647,83,22.04.2019 00:20,39,2,Dnepr
576,558,1,200,376,0,376,0,376,10,320,46,21.04.2019 21:30,39,2,Dnepr
832,824,53,320,461,51,512,0,512,13,461,38,21.04.2019 21:25,39,2,Dnepr
752,737,33,309,413,30,443,0,443,6,388,49,22.04.2019 00:20,39,2,Dnepr
720,703,10,235,477,8,485,0,485,8,416,61,22.04.2019 00:21,39,2,Dnepr
272,268,1,112,159,1,160,0,160,1,139,20,21.04.2019 21:15,39,2,Dnepr
224,228,0,96,128,0,128,0,128,3,100,25,21.04.2019 20:40,39,2,Dnepr
976,973,28,413,537,26,563,0,563,10,518,35,22.04.2019 00:57,39,2,Dnepr
576,561,33,213,330,33,363,0,363,3,329,31,21.04.2019 21:20,39,2,Dnepr
1376,1353,47,545,786,45,831,0,831,14,726,91,22.04.2019 00:20,39,2,Dnepr
624,615,16,229,381,14,395,0,395,2,349,44,22.04.2019 00:15,39,2,Dnepr
576,567,29,218,329,29,358,0,358,4,333,21,22.04.2019 00:05,39,2,Dnepr
176,160,9,54,113,9,122,0,122,0,81,41,22.04.2019 00:20,39,2,Dnepr
272,260,16,121,135,16,151,0,151,1,146,4,22.04.2019 01:40,39,2,Dnepr
368,350,23,163,185,20,205,0,205,4,183,18,21.04.2019 22:45,39,2,Dnepr
800,756,8,44,748,8,756,0,756,30,593,133,22.04.2019 00:01,39,2,Dnepr
688,671,4,259,426,3,429,0,429,9,386,34,22.04.2019 00:10,39,2,Dnepr
2224,2188,22,728,1479,17,1496,0,1496,20,1348,128,21.04.2019 23:58,39,2,Dnepr
1568,1534,18,581,972,15,987,0,987,21,903,63,22.04.2019 00:25,39,2,Dnepr
1344,1337,26,557,765,22,787,0,787,5,717,65,22.04.2019 00:20,39,2,Dnepr
1584,1541,19,629,941,14,955,0,955,13,861,81,22.04.2019 00:10,39,2,Dnepr
928,910,18,315,597,16,613,0,613,19,550,44,22.04.2019 00:30,39,2,Dnepr
944,925,3,310,631,3,634,0,634,17,560,57,22.04.2019 00:10,39,2,Dnepr
1264,1251,30,438,799,27,826,0,826,20,746,60,22.04.2019 00:31,39,2,Dnepr
1408,1384,11,530,869,9,878,0,878,3,790,85,22.04.2019 00:10,39,2,Dnepr
864,854,18,337,516,11,527,0,527,8,489,30,21.04.2019 22:45,39,2,Dnepr
1712,1685,18,660,1035,17,1052,0,1052,27,952,73,22.04.2019 00:20,39,2,Dnepr
2032,1982,21,765,1249,18,1267,0,1267,19,1151,97,22.04.2019 01:10,39,2,Dnepr
1200,1161,14,461,726,13,739,0,738,13,629,96,22.04.2019 00:43,39,2,Dnepr
1632,1589,13,638,984,10,994,0,994,18,882,94,22.04.2019 00:25,39,2,Dnepr
2080,2025,17,735,1328,17,1345,0,1345,23,1224,98,22.04.2019 00:30,39,2,Dnepr
1760,1726,10,597,1153,10,1163,0,1163,21,1042,100,22.04.2019 00:40,39,2,Dnepr
320,213,34,109,177,34,211,0,211,4,187,20,22.04.2019 00:20,39,2,Dnepr
1872,1190,77,682,1131,59,1190,0,1190,17,1066,107,22.04.2019 00:50,40,2,Dnepr
1952,1926,59,690,1207,55,1262,0,1262,24,1100,138,22.04.2019 00:05,40,2,Dnepr
784,766,14,291,481,12,493,0,493,7,420,66,22.04.2019 00:55,40,2,Dnepr
544,525,25,250,272,22,294,0,294,2,270,22,22.04.2019 00:05,40,2,Dnepr
528,516,42,198,290,40,330,0,330,0,293,37,22.04.2019 00:05,40,2,Dnepr
1248,1236,24,463,763,22,785,0,785,16,717,52,22.04.2019 00:15,40,2,Dnepr
752,739,24,278,458,16,474,0,474,6,427,41,22.04.2019 02:31,40,2,Dnepr
2256,2216,72,930,1266,60,1326,0,1326,25,1188,113,22.04.2019 01:55,40,2,Dnepr
624,604,59,267,308,49,357,0,357,6,338,13,22.04.2019 00:15,40,2,Dnepr
1008,1005,184,380,456,172,628,0,628,18,562,48,22.04.2019 00:30,40,2,Dnepr
496,486,55,218,229,49,278,0,278,4,262,12,21.04.2019 21:46,40,2,Dnepr
528,512,60,220,258,50,308,0,308,2,278,28,22.04.2019 00:30,40,2,Dnepr
944,919,75,360,519,65,584,0,584,9,529,46,22.04.2019 00:15,40,2,Dnepr
384,384,53,132,199,53,252,0,252,6,221,25,22.04.2019 00:10,40,2,Dnepr
1120,1093,84,418,628,74,702,0,702,8,621,73,22.04.2019 02:30,40,2,Dnepr
544,525,33,226,289,29,318,0,318,4,298,16,22.04.2019 00:02,40,2,Dnepr
928,909,28,382,518,28,546,0,546,10,511,25,22.04.2019 00:15,40,2,Dnepr
624,604,71,255,300,69,369,0,369,7,345,17,22.04.2019 00:15,40,2,Dnepr
1152,1119,76,487,601,64,665,0,665,9,597,59,22.04.2019 00:35,40,2,Dnepr
640,624,52,241,349,50,399,0,399,5,351,43,22.04.2019 00:20,40,2,Dnepr
1088,1065,63,513,522,53,575,0,575,5,537,33,22.04.2019 00:23,40,2,Dnepr
816,798,90,323,413,80,493,0,493,9,452,32,22.04.2019 00:10,40,2,Dnepr
544,532,39,176,330,38,368,0,368,4,334,30,22.04.2019 00:02,40,2,Dnepr
336,327,34,99,206,31,237,0,237,1,213,23,22.04.2019 00:02,40,2,Dnepr
1312,1288,38,512,764,36,800,0,800,22,688,90,22.04.2019 00:05,40,2,Dnepr
1136,1110,58,422,660,54,714,0,714,10,624,80,22.04.2019 00:30,40,2,Dnepr
880,861,10,335,536,9,545,0,545,8,507,30,22.04.2019 00:05,40,2,Dnepr
704,676,54,281,374,49,423,0,423,9,376,38,22.04.2019 00:10,40,2,Dnepr
672,650,37,211,425,36,461,0,461,4,422,35,22.04.2019 00:30,40,2,Dnepr
1216,1195,9,496,712,8,720,0,720,10,645,65,22.04.2019 00:10,40,2,Dnepr
368,360,3,176,189,3,192,0,192,4,160,28,22.04.2019 00:05,40,2,Dnepr
688,667,32,254,405,29,434,0,434,4,405,25,22.04.2019 00:20,40,2,Dnepr
928,914,4,369,555,4,559,0,559,7,484,68,22.04.2019 00:20,40,2,Dnepr
576,564,7,244,325,7,332,0,332,4,302,26,22.04.2019 00:37,40,2,Dnepr
624,610,14,230,383,11,394,0,394,9,339,46,21.04.2019 23:05,40,2,Dnepr
528,518,13,180,335,13,348,0,348,6,293,49,22.04.2019 00:05,40,2,Dnepr
496,496,14,214,269,13,282,0,282,2,266,14,22.04.2019 00:30,40,2,Dnepr
320,306,17,164,139,17,156,0,156,0,137,19,22.04.2019 00:05,40,2,Dnepr
304,294,8,101,196,7,203,0,203,1,167,35,22.04.2019 00:10,40,2,Dnepr
1248,1234,38,520,694,34,728,0,728,12,650,66,22.04.2019 00:10,40,2,Dnepr
256,250,5,89,163,4,167,0,167,1,137,29,22.04.2019 00:35,40,2,Dnepr
592,576,15,207,372,13,385,0,385,6,324,55,22.04.2019 00:15,40,2,Dnepr
224,210,8,93,123,8,131,0,131,1,120,10,21.04.2019 23:00,40,2,Dnepr
352,337,8,117,228,7,235,0,235,4,196,35,22.04.2019 00:10,40,2,Dnepr
288,281,18,68,202,18,220,0,220,0,207,13,22.04.2019 00:45,40,2,Dnepr
528,515,37,253,240,35,275,0,275,4,226,45,22.04.2019 00:45,40,2,Dnepr
224,214,21,65,141,18,159,0,159,3,133,23,22.04.2019 00:15,40,2,Dnepr
608,591,14,303,294,11,305,0,305,2,266,37,22.04.2019 00:15,40,2,Dnepr
640,631,12,304,326,10,336,0,336,6,310,20,22.04.2019 00:20,40,2,Dnepr
1280,1267,59,556,669,55,724,0,724,5,638,81,22.04.2019 00:05,40,2,Dnepr
272,265,22,121,129,22,151,0,151,2,128,21,22.04.2019 00:05,40,2,Dnepr
672,672,32,228,412,32,444,0,444,2,381,61,22.04.2019 00:57,40,2,Dnepr
592,587,30,245,318,29,347,0,347,4,311,32,22.04.2019 00:01,40,2,Dnepr
464,457,30,163,272,29,301,0,301,5,236,60,22.04.2019 00:50,40,2,Dnepr
576,565,43,250,285,41,326,0,326,2,293,31,22.04.2019 00:17,40,2,Dnepr
736,727,46,304,389,43,432,0,432,11,373,48,22.04.2019 00:15,40,2,Dnepr
848,842,20,348,480,20,500,0,500,7,419,74,22.04.2019 00:10,40,2,Dnepr
240,222,2,118,121,1,122,0,122,2,109,11,22.04.2019 00:05,40,2,Dnepr
704,686,1,328,375,1,376,0,376,2,340,34,22.04.2019 00:10,40,2,Dnepr
560,543,3,223,335,2,337,0,337,3,321,13,22.04.2019 00:10,40,2,Dnepr
1888,1880,8,641,1240,7,1247,0,1247,16,1060,171,22.04.2019 01:30,40,2,Dnepr
2160,2131,6,901,1253,6,1259,0,1259,12,1111,136,22.04.2019 00:40,40,2,Dnepr
2368,2343,9,894,1465,9,1474,0,1474,23,1281,170,22.04.2019 00:25,40,2,Dnepr
1344,1314,2,585,757,2,759,0,759,10,683,66,22.04.2019 00:10,40,2,Dnepr
912,898,3,409,501,2,503,0,503,14,453,36,22.04.2019 00:25,40,2,Dnepr
1856,1843,39,861,966,29,995,0,995,13,889,93,22.04.2019 00:48,40,2,Dnepr
464,458,18,156,292,16,308,0,308,0,281,27,22.04.2019 00:20,40,2,Dnepr
416,415,38,164,222,30,252,0,252,2,223,27,21.04.2019 22:00,40,2,Dnepr
1344,873,0,479,865,0,865,0,865,45,667,153,22.04.2019 00:10,40,2,Dnepr
1536,1509,22,612,903,21,924,0,924,20,809,95,22.04.2019 00:01,40,2,Dnepr
1952,1925,42,673,1243,36,1279,0,1279,18,1143,118,22.04.2019 00:15,40,2,Dnepr
2304,2281,25,846,1439,19,1458,0,1458,25,1326,107,22.04.2019 00:10,40,2,Dnepr
512,491,40,230,250,32,282,0,282,5,235,42,22.04.2019 05:15,40,2,Dnepr
1040,1032,63,314,668,58,726,0,726,16,668,42,22.04.2019 01:00,40,2,Dnepr
1472,1454,134,610,765,97,862,0,862,18,754,90,22.04.2019 01:47,40,2,Dnepr
432,410,14,150,272,10,282,0,282,3,231,48,22.04.2019 00:15,40,2,Dnepr
1216,1192,68,428,724,64,788,0,788,10,716,62,22.04.2019 00:15,40,2,Dnepr
928,920,42,297,594,37,631,0,631,10,538,83,22.04.2019 00:05,40,2,Dnepr
448,447,25,138,286,24,310,0,310,1,286,23,22.04.2019 00:30,40,2,Dnepr
1744,1723,62,635,1058,51,1109,0,1109,26,908,175,22.04.2019 01:20,40,2,Dnepr
608,592,17,280,317,11,328,0,328,7,295,26,22.04.2019 01:00,40,2,Dnepr
752,742,40,274,439,39,478,0,478,10,416,52,22.04.2019 00:15,40,2,Dnepr
976,960,59,466,460,50,510,0,510,6,465,39,22.04.2019 03:30,40,2,Dnepr
1360,1332,63,540,769,51,820,0,820,14,733,73,22.04.2019 00:35,40,2,Dnepr
1248,1224,117,468,679,101,780,0,780,25,669,86,22.04.2019 00:10,40,2,Dnepr
352,340,12,181,162,9,171,0,171,4,155,12,22.04.2019 00:20,40,2,Dnepr
912,894,247,344,372,196,568,0,568,17,454,97,22.04.2019 00:05,40,2,Dnepr
352,353,16,133,203,16,219,0,219,5,183,31,22.04.2019 00:05,40,2,Dnepr
944,905,20,411,518,15,533,0,533,9,459,65,22.04.2019 03:00,40,2,Dnepr
912,879,12,364,539,9,548,0,548,6,487,55,22.04.2019 00:30,40,2,Dnepr
832,829,12,355,468,9,477,0,477,15,411,51,22.04.2019 01:55,40,2,Dnepr
1392,1372,20,584,791,17,808,0,808,15,717,76,22.04.2019 01:30,40,2,Dnepr
1536,1505,28,571,946,19,965,0,965,21,841,103,22.04.2019 00:25,40,2,Dnepr
896,869,11,371,516,9,525,0,525,9,463,53,22.04.2019 01:10,40,2,Dnepr
1888,1853,31,768,1102,18,1120,0,1120,16,986,118,21.04.2019 23:50,40,2,Dnepr
1648,1617,19,738,895,15,910,0,910,11,808,91,22.04.2019 03:25,40,2,Dnepr
1424,1396,17,600,813,11,824,0,824,19,711,94,22.04.2019 01:00,40,2,Dnepr
976,981,15,392,574,10,584,0,584,5,522,57,22.04.2019 00:15,40,2,Dnepr
2240,2213,18,864,1362,14,1376,0,1376,32,1215,129,22.04.2019 01:30,40,2,Dnepr
2080,2053,18,860,1206,14,1220,0,1220,20,1095,105,22.04.2019 03:00,40,2,Dnepr
1712,1682,22,798,896,18,914,0,914,18,820,76,22.04.2019 00:15,40,2,Dnepr
1712,1676,12,717,991,4,995,0,995,15,901,79,22.04.2019 06:05,40,2,Dnepr
2096,2050,32,798,1279,19,1298,0,1298,29,1154,115,22.04.2019 03:15,40,2,Dnepr
2080,2047,24,867,1195,18,1213,0,1213,24,1071,118,22.04.2019 01:00,40,2,Dnepr
2256,2194,18,953,1287,16,1303,0,1303,22,1155,126,22.04.2019 02:10,40,2,Dnepr
2064,2008,33,833,1215,16,1231,0,1231,17,1089,125,22.04.2019 06:15,40,2,Dnepr
1488,1452,10,635,845,8,853,0,853,20,763,70,22.04.2019 00:30,40,2,Dnepr
384,387,11,146,227,11,238,0,238,1,225,12,22.04.2019 01:00,40,2,Dnepr
912,908,13,393,509,10,519,0,519,7,476,36,22.04.2019 02:05,40,2,Dnepr
1584,1572,33,636,920,28,948,0,948,3,861,84,22.04.2019 00:45,40,2,Dnepr
1792,1777,57,855,898,39,937,0,937,14,817,106,22.04.2019 01:00,40,2,Dnepr
2160,2129,17,879,1271,10,1281,0,1281,32,1137,112,22.04.2019 00:45,40,2,Dnepr
2224,2187,6,907,1313,4,1317,0,1317,31,1148,138,22.04.2019 00:55,40,2,Dnepr
2384,2385,11,792,1584,8,1592,0,1592,33,1412,147,22.04.2019 05:01,40,2,Dnepr
2176,2154,13,910,1254,12,1266,0,1266,31,1133,102,22.04.2019 00:30,40,2,Dnepr
2336,2306,13,826,1501,9,1510,0,1510,33,1329,148,22.04.2019 00:10,40,2,Dnepr
2208,2176,11,926,1272,10,1282,0,1282,37,1142,103,22.04.2019 00:10,40,2,Dnepr
2064,2033,11,689,1366,9,1375,0,1375,39,1221,115,22.04.2019 00:05,40,2,Dnepr
2048,2016,10,773,1268,7,1275,0,1275,25,1134,116,22.04.2019 00:10,40,2,Dnepr
2240,2210,6,921,1315,4,1319,0,1319,32,1166,121,22.04.2019 00:52,40,2,Dnepr
2304,2276,10,851,1446,7,1453,0,1453,28,1295,130,22.04.2019 00:11,40,2,Dnepr
2208,2156,12,857,1342,9,1351,0,1351,9,1237,105,22.04.2019 00:14,40,2,Dnepr
2240,2221,8,823,1410,7,1417,0,1417,17,1297,103,22.04.2019 00:10,40,2,Dnepr
1584,1554,9,554,1021,9,1030,0,1030,23,910,97,22.04.2019 00:03,40,2,Dnepr
368,285,65,83,220,65,285,0,285,6,198,81,22.04.2019 00:12,40,2,Dnepr
848,278,0,572,276,0,276,0,276,3,257,16,22.04.2019 00:10,40,2,Dnepr
224,83,8,155,61,8,69,0,69,3,37,29,22.04.2019 00:30,40,2,Dnepr
1344,1336,44,428,877,39,916,0,916,7,860,49,22.04.2019 00:10,40,2,Dnepr
320,296,0,36,284,0,284,0,284,30,92,162,21.04.2019 21:10,45,3,Donetsk
336,319,0,19,317,0,317,0,317,14,132,171,21.04.2019 23:00,45,3,Donetsk
352,366,0,22,330,0,330,0,330,9,187,134,22.04.2019 00:09,45,3,Donetsk
928,920,0,14,914,0,914,0,914,26,305,583,22.04.2019 00:01,45,3,Donetsk
320,316,0,45,275,0,275,0,275,15,97,163,22.04.2019 00:40,45,3,Donetsk
576,556,0,101,475,0,475,0,475,8,305,162,22.04.2019 00:10,45,3,Donetsk
2144,2095,55,1160,941,43,984,0,984,34,776,174,22.04.2019 01:30,45,3,Donetsk
560,611,14,424,136,0,136,0,136,2,70,64,22.04.2019 01:00,45,3,Donetsk
1024,1014,62,239,723,62,785,0,785,16,447,322,22.04.2019 00:05,45,3,Donetsk
1456,1463,20,744,693,19,712,0,712,33,518,161,22.04.2019 01:33,45,3,Donetsk
1552,1574,23,795,734,23,757,0,757,30,628,99,21.04.2019 22:20,45,3,Donetsk
640,622,41,346,256,38,294,0,294,7,227,60,22.04.2019 00:30,45,3,Donetsk
480,491,22,265,201,14,215,0,215,1,176,38,21.04.2019 21:00,45,3,Donetsk
720,726,61,260,399,61,460,0,460,22,359,79,22.04.2019 00:10,45,3,Donetsk
1344,1309,48,689,608,47,655,0,655,31,429,195,21.04.2019 22:25,45,3,Donetsk
432,419,8,128,296,8,304,0,304,2,203,99,21.04.2019 21:00,45,3,Donetsk
1776,1723,151,820,805,151,956,0,956,48,666,242,22.04.2019 00:50,45,3,Donetsk
816,782,73,238,505,73,578,0,578,6,337,235,22.04.2019 00:10,45,3,Donetsk
1968,1845,36,1464,494,10,504,0,504,7,235,262,21.04.2019 23:40,45,3,Donetsk
560,554,47,239,284,37,321,0,321,9,238,74,21.04.2019 21:20,45,3,Donetsk
704,693,62,223,432,49,481,0,481,3,295,183,22.04.2019 01:30,45,3,Donetsk
576,564,0,328,248,0,248,0,248,1,153,94,22.04.2019 00:20,45,3,Donetsk
992,969,14,599,381,12,393,0,393,21,348,24,22.04.2019 00:15,45,3,Donetsk
1408,1394,37,899,481,28,509,0,509,17,443,49,21.04.2019 22:01,45,3,Donetsk
944,912,27,576,343,25,368,0,368,16,318,34,22.04.2019 00:30,45,3,Donetsk
976,956,26,592,368,16,384,0,384,19,343,22,22.04.2019 00:13,45,3,Donetsk
1248,1199,40,734,484,30,514,0,514,21,438,55,22.04.2019 00:24,45,3,Donetsk
1040,1005,30,640,370,30,400,0,400,15,350,35,22.04.2019 00:50,45,3,Donetsk
1264,1209,57,800,408,56,464,0,464,18,411,35,22.04.2019 00:05,45,3,Donetsk
1984,1897,10,1140,835,9,844,0,844,44,730,70,22.04.2019 00:01,45,3,Donetsk
2224,2147,23,1386,819,19,838,0,838,13,761,64,22.04.2019 00:30,45,3,Donetsk
1872,1822,17,1049,807,16,823,0,823,40,712,71,22.04.2019 00:30,45,3,Donetsk
1136,1093,10,637,489,10,499,0,499,20,439,40,22.04.2019 00:01,45,3,Donetsk
2032,1954,32,1240,773,19,792,0,792,30,681,81,22.04.2019 00:30,45,3,Donetsk
2160,2044,19,1272,874,14,888,0,888,31,793,64,22.04.2019 00:13,45,3,Donetsk
1952,1852,23,1163,777,12,789,0,789,28,704,57,22.04.2019 00:40,45,3,Donetsk
2016,1949,21,1151,849,16,865,0,865,33,762,70,22.04.2019 00:09,45,3,Donetsk
2080,1985,14,1171,900,9,909,0,909,37,787,85,22.04.2019 00:20,45,3,Donetsk
832,602,0,230,602,0,602,0,602,52,537,13,22.04.2019 00:10,46,3,Donetsk
272,256,0,42,230,0,230,0,230,8,167,55,21.04.2019 20:30,46,3,Donetsk
256,227,0,68,188,0,188,0,188,6,125,57,21.04.2019 21:15,46,3,Donetsk
336,332,0,7,329,0,329,0,329,37,107,185,21.04.2019 20:50,46,3,Donetsk
288,261,0,50,238,0,238,0,238,24,124,90,21.04.2019 21:10,46,3,Donetsk
192,180,0,14,178,0,178,0,178,13,79,86,21.04.2019 20:46,46,3,Donetsk
1008,989,35,544,437,27,464,0,464,9,419,36,22.04.2019 00:34,46,3,Donetsk
1456,1458,45,746,672,38,710,0,710,7,653,50,22.04.2019 00:03,46,3,Donetsk
1520,1487,40,740,753,27,780,0,780,16,718,46,21.04.2019 21:00,46,3,Donetsk
1408,1393,68,723,641,44,685,0,685,9,629,47,21.04.2019 21:00,46,3,Donetsk
1536,1502,42,768,732,36,768,0,768,12,703,53,22.04.2019 00:15,46,3,Donetsk
848,839,35,455,366,27,393,0,393,6,367,20,21.04.2019 21:30,46,3,Donetsk
752,738,36,375,346,31,377,0,377,9,300,68,22.04.2019 00:45,46,3,Donetsk
912,873,34,485,397,30,427,0,427,6,348,73,21.04.2019 22:10,46,3,Donetsk
256,242,15,133,108,15,123,0,123,2,105,16,22.04.2019 00:25,46,3,Donetsk
256,243,10,123,123,10,133,0,133,2,101,30,22.04.2019 00:05,46,3,Donetsk
608,597,39,268,308,32,340,0,340,3,314,23,22.04.2019 00:02,46,3,Donetsk
448,439,23,259,171,18,189,0,189,4,174,11,22.04.2019 00:15,46,3,Donetsk
256,253,10,99,152,5,157,0,157,4,140,13,22.04.2019 00:15,46,3,Donetsk
608,588,45,200,366,42,408,0,408,9,262,137,22.04.2019 00:21,46,3,Donetsk
832,806,46,438,360,34,394,0,394,7,362,25,21.04.2019 20:54,46,3,Donetsk
336,326,32,145,170,21,191,0,191,13,154,24,21.04.2019 21:05,46,3,Donetsk
1024,1005,142,416,474,134,608,0,608,14,487,107,21.04.2019 22:28,46,3,Donetsk
944,916,43,269,639,36,675,0,674,14,451,209,22.04.2019 01:35,46,3,Donetsk
576,569,31,204,344,28,372,0,372,4,342,26,22.04.2019 00:05,46,3,Donetsk
576,565,58,222,297,57,354,0,354,8,296,50,22.04.2019 00:05,46,3,Donetsk
528,503,25,217,291,20,311,0,311,5,289,17,22.04.2019 00:30,46,3,Donetsk
160,146,4,60,96,4,100,0,100,0,65,35,22.04.2019 06:00,46,3,Donetsk
400,396,21,182,197,21,218,0,218,3,179,36,21.04.2019 21:55,46,3,Donetsk
592,583,17,279,298,15,313,0,313,6,279,28,21.04.2019 21:50,46,3,Donetsk
384,370,16,245,124,15,139,0,139,1,131,7,21.04.2019 21:18,46,3,Donetsk
1248,1225,52,515,681,52,733,0,733,15,672,46,22.04.2019 01:25,46,3,Donetsk
416,420,20,182,214,20,234,0,234,5,194,35,22.04.2019 00:05,46,3,Donetsk
752,730,78,381,309,62,371,0,371,6,354,11,22.04.2019 00:01,46,3,Donetsk
464,451,41,227,200,37,237,0,237,5,215,17,22.04.2019 00:40,46,3,Donetsk
1472,1462,54,639,784,49,833,0,833,11,744,78,21.04.2019 21:55,46,3,Donetsk
224,218,6,95,123,6,129,0,129,4,110,15,22.04.2019 00:31,46,3,Donetsk
224,220,6,55,163,6,169,0,169,3,146,20,22.04.2019 04:40,46,3,Donetsk
352,343,28,156,169,27,196,0,196,0,186,10,22.04.2019 00:30,46,3,Donetsk
512,502,34,225,256,31,287,0,287,4,261,22,22.04.2019 00:01,46,3,Donetsk
528,512,18,243,273,12,285,0,285,3,265,17,22.04.2019 00:01,46,3,Donetsk
1472,1479,44,535,906,31,937,0,937,16,867,54,22.04.2019 00:15,46,3,Donetsk
320,309,42,178,106,36,142,0,142,5,121,16,22.04.2019 00:30,46,3,Donetsk
288,278,11,105,174,9,183,0,183,3,165,15,21.04.2019 22:00,46,3,Donetsk
512,489,47,173,297,42,339,0,339,4,261,74,22.04.2019 00:10,46,3,Donetsk
512,511,59,241,221,50,271,0,271,4,243,24,21.04.2019 22:05,46,3,Donetsk
992,972,44,484,469,39,508,0,508,8,476,24,22.04.2019 01:07,46,3,Donetsk
624,615,16,299,314,11,325,0,325,7,292,26,22.04.2019 00:05,46,3,Donetsk
1488,1461,15,680,796,12,808,0,808,17,738,53,22.04.2019 00:01,46,3,Donetsk
1552,1589,30,643,886,23,909,0,909,26,789,94,22.04.2019 00:10,46,3,Donetsk
1360,1341,35,589,741,30,771,0,771,14,705,52,21.04.2019 22:00,46,3,Donetsk
1008,986,17,484,508,16,524,0,524,17,450,57,21.04.2019 21:23,46,3,Donetsk
752,749,4,364,385,3,388,0,388,9,350,29,22.04.2019 00:15,46,3,Donetsk
896,1009,24,200,675,21,696,0,696,29,538,129,22.04.2019 00:04,46,3,Donetsk
848,840,9,354,488,6,494,0,494,15,416,63,22.04.2019 00:15,46,3,Donetsk
1216,1183,16,517,686,13,699,0,699,10,644,45,21.04.2019 21:17,46,3,Donetsk
1120,1146,33,451,640,29,669,0,669,27,569,73,21.04.2019 22:00,46,3,Donetsk
1392,1372,22,527,854,11,865,0,865,20,753,92,22.04.2019 00:20,46,3,Donetsk
864,888,9,321,537,6,543,0,543,10,466,67,22.04.2019 00:10,46,3,Donetsk
1440,1413,7,573,864,3,867,0,867,20,781,66,22.04.2019 00:10,46,3,Donetsk
1792,1743,28,772,999,21,1020,0,1020,24,917,79,22.04.2019 00:15,46,3,Donetsk
1888,1873,20,935,938,15,953,0,953,23,841,89,21.04.2019 22:15,46,3,Donetsk
992,995,51,394,548,50,598,0,598,16,514,68,21.04.2019 21:44,46,3,Donetsk
1344,1321,16,558,774,12,786,0,786,12,713,61,21.04.2019 21:36,46,3,Donetsk
1504,1460,12,664,831,9,840,0,840,24,757,59,21.04.2019 21:36,46,3,Donetsk
1200,1173,9,497,694,9,703,0,703,23,614,66,21.04.2019 21:40,46,3,Donetsk
1600,1564,16,674,916,10,926,0,926,30,829,67,22.04.2019 00:06,46,3,Donetsk
1952,1920,18,808,1134,10,1144,0,1144,35,1021,88,21.04.2019 21:20,46,3,Donetsk
2176,2123,18,892,1272,12,1284,0,1284,32,1158,94,21.04.2019 21:55,46,3,Donetsk
2048,2056,12,828,1211,9,1220,0,1220,25,1086,109,21.04.2019 23:50,46,3,Donetsk
1840,1791,15,811,1017,12,1029,0,1029,29,920,80,22.04.2019 00:30,46,3,Donetsk
1760,1779,20,733,1012,15,1027,0,1027,29,905,93,21.04.2019 22:12,46,3,Donetsk
1168,1166,6,527,635,6,641,0,641,21,569,51,22.04.2019 01:22,46,3,Donetsk
1664,1585,30,816,820,28,848,0,848,22,743,83,21.04.2019 21:18,46,3,Donetsk
1552,1514,16,682,856,14,870,0,870,22,775,73,22.04.2019 06:30,46,3,Donetsk
1664,1636,15,750,902,12,914,0,914,31,800,83,21.04.2019 22:37,46,3,Donetsk
1184,1146,15,523,647,14,661,0,661,23,581,57,22.04.2019 00:18,46,3,Donetsk
1344,1323,10,518,818,8,826,0,826,13,767,46,22.04.2019 00:23,46,3,Donetsk
1504,1451,14,692,807,5,812,0,812,21,750,41,22.04.2019 00:13,46,3,Donetsk
1904,1871,11,820,1073,11,1084,0,1084,34,973,77,21.04.2019 22:05,46,3,Donetsk
1728,1696,35,753,941,34,975,0,975,30,877,68,21.04.2019 21:46,46,3,Donetsk
2192,2143,53,1020,1135,37,1172,0,1172,21,1076,75,22.04.2019 00:30,46,3,Donetsk
1840,1816,23,886,932,22,954,0,954,18,897,39,21.04.2019 22:15,46,3,Donetsk
448,441,13,163,272,13,285,0,285,7,250,28,22.04.2019 00:01,46,3,Donetsk
544,536,6,287,251,6,257,0,257,7,244,6,22.04.2019 00:02,46,3,Donetsk
896,882,7,485,409,2,411,0,411,4,382,25,21.04.2019 21:45,46,3,Donetsk
1856,1836,12,691,1156,9,1165,0,1165,19,1087,59,22.04.2019 00:01,46,3,Donetsk
1888,1865,14,720,1156,12,1168,0,1168,27,1094,47,21.04.2019 21:17,46,3,Donetsk
1648,1636,13,722,920,6,926,0,926,22,857,47,21.04.2019 21:30,46,3,Donetsk
848,841,19,434,399,15,414,0,414,7,391,16,21.04.2019 21:20,46,3,Donetsk
880,854,11,475,397,8,405,0,405,12,383,10,21.04.2019 23:50,46,3,Donetsk
1104,1083,28,587,490,27,517,0,517,19,457,41,22.04.2019 00:20,46,3,Donetsk
752,753,66,366,323,63,386,0,386,3,322,61,22.04.2019 00:08,46,3,Donetsk
912,894,15,484,417,11,428,0,428,12,373,43,22.04.2019 00:05,46,3,Donetsk
896,882,32,465,399,32,431,0,431,11,378,42,22.04.2019 00:20,46,3,Donetsk
688,675,36,318,335,35,370,0,370,13,306,51,22.04.2019 01:05,46,3,Donetsk
640,627,57,342,246,52,298,0,298,7,239,52,22.04.2019 00:05,46,3,Donetsk
736,725,27,364,345,27,372,0,372,7,320,45,22.04.2019 00:06,46,3,Donetsk
1536,1523,46,774,728,34,762,0,762,21,696,45,22.04.2019 00:15,46,3,Donetsk
912,899,14,422,477,13,490,0,490,6,436,48,22.04.2019 00:25,46,3,Donetsk
944,929,55,409,484,51,535,0,535,9,480,46,22.04.2019 00:30,46,3,Donetsk
1312,1276,29,656,639,17,656,0,656,16,599,41,22.04.2019 00:30,46,3,Donetsk
384,112,45,276,63,45,108,0,108,2,93,13,22.04.2019 00:49,46,3,Donetsk
1648,1769,5,551,1092,5,1097,0,1097,34,973,90,21.04.2019 23:50,46,3,Donetsk
1504,1486,94,603,811,90,901,0,901,18,807,76,21.04.2019 21:10,46,3,Donetsk
1440,1451,6,579,858,3,861,0,861,24,793,44,22.04.2019 00:12,46,3,Donetsk
784,804,3,364,420,0,420,0,420,6,363,51,22.04.2019 00:15,46,3,Donetsk
288,279,1,110,177,1,178,0,178,5,147,26,21.04.2019 22:02,46,3,Donetsk
1296,1278,12,531,754,11,765,0,765,10,683,72,22.04.2019 01:10,46,3,Donetsk
1200,1190,2,620,579,1,580,0,580,13,513,54,22.04.2019 01:30,46,3,Donetsk
1216,1227,9,544,663,9,672,0,672,18,595,59,22.04.2019 00:05,46,3,Donetsk
880,860,16,443,422,15,437,0,437,9,410,18,22.04.2019 00:05,46,3,Donetsk
688,667,32,302,356,30,386,0,386,36,316,34,22.04.2019 00:10,46,3,Donetsk
1776,1749,10,834,932,10,942,0,942,18,875,49,22.04.2019 00:01,46,3,Donetsk
1392,1377,13,667,715,10,725,0,725,15,659,51,22.04.2019 00:51,46,3,Donetsk
1264,1256,26,579,662,23,685,0,685,8,646,31,21.04.2019 21:07,46,3,Donetsk
1760,1791,27,755,981,24,1005,0,1005,9,933,63,22.04.2019 00:30,46,3,Donetsk
240,284,5,63,174,3,177,0,177,3,122,52,22.04.2019 01:30,46,3,Donetsk
208,213,4,44,160,4,164,0,164,1,92,71,22.04.2019 00:20,46,3,Donetsk
432,427,24,175,236,21,257,0,257,3,238,16,22.04.2019 00:05,46,3,Donetsk
256,253,14,81,162,13,175,0,175,2,123,50,22.04.2019 02:15,46,3,Donetsk
144,152,7,37,100,7,107,0,107,2,60,45,21.04.2019 23:30,46,3,Donetsk
240,239,7,70,163,7,170,0,170,4,113,53,22.04.2019 00:30,46,3,Donetsk
896,909,10,433,455,8,463,0,463,7,427,29,22.04.2019 00:10,46,3,Donetsk
704,706,12,349,343,12,355,0,355,3,327,25,22.04.2019 00:10,46,3,Donetsk
368,373,20,164,184,20,204,0,204,0,175,29,22.04.2019 00:10,46,3,Donetsk
992,973,9,387,596,9,605,0,605,14,535,56,21.04.2019 23:50,46,3,Donetsk
1040,1024,8,497,537,6,543,0,543,10,505,28,22.04.2019 00:25,46,3,Donetsk
1056,1048,12,511,535,10,545,0,545,10,467,68,22.04.2019 00:15,46,3,Donetsk
560,558,32,277,252,31,283,0,283,8,251,24,22.04.2019 00:15,46,3,Donetsk
272,270,12,124,136,12,148,0,148,1,132,15,22.04.2019 00:00,46,3,Donetsk
1088,1067,33,391,665,32,697,0,697,12,612,73,22.04.2019 01:20,46,3,Donetsk
1312,1330,33,519,762,31,793,0,793,16,687,90,22.04.2019 00:50,46,3,Donetsk
144,149,0,24,120,0,120,0,120,3,98,19,22.04.2019 00:03,46,3,Donetsk
704,718,8,305,391,8,399,0,399,5,340,54,22.04.2019 00:15,46,3,Donetsk
688,682,7,341,340,7,347,0,347,3,302,42,22.04.2019 00:40,46,3,Donetsk
336,335,5,145,186,5,191,0,191,3,154,34,22.04.2019 00:20,46,3,Donetsk
944,955,23,282,641,21,662,0,662,9,477,176,22.04.2019 02:30,46,3,Donetsk
864,854,11,461,394,9,403,0,403,10,372,21,22.04.2019 03:50,46,3,Donetsk
176,173,5,87,84,5,89,0,89,2,79,8,22.04.2019 00:05,46,3,Donetsk
336,314,2,181,154,1,155,0,155,4,128,23,22.04.2019 00:03,46,3,Donetsk
592,569,13,292,288,12,300,0,300,2,267,31,22.04.2019 01:10,46,3,Donetsk
960,945,56,366,538,56,594,0,594,14,524,56,21.04.2019 23:40,46,3,Donetsk
432,425,19,194,219,19,238,0,238,2,214,22,22.04.2019 00:05,46,3,Donetsk
448,439,12,192,244,12,256,0,256,2,235,19,22.04.2019 00:30,46,3,Donetsk
368,386,32,114,224,30,254,0,254,3,220,31,22.04.2019 00:51,46,3,Donetsk
176,80,14,98,66,12,78,0,78,0,62,16,22.04.2019 00:10,46,3,Donetsk
64,57,39,19,14,31,45,0,45,1,40,4,21.04.2019 21:00,46,3,Donetsk
128,96,0,32,96,0,96,0,96,4,86,6,21.04.2019 20:15,46,3,Donetsk
80,63,0,19,61,0,61,0,61,1,50,10,21.04.2019 21:20,47,3,Donetsk
1488,1479,34,362,1092,34,1126,0,1126,18,794,314,21.04.2019 23:00,47,3,Donetsk
1472,1450,16,465,993,14,1007,0,1007,16,811,180,21.04.2019 23:50,47,3,Donetsk
400,379,4,82,315,3,318,0,318,2,211,105,22.04.2019 00:15,47,3,Donetsk
976,952,50,359,574,43,617,0,617,6,496,115,22.04.2019 00:40,47,3,Donetsk
560,535,43,191,330,39,369,0,369,4,308,57,22.04.2019 00:15,47,3,Donetsk
624,607,22,282,324,18,342,0,342,7,288,47,21.04.2019 23:10,47,3,Donetsk
464,452,25,166,275,23,298,0,298,4,255,39,21.04.2019 21:26,47,3,Donetsk
1392,1356,42,547,803,42,845,0,845,17,777,51,22.04.2019 01:10,47,3,Donetsk
416,417,46,166,207,43,250,0,250,2,225,23,22.04.2019 00:10,47,3,Donetsk
672,655,19,188,469,15,484,0,484,7,365,112,22.04.2019 00:30,47,3,Donetsk
656,642,57,153,451,52,503,0,503,6,418,79,22.04.2019 00:37,47,3,Donetsk
496,484,21,186,290,20,310,0,310,2,277,31,21.04.2019 22:00,47,3,Donetsk
384,375,7,138,241,5,246,0,246,3,219,24,21.04.2019 23:50,47,3,Donetsk
656,654,42,260,358,38,396,0,396,2,357,37,21.04.2019 21:50,47,3,Donetsk
672,685,56,195,423,54,477,0,477,13,380,84,21.04.2019 22:05,47,3,Donetsk
528,511,44,219,268,41,309,0,309,7,284,18,22.04.2019 01:35,47,3,Donetsk
896,870,63,360,476,60,536,0,536,10,494,32,22.04.2019 00:35,47,3,Donetsk
624,605,56,184,393,47,440,0,440,9,339,92,22.04.2019 00:10,47,3,Donetsk
1008,1004,91,341,588,79,667,0,667,9,616,42,21.04.2019 23:00,47,3,Donetsk
880,857,57,372,456,52,508,0,508,8,464,36,22.04.2019 01:15,47,3,Donetsk
448,429,23,205,221,22,243,0,243,4,224,15,22.04.2019 00:30,47,3,Donetsk
528,524,49,266,215,47,262,0,262,10,232,20,21.04.2019 20:56,47,3,Donetsk
1568,1531,111,673,790,105,895,0,895,16,825,54,22.04.2019 00:20,47,3,Donetsk
992,985,69,457,474,61,535,0,535,14,480,41,22.04.2019 01:00,47,3,Donetsk
672,652,57,280,339,53,392,0,392,7,349,36,22.04.2019 00:30,47,3,Donetsk
528,515,26,168,334,26,360,0,360,11,330,19,22.04.2019 00:30,47,3,Donetsk
1184,1166,71,592,522,70,592,0,592,8,540,44,22.04.2019 00:05,47,3,Donetsk
1632,1613,35,888,712,32,744,0,744,10,656,78,22.04.2019 00:05,47,3,Donetsk
1424,1405,11,626,787,11,798,0,798,14,722,62,22.04.2019 02:40,47,3,Donetsk
1456,1433,21,647,790,19,809,0,809,12,740,57,22.04.2019 01:15,47,3,Donetsk
1216,1197,41,472,709,35,744,0,744,15,651,78,22.04.2019 00:25,47,3,Donetsk
832,831,61,313,458,61,519,0,519,4,407,108,22.04.2019 00:48,47,3,Donetsk
480,466,28,237,218,25,243,0,243,7,214,22,21.04.2019 21:46,47,3,Donetsk
368,361,42,154,174,40,214,0,214,0,193,21,21.04.2019 21:10,47,3,Donetsk
864,838,59,482,332,50,382,0,382,6,354,22,22.04.2019 00:05,47,3,Donetsk
1520,1508,72,743,716,61,777,0,777,15,698,64,22.04.2019 00:02,47,3,Donetsk
1136,1108,44,414,678,44,722,0,722,16,661,45,22.04.2019 00:01,47,3,Donetsk
480,469,20,155,305,20,325,0,325,12,265,48,21.04.2019 22:00,47,3,Donetsk
416,414,28,180,212,24,236,0,236,7,209,20,22.04.2019 00:10,47,3,Donetsk
816,823,33,391,394,31,425,0,425,9,382,34,21.04.2019 21:15,47,3,Donetsk
400,392,32,156,214,30,244,0,244,3,217,24,22.04.2019 00:10,47,3,Donetsk
368,367,20,156,193,19,212,0,212,2,182,28,22.04.2019 02:05,47,3,Donetsk
528,523,24,282,226,20,246,0,246,5,218,23,22.04.2019 05:00,47,3,Donetsk
608,622,24,271,313,24,337,0,337,18,271,48,22.04.2019 00:10,47,3,Donetsk
800,786,33,482,291,27,318,0,318,9,289,20,22.04.2019 00:01,47,3,Donetsk
432,422,15,192,225,15,240,0,240,8,213,19,22.04.2019 00:15,47,3,Donetsk
656,637,38,272,351,33,384,0,384,4,357,23,21.04.2019 20:55,47,3,Donetsk
512,504,25,229,258,25,283,0,283,8,257,18,22.04.2019 00:20,47,3,Donetsk
1056,1040,53,498,508,50,558,0,558,19,502,37,22.04.2019 00:20,47,3,Donetsk
1520,1519,28,816,684,20,704,0,704,14,634,56,22.04.2019 01:15,47,3,Donetsk
1856,1824,23,987,848,21,869,0,869,25,783,61,22.04.2019 00:25,47,3,Donetsk
1632,1643,20,729,885,18,903,0,903,28,782,93,22.04.2019 00:35,47,3,Donetsk
1824,1809,30,854,956,14,970,0,970,21,821,128,22.04.2019 00:15,47,3,Donetsk
1168,1162,13,542,614,12,626,0,626,12,557,57,22.04.2019 00:07,47,3,Donetsk
1968,1968,25,811,1137,20,1157,0,1157,33,988,136,22.04.2019 00:30,47,3,Donetsk
1712,1700,31,744,943,25,968,0,968,28,837,103,22.04.2019 00:01,47,3,Donetsk
1728,1696,34,855,851,22,873,0,873,31,759,83,22.04.2019 00:20,47,3,Donetsk
1664,1636,14,776,882,6,888,0,888,24,782,82,22.04.2019 00:30,47,3,Donetsk
1872,1861,42,845,1003,24,1027,0,1027,36,890,101,22.04.2019 00:10,47,3,Donetsk
1296,1297,54,617,639,40,679,0,679,25,594,60,22.04.2019 00:03,47,3,Donetsk
1664,1663,20,730,918,16,934,0,934,26,806,102,22.04.2019 00:02,47,3,Donetsk
1840,1865,39,742,1073,25,1098,0,1098,33,946,119,22.04.2019 00:17,47,3,Donetsk
2016,2030,26,831,1168,17,1185,0,1185,29,1030,126,22.04.2019 00:08,47,3,Donetsk
1680,1710,17,611,1056,13,1069,0,1069,36,880,153,21.04.2019 23:15,47,3,Donetsk
1232,1260,16,467,757,8,765,0,765,23,645,97,21.04.2019 23:30,47,3,Donetsk
1936,2003,49,709,1189,38,1227,0,1227,34,1050,143,22.04.2019 00:12,47,3,Donetsk
2144,2170,44,891,1219,34,1253,0,1253,28,1077,148,22.04.2019 00:08,47,3,Donetsk
1520,1518,20,727,778,15,793,0,793,15,681,97,22.04.2019 05:00,47,3,Donetsk
1504,1496,20,792,698,14,712,0,712,16,598,98,22.04.2019 00:20,47,3,Donetsk
1888,1868,32,958,910,20,930,0,930,29,829,72,22.04.2019 00:25,47,3,Donetsk
1936,1925,24,828,1094,14,1108,0,1108,27,997,84,21.04.2019 21:40,47,3,Donetsk
1792,1771,18,805,974,13,987,0,987,28,860,99,22.04.2019 00:25,47,3,Donetsk
1760,1766,15,772,979,9,988,0,988,27,863,98,22.04.2019 00:10,47,3,Donetsk
1008,998,9,495,505,8,513,0,513,15,446,52,22.04.2019 00:02,47,3,Donetsk
1392,1399,7,550,835,7,842,0,842,14,727,101,22.04.2019 00:00,47,3,Donetsk
2032,2029,23,782,1235,15,1250,0,1250,26,1090,134,22.04.2019 00:05,47,3,Donetsk
2128,2146,39,828,1271,29,1300,0,1300,32,1133,135,22.04.2019 00:01,47,3,Donetsk
2272,2280,30,923,1327,22,1349,0,1349,28,1183,138,22.04.2019 00:05,47,3,Donetsk
2176,2149,28,935,1220,21,1241,0,1241,33,1078,130,22.04.2019 00:03,47,3,Donetsk
2320,2297,28,1042,1255,23,1278,0,1278,29,1153,96,22.04.2019 00:10,47,3,Donetsk
448,445,7,218,225,5,230,0,230,7,210,13,22.04.2019 00:05,47,3,Donetsk
2080,2081,46,888,1160,32,1192,0,1192,29,1018,145,22.04.2019 00:45,47,3,Donetsk
1840,1825,32,928,884,28,912,0,912,27,775,110,22.04.2019 00:15,47,3,Donetsk
1984,1971,26,840,1123,21,1144,0,1144,32,970,142,22.04.2019 00:10,47,3,Donetsk
1744,1723,26,802,921,21,942,0,942,28,825,89,22.04.2019 00:15,47,3,Donetsk
1360,1340,21,626,717,17,734,0,734,21,635,78,22.04.2019 00:25,47,3,Donetsk
1680,1704,22,593,1067,20,1087,0,1087,26,932,129,22.04.2019 00:02,47,3,Donetsk
1488,1466,49,670,777,41,818,0,818,24,738,56,22.04.2019 00:03,47,3,Donetsk
1584,1567,17,953,615,16,631,0,631,10,571,50,22.04.2019 00:15,47,3,Donetsk
1168,1155,9,557,604,7,611,0,611,15,555,41,22.04.2019 01:08,47,3,Donetsk
1632,1624,94,692,860,80,940,0,940,23,828,89,22.04.2019 00:30,47,3,Donetsk
2128,2096,32,1119,993,16,1009,0,1009,30,906,73,22.04.2019 00:15,47,3,Donetsk
1296,1287,14,565,722,9,731,0,731,15,649,67,22.04.2019 00:15,47,3,Donetsk
1520,1508,15,709,804,7,811,0,811,12,711,88,22.04.2019 00:35,47,3,Donetsk
784,815,46,296,451,37,488,0,488,19,392,77,22.04.2019 00:10,47,3,Donetsk
1184,1167,10,550,626,8,634,0,634,11,576,47,21.04.2019 21:40,47,3,Donetsk
1472,1443,37,830,613,29,642,0,642,7,570,65,22.04.2019 01:00,47,3,Donetsk
1888,1861,33,950,920,18,938,0,938,25,835,78,22.04.2019 01:40,47,3,Donetsk
1968,1940,33,913,1026,29,1055,0,1055,30,937,88,22.04.2019 00:05,47,3,Donetsk
1984,1944,21,1069,902,13,915,0,915,39,812,64,22.04.2019 00:08,47,3,Donetsk
2048,2020,27,988,1039,21,1060,0,1060,24,961,75,22.04.2019 00:05,47,3,Donetsk
1840,1832,19,899,925,16,941,0,941,32,844,65,22.04.2019 00:03,47,3,Donetsk
1904,1864,12,782,1112,10,1122,0,1122,18,999,105,22.04.2019 00:10,47,3,Donetsk
1424,1490,40,575,824,25,849,0,849,63,687,99,22.04.2019 00:14,47,3,Donetsk
1184,1273,37,398,749,37,786,0,786,24,661,101,22.04.2019 00:10,47,3,Donetsk
64,18,5,46,13,5,18,0,18,0,13,5,22.04.2019 00:10,47,3,Donetsk
48,14,0,34,14,0,14,0,14,0,8,6,22.04.2019 00:10,47,3,Donetsk
64,12,0,52,12,0,12,0,12,0,6,6,22.04.2019 00:10,47,3,Donetsk
320,125,20,203,97,20,117,0,117,15,76,26,22.04.2019 00:30,47,3,Donetsk
64,25,6,46,14,4,18,0,18,0,12,6,22.04.2019 00:10,47,3,Donetsk
64,39,0,26,38,0,38,0,38,0,30,8,22.04.2019 00:15,47,3,Donetsk
128,57,44,79,9,40,49,0,49,0,36,13,22.04.2019 00:05,47,3,Donetsk
144,132,14,23,107,14,121,0,121,3,104,14,22.04.2019 01:48,47,3,Donetsk
848,833,0,59,789,0,789,0,789,22,387,380,21.04.2019 23:08,48,3,Donetsk
2128,1923,0,391,1737,0,1737,0,1736,53,735,948,22.04.2019 02:18,48,3,Donetsk
1664,1625,10,613,1041,10,1051,0,1051,27,907,117,21.04.2019 21:30,48,3,Donetsk
1552,1546,6,571,975,6,981,0,981,28,826,127,22.04.2019 00:20,48,3,Donetsk
1680,1678,11,635,1036,9,1045,0,1045,21,908,116,22.04.2019 00:05,48,3,Donetsk
2016,2004,15,702,1304,10,1314,0,1314,41,1121,152,21.04.2019 21:30,48,3,Donetsk
1776,1763,6,684,1088,4,1092,0,1092,25,953,114,21.04.2019 21:50,48,3,Donetsk
1840,1819,9,754,1081,5,1086,0,1086,16,958,112,21.04.2019 21:30,48,3,Donetsk
2240,2225,24,979,1246,15,1261,0,1261,32,1042,187,22.04.2019 01:15,48,3,Donetsk
2240,2220,13,992,1240,8,1248,0,1248,32,1042,174,22.04.2019 00:05,48,3,Donetsk
2016,1998,9,751,1258,7,1265,0,1265,30,1089,146,22.04.2019 00:10,48,3,Donetsk
1824,1800,3,716,1105,3,1108,0,1108,24,961,123,22.04.2019 00:05,48,3,Donetsk
1872,1829,13,813,1049,10,1059,0,1059,29,944,86,22.04.2019 00:05,48,3,Donetsk
2064,2037,14,882,1171,11,1182,0,1182,21,1036,125,21.04.2019 22:48,48,3,Donetsk
1664,1636,19,767,880,17,897,0,897,20,802,75,21.04.2019 22:05,48,3,Donetsk
1984,1962,32,817,1140,27,1167,0,1167,24,1059,84,22.04.2019 00:10,48,3,Donetsk
2176,2128,11,970,1197,9,1206,0,1206,19,1076,111,22.04.2019 00:15,48,3,Donetsk
528,517,21,223,284,21,305,0,305,2,262,41,22.04.2019 00:12,48,3,Donetsk
1728,1708,5,931,794,3,797,0,797,26,689,82,21.04.2019 21:32,48,3,Donetsk
1648,1612,8,845,796,7,803,0,803,15,691,97,21.04.2019 22:30,48,3,Donetsk
1616,1596,11,803,806,7,813,0,813,18,713,82,21.04.2019 20:50,48,3,Donetsk
1264,1256,8,652,605,7,612,0,612,14,560,38,21.04.2019 22:50,48,3,Donetsk
1360,1348,9,575,779,6,785,0,785,24,703,58,21.04.2019 22:02,48,3,Donetsk
2144,2104,37,1078,1039,27,1066,0,1066,17,932,117,21.04.2019 21:30,48,3,Donetsk
1232,1221,5,557,671,4,675,0,675,16,602,57,21.04.2019 21:00,48,3,Donetsk
1408,1387,11,585,814,9,823,0,823,19,746,58,21.04.2019 22:25,48,3,Donetsk
1456,1432,14,708,741,7,748,0,748,19,662,67,21.04.2019 21:40,48,3,Donetsk
2096,2070,18,1023,1062,11,1073,0,1073,18,937,118,21.04.2019 21:55,48,3,Donetsk
1744,1714,16,859,872,13,885,0,885,21,783,81,21.04.2019 21:45,48,3,Donetsk
1904,1907,12,758,1138,8,1146,0,1146,34,995,117,21.04.2019 22:44,48,3,Donetsk
2048,2025,7,938,1103,7,1110,0,1110,31,948,131,21.04.2019 21:50,48,3,Donetsk
1520,1518,18,609,899,12,911,0,911,15,772,124,21.04.2019 21:26,48,3,Donetsk
1456,1460,7,607,844,5,849,0,849,14,718,117,21.04.2019 21:15,48,3,Donetsk
2048,2031,18,917,1117,14,1131,0,1131,28,994,109,22.04.2019 00:04,48,3,Donetsk
1680,1671,9,826,849,5,854,0,854,20,770,64,22.04.2019 00:03,48,3,Donetsk
1504,1484,9,729,770,5,775,0,775,27,681,67,21.04.2019 21:28,48,3,Donetsk
1072,1070,6,518,551,3,554,0,554,11,486,57,22.04.2019 00:05,48,3,Donetsk
1168,1152,13,606,553,9,562,0,562,10,483,69,22.04.2019 00:10,48,3,Donetsk
2048,2033,20,860,1173,15,1188,0,1188,24,1016,148,21.04.2019 22:18,48,3,Donetsk
1664,1643,4,832,831,1,832,0,832,23,731,78,21.04.2019 21:35,48,3,Donetsk
1904,1881,17,923,968,13,981,0,981,20,861,100,22.04.2019 00:20,48,3,Donetsk
1648,1649,17,738,897,13,910,0,910,16,793,101,21.04.2019 22:34,48,3,Donetsk
1872,1843,11,880,985,7,992,0,992,22,849,121,21.04.2019 21:57,48,3,Donetsk
2016,2006,19,832,1167,17,1184,0,1184,24,1014,146,21.04.2019 21:30,48,3,Donetsk
1920,1899,10,832,1084,4,1088,0,1088,25,921,142,22.04.2019 00:05,48,3,Donetsk
1200,1119,12,567,624,9,633,0,633,16,548,69,22.04.2019 00:10,48,3,Donetsk
1136,1123,8,568,560,8,568,0,568,11,488,69,21.04.2019 21:00,48,3,Donetsk
1936,1955,16,781,1145,10,1155,0,1155,28,958,169,21.04.2019 21:50,48,3,Donetsk
1520,1527,8,503,1010,7,1017,0,1017,28,818,171,21.04.2019 22:55,48,3,Donetsk
1616,1630,12,652,956,8,964,0,964,20,829,115,22.04.2019 00:45,48,3,Donetsk
1936,1929,8,769,1160,7,1167,0,1167,36,965,166,21.04.2019 22:30,48,3,Donetsk
1952,1965,18,797,1142,13,1155,0,1155,43,962,150,22.04.2019 00:01,48,3,Donetsk
1776,1786,9,739,1030,7,1037,0,1037,14,885,138,22.04.2019 00:10,48,3,Donetsk
1664,1669,3,745,917,2,919,0,919,18,728,173,22.04.2019 00:04,48,3,Donetsk
1936,1928,7,758,1171,7,1178,0,1178,32,972,174,22.04.2019 00:25,48,3,Donetsk
1808,1814,7,654,1148,6,1154,0,1154,25,968,161,21.04.2019 22:49,48,3,Donetsk
1952,1953,10,716,1229,7,1236,0,1236,21,1038,177,21.04.2019 21:00,48,3,Donetsk
1920,1943,17,640,1268,12,1280,0,1280,33,1069,178,21.04.2019 21:38,48,3,Donetsk
1856,1818,19,639,1202,15,1217,0,1217,33,995,189,21.04.2019 22:15,48,3,Donetsk
2064,2050,18,734,1318,12,1330,0,1330,32,1111,187,22.04.2019 00:30,48,3,Donetsk
2096,2093,20,823,1256,17,1273,0,1273,32,1095,146,22.04.2019 01:40,48,3,Donetsk
2160,2164,13,858,1291,11,1302,0,1302,36,1091,175,22.04.2019 00:04,48,3,Donetsk
1920,1954,6,677,1239,4,1243,0,1243,28,1038,177,21.04.2019 22:00,48,3,Donetsk
2096,2091,10,804,1285,7,1292,0,1292,41,1087,164,21.04.2019 21:15,48,3,Donetsk
1984,1977,7,748,1229,7,1236,0,1236,37,1025,174,22.04.2019 00:20,48,3,Donetsk
2128,2111,13,843,1276,9,1285,0,1285,20,1112,153,22.04.2019 00:10,48,3,Donetsk
1584,1592,13,589,986,9,995,0,995,18,822,155,21.04.2019 21:35,48,3,Donetsk
1920,1907,13,718,1193,9,1202,0,1202,22,1014,166,21.04.2019 21:40,48,3,Donetsk
1776,1781,18,632,1128,16,1144,0,1144,34,927,183,21.04.2019 22:40,48,3,Donetsk
1536,1535,10,590,936,10,946,0,946,24,805,117,21.04.2019 23:00,48,3,Donetsk
1648,1636,11,585,1058,5,1063,0,1063,29,893,141,22.04.2019 01:30,48,3,Donetsk
1344,1340,16,512,827,5,832,0,832,14,689,129,22.04.2019 00:30,48,3,Donetsk
1808,1845,13,652,1148,8,1156,0,1156,29,928,199,21.04.2019 21:30,48,3,Donetsk
1600,1624,13,621,966,13,979,0,979,23,831,125,21.04.2019 21:30,48,3,Donetsk
1504,1507,17,605,887,12,899,0,899,38,705,156,22.04.2019 00:01,48,3,Donetsk
1648,1692,10,634,1008,6,1014,0,1014,26,876,112,21.04.2019 23:10,48,3,Donetsk
1504,1536,15,547,949,8,957,0,957,33,802,122,22.04.2019 00:05,48,3,Donetsk
2032,2047,17,861,1157,14,1171,0,1171,33,962,176,21.04.2019 21:35,48,3,Donetsk
1248,1288,22,473,762,13,775,0,775,24,644,107,21.04.2019 21:12,48,3,Donetsk
1408,1408,4,574,831,3,834,0,834,18,698,118,21.04.2019 20:56,48,3,Donetsk
1488,1524,18,513,959,16,975,0,975,24,770,181,21.04.2019 21:30,48,3,Donetsk
1344,1370,16,448,881,15,896,0,896,37,728,131,21.04.2019 22:20,48,3,Donetsk
1456,1477,12,549,899,8,907,0,907,26,734,147,22.04.2019 00:10,48,3,Donetsk
2000,2033,15,726,1264,10,1274,0,1274,35,1017,222,21.04.2019 22:15,48,3,Donetsk
2000,1959,13,754,1234,12,1246,0,1246,32,988,226,21.04.2019 21:18,48,3,Donetsk
208,121,0,120,88,0,88,0,88,7,73,8,21.04.2019 20:45,48,3,Donetsk
208,111,0,99,109,0,109,0,109,12,84,13,21.04.2019 21:00,48,3,Donetsk
224,52,39,180,13,31,44,0,44,0,36,8,21.04.2019 21:25,48,3,Donetsk
368,35,21,334,14,20,34,0,34,1,26,7,21.04.2019 22:10,48,3,Donetsk
272,34,21,238,13,21,34,0,34,1,28,5,21.04.2019 20:31,48,3,Donetsk
240,36,3,207,30,3,33,0,33,0,29,4,21.04.2019 22:00,48,3,Donetsk
208,18,0,194,14,0,14,0,14,1,9,4,21.04.2019 20:26,48,3,Donetsk
1312,1195,0,322,990,0,990,0,990,27,469,494,21.04.2019 21:10,49,3,Donetsk
144,136,0,15,129,0,129,0,129,0,38,91,21.04.2019 20:30,49,3,Donetsk
447,381,0,70,377,0,377,0,377,5,224,148,21.04.2019 23:15,49,3,Donetsk
304,294,0,35,269,0,269,0,269,10,138,121,21.04.2019 20:35,49,3,Donetsk
688,668,38,211,439,38,477,0,477,25,416,36,22.04.2019 00:05,49,3,Donetsk
384,381,14,175,196,13,209,0,209,2,196,11,22.04.2019 05:45,49,3,Donetsk
432,421,18,162,252,18,270,0,270,5,203,62,22.04.2019 00:05,49,3,Donetsk
320,315,38,121,161,38,199,0,199,6,160,33,22.04.2019 00:05,49,3,Donetsk
592,576,42,249,301,42,343,0,343,6,285,51,21.04.2019 20:30,49,3,Donetsk
1184,1160,109,346,730,108,838,0,838,12,673,153,22.04.2019 00:10,49,3,Donetsk
448,437,55,49,344,55,399,0,399,6,263,130,22.04.2019 00:20,49,3,Donetsk
1440,1425,28,622,793,25,818,0,818,21,745,52,22.04.2019 00:35,49,3,Donetsk
304,239,11,65,228,11,239,0,239,6,210,23,22.04.2019 00:10,49,3,Donetsk
160,156,7,58,95,7,102,0,102,3,65,34,22.04.2019 00:26,49,3,Donetsk
400,386,15,180,206,14,220,0,220,10,193,17,22.04.2019 00:05,49,3,Donetsk
304,297,10,114,180,10,190,0,190,0,156,34,21.04.2019 22:45,49,3,Donetsk
368,358,31,73,264,31,295,0,295,3,248,44,22.04.2019 00:05,49,3,Donetsk
752,726,27,284,442,26,468,0,468,6,401,61,22.04.2019 00:01,49,3,Donetsk
192,181,7,79,106,7,113,0,113,8,94,11,21.04.2019 20:53,49,3,Donetsk
192,179,6,88,98,6,104,0,104,2,89,13,21.04.2019 21:30,49,3,Donetsk
352,335,30,136,186,30,216,0,216,5,197,14,21.04.2019 22:35,49,3,Donetsk
288,278,10,97,181,10,191,0,191,1,164,26,21.04.2019 21:40,49,3,Donetsk
320,303,23,141,156,23,179,0,179,2,153,24,21.04.2019 20:50,49,3,Donetsk
688,676,26,380,282,26,308,0,308,0,253,55,22.04.2019 00:02,49,3,Donetsk
304,290,14,124,166,14,180,0,180,3,143,34,21.04.2019 21:30,49,3,Donetsk
512,505,27,133,352,27,379,0,379,9,337,33,22.04.2019 00:45,49,3,Donetsk
528,509,43,247,238,43,281,0,281,2,259,20,22.04.2019 00:15,49,3,Donetsk
432,426,20,184,228,20,248,0,248,2,199,47,22.04.2019 00:30,49,3,Donetsk
288,281,20,131,137,20,157,0,157,2,120,35,21.04.2019 20:50,49,3,Donetsk
448,435,20,207,223,18,241,0,241,8,215,18,22.04.2019 00:03,49,3,Donetsk
320,313,14,160,146,14,160,0,160,7,135,18,22.04.2019 00:16,49,3,Donetsk
368,363,7,180,181,7,188,0,188,3,156,29,21.04.2019 21:05,49,3,Donetsk
128,121,6,67,55,6,61,0,61,0,44,17,21.04.2019 22:50,49,3,Donetsk
400,394,18,139,243,18,261,0,261,4,239,17,21.04.2019 22:05,49,3,Donetsk
2160,2140,50,958,1152,50,1202,0,1202,23,1090,89,22.04.2019 00:15,49,3,Donetsk
1456,1431,35,609,812,35,847,0,847,23,791,33,22.04.2019 00:15,49,3,Donetsk
1200,1175,37,464,699,37,736,0,736,15,694,27,22.04.2019 01:20,49,3,Donetsk
1648,1625,71,661,925,62,987,0,987,7,918,62,21.04.2019 21:20,49,3,Donetsk
944,922,42,468,435,41,476,0,476,10,417,49,21.04.2019 21:15,49,3,Donetsk
1312,1292,44,664,608,40,648,0,648,22,558,68,21.04.2019 21:44,49,3,Donetsk
448,437,27,177,244,27,271,0,271,3,223,45,21.04.2019 22:04,49,3,Donetsk
1008,987,30,333,647,28,675,0,675,6,511,158,21.04.2019 21:45,49,3,Donetsk
624,606,47,307,270,47,317,0,317,19,266,32,22.04.2019 00:10,49,3,Donetsk
960,949,56,437,467,56,523,0,523,11,475,37,22.04.2019 00:30,49,3,Donetsk
464,454,18,196,254,14,268,0,268,7,231,30,22.04.2019 00:20,49,3,Donetsk
944,921,31,491,423,30,453,0,453,11,408,34,22.04.2019 00:40,49,3,Donetsk
496,484,17,177,302,17,319,0,319,4,276,39,22.04.2019 00:28,49,3,Donetsk
1648,1620,21,777,856,15,871,0,871,16,806,49,22.04.2019 00:05,49,3,Donetsk
2096,2076,22,1084,994,18,1012,0,1012,18,934,60,21.04.2019 21:19,49,3,Donetsk
1472,1459,12,801,661,10,671,0,671,22,600,49,21.04.2019 21:25,49,3,Donetsk
1440,1408,20,783,641,16,657,0,657,15,613,29,21.04.2019 21:10,49,3,Donetsk
2224,2191,21,1155,1056,13,1069,0,1069,25,974,70,21.04.2019 21:40,49,3,Donetsk
2256,2220,26,1069,1170,17,1187,0,1187,27,1067,93,21.04.2019 22:32,49,3,Donetsk
960,936,11,434,516,10,526,0,526,14,479,33,22.04.2019 00:45,49,3,Donetsk
1280,1269,17,550,713,17,730,0,730,16,672,42,22.04.2019 00:10,49,3,Donetsk
1392,1365,13,654,729,9,738,0,738,15,659,64,22.04.2019 00:15,49,3,Donetsk
1280,1270,3,539,738,3,741,0,741,11,690,40,22.04.2019 00:40,49,3,Donetsk
1984,1957,13,977,998,9,1007,0,1007,19,934,54,22.04.2019 00:55,49,3,Donetsk
1648,1641,21,723,910,15,925,0,925,23,837,65,22.04.2019 00:35,49,3,Donetsk
1424,1394,15,592,820,12,832,0,832,18,763,51,22.04.2019 00:50,49,3,Donetsk
2224,2228,22,993,1218,13,1231,0,1231,32,1108,91,21.04.2019 23:55,49,3,Donetsk
2048,2032,15,937,1100,11,1111,0,1111,16,1024,71,22.04.2019 00:17,49,3,Donetsk
2304,2271,15,1074,1220,10,1230,0,1230,24,1113,93,22.04.2019 00:25,49,3,Donetsk
2288,2256,10,1056,1224,8,1232,0,1232,28,1123,81,22.04.2019 01:00,49,3,Donetsk
2272,2246,14,1017,1247,8,1255,0,1255,27,1133,95,21.04.2019 21:44,49,3,Donetsk
2112,2079,11,919,1188,5,1193,0,1193,33,1072,88,21.04.2019 21:25,49,3,Donetsk
1744,1743,8,824,915,5,920,0,920,10,856,54,22.04.2019 00:50,49,3,Donetsk
1568,1560,13,645,913,10,923,0,923,16,842,65,22.04.2019 00:35,49,3,Donetsk
1440,1414,11,618,812,10,822,0,822,26,766,30,21.04.2019 22:30,49,3,Donetsk
1296,1270,90,578,632,86,718,0,718,15,584,119,21.04.2019 23:20,49,3,Donetsk
1312,1292,9,707,598,7,605,0,605,7,562,36,22.04.2019 00:02,49,3,Donetsk
1520,1498,21,779,720,21,741,0,741,20,702,19,22.04.2019 00:01,49,3,Donetsk
1712,1687,28,809,882,21,903,0,903,14,822,67,22.04.2019 00:20,49,3,Donetsk
1280,1252,17,572,694,14,708,0,708,7,644,57,22.04.2019 00:30,49,3,Donetsk
208,113,30,97,82,29,111,0,111,2,85,24,22.04.2019 00:05,49,3,Donetsk
80,61,0,22,58,0,58,0,58,2,21,35,21.04.2019 21:00,49,3,Donetsk
64,48,25,18,23,23,46,0,46,0,31,15,21.04.2019 20:40,49,3,Donetsk
1456,1423,27,673,763,20,783,0,783,21,708,54,22.04.2019 00:15,49,3,Donetsk
1344,1328,17,699,631,14,645,0,645,10,610,25,21.04.2019 20:50,49,3,Donetsk
1904,1878,20,923,973,8,981,0,981,20,909,52,22.04.2019 00:05,49,3,Donetsk
1696,1678,10,823,865,8,873,0,873,29,774,70,22.04.2019 00:01,49,3,Donetsk
1824,1824,20,957,849,18,867,0,867,30,785,52,22.04.2019 00:11,49,3,Donetsk
1856,1830,25,1007,834,15,849,0,849,20,783,46,22.04.2019 01:25,49,3,Donetsk
1632,1612,15,861,761,10,771,0,771,23,709,39,22.04.2019 00:20,49,3,Donetsk
1696,1677,14,937,747,12,759,0,759,15,694,50,22.04.2019 01:00,49,3,Donetsk
1584,1569,15,952,621,11,632,0,632,12,579,41,21.04.2019 22:30,49,3,Donetsk
1664,1634,28,922,724,18,742,0,742,23,677,42,22.04.2019 00:12,49,3,Donetsk
1216,1194,16,641,563,12,575,0,575,20,518,37,22.04.2019 00:15,49,3,Donetsk
1760,1739,17,889,854,17,871,0,871,29,810,32,22.04.2019 00:05,49,3,Donetsk
1952,1926,20,1073,861,18,879,0,879,24,793,62,22.04.2019 00:20,49,3,Donetsk
1680,1657,32,896,765,19,784,0,784,19,719,46,22.04.2019 00:32,49,3,Donetsk
1872,1838,18,949,905,18,923,0,923,33,833,57,22.04.2019 01:30,49,3,Donetsk
1104,1075,14,547,549,8,557,0,557,8,508,41,22.04.2019 00:45,49,3,Donetsk
1392,1385,12,645,739,8,747,0,747,29,651,67,22.04.2019 01:15,49,3,Donetsk
1472,1445,13,636,827,9,836,0,836,22,777,37,22.04.2019 00:15,49,3,Donetsk
1200,1188,6,545,649,6,655,0,655,16,590,49,22.04.2019 00:02,49,3,Donetsk
1296,1275,10,643,646,7,653,0,653,18,587,48,22.04.2019 00:05,49,3,Donetsk
1680,1652,19,596,1065,19,1084,0,1084,17,889,178,22.04.2019 00:25,49,3,Donetsk
1759,1732,17,786,959,14,973,0,973,26,885,62,22.04.2019 00:45,49,3,Donetsk
1680,1681,21,766,903,11,914,0,914,21,844,49,22.04.2019 02:05,49,3,Donetsk
1568,1553,21,732,823,13,836,0,836,19,774,43,22.04.2019 00:30,49,3,Donetsk
1456,1442,37,725,700,31,731,0,731,16,680,35,21.04.2019 22:00,49,3,Donetsk
1552,1556,41,717,805,30,835,0,835,16,761,58,22.04.2019 00:40,49,3,Donetsk
1840,1803,26,959,864,17,881,0,881,26,808,47,22.04.2019 01:00,49,3,Donetsk
1568,1529,19,746,808,14,822,0,822,18,751,53,22.04.2019 00:30,49,3,Donetsk
1136,1141,13,551,576,9,585,0,585,20,518,47,21.04.2019 22:10,49,3,Donetsk
1312,1299,14,639,662,11,673,0,673,19,591,63,22.04.2019 01:20,49,3,Donetsk
1680,1651,22,871,794,15,809,0,809,22,736,51,22.04.2019 00:05,49,3,Donetsk
1616,1585,21,817,784,15,799,0,799,15,741,43,22.04.2019 00:10,49,3,Donetsk
1216,1197,20,628,578,10,588,0,588,11,555,22,22.04.2019 00:15,49,3,Donetsk
1296,1281,12,605,683,8,691,0,691,22,634,35,22.04.2019 00:24,49,3,Donetsk
1456,1436,119,705,642,109,751,0,751,12,687,52,22.04.2019 00:25,49,3,Donetsk
224,67,54,157,13,54,67,0,67,0,59,8,22.04.2019 00:20,49,3,Donetsk
192,90,66,106,24,62,86,0,86,4,74,8,22.04.2019 00:58,49,3,Donetsk
112,101,0,11,101,0,101,0,101,3,51,47,21.04.2019 23:05,50,3,Donetsk
736,700,0,61,675,0,675,0,675,20,387,268,21.04.2019 21:40,50,3,Donetsk
1472,1440,60,524,900,48,948,0,948,17,858,73,22.04.2019 00:05,50,3,Donetsk
432,412,28,169,236,27,263,0,263,3,244,16,21.04.2019 20:50,50,3,Donetsk
400,394,32,106,262,32,294,0,294,2,266,26,22.04.2019 00:05,50,3,Donetsk
1312,1280,85,577,659,76,735,0,735,16,689,30,21.04.2019 23:51,50,3,Donetsk
272,257,46,118,115,39,154,0,154,3,148,3,21.04.2019 21:30,50,3,Donetsk
336,323,18,150,168,18,186,0,186,6,163,17,21.04.2019 23:10,50,3,Donetsk
816,802,53,364,407,45,452,0,452,8,385,59,21.04.2019 21:33,50,3,Donetsk
384,377,19,145,224,15,239,0,239,4,212,23,21.04.2019 22:14,50,3,Donetsk
384,373,15,152,218,14,232,0,232,2,213,17,21.04.2019 21:29,50,3,Donetsk
464,447,52,188,232,44,276,0,276,6,239,31,21.04.2019 21:15,50,3,Donetsk
256,244,18,138,105,13,118,0,118,1,105,12,21.04.2019 22:05,50,3,Donetsk
160,147,17,92,53,15,68,0,68,0,64,4,22.04.2019 00:02,50,3,Donetsk
224,215,27,73,127,24,151,0,151,2,117,32,21.04.2019 20:38,50,3,Donetsk
1072,1060,58,380,639,53,692,0,692,17,605,70,21.04.2019 20:48,50,3,Donetsk
880,857,84,336,466,78,544,0,544,14,489,41,22.04.2019 00:43,50,3,Donetsk
288,288,27,124,143,21,164,0,164,5,151,8,21.04.2019 22:00,50,3,Donetsk
464,443,29,153,282,29,311,0,311,3,270,38,21.04.2019 22:15,50,3,Donetsk
592,576,12,200,381,11,392,0,392,5,361,26,22.04.2019 02:15,50,3,Donetsk
224,208,18,98,109,17,126,0,126,0,121,5,21.04.2019 21:17,50,3,Donetsk
688,669,45,316,335,37,372,0,372,0,328,44,21.04.2019 21:00,50,3,Donetsk
592,575,42,292,271,29,300,0,300,5,240,55,21.04.2019 20:48,50,3,Donetsk
144,135,14,65,66,13,79,0,79,1,73,5,21.04.2019 21:50,50,3,Donetsk
368,350,25,142,205,21,226,0,226,6,200,20,21.04.2019 22:00,50,3,Donetsk
320,304,23,107,193,20,213,0,213,2,205,6,21.04.2019 21:02,50,3,Donetsk
1776,1722,8,1005,765,6,771,0,771,25,689,57,22.04.2019 00:40,50,3,Donetsk
1840,1819,11,785,1046,9,1055,0,1055,18,972,65,22.04.2019 00:45,50,3,Donetsk
1472,1447,9,698,766,8,774,0,774,22,705,47,22.04.2019 01:38,50,3,Donetsk
1952,1931,6,896,1052,4,1056,0,1056,37,965,54,21.04.2019 21:30,50,3,Donetsk
1600,1591,12,696,892,12,904,0,904,18,808,78,22.04.2019 00:20,50,3,Donetsk
1392,1377,13,630,751,11,762,0,762,13,693,56,22.04.2019 05:45,50,3,Donetsk
1808,1765,9,794,1009,5,1014,0,1014,28,931,55,22.04.2019 01:30,50,3,Donetsk
2016,1998,12,607,1399,10,1409,0,1409,21,1017,371,22.04.2019 00:10,50,3,Donetsk
1920,1887,4,822,1095,3,1098,0,1098,20,1006,72,22.04.2019 00:03,50,3,Donetsk
1968,1953,9,818,1146,4,1150,0,1150,28,1027,95,22.04.2019 00:15,50,3,Donetsk
2176,2140,11,1017,1150,9,1159,0,1159,12,1091,56,22.04.2019 00:35,50,3,Donetsk
2112,2097,9,851,1254,7,1261,0,1261,24,1135,102,22.04.2019 00:35,50,3,Donetsk
1920,1900,6,832,1084,4,1088,0,1088,18,1003,67,22.04.2019 00:45,50,3,Donetsk
1584,1556,8,756,822,6,828,0,828,21,755,52,21.04.2019 23:22,50,3,Donetsk
2032,2013,7,875,1150,7,1157,0,1157,29,1037,91,22.04.2019 00:02,50,3,Donetsk
2000,1971,10,911,1080,9,1089,0,1089,23,998,68,22.04.2019 00:15,50,3,Donetsk
2064,2025,15,1006,1043,15,1058,0,1058,19,990,49,22.04.2019 00:11,50,3,Donetsk
1872,1846,7,873,994,5,999,0,999,31,883,85,22.04.2019 04:00,50,3,Donetsk
1680,1655,8,740,934,6,940,0,939,27,852,60,22.04.2019 00:01,50,3,Donetsk
368,92,45,281,46,41,87,0,87,2,84,1,21.04.2019 23:57,50,3,Donetsk
96,34,0,62,34,0,34,0,34,2,30,2,21.04.2019 21:18,50,3,Donetsk
1872,1834,30,691,1156,25,1181,0,1181,25,1074,82,22.04.2019 00:29,50,3,Donetsk
736,720,2,306,429,1,430,0,430,14,383,33,21.04.2019 23:46,50,3,Donetsk
2336,2289,12,976,1349,11,1360,0,1360,21,1223,116,22.04.2019 00:10,50,3,Donetsk
2272,2226,12,882,1380,10,1390,0,1390,32,1265,93,22.04.2019 02:46,50,3,Donetsk
1920,1924,13,704,1204,12,1216,0,1216,33,1064,119,22.04.2019 00:10,50,3,Donetsk
1616,1594,12,642,966,8,974,0,974,26,878,70,22.04.2019 03:30,50,3,Donetsk
1696,1661,7,699,993,4,997,0,997,24,909,64,22.04.2019 00:10,50,3,Donetsk
1536,1559,7,530,1000,6,1006,0,1006,25,897,84,22.04.2019 00:30,50,3,Donetsk
1696,1684,7,595,1096,5,1101,0,1101,21,992,88,22.04.2019 03:35,50,3,Donetsk
2000,1954,8,723,1270,7,1277,0,1277,27,1152,98,22.04.2019 00:15,50,3,Donetsk
1392,1352,6,529,859,4,863,0,863,25,775,63,22.04.2019 00:04,50,3,Donetsk
1984,1954,14,803,1170,11,1181,0,1181,36,1074,71,22.04.2019 00:10,50,3,Donetsk
2064,2026,13,876,1180,8,1188,0,1188,36,1078,74,22.04.2019 00:10,50,3,Donetsk
1760,1722,17,771,972,17,989,0,989,24,899,66,22.04.2019 01:15,50,3,Donetsk
1360,1337,19,527,817,16,833,0,833,13,752,68,21.04.2019 21:50,50,3,Donetsk
1168,1139,8,498,663,7,670,0,670,24,588,58,22.04.2019 02:15,50,3,Donetsk
1184,1156,3,523,658,3,661,0,661,18,578,65,21.04.2019 21:10,50,3,Donetsk
1504,1457,10,710,787,7,794,0,794,15,739,40,22.04.2019 00:55,50,3,Donetsk
1632,1602,237,611,788,233,1021,0,1021,14,952,55,22.04.2019 00:00,50,3,Donetsk
1088,1060,24,435,634,19,653,0,653,22,588,43,22.04.2019 00:10,50,3,Donetsk
1648,1609,19,733,901,14,915,0,915,21,851,43,22.04.2019 00:30,50,3,Donetsk
1584,1553,11,600,976,8,984,0,984,15,902,67,22.04.2019 00:02,50,3,Donetsk
1744,1708,22,715,1013,16,1029,0,1029,16,971,42,22.04.2019 00:20,50,3,Donetsk
1600,1567,11,686,907,7,914,0,914,11,868,35,21.04.2019 22:58,50,3,Donetsk
1488,1455,10,650,828,10,838,0,838,15,777,46,22.04.2019 00:50,50,3,Donetsk
1184,1165,8,515,661,8,669,0,669,11,619,39,22.04.2019 00:10,50,3,Donetsk
1312,1296,22,503,790,19,809,0,809,20,740,49,22.04.2019 00:10,50,3,Donetsk
1856,1832,33,737,1090,29,1119,0,1119,24,1053,42,22.04.2019 00:43,50,3,Donetsk
1968,1913,27,849,1098,21,1119,0,1119,27,1056,36,22.04.2019 00:15,50,3,Donetsk
320,126,33,199,90,31,121,0,121,2,107,12,22.04.2019 01:00,50,3,Donetsk
1536,1521,11,556,972,8,980,0,980,18,922,40,22.04.2019 01:20,50,3,Donetsk
1600,1559,18,640,947,13,960,0,960,25,894,41,21.04.2019 23:06,50,3,Donetsk
1504,1464,13,617,879,8,887,0,887,25,823,39,22.04.2019 00:35,50,3,Donetsk
1856,1831,10,738,1109,9,1118,0,1118,14,1047,57,21.04.2019 22:25,50,3,Donetsk
1408,1392,12,605,793,10,803,0,803,26,734,43,21.04.2019 22:49,50,3,Donetsk
1296,1283,52,595,662,39,701,0,701,14,645,42,21.04.2019 21:45,50,3,Donetsk
736,713,15,271,452,13,465,0,465,10,425,30,21.04.2019 23:17,50,3,Donetsk
1456,1450,7,629,822,5,827,0,827,34,748,45,21.04.2019 22:40,50,3,Donetsk
1312,1291,13,536,763,13,776,0,776,15,712,49,21.04.2019 22:40,50,3,Donetsk
2144,2132,14,990,1143,11,1154,0,1154,21,1050,83,22.04.2019 00:45,50,3,Donetsk
2240,2192,24,1010,1212,18,1230,0,1230,21,1129,80,22.04.2019 00:30,50,3,Donetsk
1280,1272,10,651,622,7,629,0,629,8,592,29,21.04.2019 21:25,50,3,Donetsk
2048,2027,43,787,1220,41,1261,0,1261,29,1162,70,22.04.2019 05:13,50,3,Donetsk
1424,1409,3,773,649,2,651,0,651,18,589,44,22.04.2019 01:00,50,3,Donetsk
2080,2031,16,965,1102,13,1115,0,1115,29,1007,79,21.04.2019 22:20,50,3,Donetsk
1232,1316,5,440,788,4,792,0,792,27,672,93,22.04.2019 00:03,50,3,Donetsk
1360,1368,12,558,791,11,802,0,802,22,709,71,22.04.2019 00:20,50,3,Donetsk
1360,1366,7,541,815,4,819,0,819,20,696,103,22.04.2019 01:01,50,3,Donetsk
2128,2099,14,946,1169,13,1182,0,1182,26,1069,87,22.04.2019 00:20,50,3,Donetsk
2192,2155,20,1149,1030,13,1043,0,1043,18,953,72,22.04.2019 01:05,50,3,Donetsk
1536,1522,14,714,808,14,822,0,822,14,760,48,21.04.2019 22:30,50,3,Donetsk
1312,1385,20,442,853,17,870,0,870,20,742,108,22.04.2019 00:15,50,3,Donetsk
1568,1546,22,634,913,21,934,0,934,21,845,68,21.04.2019 21:11,50,3,Donetsk
2048,2019,26,912,1113,23,1136,0,1136,25,1015,96,21.04.2019 21:56,50,3,Donetsk
2032,2020,16,740,1278,14,1292,0,1292,26,1161,105,21.04.2019 23:20,50,3,Donetsk
1952,1977,13,743,1199,10,1209,0,1209,35,1077,97,21.04.2019 23:45,50,3,Donetsk
1904,1960,20,683,1205,16,1221,0,1221,33,1102,86,22.04.2019 00:10,50,3,Donetsk
2112,2066,16,800,1302,10,1312,0,1312,20,1199,93,21.04.2019 22:10,50,3,Donetsk
1920,1905,20,799,1108,13,1121,0,1121,28,1017,76,21.04.2019 22:05,50,3,Donetsk
1936,1972,9,650,1278,8,1286,0,1286,24,1168,94,22.04.2019 07:16,50,3,Donetsk
720,707,7,299,416,5,421,0,421,16,374,31,22.04.2019 00:05,50,3,Donetsk
336,68,34,277,25,34,59,0,59,0,55,4,21.04.2019 20:10,50,3,Donetsk
80,31,2,52,26,2,28,0,28,0,27,1,21.04.2019 20:45,50,3,Donetsk
48,22,3,26,19,3,22,0,22,0,21,1,21.04.2019 21:15,50,3,Donetsk
496,471,22,274,201,21,222,0,222,8,137,77,21.04.2019 21:25,51,3,Donetsk
2240,2210,64,1951,248,41,289,0,289,1,196,92,21.04.2019 22:30,51,3,Donetsk
624,610,0,63,561,0,561,0,561,22,152,387,22.04.2019 00:21,52,3,Donetsk
256,254,0,5,251,0,251,0,251,40,63,148,22.04.2019 00:10,52,3,Donetsk
224,198,0,29,195,0,195,0,195,3,79,113,21.04.2019 22:10,52,3,Donetsk
1888,1818,50,1143,709,36,745,0,745,23,684,38,22.04.2019 00:10,52,3,Donetsk
1952,1907,46,1156,766,30,796,0,796,39,715,42,21.04.2019 21:00,52,3,Donetsk
1584,1577,62,860,667,57,724,0,724,26,648,50,22.04.2019 00:10,52,3,Donetsk
2160,2102,51,1118,1003,39,1042,0,1042,29,963,50,21.04.2019 23:50,52,3,Donetsk
2048,2016,32,1112,909,27,936,0,936,30,874,32,21.04.2019 23:20,52,3,Donetsk
1952,1915,46,991,920,41,961,0,961,33,887,41,21.04.2019 22:00,52,3,Donetsk
2328,2267,30,1246,1060,22,1082,0,1082,47,982,53,22.04.2019 00:10,52,3,Donetsk
120,53,5,75,40,5,45,0,45,2,41,2,22.04.2019 00:15,52,3,Donetsk
1104,1073,12,609,484,11,495,0,495,20,376,99,22.04.2019 00:00,52,3,Donetsk
1024,1008,11,487,529,8,537,0,537,23,474,40,22.04.2019 00:05,52,3,Donetsk
832,807,5,410,417,5,422,0,422,14,391,17,22.04.2019 00:35,52,3,Donetsk
1296,1266,19,684,600,12,612,0,612,9,559,44,21.04.2019 20:55,52,3,Donetsk
1200,1188,10,674,518,8,526,0,526,21,461,44,21.04.2019 21:10,52,3,Donetsk
1456,1479,80,737,643,76,719,0,719,28,652,39,21.04.2019 22:45,52,3,Donetsk
1632,1615,11,750,872,10,882,0,882,18,804,60,22.04.2019 00:10,52,3,Donetsk
1632,1606,13,817,808,7,815,0,815,29,731,55,22.04.2019 00:05,52,3,Donetsk
1104,1094,18,533,559,12,571,0,571,27,498,46,22.04.2019 00:05,52,3,Donetsk
1072,1046,6,568,498,6,504,0,504,13,468,23,22.04.2019 00:25,52,3,Donetsk
1344,1300,10,766,568,10,578,0,578,17,511,50,21.04.2019 21:29,52,3,Donetsk
1616,1588,17,808,793,15,808,0,808,33,725,50,22.04.2019 00:10,52,3,Donetsk
1264,1258,15,599,650,15,665,0,665,25,543,97,22.04.2019 00:03,52,3,Donetsk
784,761,5,525,256,3,259,0,259,7,236,16,22.04.2019 00:10,52,3,Donetsk
832,829,8,487,338,7,345,0,345,11,323,11,22.04.2019 00:01,52,3,Donetsk
848,827,2,537,310,1,311,0,311,11,277,23,21.04.2019 21:11,52,3,Donetsk
976,965,1,611,364,1,365,0,365,14,310,41,22.04.2019 00:30,52,3,Donetsk
480,452,2,299,180,1,181,0,181,5,158,18,21.04.2019 21:45,52,3,Donetsk
1616,1582,11,899,706,11,717,0,717,24,572,121,21.04.2019 21:20,52,3,Donetsk
1808,1769,29,947,840,21,861,0,861,40,769,52,22.04.2019 00:40,52,3,Donetsk
1680,1659,26,926,731,23,754,0,754,27,674,53,22.04.2019 00:05,52,3,Donetsk
624,597,7,425,194,5,199,0,199,6,183,10,21.04.2019 20:03,52,3,Donetsk
1008,981,15,602,391,15,406,0,406,12,374,20,22.04.2019 00:10,52,3,Donetsk
1120,1093,20,686,414,20,434,0,434,11,394,29,22.04.2019 00:35,52,3,Donetsk
816,785,15,575,231,10,241,0,241,8,204,29,22.04.2019 00:22,52,3,Donetsk
1552,1518,19,996,540,16,556,0,556,17,517,22,22.04.2019 00:05,52,3,Donetsk
896,876,10,590,296,10,306,0,306,7,274,25,21.04.2019 23:00,52,3,Donetsk
1936,1908,29,1028,883,25,908,0,908,26,829,53,22.04.2019 00:05,52,3,Donetsk
1776,1743,20,982,776,18,794,0,794,26,740,28,22.04.2019 00:10,52,3,Donetsk
1184,1163,15,624,547,13,560,0,560,25,487,48,22.04.2019 02:06,52,3,Donetsk
816,800,35,386,395,35,430,0,430,14,389,27,22.04.2019 00:30,52,3,Donetsk
1376,1341,56,509,811,56,867,0,867,26,733,108,21.04.2019 22:30,52,3,Donetsk
1344,1331,9,662,676,6,682,0,682,21,603,58,22.04.2019 01:05,52,3,Donetsk
624,601,22,329,273,22,295,0,295,8,269,18,22.04.2019 00:06,52,3,Donetsk
1312,1292,16,769,533,10,543,0,543,16,493,34,22.04.2019 01:20,52,3,Donetsk
1552,1522,18,862,676,14,690,0,690,29,616,45,22.04.2019 00:18,52,3,Donetsk
640,624,27,308,305,27,332,0,332,14,294,24,21.04.2019 23:10,52,3,Donetsk
672,656,19,377,280,15,295,0,295,6,256,33,22.04.2019 00:14,52,3,Donetsk
464,449,37,205,222,37,259,0,259,3,218,38,22.04.2019 00:20,52,3,Donetsk
432,422,17,202,215,15,230,0,229,6,197,26,21.04.2019 21:50,52,3,Donetsk
1168,1145,51,481,637,50,687,0,687,0,631,56,22.04.2019 00:17,52,3,Donetsk
1040,1024,50,519,480,41,521,0,521,11,466,44,21.04.2019 22:30,52,3,Donetsk
672,656,35,297,340,35,375,0,375,7,340,28,22.04.2019 00:01,52,3,Donetsk
352,68,31,285,36,31,67,0,67,3,53,11,21.04.2019 20:15,52,3,Donetsk
592,544,0,61,531,0,531,0,531,38,475,18,22.04.2019 00:01,52,3,Donetsk
576,432,0,144,432,0,432,0,432,39,380,13,21.04.2019 20:35,57,3,Donetsk
912,903,0,208,704,0,704,0,704,23,521,160,21.04.2019 21:30,57,3,Donetsk
624,607,0,24,600,0,600,0,600,19,262,319,21.04.2019 20:40,57,3,Donetsk
2336,1942,0,1013,1323,0,1323,0,1323,32,754,537,22.04.2019 00:30,57,3,Donetsk
912,897,0,58,854,0,854,0,854,21,521,312,21.04.2019 21:15,57,3,Donetsk
1792,1750,20,757,1016,19,1035,0,1035,15,983,37,22.04.2019 00:20,57,3,Donetsk
1552,1531,11,728,815,9,824,0,824,7,794,23,22.04.2019 00:12,57,3,Donetsk
1424,1382,2,598,824,2,826,0,826,18,754,54,21.04.2019 23:45,57,3,Donetsk
1392,1361,6,628,758,6,764,0,764,8,726,30,22.04.2019 00:10,57,3,Donetsk
624,572,2,350,272,2,274,0,274,1,265,8,21.04.2019 22:10,57,3,Donetsk
1360,1333,4,508,849,3,852,0,852,5,798,49,22.04.2019 00:15,57,3,Donetsk
1600,1584,12,553,1037,10,1047,0,1047,21,954,72,21.04.2019 22:40,57,3,Donetsk
1936,1923,13,750,1175,11,1186,0,1186,17,1084,85,22.04.2019 00:25,57,3,Donetsk
1936,1919,17,711,1213,12,1225,0,1225,14,1125,86,22.04.2019 00:03,57,3,Donetsk
1776,1748,9,736,1031,9,1040,0,1040,17,959,64,21.04.2019 21:40,57,3,Donetsk
1984,1950,10,742,1233,9,1242,0,1242,13,1135,94,21.04.2019 21:43,57,3,Donetsk
1808,1781,15,760,1036,12,1048,0,1048,38,940,70,22.04.2019 00:05,57,3,Donetsk
1808,1791,14,732,1065,11,1076,0,1076,18,1007,51,22.04.2019 00:01,57,3,Donetsk
1296,1263,4,782,510,4,514,0,514,12,483,19,22.04.2019 00:05,57,3,Donetsk
1264,1266,3,671,591,2,593,0,593,20,535,38,21.04.2019 22:01,57,3,Donetsk
1712,1714,13,607,1094,11,1105,0,1105,21,1000,84,21.04.2019 21:35,57,3,Donetsk
1584,1602,9,597,980,7,987,0,987,21,899,67,21.04.2019 23:20,57,3,Donetsk
1824,1827,2,804,1019,1,1020,0,1020,28,945,47,22.04.2019 00:04,57,3,Donetsk
1744,1742,5,822,917,5,922,0,922,26,835,61,21.04.2019 21:30,57,3,Donetsk
1136,1121,6,475,655,6,661,0,661,20,608,33,22.04.2019 00:10,57,3,Donetsk
1280,1253,2,595,683,2,685,0,685,11,625,49,22.04.2019 00:06,57,3,Donetsk
928,907,3,449,477,2,479,0,479,13,441,25,22.04.2019 00:05,57,3,Donetsk
1632,1607,6,835,791,6,797,0,797,14,759,24,21.04.2019 22:00,57,3,Donetsk
928,922,7,488,434,6,440,0,440,6,397,37,22.04.2019 00:10,57,3,Donetsk
944,936,1,444,499,1,500,0,500,15,461,24,21.04.2019 21:08,57,3,Donetsk
1120,1101,1,575,544,1,545,0,545,13,507,25,21.04.2019 21:00,57,3,Donetsk
1664,1629,14,741,909,14,923,0,923,29,829,65,21.04.2019 22:00,57,3,Donetsk
1008,987,3,458,547,3,550,0,550,21,511,18,22.04.2019 01:05,57,3,Donetsk
1280,1262,1,584,695,1,696,0,696,9,670,17,22.04.2019 00:10,57,3,Donetsk
1712,1688,6,842,865,5,870,0,870,30,789,51,21.04.2019 22:20,57,3,Donetsk
2048,2003,4,1109,935,4,939,0,939,22,879,38,21.04.2019 22:30,57,3,Donetsk
624,618,1,287,336,1,337,0,337,6,315,16,21.04.2019 20:50,57,3,Donetsk
1152,1134,1,527,624,1,625,0,625,17,587,21,21.04.2019 22:30,57,3,Donetsk
1168,1152,1,512,655,1,656,0,656,11,622,23,21.04.2019 21:27,57,3,Donetsk
1216,1183,2,517,698,1,699,0,699,13,668,18,21.04.2019 21:15,57,3,Donetsk
848,835,1,311,536,1,537,0,537,12,507,18,21.04.2019 20:53,57,3,Donetsk
1536,1507,5,592,940,4,944,0,944,18,889,37,22.04.2019 00:40,57,3,Donetsk
1424,1403,4,580,840,4,844,0,844,18,776,50,22.04.2019 00:13,57,3,Donetsk
1616,1589,12,715,892,9,901,0,901,27,838,36,22.04.2019 00:30,57,3,Donetsk
1648,1643,4,644,1000,4,1004,0,1004,19,926,59,22.04.2019 00:15,57,3,Donetsk
1344,1313,4,611,729,4,733,0,733,20,674,39,21.04.2019 21:45,57,3,Donetsk
1056,1075,2,479,575,2,577,0,577,13,517,47,22.04.2019 00:12,57,3,Donetsk
1392,1368,3,686,704,2,706,0,706,10,649,47,21.04.2019 21:40,57,3,Donetsk
2048,2015,6,846,1198,4,1202,0,1202,29,1114,59,21.04.2019 21:25,57,3,Donetsk
1216,1192,5,512,702,2,704,0,704,19,641,44,21.04.2019 21:44,57,3,Donetsk
1488,1462,19,647,824,17,841,0,841,20,789,32,22.04.2019 02:10,57,3,Donetsk
2272,2220,15,1013,1244,15,1259,0,1259,18,1204,37,21.04.2019 21:55,57,3,Donetsk
2336,2305,29,1051,1257,28,1285,0,1285,15,1228,42,21.04.2019 23:35,57,3,Donetsk
2160,2122,8,979,1173,8,1181,0,1181,16,1136,29,22.04.2019 00:25,57,3,Donetsk
1184,1172,6,548,630,6,636,0,636,13,602,21,21.04.2019 20:53,57,3,Donetsk
1600,1555,9,724,871,5,876,0,876,16,843,17,22.04.2019 02:10,57,3,Donetsk
384,372,8,179,197,8,205,0,205,3,197,5,21.04.2019 20:45,57,3,Donetsk
80,27,0,53,27,0,27,0,27,0,21,6,21.04.2019 20:33,57,3,Donetsk
480,141,66,342,74,64,138,0,138,9,122,7,21.04.2019 21:10,57,3,Donetsk
144,30,1,116,27,1,28,0,28,0,28,0,21.04.2019 21:00,57,3,Donetsk
96,71,0,25,71,0,71,0,71,2,67,2,22.04.2019 00:10,57,3,Donetsk
576,569,1,265,310,1,311,0,311,3,283,25,22.04.2019 01:15,57,3,Donetsk
1504,1473,30,627,849,28,877,0,877,18,785,74,22.04.2019 00:10,57,3,Donetsk
1584,1564,7,660,920,4,924,0,924,23,833,68,22.04.2019 00:10,57,3,Donetsk
2048,2010,21,799,1230,19,1249,0,1249,33,1142,74,22.04.2019 00:07,57,3,Donetsk
1808,1776,21,707,1084,17,1101,0,1101,24,990,87,22.04.2019 00:10,57,3,Donetsk
1088,1061,15,478,597,13,610,0,610,13,549,48,21.04.2019 22:50,57,3,Donetsk
1024,1008,5,414,609,1,610,0,610,17,554,39,22.04.2019 00:12,57,3,Donetsk
1504,1468,12,546,950,8,958,0,958,22,863,73,22.04.2019 00:10,57,3,Donetsk
1440,1434,16,573,857,10,867,0,867,16,780,71,21.04.2019 21:45,57,3,Donetsk
1568,1548,12,666,895,7,902,0,902,31,812,59,22.04.2019 00:05,57,3,Donetsk
1664,1642,11,710,947,7,954,0,954,21,856,77,22.04.2019 00:20,57,3,Donetsk
1712,1681,35,633,1053,26,1079,0,1079,10,990,79,21.04.2019 21:00,57,3,Donetsk
1760,1718,20,714,1029,17,1046,0,1046,23,939,84,21.04.2019 20:56,57,3,Donetsk
1872,1837,4,1155,714,3,717,0,717,8,667,42,22.04.2019 00:20,57,3,Donetsk
1824,1784,12,794,1023,7,1030,0,1030,22,936,72,22.04.2019 00:15,57,3,Donetsk
1056,1036,11,426,624,6,630,0,630,12,582,36,22.04.2019 00:05,57,3,Donetsk
1280,1256,10,506,767,7,774,0,774,19,703,52,22.04.2019 00:30,57,3,Donetsk
1200,1192,17,450,738,12,750,0,750,25,656,69,22.04.2019 00:01,57,3,Donetsk
1120,1099,14,454,656,10,666,0,666,17,608,41,22.04.2019 00:35,57,3,Donetsk
1264,1248,10,509,750,5,755,0,755,12,681,62,22.04.2019 04:10,57,3,Donetsk
1152,1124,10,470,674,8,682,0,682,14,612,56,22.04.2019 00:02,57,3,Donetsk
1664,1632,8,883,774,7,781,0,781,11,728,42,21.04.2019 21:59,57,3,Donetsk
1344,1329,10,590,747,7,754,0,754,17,691,46,22.04.2019 01:00,57,3,Donetsk
1360,1337,13,535,814,11,825,0,825,17,751,57,21.04.2019 21:36,57,3,Donetsk
1392,1365,13,543,841,8,849,0,849,11,793,45,22.04.2019 00:05,57,3,Donetsk
1744,1718,20,701,1029,14,1043,0,1043,21,965,57,21.04.2019 23:40,57,3,Donetsk
1712,1694,10,681,1023,8,1031,0,1031,22,935,74,22.04.2019 00:35,57,3,Donetsk
1456,1449,15,681,763,12,775,0,775,22,705,48,21.04.2019 21:15,57,3,Donetsk
1552,1535,13,605,937,10,947,0,947,25,847,75,22.04.2019 00:27,57,3,Donetsk
1776,1747,18,805,957,14,971,0,971,14,898,59,21.04.2019 22:00,57,3,Donetsk
1648,1651,7,745,898,5,903,0,903,20,832,51,21.04.2019 23:00,57,3,Donetsk
2112,2080,21,894,1206,12,1218,0,1218,31,1090,97,21.04.2019 22:10,57,3,Donetsk
1808,1776,12,687,1114,7,1121,0,1121,24,1022,75,22.04.2019 00:15,57,3,Donetsk
1840,1784,20,745,1078,17,1095,0,1095,17,1003,75,21.04.2019 22:20,57,3,Donetsk
1072,1056,105,419,550,103,653,0,653,16,597,40,22.04.2019 00:10,57,3,Donetsk
1200,1165,4,495,701,4,705,0,705,15,640,50,22.04.2019 00:07,57,3,Donetsk
1312,1286,11,538,765,9,774,0,774,23,697,54,22.04.2019 00:05,57,3,Donetsk
1664,1623,4,747,914,3,917,0,917,20,839,58,21.04.2019 21:40,57,3,Donetsk
1856,1825,13,802,1046,8,1054,0,1054,26,957,71,21.04.2019 21:50,57,3,Donetsk
1952,1914,10,824,1119,9,1128,0,1128,24,1039,65,22.04.2019 00:05,57,3,Donetsk
1712,1685,20,708,986,18,1004,0,1004,20,912,72,22.04.2019 00:12,57,3,Donetsk
1616,1579,9,614,994,8,1002,0,1002,18,935,49,22.04.2019 00:20,57,3,Donetsk
1520,1485,6,595,924,1,925,0,925,15,862,48,22.04.2019 00:10,57,3,Donetsk
2048,2005,10,895,1148,5,1153,0,1153,32,1050,71,21.04.2019 21:30,57,3,Donetsk
1168,1148,8,439,723,6,729,0,729,14,677,38,22.04.2019 00:02,57,3,Donetsk
1488,1446,10,611,870,7,877,0,877,16,810,51,22.04.2019 00:10,57,3,Donetsk
2192,2149,6,933,1253,6,1259,0,1259,29,1170,60,21.04.2019 23:38,57,3,Donetsk
2432,2380,14,1031,1394,7,1401,0,1401,31,1299,71,21.04.2019 21:45,57,3,Donetsk
1440,1409,7,618,817,5,822,0,822,19,745,58,21.04.2019 21:40,57,3,Donetsk
2176,2129,3,932,1242,2,1244,0,1244,26,1142,76,21.04.2019 21:35,57,3,Donetsk
1472,1436,17,579,876,17,893,0,893,21,812,60,22.04.2019 00:02,57,3,Donetsk
2176,2119,8,913,1258,5,1263,0,1263,26,1172,65,22.04.2019 00:10,57,3,Donetsk
304,118,118,197,0,107,107,0,107,1,96,10,22.04.2019 00:05,57,3,Donetsk
144,60,8,85,51,8,59,0,59,1,54,4,21.04.2019 20:42,57,3,Donetsk
304,126,5,211,89,4,93,0,93,0,85,8,22.04.2019 00:10,57,3,Donetsk
448,177,128,274,49,125,174,0,174,10,145,19,22.04.2019 00:07,57,3,Donetsk
1072,1048,7,515,552,5,557,0,557,16,519,22,22.04.2019 00:02,58,3,Donetsk
1200,1180,5,632,564,4,568,0,568,8,552,8,21.04.2019 23:22,58,3,Donetsk
1488,1459,10,582,899,7,906,0,906,15,819,72,21.04.2019 23:29,58,3,Donetsk
1472,1462,5,545,922,5,927,0,927,19,861,47,22.04.2019 00:15,58,3,Donetsk
1184,1173,3,565,619,0,619,0,619,11,576,32,21.04.2019 23:00,58,3,Donetsk
1920,1917,11,689,1221,10,1231,0,1231,19,1130,82,22.04.2019 00:15,58,3,Donetsk
1936,1894,7,901,1030,5,1035,0,1035,29,928,78,21.04.2019 21:00,58,3,Donetsk
1232,1214,9,431,793,8,801,0,801,16,736,49,22.04.2019 00:20,58,3,Donetsk
2064,2028,5,753,1306,5,1311,0,1311,29,1164,118,22.04.2019 00:10,58,3,Donetsk
2256,2273,3,1100,1154,2,1156,0,1156,16,1040,100,21.04.2019 22:50,58,3,Donetsk
1104,1103,2,439,663,2,665,0,665,20,583,62,22.04.2019 00:45,58,3,Donetsk
1088,1071,6,440,643,5,648,0,648,19,524,105,21.04.2019 23:55,58,3,Donetsk
2144,2213,8,770,1368,6,1374,0,1374,48,1174,152,21.04.2019 23:30,58,3,Donetsk
1632,1591,8,763,862,7,869,0,869,14,764,91,21.04.2019 21:00,58,3,Donetsk
688,682,1,295,393,0,393,0,393,8,331,54,22.04.2019 00:15,58,3,Donetsk
1968,1982,14,821,1139,8,1147,0,1147,25,1015,107,21.04.2019 21:30,58,3,Donetsk
1264,1279,6,519,739,6,745,0,745,20,623,102,21.04.2019 21:15,58,3,Donetsk
1776,1792,8,670,1099,7,1106,0,1106,33,925,148,21.04.2019 22:20,58,3,Donetsk
1472,1462,6,586,881,5,886,0,886,31,786,69,21.04.2019 21:35,58,3,Donetsk
1776,1549,11,864,902,10,912,0,912,22,799,91,21.04.2019 22:25,58,3,Donetsk
1248,1257,7,457,786,5,791,0,791,18,688,85,22.04.2019 00:15,58,3,Donetsk
1712,1682,7,658,1047,7,1054,0,1054,22,927,105,21.04.2019 21:45,58,3,Donetsk
2048,2039,7,847,1196,5,1201,0,1201,26,1079,96,22.04.2019 00:42,58,3,Donetsk
1472,1455,5,596,873,3,876,0,876,27,780,69,21.04.2019 21:03,58,3,Donetsk
1168,1152,4,433,731,4,735,0,735,16,669,50,21.04.2019 22:00,58,3,Donetsk
1968,1995,4,581,1383,4,1387,0,1387,29,1243,115,22.04.2019 00:15,58,3,Donetsk
2144,2119,5,849,1291,4,1295,0,1295,29,1150,116,22.04.2019 00:05,58,3,Donetsk
1856,1846,9,668,1180,8,1188,0,1188,35,1062,91,22.04.2019 00:05,58,3,Donetsk
1856,1852,13,751,1093,12,1105,0,1105,22,977,106,22.04.2019 00:16,58,3,Donetsk
1888,1869,11,762,1116,10,1126,0,1126,26,1012,88,22.04.2019 01:10,58,3,Donetsk
1952,1924,4,733,1216,3,1219,0,1219,21,1093,105,22.04.2019 00:01,58,3,Donetsk
992,968,2,403,587,2,589,0,589,22,512,55,21.04.2019 22:20,58,3,Donetsk
2224,2192,8,861,1356,7,1363,0,1363,28,1221,114,22.04.2019 01:15,58,3,Donetsk
2048,2061,9,804,1236,8,1244,0,1244,25,1108,111,22.04.2019 00:25,58,3,Donetsk
2032,2011,11,801,1223,8,1231,0,1231,13,1128,90,22.04.2019 00:15,58,3,Donetsk
2032,2002,11,788,1233,11,1244,0,1244,24,1125,95,22.04.2019 00:10,58,3,Donetsk
2032,2032,14,730,1291,11,1302,0,1302,27,1158,117,21.04.2019 22:20,58,3,Donetsk
2000,1973,18,763,1225,12,1237,0,1237,29,1107,101,22.04.2019 00:25,58,3,Donetsk
960,939,4,356,601,3,604,0,604,9,548,47,22.04.2019 00:07,58,3,Donetsk
1936,1905,11,685,1243,8,1251,0,1251,29,1133,89,22.04.2019 00:31,58,3,Donetsk
1568,1562,9,601,959,8,967,0,967,23,873,71,21.04.2019 23:10,58,3,Donetsk
2064,2044,12,731,1323,10,1333,0,1333,26,1198,109,22.04.2019 00:10,58,3,Donetsk
2112,2100,13,869,1233,10,1243,0,1243,36,1130,77,21.04.2019 21:46,58,3,Donetsk
2176,2193,15,829,1336,11,1347,0,1347,24,1213,110,22.04.2019 00:05,58,3,Donetsk
1200,1176,7,541,653,6,659,0,659,7,614,38,22.04.2019 03:35,58,3,Donetsk
1760,1754,9,627,1127,6,1133,0,1133,22,1017,94,22.04.2019 00:33,58,3,Donetsk
2016,1987,8,679,1329,8,1337,0,1337,33,1218,86,22.04.2019 02:15,58,3,Donetsk
1952,1930,4,774,1174,4,1178,0,1178,22,1070,86,22.04.2019 00:01,58,3,Donetsk
1824,1797,7,688,1131,5,1136,0,1136,23,1029,84,21.04.2019 23:05,58,3,Donetsk
1808,1817,5,678,1125,5,1130,0,1130,21,1026,83,22.04.2019 00:05,58,3,Donetsk
1888,1851,8,695,1185,8,1193,0,1193,11,1102,80,22.04.2019 00:15,58,3,Donetsk
2064,2044,8,840,1218,6,1224,0,1224,27,1112,85,22.04.2019 00:03,58,3,Donetsk
1472,1442,6,585,881,6,887,0,887,13,792,82,21.04.2019 21:25,58,3,Donetsk
1968,1953,6,734,1229,5,1234,0,1234,26,1116,92,22.04.2019 00:20,58,3,Donetsk
2176,2173,5,798,1375,3,1378,0,1378,40,1249,89,22.04.2019 00:20,58,3,Donetsk
2240,2198,8,879,1355,6,1361,0,1361,26,1236,99,21.04.2019 22:05,58,3,Donetsk
2080,2035,6,841,1235,4,1239,0,1239,30,1116,93,22.04.2019 05:17,58,3,Donetsk
1840,1817,9,730,1103,7,1110,0,1110,20,1039,51,21.04.2019 21:50,58,3,Donetsk
2080,2073,5,743,1333,4,1337,0,1337,31,1225,81,22.04.2019 00:20,58,3,Donetsk
2112,2080,3,717,1392,3,1395,0,1395,29,1278,88,22.04.2019 00:30,58,3,Donetsk
1408,1381,3,579,827,2,829,0,829,20,763,46,22.04.2019 00:15,58,3,Donetsk
1248,1216,2,559,689,0,689,0,689,12,645,32,22.04.2019 00:20,58,3,Donetsk
2080,2053,21,930,1138,12,1150,0,1150,22,1036,92,21.04.2019 22:00,58,3,Donetsk
1296,1272,3,608,686,2,688,0,688,7,642,39,21.04.2019 21:25,58,3,Donetsk
1360,1328,8,631,723,6,729,0,729,8,675,46,21.04.2019 22:45,58,3,Donetsk
1984,1955,0,840,1144,0,1144,0,1144,23,1066,55,22.04.2019 00:05,58,3,Donetsk
224,144,14,126,85,13,98,0,98,3,87,8,21.04.2019 21:00,58,3,Donetsk
80,16,8,64,8,8,16,0,16,0,14,2,21.04.2019 22:10,58,3,Donetsk
576,32,14,545,17,14,31,0,31,1,27,3,21.04.2019 20:46,58,3,Donetsk
208,90,10,131,69,8,77,0,77,0,70,7,21.04.2019 20:50,58,3,Donetsk
1680,1658,12,762,907,11,918,0,918,19,824,75,21.04.2019 21:48,58,3,Donetsk
944,932,1,371,572,1,573,0,573,9,503,61,21.04.2019 20:48,58,3,Donetsk
1424,1415,19,543,868,13,881,0,881,13,788,80,21.04.2019 22:33,58,3,Donetsk
1712,1717,7,739,968,5,973,0,973,34,845,94,21.04.2019 21:50,58,3,Donetsk
1776,1765,16,729,1033,14,1047,0,1047,26,907,114,21.04.2019 21:00,58,3,Donetsk
1584,1591,13,629,945,10,955,0,955,20,861,74,22.04.2019 00:10,58,3,Donetsk
1280,1303,7,539,737,4,741,0,741,29,653,59,22.04.2019 00:15,58,3,Donetsk
1856,1857,17,792,1050,14,1064,0,1064,38,954,72,21.04.2019 23:24,58,3,Donetsk
1552,1528,22,578,957,17,974,0,974,26,868,80,22.04.2019 00:15,58,3,Donetsk
1584,1618,16,620,949,15,964,0,964,36,824,104,22.04.2019 00:10,58,3,Donetsk
1568,1593,15,646,913,9,922,0,922,35,802,85,21.04.2019 22:36,58,3,Donetsk
1648,1616,11,761,880,7,887,0,887,10,784,93,22.04.2019 00:10,58,3,Donetsk
1376,1351,10,592,777,7,784,0,784,9,715,60,22.04.2019 00:15,58,3,Donetsk
1952,1931,4,762,1186,4,1190,0,1190,23,1079,88,21.04.2019 22:00,58,3,Donetsk
2016,2000,14,778,1231,7,1238,0,1238,21,1125,92,21.04.2019 22:30,58,3,Donetsk
1280,1231,26,582,677,21,698,0,698,18,626,54,21.04.2019 22:35,58,3,Donetsk
2176,2114,12,879,1287,10,1297,0,1297,29,1141,127,21.04.2019 21:30,58,3,Donetsk
2096,2069,8,805,1284,7,1291,0,1291,28,1141,122,21.04.2019 22:30,58,3,Donetsk
1472,1243,7,767,699,6,705,0,705,17,614,74,21.04.2019 21:45,58,3,Donetsk
1712,1671,4,758,951,3,954,0,954,24,862,68,21.04.2019 22:50,58,3,Donetsk
1520,1497,9,685,828,7,835,0,835,17,750,68,22.04.2019 00:36,58,3,Donetsk
1680,1681,22,763,901,16,917,0,917,10,798,109,21.04.2019 22:30,58,3,Donetsk
1200,1185,2,577,621,2,623,0,623,17,571,35,22.04.2019 00:07,58,3,Donetsk
1920,1877,103,709,1125,86,1211,0,1211,28,1072,111,22.04.2019 00:15,58,3,Donetsk
1760,1723,7,845,911,4,915,0,915,13,852,50,21.04.2019 21:01,58,3,Donetsk
1792,1763,6,903,884,5,889,0,889,28,785,76,22.04.2019 01:10,58,3,Donetsk
128,30,0,101,27,0,27,0,27,0,15,12,22.04.2019 00:20,58,3,Donetsk
288,134,41,172,78,38,116,0,116,1,103,12,22.04.2019 00:25,58,3,Donetsk
192,137,0,64,128,0,128,0,128,7,87,34,21.04.2019 21:10,59,3,Donetsk
176,167,0,9,167,0,167,0,167,1,44,122,22.04.2019 00:30,59,3,Donetsk
304,260,0,50,254,0,254,0,254,21,33,200,21.04.2019 20:47,59,3,Donetsk
192,163,0,29,163,0,163,0,163,1,31,131,21.04.2019 21:30,59,3,Donetsk
240,228,0,14,226,0,226,0,226,10,25,191,21.04.2019 22:30,59,3,Donetsk
272,266,0,7,265,0,265,0,265,5,15,245,21.04.2019 23:30,59,3,Donetsk
96,83,0,13,83,0,83,0,83,0,23,60,21.04.2019 22:30,59,3,Donetsk
400,325,0,87,313,0,313,0,313,6,126,181,21.04.2019 23:06,59,3,Donetsk
880,875,0,12,868,0,868,0,868,101,363,404,21.04.2019 21:21,59,3,Donetsk
368,346,0,30,338,0,338,0,338,22,82,234,21.04.2019 22:30,59,3,Donetsk
320,294,0,27,293,0,293,0,293,10,135,148,22.04.2019 01:00,59,3,Donetsk
272,251,0,22,250,0,250,0,250,23,92,135,22.04.2019 02:04,59,3,Donetsk
400,380,0,26,374,0,374,0,374,14,125,235,22.04.2019 01:05,59,3,Donetsk
112,100,0,12,100,0,100,0,100,4,37,59,21.04.2019 20:50,59,3,Donetsk
624,604,0,20,604,0,604,0,604,17,280,307,21.04.2019 21:25,59,3,Donetsk
880,868,31,421,432,27,459,0,459,13,386,60,21.04.2019 20:55,59,3,Donetsk
1456,1417,52,652,761,43,804,0,804,26,714,64,21.04.2019 21:07,59,3,Donetsk
896,879,43,333,520,43,563,0,563,17,460,86,22.04.2019 00:45,59,3,Donetsk
480,477,84,155,244,81,325,0,325,4,257,64,22.04.2019 00:01,59,3,Donetsk
896,875,56,428,431,37,468,0,468,9,430,29,21.04.2019 21:35,59,3,Donetsk
1120,1117,97,397,626,97,723,0,723,27,633,63,21.04.2019 21:00,59,3,Donetsk
656,650,47,162,450,44,494,0,494,12,400,82,21.04.2019 20:38,59,3,Donetsk
336,328,47,111,185,40,225,0,225,10,199,16,21.04.2019 21:00,59,3,Donetsk
512,511,51,164,304,44,348,0,348,3,280,65,22.04.2019 00:20,59,3,Donetsk
496,489,39,121,336,39,375,0,375,5,293,77,22.04.2019 00:45,59,3,Donetsk
1312,1299,117,602,606,104,710,0,710,27,633,50,21.04.2019 23:00,59,3,Donetsk
576,560,54,251,273,52,325,0,325,5,267,53,21.04.2019 21:00,59,3,Donetsk
768,763,34,298,436,34,470,0,470,7,432,31,21.04.2019 20:55,59,3,Donetsk
576,561,22,208,347,21,368,0,368,7,318,43,21.04.2019 20:46,59,3,Donetsk
1504,1478,58,678,773,53,826,0,826,30,709,87,22.04.2019 07:15,59,3,Donetsk
1008,994,57,513,438,57,495,0,495,7,427,61,22.04.2019 00:10,59,3,Donetsk
384,376,17,136,231,17,248,0,248,3,203,42,22.04.2019 00:20,59,3,Donetsk
448,441,28,137,283,28,311,0,311,4,276,31,21.04.2019 21:35,59,3,Donetsk
560,556,47,129,384,47,431,0,431,5,389,37,22.04.2019 00:15,59,3,Donetsk
464,462,18,155,293,16,309,0,309,5,297,7,21.04.2019 21:17,59,3,Donetsk
400,397,12,145,245,10,255,0,255,6,221,28,21.04.2019 22:00,59,3,Donetsk
752,738,22,210,520,22,542,0,542,8,445,89,22.04.2019 00:05,59,3,Donetsk
208,203,8,53,147,8,155,0,155,2,116,37,21.04.2019 20:20,59,3,Donetsk
288,284,19,136,136,16,152,0,152,0,124,28,21.04.2019 20:40,59,3,Donetsk
656,645,50,246,360,50,410,0,410,13,359,38,22.04.2019 00:20,59,3,Donetsk
464,457,23,148,293,23,316,0,316,6,263,47,22.04.2019 07:20,59,3,Donetsk
1248,1229,39,593,621,34,655,0,655,17,521,117,21.04.2019 21:50,59,3,Donetsk
1088,1074,33,482,574,32,606,0,606,12,530,64,22.04.2019 00:10,59,3,Donetsk
400,393,13,161,229,10,239,0,239,1,190,48,21.04.2019 21:35,59,3,Donetsk
208,202,12,58,138,12,150,0,150,3,115,32,22.04.2019 00:05,59,3,Donetsk
752,731,40,339,378,35,413,0,413,11,376,26,21.04.2019 22:40,59,3,Donetsk
272,262,17,61,194,17,211,0,211,3,170,38,21.04.2019 22:15,59,3,Donetsk
288,273,15,79,196,13,209,0,209,3,159,47,21.04.2019 22:05,59,3,Donetsk
400,385,19,90,291,19,310,0,310,9,254,47,21.04.2019 20:40,59,3,Donetsk
896,885,41,262,597,37,634,0,634,9,478,147,22.04.2019 00:30,59,3,Donetsk
1552,1532,48,807,697,48,745,0,745,35,533,177,21.04.2019 21:12,59,3,Donetsk
1168,1144,4,691,473,4,477,0,477,5,223,249,21.04.2019 21:50,59,3,Donetsk
1392,1328,35,684,685,23,708,0,708,16,418,274,21.04.2019 21:25,59,3,Donetsk
1120,1075,25,557,538,25,563,0,563,0,384,179,21.04.2019 21:20,59,3,Donetsk
1280,1222,9,730,546,4,550,0,550,7,260,283,21.04.2019 20:55,59,3,Donetsk
1104,1064,34,360,722,22,744,0,744,7,230,507,21.04.2019 21:15,59,3,Donetsk
1408,1348,39,813,576,19,595,0,595,25,386,184,21.04.2019 21:57,59,3,Donetsk
1424,1353,23,680,722,22,744,0,744,21,259,464,21.04.2019 21:25,59,3,Donetsk
1536,1477,20,795,735,6,741,0,741,25,258,458,21.04.2019 21:20,59,3,Donetsk
992,947,18,621,360,11,371,0,371,9,236,126,21.04.2019 21:25,59,3,Donetsk
976,953,27,588,362,26,388,0,388,8,219,161,22.04.2019 05:20,59,3,Donetsk
1568,1557,10,680,878,10,888,0,888,29,809,50,22.04.2019 00:40,59,3,Donetsk
1952,1937,22,828,1111,13,1124,0,1124,37,1009,78,21.04.2019 21:35,59,3,Donetsk
1792,1788,21,828,946,18,964,0,964,26,866,72,22.04.2019 00:35,59,3,Donetsk
1568,1591,8,626,938,4,942,0,942,23,824,95,21.04.2019 21:10,59,3,Donetsk
1392,1374,14,725,654,13,667,0,667,17,598,52,21.04.2019 21:50,59,3,Donetsk
1664,1648,14,771,881,12,893,0,893,32,803,58,21.04.2019 21:43,59,3,Donetsk
1600,1561,17,784,801,15,816,0,816,31,704,81,21.04.2019 22:50,59,3,Donetsk
624,611,20,380,227,17,244,0,244,5,223,16,21.04.2019 21:05,59,3,Donetsk
880,867,19,484,378,18,396,0,396,4,361,31,21.04.2019 21:26,59,3,Donetsk
480,465,15,273,193,14,207,0,207,3,190,14,21.04.2019 21:34,59,3,Donetsk
288,282,7,94,187,7,194,0,194,4,124,66,21.04.2019 20:35,59,3,Donetsk
1072,1057,37,537,499,36,535,0,535,13,482,40,21.04.2019 21:00,59,3,Donetsk
1152,1151,32,491,631,30,661,0,661,21,424,216,21.04.2019 21:45,59,3,Donetsk
1280,1277,73,653,571,56,627,0,627,21,570,36,21.04.2019 21:40,59,3,Donetsk
400,384,13,224,166,10,176,0,176,10,141,25,21.04.2019 21:05,59,3,Donetsk
288,286,12,32,245,11,256,0,256,0,174,82,21.04.2019 20:30,59,3,Donetsk
288,286,11,62,219,7,226,0,226,6,141,79,21.04.2019 22:01,59,3,Donetsk
1424,1402,48,690,700,34,734,0,734,36,624,74,21.04.2019 21:45,59,3,Donetsk
1024,997,20,546,458,20,478,0,478,15,383,80,22.04.2019 05:22,59,3,Donetsk
864,851,43,367,454,43,497,0,497,10,418,69,22.04.2019 03:42,59,3,Donetsk
1584,1567,48,800,741,43,784,0,784,27,670,87,21.04.2019 21:42,59,3,Donetsk
816,790,29,443,351,22,373,0,373,27,304,42,21.04.2019 21:30,59,3,Donetsk
976,959,18,470,493,13,506,0,506,12,469,25,21.04.2019 23:55,59,3,Donetsk
1088,1069,24,481,583,24,607,0,607,5,519,83,21.04.2019 21:25,59,3,Donetsk
480,468,14,154,315,11,326,0,326,4,267,55,21.04.2019 22:10,59,3,Donetsk
480,465,5,142,335,3,338,0,338,8,250,80,21.04.2019 20:55,59,3,Donetsk
1728,1709,40,741,950,37,987,0,987,28,870,89,21.04.2019 21:28,59,3,Donetsk
1024,1008,20,455,549,20,569,0,569,31,434,104,21.04.2019 22:15,59,3,Donetsk
352,344,6,140,206,6,212,0,212,8,154,50,21.04.2019 21:02,59,3,Donetsk
240,240,17,84,139,17,156,0,156,5,133,18,21.04.2019 20:40,59,3,Donetsk
672,665,32,256,388,28,416,0,416,6,309,101,21.04.2019 21:50,59,3,Donetsk
160,30,0,131,29,0,29,0,29,0,23,6,22.04.2019 00:15,59,3,Donetsk
144,101,34,58,52,34,86,0,86,1,75,10,21.04.2019 20:15,59,3,Donetsk
2272,2259,45,993,1248,31,1279,0,1279,37,1151,91,22.04.2019 00:05,59,3,Donetsk
1648,1647,18,671,962,15,977,0,977,20,884,73,22.04.2019 00:05,59,3,Donetsk
1664,1689,9,665,991,8,999,0,999,23,907,69,21.04.2019 21:30,59,3,Donetsk
1680,1697,29,632,1026,22,1048,0,1048,23,938,87,22.04.2019 00:15,59,3,Donetsk
1696,1683,28,660,1012,24,1036,0,1036,18,952,66,21.04.2019 23:45,59,3,Donetsk
1632,1634,8,680,947,5,952,0,952,17,863,72,21.04.2019 21:30,59,3,Donetsk
864,856,35,379,467,18,485,0,485,3,436,46,21.04.2019 21:30,59,3,Donetsk
1792,1785,30,850,929,13,942,0,942,25,858,59,22.04.2019 01:00,59,3,Donetsk
2160,2133,43,1019,1108,33,1141,0,1141,29,1063,49,21.04.2019 22:00,59,3,Donetsk
1248,1221,37,592,635,21,656,0,656,22,579,55,21.04.2019 21:30,59,3,Donetsk
1424,1409,20,626,786,12,798,0,798,16,707,75,21.04.2019 22:22,59,3,Donetsk
1472,1453,35,645,800,27,827,0,827,22,630,175,21.04.2019 21:40,59,3,Donetsk
1744,1714,7,786,951,7,958,0,958,25,873,60,21.04.2019 22:00,59,3,Donetsk
1056,1058,11,527,522,7,529,0,529,12,482,35,21.04.2019 21:40,59,3,Donetsk
1824,1826,21,846,963,15,978,0,978,20,879,79,21.04.2019 21:20,59,3,Donetsk
1952,1916,23,823,1120,9,1129,0,1129,30,980,119,22.04.2019 00:02,59,3,Donetsk
1248,1252,9,570,672,6,678,0,678,22,592,64,21.04.2019 21:23,59,3,Donetsk
1664,1640,25,811,842,11,853,0,853,20,718,115,22.04.2019 01:55,59,3,Donetsk
1696,1682,23,774,908,14,922,0,922,9,840,73,22.04.2019 06:50,59,3,Donetsk
1536,1515,36,682,825,29,854,0,854,20,794,40,21.04.2019 23:40,59,3,Donetsk
1552,1516,32,775,753,24,777,0,777,16,728,33,21.04.2019 20:39,59,3,Donetsk
208,203,11,84,113,11,124,0,124,3,106,15,21.04.2019 20:23,59,3,Donetsk
272,264,27,59,188,25,213,0,213,9,120,84,22.04.2019 00:16,59,3,Donetsk
1728,1669,37,878,828,22,850,0,850,20,786,44,21.04.2019 20:50,59,3,Donetsk
1632,1603,24,934,676,22,698,0,698,32,633,33,22.04.2019 00:20,59,3,Donetsk
1472,1454,23,749,709,14,723,0,723,28,628,67,21.04.2019 20:40,59,3,Donetsk
1152,1134,26,371,756,25,781,0,781,74,645,62,21.04.2019 21:30,59,3,Donetsk
1440,1421,18,901,525,14,539,0,539,22,477,40,22.04.2019 00:25,59,3,Donetsk
2176,2148,26,1232,918,26,944,0,944,32,853,59,21.04.2019 21:36,59,3,Donetsk
1488,1454,38,778,677,33,710,0,710,25,647,38,21.04.2019 20:38,59,3,Donetsk
1488,1454,32,892,574,22,596,0,596,11,567,18,21.04.2019 22:35,59,3,Donetsk
1808,1777,44,962,802,44,846,0,846,30,736,80,21.04.2019 20:52,59,3,Donetsk
672,662,16,368,288,16,304,0,304,4,279,21,22.04.2019 00:30,59,3,Donetsk
1552,1533,47,901,618,33,651,0,651,18,591,42,22.04.2019 00:30,59,3,Donetsk
1120,1100,49,660,430,30,460,0,460,13,410,37,22.04.2019 01:15,59,3,Donetsk
560,546,22,291,254,15,269,0,269,3,252,14,21.04.2019 21:25,59,3,Donetsk
960,938,44,315,601,44,645,0,645,15,598,32,22.04.2019 05:15,59,3,Donetsk
560,542,13,288,262,10,272,0,272,4,248,20,22.04.2019 03:45,59,3,Donetsk
800,706,0,119,681,0,681,0,681,43,607,31,21.04.2019 21:00,59,3,Donetsk
576,541,0,48,528,0,528,0,528,28,227,273,21.04.2019 21:55,60,3,Donetsk
784,767,0,90,694,0,694,0,694,25,382,287,21.04.2019 21:50,60,3,Donetsk
448,341,0,111,337,0,337,0,337,18,122,197,21.04.2019 23:10,60,3,Donetsk
336,307,0,77,259,0,259,0,259,28,133,98,21.04.2019 21:24,60,3,Donetsk
288,272,0,17,271,0,271,0,271,26,118,127,21.04.2019 21:00,60,3,Donetsk
880,773,0,170,710,0,710,0,710,76,402,232,22.04.2019 02:15,60,3,Donetsk
336,318,0,18,318,0,318,0,318,25,102,191,21.04.2019 21:00,60,3,Donetsk
512,489,0,39,473,0,473,0,473,36,209,228,21.04.2019 23:15,60,3,Donetsk
208,194,0,22,186,0,186,0,186,3,74,109,21.04.2019 21:05,60,3,Donetsk
128,106,0,24,104,0,104,0,104,4,42,58,21.04.2019 20:40,60,3,Donetsk
352,318,0,52,300,0,300,15,300,15,209,76,21.04.2019 21:20,60,3,Donetsk
272,224,0,53,219,0,219,0,219,5,132,82,21.04.2019 21:05,60,3,Donetsk
144,122,0,26,118,0,118,0,118,6,94,18,21.04.2019 20:36,60,3,Donetsk
528,492,0,242,286,0,286,0,286,23,154,109,21.04.2019 20:50,60,3,Donetsk
1424,1396,31,662,735,27,762,0,762,17,703,42,22.04.2019 00:07,60,3,Donetsk
1488,1475,33,650,812,26,838,0,838,11,772,55,22.04.2019 00:31,60,3,Donetsk
1168,1146,45,474,658,36,694,0,694,27,628,39,22.04.2019 00:20,60,3,Donetsk
1504,1492,73,600,831,73,904,0,904,19,809,76,22.04.2019 01:25,60,3,Donetsk
1936,1918,90,811,1051,74,1125,0,1125,27,984,114,22.04.2019 00:40,60,3,Donetsk
2224,2229,69,923,1254,47,1301,0,1301,40,1093,168,22.04.2019 00:05,60,3,Donetsk
1248,1238,33,560,660,28,688,0,688,21,598,69,21.04.2019 21:23,60,3,Donetsk
1248,1233,61,562,628,58,686,0,686,15,600,71,22.04.2019 00:05,60,3,Donetsk
1648,1627,67,734,877,37,914,0,914,23,819,72,21.04.2019 22:03,60,3,Donetsk
2304,2279,43,908,1361,35,1396,0,1396,32,1232,132,22.04.2019 00:30,60,3,Donetsk
1984,1966,25,1008,959,17,976,0,976,23,902,51,22.04.2019 00:13,60,3,Donetsk
1328,1301,50,672,610,46,656,0,656,16,554,86,22.04.2019 00:10,60,3,Donetsk
1952,1921,67,793,1098,61,1159,0,1159,24,1089,46,22.04.2019 00:30,60,3,Donetsk
1968,1930,33,812,1127,29,1156,0,1156,17,1070,69,22.04.2019 00:40,60,3,Donetsk
1696,1682,44,832,833,31,864,0,864,31,740,93,21.04.2019 22:15,60,3,Donetsk
1808,1763,56,1094,681,33,714,0,714,35,627,52,21.04.2019 22:30,60,3,Donetsk
1808,1769,73,1111,644,53,697,0,697,56,565,76,22.04.2019 00:01,60,3,Donetsk
880,871,58,482,347,51,398,0,398,8,318,72,22.04.2019 00:50,60,3,Donetsk
576,558,51,156,373,47,420,0,420,11,348,61,22.04.2019 00:30,60,3,Donetsk
976,969,35,461,483,32,515,0,515,8,485,22,22.04.2019 00:15,60,3,Donetsk
912,922,22,371,522,19,541,0,541,20,452,69,22.04.2019 00:20,60,3,Donetsk
768,758,19,231,519,18,537,0,537,9,482,46,22.04.2019 00:01,60,3,Donetsk
944,918,66,471,416,57,473,0,473,12,452,9,22.04.2019 04:50,60,3,Donetsk
640,630,52,219,372,49,421,0,421,12,388,21,22.04.2019 04:25,60,3,Donetsk
432,421,24,178,232,22,254,0,254,3,227,24,21.04.2019 21:00,60,3,Donetsk
384,374,16,180,190,14,204,0,204,6,186,12,21.04.2019 21:00,60,3,Donetsk
2320,2289,91,1258,991,71,1062,0,1062,29,988,45,22.04.2019 04:01,60,3,Donetsk
704,690,60,341,311,52,363,0,363,5,324,34,21.04.2019 21:00,60,3,Donetsk
448,433,23,194,233,21,254,0,254,1,238,15,21.04.2019 20:35,60,3,Donetsk
704,692,34,315,359,30,389,0,389,4,366,19,22.04.2019 00:03,60,3,Donetsk
592,580,54,161,378,53,431,0,431,7,322,102,21.04.2019 21:25,60,3,Donetsk
1472,1450,38,693,747,32,779,0,779,16,704,59,21.04.2019 22:00,60,3,Donetsk
1008,994,57,465,486,57,543,0,543,20,491,32,22.04.2019 00:10,60,3,Donetsk
544,537,15,282,250,12,262,0,262,6,238,18,21.04.2019 23:55,60,3,Donetsk
464,453,30,203,237,24,261,0,261,4,251,6,22.04.2019 00:30,60,3,Donetsk
576,554,36,258,287,31,318,0,318,8,292,18,22.04.2019 00:05,60,3,Donetsk
464,447,28,229,212,23,235,0,235,8,201,26,22.04.2019 00:20,60,3,Donetsk
672,651,54,254,379,39,418,0,418,11,360,47,21.04.2019 21:37,60,3,Donetsk
720,715,62,284,379,57,436,0,436,9,383,44,21.04.2019 21:50,60,3,Donetsk
608,597,30,267,315,26,341,0,341,7,302,32,22.04.2019 00:50,60,3,Donetsk
528,519,44,248,247,33,280,0,280,4,254,22,22.04.2019 00:38,60,3,Donetsk
1088,1074,50,486,557,45,602,0,602,16,546,40,21.04.2019 21:30,60,3,Donetsk
976,950,36,441,501,34,535,0,535,21,498,16,22.04.2019 00:15,60,3,Donetsk
496,487,17,297,182,17,199,0,199,6,183,10,21.04.2019 23:10,60,3,Donetsk
672,645,31,269,374,29,403,0,403,13,335,55,21.04.2019 23:18,60,3,Donetsk
1264,1248,103,419,744,101,845,0,845,18,792,35,22.04.2019 00:20,60,3,Donetsk
768,758,42,237,494,37,531,0,531,16,465,50,22.04.2019 00:30,60,3,Donetsk
944,920,62,379,514,51,565,0,565,10,509,46,22.04.2019 00:15,60,3,Donetsk
352,119,39,236,79,37,116,0,116,2,104,10,22.04.2019 00:15,60,3,Donetsk
1568,1542,19,606,944,18,962,0,962,21,891,50,22.04.2019 00:15,60,3,Donetsk
1744,1725,47,658,1045,41,1086,0,1086,27,1002,57,22.04.2019 02:20,60,3,Donetsk
1728,1696,24,712,992,24,1016,0,1016,18,958,40,22.04.2019 01:20,60,3,Donetsk
1552,1530,28,450,1074,28,1102,0,1102,19,1014,69,22.04.2019 01:30,60,3,Donetsk
368,358,29,125,216,27,243,0,243,2,238,3,22.04.2019 00:05,60,3,Donetsk
736,726,73,250,416,70,486,0,486,3,454,29,22.04.2019 00:10,60,3,Donetsk
800,771,48,312,444,44,488,0,488,11,450,27,21.04.2019 22:00,60,3,Donetsk
336,330,28,109,205,22,227,0,227,3,173,51,21.04.2019 23:45,60,3,Donetsk
528,508,52,133,344,51,395,0,395,3,369,23,21.04.2019 20:49,60,3,Donetsk
368,372,24,133,218,17,235,0,235,2,216,17,21.04.2019 20:50,60,3,Donetsk
1904,1884,86,710,1115,79,1194,0,1194,20,1106,68,21.04.2019 21:46,60,3,Donetsk
1088,1055,76,438,582,68,650,0,650,11,620,19,22.04.2019 00:15,60,3,Donetsk
400,398,29,164,211,25,236,0,236,3,219,14,22.04.2019 01:10,60,3,Donetsk
864,843,59,225,583,56,639,0,639,8,608,23,22.04.2019 00:20,60,3,Donetsk
912,886,39,333,541,38,579,0,579,4,555,20,21.04.2019 21:17,60,3,Donetsk
1520,1494,143,614,771,135,906,0,906,7,876,23,21.04.2019 21:30,60,3,Donetsk
400,389,46,180,177,43,220,0,220,5,206,9,22.04.2019 00:10,60,3,Donetsk
864,850,45,294,526,44,570,0,570,7,529,34,22.04.2019 01:40,60,3,Donetsk
848,823,72,326,456,66,522,0,522,4,465,53,22.04.2019 00:45,60,3,Donetsk
1360,1331,102,415,846,99,945,0,945,18,904,23,22.04.2019 00:15,60,3,Donetsk
864,847,17,372,477,15,492,0,492,10,466,16,21.04.2019 22:05,60,3,Donetsk
208,192,15,207,1,0,1,0,1,0,1,0,22.04.2019 01:05,60,3,Donetsk
768,731,36,382,356,30,386,0,386,5,368,13,22.04.2019 01:25,60,3,Donetsk
624,610,24,243,361,20,381,0,381,4,361,16,22.04.2019 00:03,60,3,Donetsk
528,493,17,242,272,14,286,0,286,2,257,27,21.04.2019 23:40,60,3,Donetsk
1120,1024,30,866,248,6,254,0,254,5,212,37,22.04.2019 00:15,60,3,Donetsk
1056,1059,31,344,683,29,712,0,712,8,649,55,21.04.2019 20:35,60,3,Donetsk
1056,1032,25,426,610,20,630,0,630,9,578,43,22.04.2019 06:50,60,3,Donetsk
1200,1171,43,425,737,38,775,0,775,7,710,58,22.04.2019 00:30,60,3,Donetsk
1168,1140,34,425,711,32,743,0,743,6,680,57,21.04.2019 22:03,60,3,Donetsk
1088,1066,42,390,663,35,698,0,698,12,636,50,21.04.2019 21:59,60,3,Donetsk
1824,1791,72,663,1095,66,1161,0,1161,21,1092,48,21.04.2019 23:30,60,3,Donetsk
960,941,42,347,572,41,613,0,613,10,577,26,21.04.2019 22:18,60,3,Donetsk
256,266,12,71,176,9,185,0,185,8,164,13,22.04.2019 00:02,60,3,Donetsk
288,286,11,109,169,10,179,0,179,4,162,13,21.04.2019 21:28,60,3,Donetsk
1264,1257,81,497,700,67,767,0,767,11,701,55,22.04.2019 00:15,60,3,Donetsk
656,638,27,275,358,23,381,0,381,7,340,34,22.04.2019 00:43,60,3,Donetsk
704,685,37,285,384,35,419,0,419,9,379,31,21.04.2019 21:40,60,3,Donetsk
608,568,37,249,333,26,359,0,359,2,317,40,22.04.2019 00:15,60,3,Donetsk
992,987,66,413,525,54,579,0,579,10,534,35,21.04.2019 23:40,60,3,Donetsk
640,613,45,265,336,39,375,0,375,3,339,33,21.04.2019 21:35,60,3,Donetsk
576,597,26,239,317,20,337,0,337,10,310,17,22.04.2019 06:15,60,3,Donetsk
544,522,20,225,304,15,319,0,319,4,299,16,22.04.2019 00:05,60,3,Donetsk
448,430,22,181,245,22,267,0,267,2,232,33,22.04.2019 00:25,60,3,Donetsk
1456,1432,90,878,514,64,578,0,578,17,506,55,21.04.2019 21:55,60,3,Donetsk
1248,1211,67,741,458,49,507,0,507,11,481,15,22.04.2019 00:10,60,3,Donetsk
1392,1366,92,687,632,73,705,0,705,13,586,106,22.04.2019 04:00,60,3,Donetsk
688,654,32,235,428,25,453,0,453,5,436,12,21.04.2019 21:35,60,3,Donetsk
288,263,17,85,187,16,203,0,203,2,194,7,21.04.2019 21:30,60,3,Donetsk
304,291,26,78,200,26,226,0,226,3,180,43,21.04.2019 20:45,60,3,Donetsk
688,669,31,271,389,28,417,0,417,11,377,29,21.04.2019 23:00,60,3,Donetsk
1152,1127,52,638,468,46,514,0,514,16,471,27,21.04.2019 22:40,60,3,Donetsk
1296,1260,76,521,714,61,775,0,775,12,742,21,22.04.2019 00:15,60,3,Donetsk
192,190,8,66,118,8,126,0,126,2,117,7,21.04.2019 22:50,60,3,Donetsk
2080,2038,96,1033,985,62,1047,0,1047,12,991,44,21.04.2019 21:20,60,3,Donetsk
448,432,21,241,194,13,207,0,207,2,185,20,21.04.2019 21:00,60,3,Donetsk
896,459,1,437,458,1,459,0,459,42,396,21,22.04.2019 00:47,62,4,Zhitomir
32,5,0,27,5,0,5,0,5,1,3,1,21.04.2019 20:45,62,4,Zhitomir
2400,2364,24,895,1488,17,1505,0,1505,30,1127,348,22.04.2019 00:15,62,4,Zhitomir
2208,2178,34,835,1348,25,1373,0,1373,42,1021,310,22.04.2019 00:34,62,4,Zhitomir
1360,1335,13,431,919,10,929,0,929,15,702,212,22.04.2019 00:25,62,4,Zhitomir
2336,2302,26,862,1454,20,1474,0,1474,37,1112,325,22.04.2019 00:20,62,4,Zhitomir
2032,2025,21,729,1288,15,1303,0,1303,44,968,291,22.04.2019 00:15,62,4,Zhitomir
1840,1825,15,649,1179,12,1191,0,1191,33,862,296,22.04.2019 01:00,62,4,Zhitomir
1152,1133,3,453,697,2,699,0,699,11,553,135,22.04.2019 00:35,62,4,Zhitomir
1488,1480,5,471,1014,3,1017,0,1017,25,764,228,22.04.2019 00:10,62,4,Zhitomir
1936,1932,8,680,1249,7,1256,0,1256,38,987,231,22.04.2019 00:25,62,4,Zhitomir
1936,1922,16,694,1230,12,1242,0,1242,33,905,304,22.04.2019 00:45,62,4,Zhitomir
2016,2014,16,779,1225,12,1237,0,1237,35,950,252,22.04.2019 01:20,62,4,Zhitomir
1344,1329,12,457,877,10,887,0,887,11,640,236,22.04.2019 00:01,62,4,Zhitomir
1344,1337,19,439,891,14,905,0,905,17,694,194,22.04.2019 00:05,62,4,Zhitomir
992,981,2,333,657,2,659,0,659,19,473,167,22.04.2019 00:15,62,4,Zhitomir
1312,1343,39,438,851,23,874,0,874,14,654,206,21.04.2019 22:07,62,4,Zhitomir
1440,1412,12,569,861,10,871,0,871,26,647,198,22.04.2019 00:32,62,4,Zhitomir
848,837,11,283,557,8,565,0,565,21,399,145,22.04.2019 00:35,62,4,Zhitomir
1296,1272,20,549,734,13,747,0,747,15,584,148,22.04.2019 00:10,62,4,Zhitomir
2032,2019,44,721,1282,29,1311,0,1311,38,981,292,22.04.2019 00:10,62,4,Zhitomir
1232,1225,13,470,751,11,762,0,762,17,562,183,21.04.2019 23:50,62,4,Zhitomir
1760,1755,22,575,1169,16,1185,0,1185,34,871,280,22.04.2019 00:35,62,4,Zhitomir
1808,1808,26,603,1186,19,1205,0,1205,35,887,283,22.04.2019 00:12,62,4,Zhitomir
1408,1385,13,528,868,12,880,0,880,26,668,186,22.04.2019 00:41,62,4,Zhitomir
1712,1690,16,668,1036,8,1044,0,1044,21,829,194,22.04.2019 01:10,62,4,Zhitomir
1328,1313,11,450,867,11,878,0,878,21,653,204,22.04.2019 00:40,62,4,Zhitomir
2064,2043,8,804,1253,7,1260,0,1260,36,925,299,22.04.2019 00:22,62,4,Zhitomir
2208,2183,4,717,1489,2,1491,0,1491,35,1102,354,22.04.2019 00:20,62,4,Zhitomir
2096,2078,19,790,1295,11,1306,0,1306,24,967,315,22.04.2019 00:35,62,4,Zhitomir
2304,2284,12,868,1426,10,1436,0,1436,32,1045,359,22.04.2019 00:20,62,4,Zhitomir
2304,2277,12,810,1484,10,1494,0,1494,20,1116,358,22.04.2019 00:10,62,4,Zhitomir
2176,2165,5,694,1477,5,1482,0,1482,23,1126,333,22.04.2019 00:35,62,4,Zhitomir
1680,1663,6,504,1172,4,1176,0,1176,40,843,293,22.04.2019 00:10,62,4,Zhitomir
2064,2036,15,714,1340,10,1350,0,1350,37,982,331,22.04.2019 00:20,62,4,Zhitomir
2304,2277,6,774,1525,5,1530,0,1530,39,1108,383,22.04.2019 00:20,62,4,Zhitomir
2128,2098,6,853,1271,4,1275,0,1275,41,924,310,22.04.2019 00:40,62,4,Zhitomir
2208,2185,7,732,1469,7,1476,0,1476,45,1050,381,22.04.2019 00:09,62,4,Zhitomir
2288,2272,14,943,1335,10,1345,0,1345,33,1078,234,22.04.2019 00:30,62,4,Zhitomir
1632,1614,4,644,985,3,988,0,988,24,760,204,22.04.2019 00:15,62,4,Zhitomir
1904,1867,8,652,1248,4,1252,0,1252,47,892,313,22.04.2019 00:30,62,4,Zhitomir
2144,2112,6,715,1423,6,1429,0,1429,43,1114,272,22.04.2019 00:33,62,4,Zhitomir
2096,1959,5,903,1191,2,1193,0,1193,32,745,416,22.04.2019 02:45,62,4,Zhitomir
1264,1234,1,436,827,1,828,0,828,27,440,361,22.04.2019 00:50,62,4,Zhitomir
320,102,30,220,72,28,100,0,100,3,74,23,22.04.2019 00:10,62,4,Zhitomir
128,56,20,72,39,17,56,0,56,0,48,8,21.04.2019 21:00,62,4,Zhitomir
128,23,3,105,20,3,23,0,23,0,17,6,22.04.2019 00:20,62,4,Zhitomir
832,748,0,93,739,0,739,0,738,32,646,60,21.04.2019 21:00,62,4,Zhitomir
656,369,4,297,355,4,359,0,359,27,302,30,21.04.2019 23:22,62,4,Zhitomir
1504,1487,1,621,882,1,883,0,883,22,669,192,22.04.2019 00:41,62,4,Zhitomir
1632,1619,8,577,1048,7,1055,0,1055,34,753,268,22.04.2019 00:20,62,4,Zhitomir
1952,1954,3,721,1228,3,1231,0,1231,30,972,229,22.04.2019 00:05,62,4,Zhitomir
2032,2016,3,727,1302,3,1305,0,1305,27,983,295,21.04.2019 23:28,62,4,Zhitomir
2048,2017,11,755,1285,8,1293,0,1293,30,970,293,22.04.2019 00:12,62,4,Zhitomir
2240,2211,6,871,1363,6,1369,0,1369,34,1036,299,22.04.2019 00:30,62,4,Zhitomir
2128,2119,5,717,1407,4,1411,0,1411,32,1071,308,22.04.2019 00:15,62,4,Zhitomir
1264,1232,3,480,783,1,784,0,784,22,585,177,22.04.2019 00:25,62,4,Zhitomir
2064,2029,9,776,1279,9,1288,0,1288,36,986,266,22.04.2019 00:07,62,4,Zhitomir
1856,1838,6,678,1173,5,1178,0,1178,32,859,287,21.04.2019 23:55,62,4,Zhitomir
1648,1614,10,592,1048,8,1056,0,1056,36,765,255,22.04.2019 00:45,62,4,Zhitomir
1936,1915,10,738,1189,9,1198,0,1198,25,899,274,22.04.2019 00:20,62,4,Zhitomir
1072,1059,8,384,684,4,688,0,688,24,496,168,22.04.2019 00:07,62,4,Zhitomir
704,704,3,221,482,1,483,0,483,16,324,143,22.04.2019 00:20,62,4,Zhitomir
1584,1568,5,508,1072,4,1076,0,1076,44,776,256,21.04.2019 23:50,62,4,Zhitomir
1040,1006,3,394,643,3,646,0,646,17,434,195,21.04.2019 20:58,62,4,Zhitomir
1200,1175,2,457,742,1,743,0,743,31,566,146,22.04.2019 00:04,62,4,Zhitomir
848,841,0,393,455,0,455,0,455,12,299,144,22.04.2019 00:12,62,4,Zhitomir
1232,1214,4,406,823,3,826,0,826,35,555,236,22.04.2019 00:10,62,4,Zhitomir
1360,1363,13,481,869,10,879,0,879,29,646,204,22.04.2019 00:30,62,4,Zhitomir
1680,1660,3,543,1134,3,1137,0,1137,24,866,247,22.04.2019 00:10,62,4,Zhitomir
2144,2122,9,724,1415,5,1420,0,1420,39,1036,345,22.04.2019 01:20,62,4,Zhitomir
1632,1622,0,532,1100,0,1100,0,1100,32,784,284,22.04.2019 00:51,62,4,Zhitomir
2064,2049,7,731,1327,6,1333,0,1333,37,982,314,21.04.2019 22:30,62,4,Zhitomir
2000,1982,9,659,1332,9,1341,0,1341,21,957,363,22.04.2019 00:02,62,4,Zhitomir
2192,2166,9,706,1482,4,1486,0,1486,52,1051,383,22.04.2019 00:35,62,4,Zhitomir
2080,2061,9,725,1350,5,1355,0,1355,35,1007,313,22.04.2019 00:15,62,4,Zhitomir
1984,1968,2,743,1239,2,1241,0,1241,30,899,312,22.04.2019 00:05,62,4,Zhitomir
960,948,2,304,655,1,656,0,656,15,474,167,21.04.2019 22:00,62,4,Zhitomir
1072,1051,0,556,516,0,516,0,516,11,410,95,21.04.2019 23:36,62,4,Zhitomir
1296,1270,9,548,742,6,748,0,748,27,563,158,22.04.2019 00:05,62,4,Zhitomir
1808,1786,9,557,1243,8,1251,0,1251,49,900,302,22.04.2019 00:30,62,4,Zhitomir
768,754,1,291,476,1,477,0,477,10,330,137,21.04.2019 23:30,62,4,Zhitomir
1872,1855,3,581,1289,2,1291,0,1291,26,929,336,21.04.2019 22:40,62,4,Zhitomir
1984,1984,4,602,1378,4,1382,0,1382,44,979,359,22.04.2019 00:20,62,4,Zhitomir
1456,1436,10,583,863,10,873,0,873,20,656,197,22.04.2019 00:07,62,4,Zhitomir
2224,2201,7,885,1334,5,1339,0,1339,35,1038,266,22.04.2019 00:25,62,4,Zhitomir
1152,1138,3,478,671,3,674,0,674,16,531,127,22.04.2019 00:30,62,4,Zhitomir
2064,2044,4,766,1294,4,1298,0,1298,37,980,281,22.04.2019 01:25,62,4,Zhitomir
1984,1952,1,737,1246,1,1247,0,1247,32,974,241,22.04.2019 00:40,62,4,Zhitomir
2224,2203,8,779,1439,6,1445,0,1445,28,1154,263,22.04.2019 00:10,62,4,Zhitomir
2192,2159,3,910,1281,1,1282,0,1282,35,936,311,22.04.2019 00:30,62,4,Zhitomir
2160,2137,3,954,1203,3,1206,0,1206,34,895,277,21.04.2019 22:30,62,4,Zhitomir
1552,1549,1,644,907,1,908,0,908,29,707,172,21.04.2019 21:10,62,4,Zhitomir
2208,2165,7,868,1336,4,1340,0,1340,32,975,333,21.04.2019 22:30,62,4,Zhitomir
2144,2125,7,764,1375,5,1380,0,1380,50,1064,266,22.04.2019 00:50,62,4,Zhitomir
2288,2254,14,847,1432,9,1441,0,1441,42,1110,289,22.04.2019 00:55,62,4,Zhitomir
2144,2123,10,779,1360,5,1365,0,1365,34,1045,286,22.04.2019 00:40,62,4,Zhitomir
2160,2139,12,734,1418,8,1426,0,1426,39,1064,323,22.04.2019 01:20,62,4,Zhitomir
2064,2039,4,820,1241,3,1244,0,1244,27,956,261,22.04.2019 00:10,62,4,Zhitomir
1744,1715,4,745,996,3,999,0,999,23,753,223,21.04.2019 22:30,62,4,Zhitomir
528,77,42,457,32,39,71,0,71,6,49,16,22.04.2019 00:36,62,4,Zhitomir
816,231,131,623,78,115,193,0,193,1,154,38,21.04.2019 21:30,62,4,Zhitomir
240,25,0,216,24,0,24,0,24,0,18,6,21.04.2019 22:00,62,4,Zhitomir
224,78,3,149,72,3,75,0,75,1,57,17,22.04.2019 00:20,62,4,Zhitomir
224,32,2,192,30,2,32,0,32,2,24,6,22.04.2019 00:05,62,4,Zhitomir
128,15,0,114,14,0,14,0,14,0,12,2,22.04.2019 00:02,62,4,Zhitomir
1136,1121,43,467,628,41,669,0,669,16,480,173,22.04.2019 00:15,63,4,Zhitomir
992,972,38,398,562,32,594,0,594,8,478,108,21.04.2019 22:10,63,4,Zhitomir
704,696,18,304,383,17,400,0,400,4,313,83,22.04.2019 00:10,63,4,Zhitomir
1104,1088,46,470,591,43,634,0,634,18,461,155,22.04.2019 00:40,63,4,Zhitomir
1008,984,29,408,575,25,600,0,600,13,409,178,21.04.2019 21:35,63,4,Zhitomir
688,677,16,257,416,15,431,0,431,0,334,97,22.04.2019 00:30,63,4,Zhitomir
688,671,34,309,347,32,379,0,379,9,273,97,22.04.2019 00:15,63,4,Zhitomir
864,860,23,320,522,22,544,0,544,9,416,119,22.04.2019 00:10,63,4,Zhitomir
1120,1112,49,487,584,49,633,0,633,16,442,175,22.04.2019 00:02,63,4,Zhitomir
992,973,39,467,488,37,525,0,525,15,320,190,22.04.2019 01:51,63,4,Zhitomir
304,300,25,135,148,21,169,0,169,5,114,50,21.04.2019 23:00,63,4,Zhitomir
592,580,43,249,304,39,343,0,343,13,239,91,22.04.2019 00:17,63,4,Zhitomir
320,309,29,134,157,29,186,0,186,2,147,37,21.04.2019 21:00,63,4,Zhitomir
304,300,27,123,158,23,181,0,181,1,117,63,21.04.2019 21:35,63,4,Zhitomir
576,573,50,216,314,46,360,0,360,9,271,80,21.04.2019 23:00,63,4,Zhitomir
352,336,38,137,177,38,215,0,215,3,158,54,22.04.2019 00:15,63,4,Zhitomir
1808,1772,73,703,1043,62,1105,0,1105,27,851,227,22.04.2019 00:08,63,4,Zhitomir
432,415,26,149,260,23,283,0,283,5,181,97,21.04.2019 21:30,63,4,Zhitomir
656,652,71,298,296,62,358,0,358,6,249,103,21.04.2019 22:23,63,4,Zhitomir
256,251,11,106,141,9,150,0,150,1,100,49,21.04.2019 20:50,63,4,Zhitomir
160,153,16,50,94,16,110,0,110,0,84,26,21.04.2019 21:00,63,4,Zhitomir
592,580,68,208,323,61,384,0,384,13,280,91,22.04.2019 01:30,63,4,Zhitomir
592,577,53,186,360,46,406,0,406,4,314,88,21.04.2019 22:00,63,4,Zhitomir
544,534,64,182,302,60,362,0,362,12,235,115,22.04.2019 01:55,63,4,Zhitomir
1024,996,53,517,458,49,507,0,507,14,353,140,21.04.2019 21:45,63,4,Zhitomir
272,272,18,99,159,14,173,0,173,4,114,55,21.04.2019 21:50,63,4,Zhitomir
640,629,56,225,363,52,415,0,415,7,317,91,21.04.2019 23:00,63,4,Zhitomir
224,232,28,86,118,20,138,0,138,3,87,48,21.04.2019 21:15,63,4,Zhitomir
256,257,33,105,121,30,151,0,151,5,110,36,21.04.2019 21:30,63,4,Zhitomir
240,232,24,85,133,22,155,0,155,4,101,50,21.04.2019 20:50,63,4,Zhitomir
480,469,35,202,246,32,278,0,278,7,193,78,21.04.2019 23:30,63,4,Zhitomir
384,370,25,173,188,23,211,0,211,4,143,64,21.04.2019 21:40,63,4,Zhitomir
384,383,44,149,197,38,235,0,235,3,171,61,21.04.2019 20:35,63,4,Zhitomir
112,105,20,31,65,16,81,0,81,3,42,36,21.04.2019 21:05,63,4,Zhitomir
880,869,56,415,413,52,465,0,465,14,357,94,22.04.2019 00:10,63,4,Zhitomir
1632,1562,19,788,831,13,844,0,844,32,652,160,22.04.2019 00:40,63,4,Zhitomir
288,279,33,104,155,29,184,0,184,6,136,42,22.04.2019 00:05,63,4,Zhitomir
432,421,46,147,243,42,285,0,285,5,204,76,21.04.2019 21:00,63,4,Zhitomir
176,169,6,35,135,6,141,0,141,2,103,36,21.04.2019 20:57,63,4,Zhitomir
896,914,51,380,471,45,516,0,516,11,305,200,21.04.2019 22:00,63,4,Zhitomir
288,272,18,141,130,17,147,0,147,4,83,60,21.04.2019 21:30,63,4,Zhitomir
416,406,30,146,242,28,270,0,270,7,171,92,21.04.2019 22:00,63,4,Zhitomir
144,151,13,30,103,11,114,0,114,3,69,42,21.04.2019 21:00,63,4,Zhitomir
656,641,21,304,334,18,352,0,352,11,242,99,21.04.2019 22:00,63,4,Zhitomir
112,45,11,77,29,6,35,0,35,0,26,9,21.04.2019 20:20,63,4,Zhitomir
2176,2148,32,787,1359,30,1389,0,1389,18,1072,299,22.04.2019 00:10,63,4,Zhitomir
1408,1372,13,525,872,11,883,0,883,17,677,189,21.04.2019 21:40,63,4,Zhitomir
448,438,21,188,243,17,260,0,260,3,175,82,21.04.2019 20:36,63,4,Zhitomir
832,825,27,390,418,24,442,0,442,6,359,77,21.04.2019 21:40,63,4,Zhitomir
320,301,30,105,189,26,215,0,215,2,100,113,21.04.2019 22:40,63,4,Zhitomir
624,605,30,292,308,24,332,0,332,7,232,93,21.04.2019 21:00,63,4,Zhitomir
624,611,41,187,396,41,437,0,437,15,291,131,21.04.2019 22:00,63,4,Zhitomir
240,232,2,102,136,2,138,0,138,0,107,31,21.04.2019 20:45,63,4,Zhitomir
368,365,31,149,189,30,219,0,219,3,154,62,21.04.2019 21:00,63,4,Zhitomir
496,477,22,224,254,18,272,0,272,3,185,84,21.04.2019 21:20,63,4,Zhitomir
128,118,5,44,79,5,84,0,84,1,67,16,21.04.2019 20:30,63,4,Zhitomir
256,240,13,119,127,10,137,0,137,3,98,36,21.04.2019 22:00,63,4,Zhitomir
144,139,15,59,71,14,85,0,85,0,69,16,21.04.2019 21:00,63,4,Zhitomir
64,53,7,24,34,6,40,0,40,0,31,9,21.04.2019 21:30,63,4,Zhitomir
544,537,39,223,283,38,321,0,321,4,249,68,21.04.2019 21:20,63,4,Zhitomir
720,691,37,275,414,31,445,0,445,12,314,119,21.04.2019 21:41,63,4,Zhitomir
224,225,18,66,140,18,158,0,158,5,107,46,21.04.2019 22:00,63,4,Zhitomir
192,176,26,84,86,22,108,0,108,0,79,29,21.04.2019 21:00,63,4,Zhitomir
528,505,40,218,270,40,310,0,310,5,207,98,21.04.2019 21:30,63,4,Zhitomir
432,418,40,142,250,40,290,0,290,6,177,107,21.04.2019 21:25,63,4,Zhitomir
208,189,13,93,105,10,115,0,115,0,91,24,21.04.2019 21:00,63,4,Zhitomir
720,706,50,249,426,45,471,0,471,9,304,158,21.04.2019 21:05,63,4,Zhitomir
208,196,14,75,119,14,133,0,133,3,80,50,21.04.2019 21:20,63,4,Zhitomir
368,364,26,137,207,24,231,0,231,2,182,47,21.04.2019 21:10,63,4,Zhitomir
208,203,29,86,96,26,122,0,122,4,86,32,21.04.2019 21:55,63,4,Zhitomir
752,738,26,300,426,26,452,0,452,6,379,67,22.04.2019 00:15,63,4,Zhitomir
176,159,6,72,98,6,104,0,104,1,69,34,21.04.2019 20:50,63,4,Zhitomir
688,670,34,283,374,31,405,0,405,10,327,68,22.04.2019 00:05,63,4,Zhitomir
112,99,7,46,59,7,66,0,66,0,45,21,21.04.2019 21:00,63,4,Zhitomir
576,558,39,155,383,38,421,0,421,12,334,75,21.04.2019 21:00,63,4,Zhitomir
208,199,5,53,150,5,155,0,155,3,114,38,22.04.2019 00:15,63,4,Zhitomir
784,770,23,339,423,22,445,0,445,13,331,101,21.04.2019 23:45,63,4,Zhitomir
784,767,64,323,398,63,461,0,461,8,332,121,21.04.2019 20:47,63,4,Zhitomir
176,172,14,62,103,11,114,0,114,0,81,33,21.04.2019 20:30,63,4,Zhitomir
848,831,42,277,530,41,571,0,571,10,399,162,21.04.2019 21:10,63,4,Zhitomir
768,748,29,320,423,25,448,0,448,8,307,133,21.04.2019 21:10,63,4,Zhitomir
144,142,12,61,71,12,83,0,83,0,60,23,21.04.2019 20:50,63,4,Zhitomir
320,306,20,138,166,16,182,0,182,2,147,33,21.04.2019 20:30,63,4,Zhitomir
208,197,23,98,90,20,110,0,110,3,67,40,21.04.2019 20:45,63,4,Zhitomir
288,272,14,124,152,12,164,0,164,3,93,68,21.04.2019 21:15,63,4,Zhitomir
192,179,14,80,99,13,112,0,112,1,73,38,21.04.2019 22:30,63,4,Zhitomir
160,147,13,77,70,13,83,0,83,1,64,18,21.04.2019 21:00,63,4,Zhitomir
1056,1044,36,452,568,36,604,0,604,6,400,198,21.04.2019 21:05,63,4,Zhitomir
80,80,1,35,44,1,45,0,45,1,35,9,21.04.2019 21:05,63,4,Zhitomir
624,602,44,272,311,41,352,0,352,2,262,88,21.04.2019 21:00,63,4,Zhitomir
752,731,26,345,381,26,407,0,407,8,293,106,21.04.2019 21:00,63,4,Zhitomir
144,134,3,54,87,3,90,0,90,0,69,21,21.04.2019 21:15,63,4,Zhitomir
352,340,16,160,176,16,192,0,192,3,123,66,21.04.2019 20:45,63,4,Zhitomir
176,161,13,94,69,13,82,0,82,2,51,29,21.04.2019 20:30,63,4,Zhitomir
800,782,40,318,452,30,482,0,482,6,338,138,22.04.2019 00:05,63,4,Zhitomir
640,629,57,275,308,57,365,0,365,2,248,115,21.04.2019 21:00,63,4,Zhitomir
112,111,10,36,66,10,76,0,76,1,54,21,21.04.2019 20:27,63,4,Zhitomir
736,584,0,171,565,0,565,0,565,21,519,25,21.04.2019 20:50,63,4,Zhitomir
976,964,31,425,522,29,551,0,551,10,438,103,22.04.2019 00:40,63,4,Zhitomir
848,835,39,416,396,36,432,0,432,8,301,123,22.04.2019 00:10,63,4,Zhitomir
1040,1014,55,473,517,50,567,0,567,14,405,148,21.04.2019 21:42,63,4,Zhitomir
64,53,4,32,28,4,32,0,32,1,23,8,22.04.2019 00:10,63,4,Zhitomir
1856,1842,17,667,1175,14,1189,0,1189,36,907,246,22.04.2019 00:45,63,4,Zhitomir
1664,1644,30,717,921,26,947,0,947,22,720,205,22.04.2019 00:35,63,4,Zhitomir
1264,1238,11,464,791,9,800,0,800,12,618,170,22.04.2019 00:00,63,4,Zhitomir
1488,1476,81,660,757,71,828,0,828,27,646,155,21.04.2019 21:10,63,4,Zhitomir
256,247,28,107,127,22,149,0,149,2,81,66,21.04.2019 21:05,63,4,Zhitomir
288,272,34,107,150,31,181,0,181,0,141,40,21.04.2019 20:30,63,4,Zhitomir
336,324,50,124,165,47,212,0,212,5,161,46,21.04.2019 20:45,63,4,Zhitomir
272,260,8,110,154,8,162,0,162,3,122,37,21.04.2019 20:46,63,4,Zhitomir
320,335,22,119,183,18,201,0,201,2,147,52,21.04.2019 20:40,63,4,Zhitomir
400,387,36,145,222,33,255,0,255,4,182,69,21.04.2019 22:35,63,4,Zhitomir
192,179,32,75,93,24,117,0,117,3,75,39,21.04.2019 21:00,63,4,Zhitomir
1424,1397,56,625,755,44,799,0,799,8,621,170,21.04.2019 23:05,63,4,Zhitomir
608,590,48,221,344,43,387,0,387,9,288,90,21.04.2019 21:05,63,4,Zhitomir
336,320,31,95,213,28,241,0,241,5,184,52,21.04.2019 22:00,63,4,Zhitomir
240,234,23,97,123,20,143,0,143,7,82,54,22.04.2019 01:10,63,4,Zhitomir
368,355,14,123,231,14,245,0,245,4,164,77,21.04.2019 23:00,63,4,Zhitomir
368,374,45,132,199,37,236,0,236,9,167,60,21.04.2019 21:15,63,4,Zhitomir
464,459,44,187,240,37,277,0,277,9,203,65,21.04.2019 21:00,63,4,Zhitomir
192,192,27,62,103,27,130,0,130,0,86,44,21.04.2019 23:50,63,4,Zhitomir
704,685,76,244,387,73,460,0,460,5,354,101,21.04.2019 23:55,63,4,Zhitomir
288,283,35,100,153,35,188,0,188,10,150,28,22.04.2019 00:45,63,4,Zhitomir
304,295,21,100,183,21,204,0,204,8,145,51,22.04.2019 01:00,63,4,Zhitomir
464,447,21,169,275,20,295,0,295,6,228,61,21.04.2019 20:45,63,4,Zhitomir
832,828,81,342,415,75,490,0,490,12,379,99,21.04.2019 21:42,63,4,Zhitomir
112,105,10,46,56,10,66,0,66,0,42,24,21.04.2019 22:00,63,4,Zhitomir
768,757,54,264,452,52,504,0,504,4,365,135,21.04.2019 22:00,63,4,Zhitomir
1520,1505,59,574,893,53,946,0,946,12,718,216,22.04.2019 00:20,63,4,Zhitomir
560,571,52,174,337,49,386,0,386,8,280,98,21.04.2019 21:37,63,4,Zhitomir
464,461,30,163,274,27,301,0,301,10,200,91,21.04.2019 22:48,63,4,Zhitomir
192,189,10,81,105,6,111,0,111,3,82,26,21.04.2019 20:50,63,4,Zhitomir
576,575,61,112,407,57,464,0,464,12,385,67,21.04.2019 21:30,63,4,Zhitomir
592,585,54,208,330,54,384,0,384,4,250,130,21.04.2019 20:35,63,4,Zhitomir
272,268,28,109,135,28,163,0,163,3,126,34,21.04.2019 20:29,63,4,Zhitomir
416,417,42,156,219,41,260,0,260,9,175,76,21.04.2019 21:20,63,4,Zhitomir
208,207,34,77,100,31,131,0,131,0,88,43,21.04.2019 21:15,63,4,Zhitomir
272,265,22,107,147,18,165,0,165,2,139,24,21.04.2019 21:50,63,4,Zhitomir
384,292,52,131,202,51,253,0,253,2,188,63,21.04.2019 22:00,63,4,Zhitomir
944,932,65,418,466,60,526,0,526,32,338,156,21.04.2019 21:00,63,4,Zhitomir
144,32,21,116,11,17,28,0,28,0,20,8,22.04.2019 00:10,63,4,Zhitomir
512,505,21,210,283,19,302,0,302,4,217,81,21.04.2019 22:40,63,4,Zhitomir
1008,991,39,369,601,38,639,0,639,9,431,199,21.04.2019 22:00,63,4,Zhitomir
368,352,31,126,213,29,242,0,242,4,208,30,21.04.2019 20:47,63,4,Zhitomir
1472,1455,59,726,690,56,746,0,746,10,554,182,21.04.2019 23:50,63,4,Zhitomir
112,113,5,32,75,5,80,0,80,0,61,19,21.04.2019 21:15,63,4,Zhitomir
352,340,33,144,175,33,208,0,208,1,140,67,21.04.2019 21:28,63,4,Zhitomir
128,123,9,64,55,9,64,0,64,2,36,26,21.04.2019 21:30,63,4,Zhitomir
592,581,61,220,313,59,372,0,372,3,285,84,21.04.2019 20:40,63,4,Zhitomir
144,141,25,50,75,19,94,0,94,2,63,29,21.04.2019 21:10,63,4,Zhitomir
128,107,14,43,71,14,85,0,85,0,51,34,21.04.2019 22:00,63,4,Zhitomir
464,443,5,211,249,4,253,0,253,3,166,84,21.04.2019 22:30,63,4,Zhitomir
816,803,45,381,393,42,435,0,435,12,285,138,21.04.2019 21:10,63,4,Zhitomir
480,479,30,140,310,30,340,0,340,2,241,97,21.04.2019 21:30,63,4,Zhitomir
80,75,0,29,51,0,51,0,51,0,32,19,21.04.2019 23:55,63,4,Zhitomir
336,320,25,114,198,24,222,0,222,7,114,101,21.04.2019 21:30,63,4,Zhitomir
464,452,34,217,213,34,247,0,247,7,142,98,21.04.2019 21:30,63,4,Zhitomir
128,117,19,38,73,17,90,0,90,2,57,31,21.04.2019 21:17,63,4,Zhitomir
400,384,16,171,214,15,229,0,229,4,185,40,21.04.2019 23:00,63,4,Zhitomir
128,112,19,56,54,18,72,0,72,3,50,19,21.04.2019 23:20,63,4,Zhitomir
624,611,41,247,337,40,377,0,377,3,270,104,21.04.2019 21:10,63,4,Zhitomir
240,234,11,101,128,11,139,0,139,6,86,47,21.04.2019 21:30,63,4,Zhitomir
464,447,61,99,304,61,365,0,365,2,250,113,21.04.2019 22:00,63,4,Zhitomir
240,226,16,92,133,15,148,0,148,4,103,41,21.04.2019 22:00,63,4,Zhitomir
96,84,13,33,50,13,63,0,63,1,50,12,21.04.2019 23:00,63,4,Zhitomir
304,292,10,111,187,6,193,0,193,4,142,47,21.04.2019 21:00,63,4,Zhitomir
144,145,15,42,87,15,102,0,102,2,65,35,21.04.2019 21:00,63,4,Zhitomir
256,246,9,85,164,7,171,0,171,3,118,50,21.04.2019 22:20,63,4,Zhitomir
352,343,38,142,172,38,210,0,210,3,147,60,21.04.2019 20:35,63,4,Zhitomir
112,106,3,42,67,3,70,0,70,1,47,22,21.04.2019 20:30,63,4,Zhitomir
784,771,27,284,476,24,500,0,500,2,350,148,21.04.2019 21:00,63,4,Zhitomir
544,541,47,210,288,46,334,0,334,6,238,90,21.04.2019 22:00,63,4,Zhitomir
368,356,33,122,215,31,246,0,246,3,126,117,21.04.2019 20:20,63,4,Zhitomir
320,315,36,86,199,35,234,0,234,1,188,45,21.04.2019 20:40,63,4,Zhitomir
384,379,25,80,279,25,304,0,304,1,219,84,21.04.2019 21:40,63,4,Zhitomir
208,202,33,55,120,33,153,0,153,2,123,28,21.04.2019 21:30,63,4,Zhitomir
640,628,5,286,349,5,354,0,354,11,264,79,21.04.2019 22:15,63,4,Zhitomir
1824,1799,39,668,1123,33,1156,0,1156,29,746,381,21.04.2019 23:40,63,4,Zhitomir
2096,2080,25,822,1252,22,1274,0,1274,27,881,366,21.04.2019 22:00,63,4,Zhitomir
1552,1534,30,596,931,25,956,0,956,19,708,229,21.04.2019 22:10,63,4,Zhitomir
640,630,74,250,318,72,390,0,390,2,293,95,21.04.2019 21:15,63,4,Zhitomir
640,627,16,300,324,16,340,0,340,8,274,58,21.04.2019 21:01,63,4,Zhitomir
352,342,17,132,204,16,220,0,220,1,169,50,21.04.2019 20:45,63,4,Zhitomir
816,803,30,284,503,29,532,0,532,14,411,107,21.04.2019 21:30,63,4,Zhitomir
160,17,4,143,13,4,17,0,17,0,15,2,22.04.2019 00:20,63,4,Zhitomir
2320,2299,17,898,1405,17,1422,0,1422,32,1101,289,21.04.2019 23:50,63,4,Zhitomir
1600,1574,18,626,962,12,974,0,974,25,718,231,22.04.2019 00:10,63,4,Zhitomir
1728,1707,18,704,1007,17,1024,0,1024,21,810,193,22.04.2019 00:15,63,4,Zhitomir
1360,1345,10,492,859,9,868,0,868,24,646,198,21.04.2019 22:25,63,4,Zhitomir
1264,1236,6,500,758,6,764,0,764,18,565,181,22.04.2019 00:30,63,4,Zhitomir
2352,2336,27,940,1394,18,1412,0,1412,42,1083,287,21.04.2019 22:45,63,4,Zhitomir
2064,2047,25,792,1252,20,1272,0,1272,18,921,333,21.04.2019 22:30,63,4,Zhitomir
1920,1897,28,770,1134,16,1150,0,1150,15,867,268,21.04.2019 21:10,63,4,Zhitomir
2304,2284,15,895,1399,10,1409,0,1409,51,1011,347,21.04.2019 21:32,63,4,Zhitomir
1136,1126,12,480,647,9,656,0,656,13,529,114,21.04.2019 21:30,63,4,Zhitomir
1760,1727,13,695,1055,10,1065,0,1065,14,793,258,21.04.2019 21:50,63,4,Zhitomir
1296,1283,13,546,738,12,750,0,750,11,569,170,21.04.2019 22:10,63,4,Zhitomir
2128,2089,22,827,1282,19,1301,0,1301,21,915,365,22.04.2019 00:06,63,4,Zhitomir
1872,1842,12,741,1121,10,1131,0,1131,27,886,218,21.04.2019 22:30,63,4,Zhitomir
1792,1770,11,780,1004,8,1012,0,1012,23,816,173,21.04.2019 22:36,63,4,Zhitomir
1920,1901,35,795,1094,31,1125,0,1125,33,843,249,21.04.2019 22:18,63,4,Zhitomir
1920,1889,25,780,1118,22,1140,0,1140,26,884,230,21.04.2019 22:00,63,4,Zhitomir
1360,1332,21,553,793,14,807,0,807,14,628,165,21.04.2019 21:50,63,4,Zhitomir
1600,1562,16,590,997,13,1010,0,1010,17,788,205,21.04.2019 22:13,63,4,Zhitomir
1376,1356,10,513,854,9,863,0,863,32,609,222,21.04.2019 22:10,63,4,Zhitomir
2112,2071,34,818,1264,30,1294,0,1294,24,932,338,21.04.2019 22:03,63,4,Zhitomir
2112,2076,16,827,1273,12,1285,0,1285,27,933,325,21.04.2019 20:51,63,4,Zhitomir
2272,2229,18,890,1371,11,1382,0,1382,37,1062,283,21.04.2019 21:45,63,4,Zhitomir
2144,2104,21,875,1252,17,1269,0,1269,34,892,343,21.04.2019 22:30,63,4,Zhitomir
2288,2217,7,917,1366,5,1371,0,1371,32,1014,325,21.04.2019 21:43,63,4,Zhitomir
2144,1970,15,966,1166,12,1178,0,1178,26,867,285,21.04.2019 22:00,63,4,Zhitomir
2192,2141,14,821,1360,11,1371,0,1371,36,1016,319,21.04.2019 22:32,63,4,Zhitomir
1024,990,7,420,598,6,604,0,604,18,451,135,21.04.2019 21:25,63,4,Zhitomir
1536,1503,7,645,885,6,891,0,891,22,667,202,22.04.2019 00:20,63,4,Zhitomir
1728,1703,17,736,976,16,992,0,992,29,725,238,21.04.2019 21:30,63,4,Zhitomir
1744,1721,15,686,1043,15,1058,0,1058,22,802,234,22.04.2019 00:15,63,4,Zhitomir
1888,1854,22,717,1154,17,1171,0,1171,28,834,309,21.04.2019 22:15,63,4,Zhitomir
1408,1388,15,577,819,12,831,0,831,27,582,222,22.04.2019 00:01,63,4,Zhitomir
1792,1753,10,713,1071,8,1079,0,1079,30,767,282,21.04.2019 21:00,63,4,Zhitomir
192,177,62,54,88,50,138,0,138,5,97,36,21.04.2019 21:15,63,4,Zhitomir
256,197,30,76,153,27,180,0,180,7,134,39,21.04.2019 20:25,63,4,Zhitomir
320,63,12,261,47,12,59,0,59,0,46,13,21.04.2019 20:35,63,4,Zhitomir
128,41,3,87,39,2,41,0,41,1,35,5,21.04.2019 21:27,63,4,Zhitomir
352,179,0,177,175,0,175,0,175,12,152,11,21.04.2019 21:10,63,4,Zhitomir
368,226,0,143,225,0,225,0,225,7,209,9,21.04.2019 20:30,63,4,Zhitomir
128,134,11,43,76,9,85,0,85,3,70,12,22.04.2019 00:00,64,4,Zhitomir
400,381,13,196,191,13,204,0,204,3,159,42,22.04.2019 00:20,64,4,Zhitomir
128,116,3,52,73,3,76,0,76,1,54,21,22.04.2019 00:25,64,4,Zhitomir
176,171,2,79,95,2,97,0,97,1,86,10,22.04.2019 00:37,64,4,Zhitomir
384,372,10,154,220,10,230,0,230,6,165,59,22.04.2019 00:30,64,4,Zhitomir
240,237,23,81,136,23,159,0,159,1,87,71,22.04.2019 00:54,64,4,Zhitomir
528,510,21,238,269,21,290,0,290,5,203,82,22.04.2019 00:15,64,4,Zhitomir
592,565,8,232,355,5,360,0,360,4,272,84,22.04.2019 00:30,64,4,Zhitomir
160,153,17,57,87,16,103,0,103,2,67,34,22.04.2019 00:15,64,4,Zhitomir
112,103,12,51,49,12,61,0,61,0,43,18,22.04.2019 00:25,64,4,Zhitomir
736,727,29,336,375,25,400,0,400,3,346,51,22.04.2019 00:20,64,4,Zhitomir
416,409,17,151,249,16,265,0,265,7,212,46,22.04.2019 00:15,64,4,Zhitomir
160,154,1,70,89,1,90,0,90,1,74,15,22.04.2019 00:30,64,4,Zhitomir
192,183,12,89,91,12,103,0,103,1,51,51,22.04.2019 01:00,64,4,Zhitomir
336,324,16,134,187,15,202,0,202,4,172,26,22.04.2019 00:10,64,4,Zhitomir
96,91,2,46,48,2,50,0,50,2,34,14,22.04.2019 00:30,64,4,Zhitomir
608,590,11,294,307,7,314,0,314,1,268,45,22.04.2019 00:05,64,4,Zhitomir
1024,1012,35,441,549,34,583,0,583,7,473,103,22.04.2019 00:15,64,4,Zhitomir
160,143,9,62,89,9,98,0,98,0,78,20,22.04.2019 00:15,64,4,Zhitomir
256,261,18,102,137,17,154,0,154,0,90,64,22.04.2019 00:45,64,4,Zhitomir
240,239,19,116,105,19,124,0,124,1,90,33,22.04.2019 00:10,64,4,Zhitomir
320,310,24,120,178,22,200,0,200,1,152,47,22.04.2019 00:15,64,4,Zhitomir
96,94,12,38,46,12,58,0,58,0,34,24,22.04.2019 00:40,64,4,Zhitomir
80,79,0,17,63,0,63,0,63,2,35,26,22.04.2019 00:20,64,4,Zhitomir
224,220,11,93,120,11,131,0,131,0,96,35,22.04.2019 00:15,64,4,Zhitomir
240,227,2,99,139,2,141,0,141,3,121,17,22.04.2019 00:03,64,4,Zhitomir
112,107,0,52,60,0,60,0,60,1,46,13,22.04.2019 01:10,64,4,Zhitomir
192,191,4,79,110,3,113,0,113,0,93,20,22.04.2019 00:00,64,4,Zhitomir
336,330,2,133,201,2,203,0,203,4,181,18,22.04.2019 00:20,64,4,Zhitomir
576,568,30,240,307,29,336,0,336,5,259,72,22.04.2019 00:05,64,4,Zhitomir
416,408,1,178,237,1,238,0,238,4,176,58,22.04.2019 00:19,64,4,Zhitomir
128,119,1,66,61,1,62,0,62,1,40,21,22.04.2019 00:20,64,4,Zhitomir
128,118,12,69,47,12,59,0,59,3,35,21,22.04.2019 01:00,64,4,Zhitomir
112,110,9,49,54,9,63,0,63,0,46,17,22.04.2019 00:34,64,4,Zhitomir
592,574,50,202,340,50,390,0,390,5,281,104,22.04.2019 00:12,64,4,Zhitomir
112,103,9,48,55,9,64,0,64,0,45,19,22.04.2019 00:15,64,4,Zhitomir
64,62,10,15,39,10,49,0,49,1,29,19,22.04.2019 00:05,64,4,Zhitomir
800,793,5,442,354,4,358,0,358,7,274,77,22.04.2019 01:22,64,4,Zhitomir
448,436,13,226,213,9,222,0,222,4,164,54,22.04.2019 00:32,64,4,Zhitomir
48,50,0,16,32,0,32,0,32,0,22,10,22.04.2019 00:15,64,4,Zhitomir
880,870,20,314,547,19,566,0,566,13,453,100,22.04.2019 00:15,64,4,Zhitomir
256,248,9,126,124,6,130,0,130,4,100,26,22.04.2019 00:43,64,4,Zhitomir
208,199,7,88,113,7,120,0,120,2,88,30,22.04.2019 00:45,64,4,Zhitomir
224,214,32,75,117,32,149,0,149,3,75,71,22.04.2019 00:25,64,4,Zhitomir
336,323,26,149,161,26,187,0,187,1,133,53,22.04.2019 00:14,64,4,Zhitomir
48,43,7,17,24,7,31,0,31,1,18,12,22.04.2019 00:10,64,4,Zhitomir
208,194,19,86,103,19,122,0,122,2,93,27,22.04.2019 00:35,64,4,Zhitomir
416,401,9,200,208,8,216,0,216,1,170,45,22.04.2019 00:00,64,4,Zhitomir
848,828,3,346,499,3,502,0,502,5,379,118,22.04.2019 00:20,64,4,Zhitomir
144,135,14,28,102,14,116,0,116,0,95,21,22.04.2019 00:07,64,4,Zhitomir
320,317,19,127,175,18,193,0,193,3,162,28,22.04.2019 00:10,64,4,Zhitomir
96,90,0,46,50,0,50,0,50,2,27,21,22.04.2019 00:05,64,4,Zhitomir
304,291,6,132,166,6,172,0,172,2,130,40,22.04.2019 00:27,64,4,Zhitomir
112,106,2,52,59,1,60,0,60,0,41,19,22.04.2019 00:20,64,4,Zhitomir
80,80,8,27,47,6,53,0,53,0,32,21,22.04.2019 00:05,64,4,Zhitomir
1008,985,26,386,596,26,622,0,622,10,484,128,22.04.2019 00:40,64,4,Zhitomir
128,122,18,44,66,18,84,0,84,0,69,15,22.04.2019 00:15,64,4,Zhitomir
144,143,5,36,103,5,108,0,108,4,80,24,22.04.2019 00:05,64,4,Zhitomir
256,241,8,79,169,8,177,0,177,2,145,30,22.04.2019 00:10,64,4,Zhitomir
160,153,21,71,68,21,89,0,89,3,66,20,22.04.2019 00:10,64,4,Zhitomir
144,144,8,64,73,7,80,0,80,2,51,27,22.04.2019 00:35,64,4,Zhitomir
320,313,20,128,172,20,192,0,192,4,131,57,22.04.2019 00:02,64,4,Zhitomir
192,181,12,80,101,11,112,0,112,1,78,33,22.04.2019 00:05,64,4,Zhitomir
64,64,3,29,34,1,35,0,35,1,21,13,22.04.2019 00:07,64,4,Zhitomir
192,186,17,90,85,17,102,0,102,2,89,11,22.04.2019 00:06,64,4,Zhitomir
32,38,0,2,30,0,30,0,30,0,23,7,22.04.2019 00:06,64,4,Zhitomir
352,340,27,132,193,27,220,0,220,9,177,34,22.04.2019 00:22,64,4,Zhitomir
96,82,8,47,41,8,49,0,49,0,29,20,22.04.2019 00:03,64,4,Zhitomir
192,185,9,81,103,8,111,0,111,0,84,27,22.04.2019 00:10,64,4,Zhitomir
80,72,3,30,47,3,50,0,50,0,40,10,22.04.2019 00:15,64,4,Zhitomir
112,103,1,46,65,1,66,0,66,2,45,19,22.04.2019 00:06,64,4,Zhitomir
208,203,12,84,112,12,124,0,124,3,89,32,22.04.2019 00:03,64,4,Zhitomir
48,46,2,22,24,2,26,0,26,1,17,8,22.04.2019 00:10,64,4,Zhitomir
336,317,20,128,188,20,208,0,208,1,152,55,22.04.2019 00:20,64,4,Zhitomir
528,522,4,244,280,4,284,0,284,5,244,35,22.04.2019 00:18,64,4,Zhitomir
32,14,0,18,14,0,14,0,14,0,11,3,22.04.2019 00:10,64,4,Zhitomir
32,15,0,18,14,0,14,0,14,1,8,5,22.04.2019 00:04,64,4,Zhitomir
1664,1654,7,793,867,4,871,0,871,14,676,181,22.04.2019 00:35,64,4,Zhitomir
1504,1485,7,685,814,5,819,0,818,13,624,181,22.04.2019 00:05,64,4,Zhitomir
384,372,1,171,212,1,213,0,213,2,159,52,22.04.2019 00:20,64,4,Zhitomir
320,308,4,167,150,3,153,0,153,1,107,45,22.04.2019 00:20,64,4,Zhitomir
304,281,2,174,130,0,130,0,130,0,110,20,22.04.2019 00:25,64,4,Zhitomir
1120,1095,7,505,608,7,615,0,615,7,446,162,22.04.2019 00:55,64,4,Zhitomir
80,80,8,26,48,6,54,0,54,1,30,23,22.04.2019 00:15,64,4,Zhitomir
112,101,8,38,66,8,74,0,74,0,51,23,22.04.2019 00:55,64,4,Zhitomir
208,195,20,81,108,19,127,0,127,3,83,41,22.04.2019 00:30,64,4,Zhitomir
272,266,32,143,100,29,129,0,129,2,107,20,22.04.2019 00:15,64,4,Zhitomir
544,534,3,241,301,2,303,0,303,5,224,74,22.04.2019 00:15,64,4,Zhitomir
256,252,20,127,109,20,129,0,129,2,92,35,22.04.2019 00:45,64,4,Zhitomir
544,525,8,286,251,7,258,0,258,0,211,47,22.04.2019 00:30,64,4,Zhitomir
112,102,3,60,50,2,52,0,52,0,42,10,22.04.2019 00:10,64,4,Zhitomir
80,72,1,32,47,1,48,0,48,1,26,21,22.04.2019 00:30,64,4,Zhitomir
256,243,17,88,151,17,168,0,168,9,94,65,22.04.2019 00:30,64,4,Zhitomir
144,132,0,71,73,0,73,0,73,0,51,22,22.04.2019 00:10,64,4,Zhitomir
288,286,3,140,146,2,148,0,148,0,112,36,22.04.2019 00:45,64,4,Zhitomir
656,632,1,298,357,1,358,0,358,11,300,47,22.04.2019 00:18,64,4,Zhitomir
112,111,5,72,35,5,40,0,40,0,29,11,22.04.2019 00:25,64,4,Zhitomir
272,256,1,111,160,1,161,0,161,2,120,39,22.04.2019 01:08,64,4,Zhitomir
320,297,3,175,142,3,145,0,145,3,97,45,22.04.2019 00:30,64,4,Zhitomir
432,423,11,220,203,9,212,0,212,3,157,52,22.04.2019 00:30,64,4,Zhitomir
736,714,8,364,368,4,372,0,372,9,271,92,22.04.2019 00:10,64,4,Zhitomir
496,487,0,254,242,0,242,0,242,1,169,72,22.04.2019 00:25,64,4,Zhitomir
400,389,6,235,159,6,165,0,165,4,109,52,22.04.2019 00:20,64,4,Zhitomir
688,671,3,351,334,3,337,0,337,6,212,119,22.04.2019 00:45,64,4,Zhitomir
288,284,0,146,142,0,142,0,142,1,98,43,22.04.2019 00:16,64,4,Zhitomir
240,226,1,111,128,1,129,0,129,4,83,42,22.04.2019 00:20,64,4,Zhitomir
224,216,1,113,110,1,111,0,111,0,82,29,22.04.2019 00:40,64,4,Zhitomir
80,21,2,61,17,2,19,0,19,0,16,3,22.04.2019 00:42,64,4,Zhitomir
1744,1714,24,707,1018,19,1037,0,1037,13,817,207,22.04.2019 00:20,64,4,Zhitomir
1808,1766,13,714,1084,10,1094,0,1094,20,876,198,22.04.2019 01:50,64,4,Zhitomir
2192,2145,24,914,1258,20,1278,0,1278,23,1017,238,22.04.2019 01:00,64,4,Zhitomir
2288,2231,11,890,1390,8,1398,0,1398,29,1129,240,22.04.2019 00:03,64,4,Zhitomir
1088,1085,14,438,641,9,650,0,650,16,539,95,22.04.2019 01:00,64,4,Zhitomir
1264,1235,5,537,724,3,727,0,727,9,591,127,22.04.2019 01:00,64,4,Zhitomir
2320,2256,13,936,1374,10,1384,0,1384,30,1148,206,22.04.2019 02:00,64,4,Zhitomir
560,546,37,208,315,37,352,0,352,4,289,59,22.04.2019 00:20,64,4,Zhitomir
304,294,25,105,174,25,199,0,199,2,144,53,22.04.2019 00:10,64,4,Zhitomir
432,419,15,169,249,14,263,0,263,6,212,45,22.04.2019 00:00,64,4,Zhitomir
272,258,9,57,206,9,215,0,215,6,113,96,22.04.2019 00:30,64,4,Zhitomir
448,436,5,141,302,5,307,0,307,5,190,112,22.04.2019 00:02,64,4,Zhitomir
1264,1245,14,568,682,14,696,0,696,16,568,112,22.04.2019 00:10,64,4,Zhitomir
112,113,6,56,50,6,56,0,56,1,30,25,22.04.2019 00:10,64,4,Zhitomir
144,134,0,63,81,0,81,0,81,1,66,14,22.04.2019 00:05,64,4,Zhitomir
608,588,11,296,301,11,312,0,312,5,267,40,22.04.2019 00:45,64,4,Zhitomir
304,281,13,171,120,13,133,0,133,0,115,18,22.04.2019 00:20,64,4,Zhitomir
128,125,8,49,71,8,79,0,79,2,52,25,22.04.2019 00:01,64,4,Zhitomir
96,86,6,40,50,6,56,0,56,1,48,7,22.04.2019 00:41,64,4,Zhitomir
560,548,6,187,367,6,373,0,373,3,305,65,22.04.2019 00:30,64,4,Zhitomir
272,255,9,92,171,9,180,0,180,5,139,36,22.04.2019 01:19,64,4,Zhitomir
448,431,4,203,241,4,245,0,245,5,209,31,22.04.2019 01:05,64,4,Zhitomir
32,29,1,14,17,1,18,0,18,0,12,6,22.04.2019 00:05,64,4,Zhitomir
336,326,32,136,168,32,200,0,200,1,174,25,22.04.2019 00:20,64,4,Zhitomir
560,554,25,196,340,24,364,0,364,13,265,86,22.04.2019 00:15,64,4,Zhitomir
176,168,20,40,117,19,136,0,136,2,114,20,22.04.2019 00:20,64,4,Zhitomir
1008,989,16,445,548,15,563,0,563,16,378,169,22.04.2019 00:40,64,4,Zhitomir
144,140,0,53,91,0,91,0,91,1,75,15,22.04.2019 00:10,64,4,Zhitomir
288,275,22,110,157,21,178,0,178,3,129,46,22.04.2019 00:20,64,4,Zhitomir
128,123,17,60,51,17,68,0,68,3,46,19,22.04.2019 00:25,64,4,Zhitomir
464,443,26,188,252,24,276,0,276,4,179,93,22.04.2019 00:10,64,4,Zhitomir
224,207,15,65,145,14,159,0,159,4,54,101,22.04.2019 00:30,64,4,Zhitomir
48,34,1,18,29,1,30,0,30,0,17,13,22.04.2019 00:15,64,4,Zhitomir
144,123,4,40,100,4,104,0,104,0,77,27,22.04.2019 00:00,64,4,Zhitomir
272,245,1,132,139,1,140,0,140,3,105,32,22.04.2019 00:15,64,4,Zhitomir
400,383,1,163,236,1,237,0,237,4,189,44,22.04.2019 00:30,64,4,Zhitomir
1136,1112,9,530,598,8,606,0,606,18,462,126,22.04.2019 00:05,64,4,Zhitomir
800,784,39,299,463,38,501,0,501,10,347,144,22.04.2019 01:30,64,4,Zhitomir
400,385,32,151,219,30,249,0,249,4,203,42,22.04.2019 00:10,64,4,Zhitomir
176,171,14,47,115,14,129,0,129,3,92,34,22.04.2019 00:15,64,4,Zhitomir
272,263,26,98,152,22,174,0,174,3,135,36,22.04.2019 00:25,64,4,Zhitomir
144,138,10,59,75,10,85,0,85,0,61,24,22.04.2019 02:30,64,4,Zhitomir
176,170,14,65,97,14,111,0,111,1,81,29,22.04.2019 00:30,64,4,Zhitomir
160,159,10,68,83,9,92,0,92,3,62,27,22.04.2019 00:25,64,4,Zhitomir
992,971,9,329,654,9,663,0,663,13,456,194,22.04.2019 02:58,64,4,Zhitomir
32,25,0,9,23,0,23,0,23,0,11,12,22.04.2019 00:44,64,4,Zhitomir
1056,1025,11,486,559,11,570,0,570,8,496,66,22.04.2019 00:45,64,4,Zhitomir
368,346,16,186,167,15,182,0,182,0,168,14,22.04.2019 00:40,64,4,Zhitomir
240,227,11,75,155,10,165,0,165,3,122,40,22.04.2019 01:00,64,4,Zhitomir
64,55,4,32,28,4,32,0,32,0,21,11,22.04.2019 00:15,64,4,Zhitomir
128,123,9,39,80,9,89,0,89,1,69,19,22.04.2019 00:40,64,4,Zhitomir
224,206,15,75,134,15,149,0,149,4,94,51,22.04.2019 00:30,64,4,Zhitomir
224,218,11,62,151,11,162,0,162,0,134,28,22.04.2019 00:25,64,4,Zhitomir
576,553,47,227,302,47,349,0,349,12,245,92,22.04.2019 00:15,64,4,Zhitomir
48,55,11,4,33,11,44,0,44,1,26,17,22.04.2019 00:35,64,4,Zhitomir
992,980,54,453,501,38,539,0,539,3,430,106,22.04.2019 00:10,64,4,Zhitomir
96,85,4,28,64,4,68,0,68,1,32,35,22.04.2019 00:15,64,4,Zhitomir
64,56,2,28,34,2,36,0,36,0,26,10,22.04.2019 01:30,64,4,Zhitomir
144,128,16,52,76,16,92,0,92,0,59,33,22.04.2019 00:40,64,4,Zhitomir
640,629,15,230,399,11,410,0,410,12,340,58,22.04.2019 00:30,64,4,Zhitomir
128,126,5,45,78,5,83,0,83,2,75,6,22.04.2019 00:10,64,4,Zhitomir
80,66,14,25,42,13,55,0,55,2,44,9,22.04.2019 00:05,64,4,Zhitomir
528,522,34,183,314,31,345,0,345,5,277,63,22.04.2019 00:15,64,4,Zhitomir
576,564,34,157,386,33,419,0,419,5,333,81,22.04.2019 00:15,64,4,Zhitomir
336,332,27,88,221,27,248,0,248,3,155,90,22.04.2019 00:05,64,4,Zhitomir
272,252,17,82,174,16,190,0,190,1,143,46,22.04.2019 00:10,64,4,Zhitomir
160,149,16,54,90,16,106,0,106,5,78,23,22.04.2019 02:00,64,4,Zhitomir
80,68,2,20,58,2,60,0,60,1,37,22,22.04.2019 00:20,64,4,Zhitomir
80,75,0,26,54,0,54,0,54,3,35,16,22.04.2019 00:34,64,4,Zhitomir
112,105,6,17,89,6,95,0,95,0,68,27,22.04.2019 00:50,64,4,Zhitomir
256,241,24,89,145,22,167,0,167,1,112,54,22.04.2019 00:05,64,4,Zhitomir
288,279,11,109,172,7,179,0,179,0,144,35,22.04.2019 01:00,64,4,Zhitomir
752,729,18,333,402,17,419,0,419,7,361,51,22.04.2019 00:03,64,4,Zhitomir
528,513,13,247,269,12,281,0,281,2,224,55,22.04.2019 00:30,64,4,Zhitomir
656,636,15,315,326,15,341,0,341,14,272,55,22.04.2019 01:10,64,4,Zhitomir
623,588,11,268,345,10,355,0,355,7,229,119,22.04.2019 00:30,64,4,Zhitomir
225,286,18,63,145,17,162,0,162,2,115,45,22.04.2019 00:15,64,4,Zhitomir
224,215,9,82,133,9,142,0,142,2,103,37,22.04.2019 00:35,64,4,Zhitomir
160,146,6,68,86,6,92,0,92,2,66,24,22.04.2019 00:00,64,4,Zhitomir
112,101,13,46,53,13,66,0,66,1,41,24,22.04.2019 00:31,64,4,Zhitomir
48,40,2,27,19,2,21,0,21,0,13,8,22.04.2019 00:10,64,4,Zhitomir
816,794,57,349,412,55,467,0,467,6,324,137,22.04.2019 00:30,64,4,Zhitomir
64,69,5,34,25,5,30,0,30,1,24,5,22.04.2019 00:10,64,4,Zhitomir
224,217,24,84,118,22,140,0,140,2,107,31,22.04.2019 00:30,64,4,Zhitomir
208,191,13,76,120,12,132,0,132,0,97,35,22.04.2019 00:05,64,4,Zhitomir
128,117,8,37,84,7,91,0,91,2,45,44,22.04.2019 00:20,64,4,Zhitomir
256,254,14,82,161,13,174,0,174,5,122,47,22.04.2019 00:15,64,4,Zhitomir
256,247,26,73,161,22,183,0,183,0,145,38,22.04.2019 00:30,64,4,Zhitomir
480,471,22,202,256,22,278,0,278,3,213,62,22.04.2019 00:18,64,4,Zhitomir
192,183,22,79,91,22,113,0,113,1,66,46,22.04.2019 00:20,64,4,Zhitomir
1968,1909,16,944,1010,14,1024,0,1024,18,827,179,22.04.2019 00:01,64,4,Zhitomir
640,627,7,360,273,7,280,0,280,2,204,74,22.04.2019 00:24,64,4,Zhitomir
272,257,7,120,147,5,152,0,152,0,136,16,22.04.2019 00:30,64,4,Zhitomir
128,119,5,57,66,5,71,0,71,1,57,13,22.04.2019 00:15,64,4,Zhitomir
208,47,15,166,29,13,42,0,42,1,30,11,22.04.2019 00:46,64,4,Zhitomir
80,20,4,61,15,4,19,0,19,0,11,8,22.04.2019 00:05,64,4,Zhitomir
128,76,1,84,43,1,44,0,44,1,29,14,22.04.2019 00:10,64,4,Zhitomir
608,591,17,290,302,16,318,0,318,3,226,89,22.04.2019 00:25,64,4,Zhitomir
480,473,3,233,244,3,247,0,247,1,180,66,22.04.2019 02:00,64,4,Zhitomir
432,421,2,219,212,1,213,0,213,0,142,71,22.04.2019 00:00,64,4,Zhitomir
192,177,0,80,112,0,112,0,112,1,72,39,22.04.2019 01:47,64,4,Zhitomir
144,132,1,46,97,1,98,0,98,2,75,21,22.04.2019 00:30,64,4,Zhitomir
1056,1036,20,611,425,20,445,0,445,5,364,76,22.04.2019 00:10,64,4,Zhitomir
1328,1287,2,718,608,2,610,0,610,10,491,109,22.04.2019 00:15,64,4,Zhitomir
512,488,1,262,249,1,250,0,250,14,166,70,22.04.2019 01:45,64,4,Zhitomir
1104,1087,0,590,514,0,514,0,514,14,375,125,22.04.2019 00:17,64,4,Zhitomir
560,553,0,276,284,0,284,0,284,4,175,105,22.04.2019 00:00,64,4,Zhitomir
48,43,0,19,29,0,29,0,29,0,13,16,22.04.2019 00:40,64,4,Zhitomir
80,71,1,33,47,0,47,0,47,2,14,31,22.04.2019 00:32,64,4,Zhitomir
48,40,0,20,28,0,28,0,28,0,12,16,22.04.2019 00:40,64,4,Zhitomir
1072,1055,1,376,695,1,696,0,696,12,540,144,22.04.2019 00:53,64,4,Zhitomir
400,386,0,201,199,0,199,0,199,2,166,31,22.04.2019 00:10,64,4,Zhitomir
176,170,3,66,107,3,110,0,110,0,86,24,22.04.2019 00:13,64,4,Zhitomir
288,274,0,107,181,0,181,0,181,4,133,44,22.04.2019 00:15,64,4,Zhitomir
736,733,2,301,433,2,435,0,435,4,353,78,22.04.2019 00:03,64,4,Zhitomir
144,137,0,57,87,0,87,0,87,1,73,13,22.04.2019 00:17,64,4,Zhitomir
1200,1177,18,584,598,18,616,0,616,11,505,100,22.04.2019 00:15,64,4,Zhitomir
208,207,0,41,167,0,167,0,167,7,133,27,22.04.2019 00:15,64,4,Zhitomir
112,107,0,20,92,0,92,0,92,2,62,28,22.04.2019 00:30,64,4,Zhitomir
256,242,1,95,160,1,161,0,161,2,100,59,22.04.2019 01:30,64,4,Zhitomir
512,495,17,225,270,17,287,0,287,6,242,39,22.04.2019 02:35,64,4,Zhitomir
800,775,12,298,490,12,502,0,502,6,396,100,22.04.2019 00:30,64,4,Zhitomir
640,641,0,256,384,0,384,0,384,3,269,112,22.04.2019 00:20,64,4,Zhitomir
256,255,0,95,161,0,161,0,161,0,121,40,22.04.2019 00:25,64,4,Zhitomir
496,484,3,206,287,3,290,0,290,4,231,55,22.04.2019 00:40,64,4,Zhitomir
192,179,8,64,120,8,128,0,128,4,107,17,22.04.2019 00:45,64,4,Zhitomir
176,165,0,65,111,0,111,0,111,3,91,17,22.04.2019 01:40,64,4,Zhitomir
80,74,0,41,39,0,39,0,39,0,26,13,22.04.2019 00:30,64,4,Zhitomir
768,759,0,336,432,0,432,0,432,5,351,76,22.04.2019 01:45,64,4,Zhitomir
304,286,4,150,150,4,154,0,154,6,127,21,22.04.2019 00:05,64,4,Zhitomir
176,167,1,61,114,1,115,0,115,0,101,14,22.04.2019 00:40,64,4,Zhitomir
272,255,0,115,157,0,157,0,157,1,127,29,22.04.2019 00:50,64,4,Zhitomir
160,149,0,58,102,0,102,0,102,0,69,33,22.04.2019 00:17,64,4,Zhitomir
320,310,0,120,200,0,200,0,200,4,131,65,22.04.2019 00:20,64,4,Zhitomir
144,136,0,60,84,0,84,0,84,0,54,30,22.04.2019 00:50,64,4,Zhitomir
112,105,0,37,75,0,75,0,75,0,62,13,22.04.2019 01:15,64,4,Zhitomir
336,316,7,124,205,7,212,0,212,5,139,68,22.04.2019 01:30,64,4,Zhitomir
128,114,7,46,75,7,82,0,82,1,63,18,22.04.2019 00:20,64,4,Zhitomir
256,242,0,96,160,0,160,0,160,4,117,39,22.04.2019 01:20,64,4,Zhitomir
944,909,27,399,520,25,545,0,545,4,417,124,22.04.2019 00:15,64,4,Zhitomir
288,274,2,146,140,2,142,0,142,3,105,34,22.04.2019 00:57,64,4,Zhitomir
1776,1755,1,914,861,1,862,0,862,8,712,142,22.04.2019 01:12,64,4,Zhitomir
224,206,0,87,137,0,137,0,137,3,89,45,22.04.2019 00:55,64,4,Zhitomir
96,81,0,44,52,0,52,0,52,1,22,29,22.04.2019 01:35,64,4,Zhitomir
1216,1198,0,564,652,0,652,0,652,13,475,164,22.04.2019 02:00,64,4,Zhitomir
448,444,1,155,292,1,293,0,293,5,220,68,22.04.2019 01:25,64,4,Zhitomir
80,71,0,16,64,0,64,0,64,0,49,15,22.04.2019 01:20,64,4,Zhitomir
48,42,0,24,24,0,24,0,24,0,14,10,22.04.2019 01:15,64,4,Zhitomir
464,460,1,234,229,1,230,0,230,5,177,48,22.04.2019 02:00,64,4,Zhitomir
1664,1632,1,951,712,1,713,0,713,11,527,175,22.04.2019 00:50,64,4,Zhitomir
1728,1709,5,697,1026,5,1031,0,1031,14,804,213,22.04.2019 02:20,64,4,Zhitomir
1395,1471,2,529,864,2,866,0,866,18,682,166,22.04.2019 01:10,64,4,Zhitomir
1853,1736,3,868,983,2,985,0,985,13,837,135,22.04.2019 00:10,64,4,Zhitomir
1664,1633,7,730,928,6,934,0,934,18,751,165,22.04.2019 01:30,64,4,Zhitomir
1920,1891,4,941,977,2,979,0,979,9,784,186,22.04.2019 01:55,64,4,Zhitomir
176,21,9,159,11,6,17,0,17,0,12,5,22.04.2019 00:20,64,4,Zhitomir
640,613,3,294,343,3,346,0,346,4,295,47,22.04.2019 00:10,64,4,Zhitomir
736,720,6,332,402,2,404,0,404,14,324,66,22.04.2019 00:52,64,4,Zhitomir
2256,2218,29,895,1340,21,1361,0,1361,37,1061,263,22.04.2019 00:20,64,4,Zhitomir
1872,1848,14,761,1101,10,1111,0,1111,27,915,169,22.04.2019 00:15,64,4,Zhitomir
1424,1401,147,529,761,134,895,0,895,25,692,178,22.04.2019 00:34,64,4,Zhitomir
1952,1926,19,701,1238,13,1251,0,1251,28,1036,187,22.04.2019 00:15,64,4,Zhitomir
2256,2224,27,808,1424,24,1448,0,1448,31,1172,245,22.04.2019 00:01,64,4,Zhitomir
2304,2284,13,972,1322,10,1332,0,1332,40,1096,196,22.04.2019 00:30,64,4,Zhitomir
1568,1558,23,599,949,20,969,0,969,22,777,170,22.04.2019 00:05,64,4,Zhitomir
2144,2102,19,830,1299,15,1314,0,1314,22,1060,232,22.04.2019 00:46,64,4,Zhitomir
720,713,10,253,459,8,467,0,467,10,373,84,22.04.2019 00:20,64,4,Zhitomir
1392,1376,13,504,878,10,888,0,888,34,689,165,22.04.2019 00:20,64,4,Zhitomir
1952,1926,19,726,1209,17,1226,0,1226,15,1007,204,22.04.2019 00:20,64,4,Zhitomir
1424,1396,5,580,841,3,844,0,844,19,691,134,22.04.2019 00:15,64,4,Zhitomir
1792,1748,10,706,1078,8,1086,0,1086,30,864,192,22.04.2019 00:11,64,4,Zhitomir
1584,1551,15,598,975,11,986,0,986,29,736,221,22.04.2019 00:03,64,4,Zhitomir
2032,1995,25,745,1267,20,1287,0,1287,32,1026,229,22.04.2019 00:25,64,4,Zhitomir
1952,1929,19,678,1264,10,1274,0,1274,28,1025,221,22.04.2019 00:33,64,4,Zhitomir
1536,1515,19,578,941,17,958,0,958,40,774,144,22.04.2019 00:10,64,4,Zhitomir
2016,1996,10,806,1202,8,1210,0,1210,31,993,186,22.04.2019 00:01,64,4,Zhitomir
2096,2072,17,907,1180,9,1189,0,1189,37,1003,149,22.04.2019 01:00,64,4,Zhitomir
2208,2182,13,958,1239,11,1250,0,1250,22,1022,206,22.04.2019 00:35,64,4,Zhitomir
1376,1348,9,597,774,5,779,0,779,12,637,130,22.04.2019 00:26,64,4,Zhitomir
1360,1337,9,551,803,6,809,0,809,26,663,120,22.04.2019 00:42,64,4,Zhitomir
1616,1559,11,668,940,8,948,0,948,20,775,153,22.04.2019 00:30,64,4,Zhitomir
1408,1379,18,655,736,17,753,0,753,10,627,116,22.04.2019 00:00,64,4,Zhitomir
1488,1476,10,660,820,8,828,0,828,13,680,135,22.04.2019 00:15,64,4,Zhitomir
896,877,5,387,506,3,509,0,509,11,423,75,22.04.2019 00:10,64,4,Zhitomir
1104,1076,9,461,637,6,643,0,643,18,544,81,22.04.2019 00:05,64,4,Zhitomir
400,381,5,185,210,5,215,0,215,4,174,37,22.04.2019 00:02,64,4,Zhitomir
784,777,6,380,398,6,404,0,404,1,358,45,22.04.2019 00:05,64,4,Zhitomir
368,62,34,312,24,32,56,0,56,2,47,7,22.04.2019 00:30,64,4,Zhitomir
128,35,18,96,16,16,32,0,32,0,23,9,22.04.2019 00:34,64,4,Zhitomir
864,779,0,185,679,0,679,0,679,28,617,34,22.04.2019 00:00,64,4,Zhitomir
80,73,0,35,45,0,45,0,45,0,27,18,22.04.2019 01:15,64,4,Zhitomir
2160,2102,43,875,1247,38,1285,0,1285,23,949,313,22.04.2019 02:40,65,4,Zhitomir
1952,1924,46,816,1093,43,1136,0,1136,17,911,208,22.04.2019 00:45,65,4,Zhitomir
1088,1066,26,443,626,19,645,0,645,16,507,122,21.04.2019 21:00,65,4,Zhitomir
368,354,24,155,189,24,213,0,213,6,169,38,22.04.2019 00:30,65,4,Zhitomir
1856,1839,39,865,957,34,991,0,991,13,807,171,22.04.2019 00:15,65,4,Zhitomir
128,120,5,59,64,5,69,0,69,2,39,28,22.04.2019 00:15,65,4,Zhitomir
176,169,7,81,89,6,95,0,95,0,69,26,22.04.2019 00:57,65,4,Zhitomir
1088,1065,55,405,635,48,683,0,683,15,574,94,22.04.2019 01:00,65,4,Zhitomir
1312,1291,77,581,673,58,731,0,731,22,603,106,22.04.2019 00:08,65,4,Zhitomir
1280,1264,59,548,682,50,732,0,732,21,575,136,22.04.2019 00:21,65,4,Zhitomir
1200,1179,29,528,645,27,672,0,672,9,490,173,22.04.2019 01:20,65,4,Zhitomir
352,346,29,122,206,24,230,0,230,3,130,97,22.04.2019 00:50,65,4,Zhitomir
320,196,7,124,189,7,196,0,196,1,111,84,22.04.2019 01:30,65,4,Zhitomir
544,532,25,158,361,25,386,0,386,4,284,98,22.04.2019 00:20,65,4,Zhitomir
448,436,32,161,259,28,287,0,287,2,195,90,22.04.2019 00:01,65,4,Zhitomir
1648,1638,43,748,863,37,900,0,900,20,633,247,22.04.2019 00:30,65,4,Zhitomir
112,108,11,46,55,11,66,0,66,2,49,15,22.04.2019 00:30,65,4,Zhitomir
80,63,1,30,49,1,50,0,50,0,35,15,22.04.2019 00:30,65,4,Zhitomir
48,40,1,19,28,1,29,0,29,0,24,5,22.04.2019 00:20,65,4,Zhitomir
448,432,27,182,244,22,266,0,266,1,222,43,22.04.2019 00:35,65,4,Zhitomir
64,62,7,26,34,4,38,0,38,2,32,4,22.04.2019 00:30,65,4,Zhitomir
240,222,6,127,107,6,113,0,113,2,89,22,22.04.2019 00:50,65,4,Zhitomir
320,301,16,128,177,15,192,0,192,2,152,38,22.04.2019 01:05,65,4,Zhitomir
608,602,34,294,285,29,314,0,314,1,246,67,22.04.2019 00:20,65,4,Zhitomir
208,191,12,90,110,8,118,0,118,0,83,35,22.04.2019 01:00,65,4,Zhitomir
112,101,7,47,60,5,65,0,65,0,42,23,21.04.2019 20:35,65,4,Zhitomir
672,655,18,296,358,18,376,0,376,9,316,51,22.04.2019 03:10,65,4,Zhitomir
480,467,14,204,266,10,276,0,276,4,202,70,22.04.2019 01:30,65,4,Zhitomir
288,284,10,106,173,9,182,0,182,3,123,56,22.04.2019 01:30,65,4,Zhitomir
96,88,1,27,68,1,69,0,69,1,38,30,21.04.2019 20:57,65,4,Zhitomir
176,169,16,46,115,15,130,0,130,0,67,63,22.04.2019 00:30,65,4,Zhitomir
112,106,9,41,62,9,71,0,71,3,52,16,22.04.2019 00:02,65,4,Zhitomir
256,242,30,104,128,24,152,0,152,2,98,52,22.04.2019 00:30,65,4,Zhitomir
96,84,12,45,43,8,51,0,51,1,33,17,22.04.2019 00:10,65,4,Zhitomir
640,619,33,319,293,28,321,0,321,4,205,112,22.04.2019 00:50,65,4,Zhitomir
432,411,18,199,216,17,233,0,233,2,163,68,22.04.2019 00:22,65,4,Zhitomir
496,476,40,152,309,35,344,0,344,3,246,95,22.04.2019 02:10,65,4,Zhitomir
80,76,13,23,44,13,57,0,57,0,29,28,22.04.2019 00:03,65,4,Zhitomir
112,101,4,51,57,4,61,0,61,5,36,20,22.04.2019 00:20,65,4,Zhitomir
528,513,48,173,311,44,355,0,355,9,229,117,22.04.2019 02:15,65,4,Zhitomir
48,46,0,5,43,0,43,0,43,0,18,25,22.04.2019 00:02,65,4,Zhitomir
288,283,18,81,189,18,207,0,207,0,162,45,21.04.2019 21:00,65,4,Zhitomir
96,83,1,63,33,0,33,0,33,0,12,21,21.04.2019 20:35,65,4,Zhitomir
112,110,6,48,59,5,64,0,64,1,45,18,22.04.2019 00:55,65,4,Zhitomir
80,75,2,18,60,2,62,0,62,0,43,19,22.04.2019 00:10,65,4,Zhitomir
160,151,6,54,102,4,106,0,106,0,94,12,22.04.2019 00:50,65,4,Zhitomir
176,33,19,150,12,14,26,0,26,0,20,6,22.04.2019 01:40,65,4,Zhitomir
272,256,30,92,150,30,180,0,180,0,100,80,22.04.2019 01:30,65,4,Zhitomir
368,348,18,195,158,15,173,0,173,2,91,80,22.04.2019 01:00,65,4,Zhitomir
176,170,17,75,85,16,101,0,101,1,76,24,22.04.2019 03:05,65,4,Zhitomir
96,84,11,28,57,11,68,0,68,1,39,28,22.04.2019 00:20,65,4,Zhitomir
80,76,11,33,36,11,47,0,47,0,38,9,22.04.2019 00:10,65,4,Zhitomir
336,329,3,178,156,2,158,0,158,6,122,30,22.04.2019 01:00,65,4,Zhitomir
208,200,18,86,105,17,122,0,122,2,87,33,22.04.2019 00:05,65,4,Zhitomir
176,174,13,70,93,13,106,0,106,1,74,31,22.04.2019 00:40,65,4,Zhitomir
208,195,2,43,163,2,165,0,165,1,100,64,22.04.2019 01:05,65,4,Zhitomir
448,439,30,212,206,30,236,0,236,3,166,67,22.04.2019 02:10,65,4,Zhitomir
160,156,4,65,91,4,95,0,95,2,57,36,22.04.2019 00:05,65,4,Zhitomir
80,74,1,38,41,1,42,0,42,0,26,16,22.04.2019 00:20,65,4,Zhitomir
1024,995,24,493,508,23,531,0,531,13,403,115,22.04.2019 01:30,65,4,Zhitomir
432,425,26,203,203,26,229,0,229,4,145,80,22.04.2019 00:40,65,4,Zhitomir
400,392,29,152,221,27,248,0,248,1,195,52,22.04.2019 00:15,65,4,Zhitomir
64,56,4,22,38,4,42,0,42,0,34,8,22.04.2019 00:18,65,4,Zhitomir
720,695,26,286,410,24,434,0,434,3,304,127,22.04.2019 00:10,65,4,Zhitomir
320,315,26,117,180,23,203,0,203,1,142,60,22.04.2019 00:40,65,4,Zhitomir
352,343,33,130,192,30,222,0,222,4,105,113,22.04.2019 00:45,65,4,Zhitomir
256,250,6,110,141,5,146,0,146,0,106,40,22.04.2019 00:20,65,4,Zhitomir
320,310,16,136,168,16,184,0,184,2,159,23,22.04.2019 00:10,65,4,Zhitomir
224,213,16,91,117,16,133,0,133,0,95,38,22.04.2019 00:07,65,4,Zhitomir
144,133,9,64,71,9,80,0,80,2,55,23,22.04.2019 00:02,65,4,Zhitomir
480,471,23,175,282,23,305,0,305,11,198,96,22.04.2019 00:05,65,4,Zhitomir
288,274,17,72,199,17,216,0,216,2,147,67,22.04.2019 00:10,65,4,Zhitomir
336,318,6,115,215,6,221,0,221,2,176,43,22.04.2019 00:20,65,4,Zhitomir
560,555,34,225,301,34,335,0,335,2,228,105,22.04.2019 01:30,65,4,Zhitomir
368,348,28,146,194,28,222,0,222,3,141,78,22.04.2019 01:50,65,4,Zhitomir
976,955,42,417,517,42,559,0,559,8,385,166,22.04.2019 00:30,65,4,Zhitomir
400,383,28,159,213,28,241,0,241,5,162,74,22.04.2019 03:40,65,4,Zhitomir
272,259,23,107,142,23,165,0,165,0,111,54,22.04.2019 00:45,65,4,Zhitomir
368,363,34,132,202,34,236,0,236,3,166,67,22.04.2019 00:46,65,4,Zhitomir
256,247,25,105,126,25,151,0,151,0,93,58,22.04.2019 01:10,65,4,Zhitomir
144,140,7,69,70,5,75,0,75,2,52,21,22.04.2019 00:03,65,4,Zhitomir
176,163,3,90,83,3,86,0,86,1,68,17,22.04.2019 00:05,65,4,Zhitomir
240,236,7,93,140,7,147,0,147,0,115,32,22.04.2019 00:20,65,4,Zhitomir
816,807,43,407,366,43,409,0,409,4,301,104,22.04.2019 00:15,65,4,Zhitomir
272,267,22,109,141,22,163,0,163,3,102,58,22.04.2019 01:05,65,4,Zhitomir
416,400,37,169,210,37,247,0,247,4,132,111,22.04.2019 00:15,65,4,Zhitomir
352,349,13,150,189,13,202,0,202,1,117,84,22.04.2019 01:20,65,4,Zhitomir
96,88,3,24,69,3,72,0,72,1,40,31,21.04.2019 21:00,65,4,Zhitomir
208,200,10,77,121,10,131,0,131,1,105,25,22.04.2019 00:37,65,4,Zhitomir
64,52,1,18,45,1,46,0,46,0,21,25,22.04.2019 00:20,65,4,Zhitomir
544,528,32,228,284,32,316,0,316,4,199,113,22.04.2019 01:30,65,4,Zhitomir
192,179,11,83,98,11,109,0,109,0,87,22,21.04.2019 23:47,65,4,Zhitomir
320,303,5,131,184,5,189,0,189,5,103,81,22.04.2019 00:45,65,4,Zhitomir
208,194,0,104,104,0,104,0,104,0,64,40,22.04.2019 00:10,65,4,Zhitomir
480,474,32,223,226,31,257,0,257,6,157,94,21.04.2019 23:05,65,4,Zhitomir
448,431,21,208,220,20,240,0,240,5,145,90,22.04.2019 00:15,65,4,Zhitomir
288,283,4,136,149,3,152,0,152,6,106,40,22.04.2019 00:25,65,4,Zhitomir
128,122,7,36,89,3,92,0,92,0,58,34,22.04.2019 00:15,65,4,Zhitomir
128,119,3,55,71,2,73,0,73,2,48,23,22.04.2019 00:15,65,4,Zhitomir
176,165,3,73,101,2,103,0,103,0,65,38,22.04.2019 00:45,65,4,Zhitomir
240,238,28,74,138,28,166,0,166,4,90,72,22.04.2019 00:15,65,4,Zhitomir
256,245,16,112,131,13,144,0,144,9,77,58,22.04.2019 00:10,65,4,Zhitomir
416,406,9,198,210,8,218,0,218,3,175,40,22.04.2019 00:05,65,4,Zhitomir
384,375,15,154,215,15,230,0,230,6,173,51,22.04.2019 00:20,65,4,Zhitomir
288,273,9,116,163,9,172,0,172,4,128,40,22.04.2019 00:24,65,4,Zhitomir
208,206,17,84,107,17,124,0,124,0,93,31,22.04.2019 00:10,65,4,Zhitomir
176,168,0,46,130,0,130,0,130,4,102,24,22.04.2019 00:30,65,4,Zhitomir
384,363,37,183,165,36,201,0,201,0,153,48,22.04.2019 00:25,65,4,Zhitomir
1344,1318,30,565,756,23,779,0,779,14,620,145,22.04.2019 00:35,65,4,Zhitomir
416,404,29,172,217,27,244,0,244,8,146,90,22.04.2019 00:10,65,4,Zhitomir
256,246,20,140,98,18,116,0,116,0,99,17,22.04.2019 00:35,65,4,Zhitomir
624,607,27,237,360,27,387,0,387,5,301,81,22.04.2019 00:10,65,4,Zhitomir
352,343,34,184,134,34,168,0,168,1,111,56,22.04.2019 00:10,65,4,Zhitomir
432,420,24,155,253,24,277,0,277,3,181,93,22.04.2019 00:10,65,4,Zhitomir
688,674,15,289,384,15,399,0,399,1,304,94,21.04.2019 21:00,65,4,Zhitomir
1152,1130,53,456,644,52,696,0,696,12,511,173,22.04.2019 00:10,65,4,Zhitomir
144,137,5,50,89,5,94,0,94,2,55,37,22.04.2019 00:03,65,4,Zhitomir
512,501,20,235,257,20,277,0,277,4,179,94,22.04.2019 00:48,65,4,Zhitomir
208,194,11,97,100,11,111,0,111,0,78,33,22.04.2019 00:20,65,4,Zhitomir
240,238,7,60,173,7,180,0,180,2,116,62,22.04.2019 00:17,65,4,Zhitomir
400,391,14,147,240,13,253,0,253,8,159,86,22.04.2019 00:05,65,4,Zhitomir
304,293,15,113,176,15,191,0,191,5,111,75,22.04.2019 00:30,65,4,Zhitomir
352,341,24,158,170,24,194,0,194,2,160,32,21.04.2019 22:30,65,4,Zhitomir
240,221,1,114,125,1,126,0,126,2,97,27,22.04.2019 00:14,65,4,Zhitomir
240,229,4,120,117,3,120,0,120,4,81,35,22.04.2019 01:10,65,4,Zhitomir
576,561,33,262,282,32,314,0,314,6,197,111,22.04.2019 00:15,65,4,Zhitomir
800,790,18,291,491,18,509,0,509,6,390,113,22.04.2019 00:15,65,4,Zhitomir
336,328,8,124,204,8,212,0,212,1,176,35,22.04.2019 00:10,65,4,Zhitomir
448,442,22,217,210,21,231,0,231,3,131,97,22.04.2019 00:30,65,4,Zhitomir
256,251,18,104,135,17,152,0,152,10,101,41,22.04.2019 00:30,65,4,Zhitomir
816,798,37,379,400,37,437,0,437,5,258,174,22.04.2019 00:02,65,4,Zhitomir
496,497,27,236,233,27,260,0,260,5,162,93,22.04.2019 00:05,65,4,Zhitomir
352,344,24,132,197,23,220,0,220,3,158,59,22.04.2019 00:35,65,4,Zhitomir
256,244,18,46,192,18,210,0,210,5,106,99,22.04.2019 03:40,65,4,Zhitomir
32,28,0,8,24,0,24,0,24,0,12,12,22.04.2019 00:10,65,4,Zhitomir
1280,1259,26,585,671,24,695,0,695,14,509,172,22.04.2019 00:30,65,4,Zhitomir
128,131,8,25,95,8,103,0,103,2,71,30,21.04.2019 22:55,65,4,Zhitomir
1664,1644,34,809,828,27,855,0,855,14,669,172,22.04.2019 00:46,65,4,Zhitomir
304,289,28,81,195,28,223,0,223,5,145,73,21.04.2019 23:00,65,4,Zhitomir
448,445,25,203,221,24,245,0,245,5,186,54,22.04.2019 00:05,65,4,Zhitomir
640,614,44,264,332,44,376,0,376,11,241,124,22.04.2019 01:45,65,4,Zhitomir
2176,2128,40,1043,1097,36,1133,0,1133,17,873,243,22.04.2019 00:50,65,4,Zhitomir
1744,1728,4,865,877,2,879,0,879,24,657,198,22.04.2019 00:15,65,4,Zhitomir
272,267,3,132,137,3,140,0,140,1,84,55,22.04.2019 00:15,65,4,Zhitomir
80,71,4,31,45,4,49,0,49,1,29,19,22.04.2019 01:30,65,4,Zhitomir
128,126,2,53,73,2,75,0,75,2,54,19,22.04.2019 00:35,65,4,Zhitomir
176,165,11,75,90,11,101,0,101,4,78,19,22.04.2019 00:30,65,4,Zhitomir
160,162,12,56,92,12,104,0,104,0,60,44,22.04.2019 00:15,65,4,Zhitomir
432,424,24,207,202,23,225,0,225,3,147,75,22.04.2019 00:05,65,4,Zhitomir
128,128,7,55,67,6,73,0,73,1,45,27,22.04.2019 00:45,65,4,Zhitomir
80,70,6,46,28,6,34,0,34,0,23,11,22.04.2019 00:30,65,4,Zhitomir
144,143,5,59,80,5,85,0,85,0,49,36,22.04.2019 00:55,65,4,Zhitomir
112,101,1,57,54,1,55,0,55,0,35,20,22.04.2019 00:45,65,4,Zhitomir
208,193,9,93,106,9,115,0,115,2,76,37,22.04.2019 00:30,65,4,Zhitomir
752,737,31,357,370,25,395,0,395,4,306,85,22.04.2019 01:10,65,4,Zhitomir
160,156,0,81,79,0,79,0,79,2,58,19,22.04.2019 00:10,65,4,Zhitomir
384,371,24,143,217,24,241,0,241,5,186,50,22.04.2019 00:45,65,4,Zhitomir
80,46,4,34,42,4,46,0,46,0,34,12,22.04.2019 00:20,65,4,Zhitomir
224,216,0,108,116,0,116,0,116,3,57,56,22.04.2019 00:05,65,4,Zhitomir
688,670,8,386,297,5,302,0,302,5,203,94,22.04.2019 00:15,65,4,Zhitomir
544,526,10,296,240,8,248,0,248,5,170,73,22.04.2019 00:05,65,4,Zhitomir
208,195,6,98,105,5,110,0,110,2,74,34,21.04.2019 23:25,65,4,Zhitomir
256,237,12,117,127,12,139,0,139,2,105,32,21.04.2019 22:00,65,4,Zhitomir
416,405,18,173,225,18,243,0,243,2,218,23,22.04.2019 01:20,65,4,Zhitomir
64,55,8,13,43,8,51,0,51,0,39,12,22.04.2019 00:16,65,4,Zhitomir
160,154,3,58,99,3,102,0,102,3,68,31,22.04.2019 00:05,65,4,Zhitomir
480,463,25,238,218,24,242,0,242,2,165,75,22.04.2019 00:50,65,4,Zhitomir
80,81,1,25,54,1,55,0,55,2,35,18,22.04.2019 00:10,65,4,Zhitomir
496,475,18,233,251,12,263,0,263,6,193,64,22.04.2019 00:21,65,4,Zhitomir
480,465,31,222,230,28,258,0,258,5,188,65,22.04.2019 00:40,65,4,Zhitomir
224,221,18,99,108,17,125,0,125,0,75,50,22.04.2019 00:10,65,4,Zhitomir
176,173,13,66,97,13,110,0,110,2,82,26,22.04.2019 03:00,65,4,Zhitomir
272,259,23,96,156,20,176,0,176,2,141,33,22.04.2019 00:40,65,4,Zhitomir
160,144,11,49,100,11,111,0,111,3,68,40,22.04.2019 00:50,65,4,Zhitomir
192,183,6,89,97,6,103,0,103,2,60,41,22.04.2019 00:10,65,4,Zhitomir
304,289,12,103,189,12,201,0,201,5,168,28,22.04.2019 00:35,65,4,Zhitomir
528,508,22,247,259,22,281,0,281,4,226,51,22.04.2019 00:20,65,4,Zhitomir
80,75,1,36,44,0,44,0,44,0,26,18,21.04.2019 23:30,65,4,Zhitomir
368,352,18,167,185,16,201,0,201,3,135,63,22.04.2019 00:35,65,4,Zhitomir
800,780,37,398,372,30,402,0,402,6,307,89,22.04.2019 00:27,65,4,Zhitomir
192,178,14,96,84,12,96,0,96,1,84,11,22.04.2019 00:15,65,4,Zhitomir
192,187,10,85,97,10,107,0,107,2,78,27,22.04.2019 00:30,65,4,Zhitomir
416,403,16,179,222,15,237,0,237,8,140,89,22.04.2019 02:00,65,4,Zhitomir
192,181,14,88,91,13,104,0,104,2,54,48,22.04.2019 01:10,65,4,Zhitomir
160,155,11,49,101,10,111,0,111,1,72,38,22.04.2019 00:20,65,4,Zhitomir
304,288,11,111,182,11,193,0,193,3,151,39,22.04.2019 00:05,65,4,Zhitomir
144,132,8,70,67,7,74,0,74,0,47,27,22.04.2019 00:15,65,4,Zhitomir
208,199,18,78,112,18,130,0,130,0,91,39,22.04.2019 00:10,65,4,Zhitomir
192,175,9,95,88,9,97,0,97,1,56,40,22.04.2019 00:16,65,4,Zhitomir
1216,1192,1,575,640,1,641,0,641,17,462,162,22.04.2019 01:55,65,4,Zhitomir
1200,1179,0,520,680,0,680,0,680,4,499,177,22.04.2019 00:20,65,4,Zhitomir
1023,987,6,467,550,6,556,0,556,9,407,140,22.04.2019 00:33,65,4,Zhitomir
480,467,4,221,255,4,259,0,259,5,181,73,22.04.2019 01:30,65,4,Zhitomir
272,264,16,105,151,16,167,0,167,0,134,33,22.04.2019 00:40,65,4,Zhitomir
112,108,3,41,68,3,71,0,71,2,46,23,22.04.2019 00:10,65,4,Zhitomir
128,20,2,108,18,2,20,0,20,0,13,7,22.04.2019 00:40,65,4,Zhitomir
2064,2021,28,949,1094,21,1115,0,1115,27,795,293,22.04.2019 00:21,65,4,Zhitomir
1056,1046,15,479,563,14,577,0,577,12,442,123,22.04.2019 00:15,65,4,Zhitomir
1008,993,30,382,603,23,626,0,626,15,477,134,22.04.2019 00:15,65,4,Zhitomir
1856,1818,47,773,1049,34,1083,0,1083,26,842,215,22.04.2019 01:15,65,4,Zhitomir
2160,2055,10,810,1340,10,1350,0,1350,29,1013,308,22.04.2019 00:35,65,4,Zhitomir
1760,1698,25,675,1066,19,1085,0,1085,30,847,208,22.04.2019 00:25,65,4,Zhitomir
1904,1639,7,923,976,5,981,0,981,19,730,232,22.04.2019 00:02,65,4,Zhitomir
1776,1697,20,750,1012,14,1026,0,1026,33,762,231,22.04.2019 00:02,65,4,Zhitomir
1344,1313,20,588,739,17,756,0,756,16,565,175,22.04.2019 00:03,65,4,Zhitomir
2256,2217,24,899,1340,17,1357,0,1357,35,1027,295,22.04.2019 00:10,65,4,Zhitomir
880,872,16,404,462,14,476,0,476,10,367,99,22.04.2019 00:05,65,4,Zhitomir
1936,1871,11,814,1113,9,1122,0,1122,30,839,253,22.04.2019 00:40,65,4,Zhitomir
1888,1851,32,797,1065,26,1091,0,1091,25,800,266,22.04.2019 02:35,65,4,Zhitomir
1696,1651,23,689,992,15,1007,0,1007,28,730,249,22.04.2019 01:10,65,4,Zhitomir
1920,1876,36,896,1007,17,1024,0,1024,21,764,239,22.04.2019 01:05,65,4,Zhitomir
1104,1088,23,483,598,23,621,0,621,16,456,149,22.04.2019 00:41,65,4,Zhitomir
1360,1340,24,558,785,17,802,0,802,18,641,143,22.04.2019 00:03,65,4,Zhitomir
2288,2245,36,995,1266,27,1293,0,1293,21,970,302,22.04.2019 00:09,65,4,Zhitomir
1888,1848,24,758,1108,22,1130,0,1130,18,877,235,22.04.2019 00:10,65,4,Zhitomir
1568,1530,18,650,907,11,918,0,918,25,676,217,22.04.2019 00:25,65,4,Zhitomir
1792,1739,12,733,1049,10,1059,0,1059,21,819,219,22.04.2019 00:50,65,4,Zhitomir
1504,1456,24,624,865,15,880,0,880,30,642,208,22.04.2019 00:45,65,4,Zhitomir
2048,2013,19,826,1208,14,1222,0,1222,30,870,322,22.04.2019 00:10,65,4,Zhitomir
1872,1825,15,688,1174,10,1184,0,1184,24,797,363,22.04.2019 00:10,65,4,Zhitomir
848,821,16,390,443,15,458,0,458,15,340,103,22.04.2019 00:45,65,4,Zhitomir
400,237,102,204,108,88,196,0,196,4,143,49,22.04.2019 00:10,65,4,Zhitomir
704,704,4,290,412,2,414,0,414,11,318,85,22.04.2019 00:40,66,4,Zhitomir
1184,1162,6,482,696,6,702,0,702,14,547,141,22.04.2019 00:10,66,4,Zhitomir
1104,1110,19,567,523,14,537,0,537,15,336,186,22.04.2019 02:30,66,4,Zhitomir
1152,1133,9,510,636,6,642,0,642,18,492,132,22.04.2019 00:20,66,4,Zhitomir
320,323,23,120,177,23,200,0,200,1,137,62,22.04.2019 00:02,66,4,Zhitomir
80,84,6,33,41,6,47,0,47,1,30,16,22.04.2019 00:05,66,4,Zhitomir
208,204,13,67,128,13,141,0,141,4,99,38,22.04.2019 00:30,66,4,Zhitomir
176,191,25,39,112,25,137,0,137,1,98,38,22.04.2019 00:30,66,4,Zhitomir
464,447,16,175,276,13,289,0,289,5,230,54,22.04.2019 01:20,66,4,Zhitomir
208,194,15,98,96,14,110,0,110,5,80,25,22.04.2019 00:20,66,4,Zhitomir
864,861,39,394,434,36,470,0,470,23,344,103,22.04.2019 01:15,66,4,Zhitomir
368,359,33,155,183,30,213,0,213,2,144,67,22.04.2019 00:15,66,4,Zhitomir
224,220,17,94,114,16,130,0,130,1,77,52,22.04.2019 00:02,66,4,Zhitomir
208,195,19,55,135,18,153,0,153,1,78,74,22.04.2019 00:10,66,4,Zhitomir
464,457,48,169,249,46,295,0,295,7,191,97,22.04.2019 00:05,66,4,Zhitomir
288,285,25,107,160,21,181,0,181,0,119,62,22.04.2019 00:10,66,4,Zhitomir
544,535,22,233,292,19,311,0,311,9,223,79,22.04.2019 00:15,66,4,Zhitomir
160,155,3,57,100,3,103,0,103,3,58,42,22.04.2019 00:10,66,4,Zhitomir
192,185,3,85,106,1,107,0,107,0,84,23,22.04.2019 00:10,66,4,Zhitomir
304,304,4,124,177,3,180,0,180,1,121,58,22.04.2019 01:30,66,4,Zhitomir
208,204,9,89,110,9,119,0,119,0,86,33,22.04.2019 00:10,66,4,Zhitomir
272,270,14,83,175,14,189,0,189,2,127,60,22.04.2019 00:30,66,4,Zhitomir
560,555,39,264,262,34,296,0,296,4,221,71,22.04.2019 02:05,66,4,Zhitomir
400,394,19,157,224,19,243,0,243,10,175,58,22.04.2019 00:05,66,4,Zhitomir
144,145,12,39,93,12,105,0,105,3,84,18,22.04.2019 00:09,66,4,Zhitomir
288,276,25,111,159,18,177,0,177,4,120,53,22.04.2019 00:01,66,4,Zhitomir
64,69,3,11,50,3,53,0,53,2,36,15,22.04.2019 02:00,66,4,Zhitomir
960,950,61,396,507,57,564,0,564,5,419,140,22.04.2019 00:15,66,4,Zhitomir
112,114,12,37,63,12,75,0,75,0,41,34,22.04.2019 00:05,66,4,Zhitomir
224,238,25,65,135,24,159,0,159,2,117,40,22.04.2019 00:26,66,4,Zhitomir
80,30,20,50,10,20,30,0,30,4,20,6,22.04.2019 00:15,66,4,Zhitomir
1504,1494,19,655,835,14,849,0,849,11,565,273,22.04.2019 00:18,66,4,Zhitomir
2064,2024,61,956,1057,51,1108,0,1108,21,750,337,22.04.2019 01:00,66,4,Zhitomir
1568,1544,12,702,857,9,866,0,866,11,593,262,22.04.2019 00:50,66,4,Zhitomir
1120,1103,31,580,519,21,540,0,540,8,356,176,22.04.2019 02:15,66,4,Zhitomir
1232,1210,18,526,693,13,706,0,706,16,519,171,22.04.2019 00:45,66,4,Zhitomir
1904,1885,22,760,1128,16,1144,0,1144,24,901,219,22.04.2019 02:10,66,4,Zhitomir
1808,1777,16,770,1027,11,1038,0,1038,25,801,212,22.04.2019 00:22,66,4,Zhitomir
2016,1988,72,921,1038,57,1095,0,1095,29,820,246,22.04.2019 03:00,66,4,Zhitomir
2064,2035,36,834,1203,27,1230,0,1230,17,912,301,22.04.2019 00:40,66,4,Zhitomir
304,299,24,114,170,20,190,0,190,2,116,72,22.04.2019 00:15,66,4,Zhitomir
384,372,35,148,203,33,236,0,236,4,180,52,22.04.2019 00:10,66,4,Zhitomir
400,403,42,158,208,34,242,0,242,4,149,89,22.04.2019 00:10,66,4,Zhitomir
512,511,62,232,220,60,280,0,280,2,169,109,22.04.2019 01:15,66,4,Zhitomir
448,431,16,154,279,15,294,0,294,0,187,107,22.04.2019 00:30,66,4,Zhitomir
288,273,20,121,149,18,167,0,167,0,82,85,22.04.2019 01:20,66,4,Zhitomir
528,518,20,267,245,16,261,0,261,5,204,52,22.04.2019 00:50,66,4,Zhitomir
512,508,59,154,299,59,358,0,358,7,236,115,22.04.2019 01:30,66,4,Zhitomir
272,265,23,122,127,23,150,0,150,0,85,65,22.04.2019 00:58,66,4,Zhitomir
432,420,29,226,180,26,206,0,206,4,119,83,22.04.2019 01:20,66,4,Zhitomir
512,497,12,262,240,10,250,0,250,10,170,70,22.04.2019 00:15,66,4,Zhitomir
128,123,10,62,56,10,66,0,66,1,33,32,22.04.2019 00:30,66,4,Zhitomir
320,315,15,129,180,11,191,0,191,1,126,64,22.04.2019 00:40,66,4,Zhitomir
688,665,70,295,336,57,393,0,393,7,252,134,22.04.2019 00:10,66,4,Zhitomir
320,307,20,137,165,18,183,0,183,3,110,70,22.04.2019 00:15,66,4,Zhitomir
192,191,12,58,122,12,134,0,134,0,101,33,22.04.2019 01:20,66,4,Zhitomir
960,944,77,497,399,64,463,0,463,4,294,165,22.04.2019 01:26,66,4,Zhitomir
256,250,3,122,131,3,134,0,134,1,100,33,22.04.2019 00:04,66,4,Zhitomir
400,384,6,193,201,6,207,0,207,5,153,49,22.04.2019 00:10,66,4,Zhitomir
416,411,17,188,215,13,228,0,228,6,136,86,22.04.2019 00:20,66,4,Zhitomir
336,320,16,167,157,12,169,0,169,2,95,72,22.04.2019 00:37,66,4,Zhitomir
512,497,20,210,286,16,302,0,302,6,232,64,22.04.2019 01:15,66,4,Zhitomir
192,183,9,74,109,9,118,0,118,1,97,20,22.04.2019 00:20,66,4,Zhitomir
224,203,13,103,109,12,121,0,121,3,98,20,22.04.2019 00:05,66,4,Zhitomir
416,395,9,192,216,8,224,0,224,1,182,41,22.04.2019 00:40,66,4,Zhitomir
288,286,22,125,148,15,163,0,163,4,116,43,22.04.2019 00:02,66,4,Zhitomir
160,148,12,77,73,10,83,0,83,1,60,22,22.04.2019 00:15,66,4,Zhitomir
304,302,46,137,124,43,167,0,167,1,118,48,22.04.2019 02:40,66,4,Zhitomir
320,311,29,139,156,25,181,0,181,3,156,22,22.04.2019 00:20,66,4,Zhitomir
256,252,40,108,111,37,148,0,148,3,98,47,22.04.2019 01:10,66,4,Zhitomir
144,41,12,105,28,11,39,0,39,0,20,19,22.04.2019 00:25,66,4,Zhitomir
2032,2014,16,687,1333,12,1345,0,1345,44,953,348,22.04.2019 03:30,66,4,Zhitomir
1632,1617,18,639,983,10,993,0,993,26,769,198,22.04.2019 00:35,66,4,Zhitomir
512,503,3,222,287,3,290,0,290,5,221,64,22.04.2019 00:30,66,4,Zhitomir
592,604,5,234,353,5,358,0,358,10,272,76,22.04.2019 00:05,66,4,Zhitomir
2272,2242,25,867,1386,19,1405,0,1405,29,1049,327,22.04.2019 00:30,66,4,Zhitomir
2080,2053,16,746,1319,15,1334,0,1334,22,981,331,22.04.2019 03:20,66,4,Zhitomir
1968,1938,27,767,1184,17,1201,0,1201,22,918,261,22.04.2019 00:22,66,4,Zhitomir
2048,2029,20,679,1353,16,1369,0,1369,27,1032,310,22.04.2019 02:33,66,4,Zhitomir
2176,2155,27,820,1333,23,1356,0,1356,32,1034,290,22.04.2019 00:25,66,4,Zhitomir
2080,2035,13,871,1200,9,1209,0,1209,23,903,283,22.04.2019 00:25,66,4,Zhitomir
256,252,8,108,141,7,148,0,148,2,98,48,22.04.2019 00:05,66,4,Zhitomir
720,706,7,359,355,6,361,0,361,6,268,87,22.04.2019 00:15,66,4,Zhitomir
112,104,0,46,66,0,66,0,66,1,53,12,22.04.2019 00:30,66,4,Zhitomir
128,126,9,44,77,7,84,0,84,2,62,20,22.04.2019 00:30,66,4,Zhitomir
192,182,16,76,102,14,116,0,116,2,80,34,22.04.2019 00:20,66,4,Zhitomir
192,187,26,58,111,23,134,0,134,1,87,46,22.04.2019 01:10,66,4,Zhitomir
416,405,42,158,217,41,258,0,258,10,169,79,22.04.2019 00:05,66,4,Zhitomir
368,358,39,143,194,31,225,0,225,2,180,43,22.04.2019 00:35,66,4,Zhitomir
160,157,19,53,89,18,107,0,107,2,80,25,22.04.2019 00:25,66,4,Zhitomir
528,517,56,198,283,47,330,0,330,4,187,139,22.04.2019 00:05,66,4,Zhitomir
256,244,10,121,129,6,135,0,135,1,80,54,22.04.2019 02:30,66,4,Zhitomir
128,117,17,48,66,14,80,0,80,0,60,20,22.04.2019 01:05,66,4,Zhitomir
64,63,9,25,31,8,39,0,39,0,10,29,22.04.2019 00:15,66,4,Zhitomir
400,398,3,158,239,3,242,0,242,1,178,63,22.04.2019 00:10,66,4,Zhitomir
496,479,8,188,300,8,308,0,308,6,275,27,22.04.2019 00:15,66,4,Zhitomir
384,374,25,154,206,24,230,0,230,11,169,50,22.04.2019 00:01,66,4,Zhitomir
368,355,15,133,220,15,235,0,235,8,179,48,22.04.2019 00:50,66,4,Zhitomir
128,115,12,52,66,10,76,0,76,2,51,23,22.04.2019 00:15,66,4,Zhitomir
272,270,25,54,195,23,218,0,218,2,159,57,22.04.2019 00:10,66,4,Zhitomir
288,287,36,87,172,29,201,0,201,1,118,82,22.04.2019 00:10,66,4,Zhitomir
144,133,3,61,80,3,83,0,83,1,50,32,22.04.2019 00:20,66,4,Zhitomir
416,396,31,159,228,29,257,0,257,6,165,86,22.04.2019 00:10,66,4,Zhitomir
560,562,22,218,325,17,342,0,342,4,242,96,22.04.2019 00:27,66,4,Zhitomir
112,109,19,37,56,19,75,0,75,1,54,20,22.04.2019 00:30,66,4,Zhitomir
1136,1132,66,422,654,60,714,0,714,13,537,164,22.04.2019 00:01,66,4,Zhitomir
1008,987,30,497,487,24,511,0,511,17,355,139,22.04.2019 01:15,66,4,Zhitomir
512,505,35,183,300,29,329,0,329,2,209,118,22.04.2019 00:21,66,4,Zhitomir
240,232,8,95,141,4,145,0,145,1,110,34,22.04.2019 02:50,66,4,Zhitomir
144,143,11,58,75,11,86,0,86,0,59,27,22.04.2019 00:30,66,4,Zhitomir
240,229,4,103,136,1,137,0,137,3,102,32,22.04.2019 00:45,66,4,Zhitomir
192,187,6,59,128,5,133,0,133,1,93,39,22.04.2019 00:05,66,4,Zhitomir
176,176,12,48,119,9,128,0,128,0,82,46,22.04.2019 00:05,66,4,Zhitomir
960,934,63,344,564,52,616,0,616,5,493,118,22.04.2019 00:28,66,4,Zhitomir
208,205,23,75,113,20,133,0,133,2,110,21,22.04.2019 02:15,66,4,Zhitomir
176,32,0,152,24,0,24,0,24,0,17,7,22.04.2019 00:30,66,4,Zhitomir
1152,1141,31,436,687,29,716,0,716,15,513,188,22.04.2019 00:31,66,4,Zhitomir
1552,1518,23,801,728,23,751,0,751,13,496,242,22.04.2019 01:15,66,4,Zhitomir
400,390,7,210,183,7,190,0,190,2,114,74,22.04.2019 02:30,66,4,Zhitomir
544,534,25,259,261,24,285,0,285,7,188,90,22.04.2019 00:46,66,4,Zhitomir
416,411,18,181,217,18,235,0,235,3,173,59,22.04.2019 00:05,66,4,Zhitomir
224,227,13,74,137,13,150,0,150,1,101,48,22.04.2019 00:15,66,4,Zhitomir
192,178,14,94,84,14,98,0,98,0,61,37,22.04.2019 00:15,66,4,Zhitomir
256,240,9,141,108,7,115,0,115,0,79,36,22.04.2019 00:15,66,4,Zhitomir
448,435,25,187,236,25,261,0,261,2,181,78,22.04.2019 00:15,66,4,Zhitomir
480,478,34,222,225,33,258,0,258,4,191,63,22.04.2019 00:30,66,4,Zhitomir
304,300,16,129,160,15,175,0,175,2,128,45,22.04.2019 00:10,66,4,Zhitomir
112,95,5,43,64,5,69,0,69,0,36,33,22.04.2019 00:15,66,4,Zhitomir
336,322,36,106,195,35,230,0,230,7,155,68,22.04.2019 00:15,66,4,Zhitomir
144,130,11,54,79,11,90,0,90,1,69,20,22.04.2019 00:02,66,4,Zhitomir
240,224,10,91,140,9,149,0,149,1,108,40,22.04.2019 00:15,66,4,Zhitomir
96,90,6,42,48,6,54,0,54,0,29,25,22.04.2019 01:50,66,4,Zhitomir
336,315,8,157,172,7,179,0,179,5,128,46,22.04.2019 00:20,66,4,Zhitomir
144,135,8,65,71,8,79,0,79,3,46,30,22.04.2019 00:05,66,4,Zhitomir
96,82,0,51,45,0,45,0,45,3,27,15,22.04.2019 00:15,66,4,Zhitomir
288,283,19,106,163,19,182,0,182,4,128,50,22.04.2019 00:18,66,4,Zhitomir
112,101,11,34,67,11,78,0,78,0,67,11,22.04.2019 00:10,66,4,Zhitomir
544,534,48,239,257,48,305,0,305,1,243,61,22.04.2019 00:07,66,4,Zhitomir
304,310,23,90,192,22,214,0,214,1,146,67,22.04.2019 00:03,66,4,Zhitomir
224,224,12,96,116,12,128,0,128,0,77,51,22.04.2019 00:02,66,4,Zhitomir
720,713,8,272,442,6,448,0,448,6,311,131,22.04.2019 00:50,66,4,Zhitomir
208,195,15,92,101,15,116,0,116,1,80,35,22.04.2019 00:30,66,4,Zhitomir
176,172,14,71,91,14,105,0,105,0,81,24,22.04.2019 00:00,66,4,Zhitomir
160,159,14,78,71,11,82,0,82,0,53,29,22.04.2019 00:03,66,4,Zhitomir
160,160,24,86,53,21,74,0,74,2,45,27,22.04.2019 00:15,66,4,Zhitomir
416,408,41,157,221,38,259,0,259,3,187,69,22.04.2019 00:35,66,4,Zhitomir
368,355,36,115,218,35,253,0,253,2,157,93,22.04.2019 02:45,66,4,Zhitomir
528,510,42,216,271,41,312,0,312,3,196,113,22.04.2019 00:05,66,4,Zhitomir
144,135,7,48,89,7,96,0,96,0,76,20,22.04.2019 00:05,66,4,Zhitomir
384,375,39,177,169,38,207,0,207,5,155,47,22.04.2019 00:30,66,4,Zhitomir
416,415,22,145,249,22,271,0,271,6,203,62,22.04.2019 00:20,66,4,Zhitomir
240,223,5,100,137,3,140,0,140,4,98,38,22.04.2019 01:25,66,4,Zhitomir
288,281,5,86,197,5,202,0,202,4,145,53,22.04.2019 00:30,66,4,Zhitomir
144,144,14,52,78,14,92,0,92,1,57,34,22.04.2019 00:02,66,4,Zhitomir
640,630,39,259,342,39,381,0,381,8,252,121,22.04.2019 00:01,66,4,Zhitomir
208,207,24,71,114,23,137,0,137,4,81,52,22.04.2019 00:16,66,4,Zhitomir
496,480,23,213,260,23,283,0,283,6,199,78,22.04.2019 00:15,66,4,Zhitomir
336,334,44,147,146,43,189,0,189,3,129,57,22.04.2019 02:50,66,4,Zhitomir
48,14,0,34,14,0,14,0,14,1,7,6,22.04.2019 00:05,66,4,Zhitomir
1936,1934,9,879,1049,8,1057,0,1057,28,894,135,22.04.2019 00:05,66,4,Zhitomir
368,378,2,154,212,2,214,0,214,2,151,61,22.04.2019 00:15,66,4,Zhitomir
176,162,0,79,97,0,97,0,97,0,76,21,21.04.2019 21:35,66,4,Zhitomir
352,338,0,171,181,0,181,0,181,11,129,41,22.04.2019 00:15,66,4,Zhitomir
96,94,0,50,46,0,46,0,46,0,33,13,22.04.2019 00:27,66,4,Zhitomir
96,89,0,44,52,0,52,0,52,0,40,12,22.04.2019 00:15,66,4,Zhitomir
160,152,13,66,83,11,94,0,94,1,62,31,22.04.2019 00:10,66,4,Zhitomir
272,259,6,158,108,6,114,0,114,2,72,40,22.04.2019 00:05,66,4,Zhitomir
288,273,1,111,176,1,177,0,177,0,138,39,22.04.2019 00:10,66,4,Zhitomir
176,168,11,57,108,11,119,0,119,0,73,46,22.04.2019 00:15,66,4,Zhitomir
416,402,7,168,241,7,248,0,248,6,202,40,22.04.2019 00:10,66,4,Zhitomir
240,219,1,112,127,1,128,0,128,5,91,32,22.04.2019 00:10,66,4,Zhitomir
160,144,0,81,79,0,79,0,79,3,44,32,22.04.2019 00:15,66,4,Zhitomir
208,193,10,75,123,10,133,0,133,2,82,49,22.04.2019 00:10,66,4,Zhitomir
224,209,13,81,130,13,143,0,143,4,111,28,22.04.2019 00:05,66,4,Zhitomir
336,326,20,112,204,20,224,0,224,5,141,78,22.04.2019 00:15,66,4,Zhitomir
320,307,6,131,183,6,189,0,189,3,141,45,22.04.2019 00:05,66,4,Zhitomir
336,342,8,149,179,8,187,0,187,1,157,29,22.04.2019 00:10,66,4,Zhitomir
224,215,6,83,135,6,141,0,141,2,88,51,22.04.2019 00:15,66,4,Zhitomir
192,183,4,72,116,4,120,0,120,1,97,22,21.04.2019 21:12,66,4,Zhitomir
192,182,14,69,109,14,123,0,123,2,99,22,22.04.2019 00:20,66,4,Zhitomir
64,21,8,45,12,7,19,0,19,0,16,3,22.04.2019 00:15,66,4,Zhitomir
752,752,4,311,437,4,441,0,441,5,300,136,22.04.2019 00:15,66,4,Zhitomir
1072,1041,1,484,588,0,588,0,588,17,391,180,22.04.2019 00:35,66,4,Zhitomir
1408,1383,5,618,785,5,790,0,790,20,568,202,22.04.2019 00:15,66,4,Zhitomir
1216,1204,8,563,647,6,653,0,653,18,442,193,22.04.2019 01:00,66,4,Zhitomir
1232,1214,1,540,691,1,692,0,692,18,523,151,22.04.2019 01:20,66,4,Zhitomir
1840,1820,9,782,1050,8,1058,0,1058,20,677,361,22.04.2019 02:58,66,4,Zhitomir
1312,1283,12,587,715,10,725,0,725,14,533,178,22.04.2019 00:55,66,4,Zhitomir
1648,1628,27,702,925,21,946,0,946,29,662,255,22.04.2019 00:20,66,4,Zhitomir
480,458,2,210,268,2,270,0,270,5,173,92,22.04.2019 00:15,66,4,Zhitomir
160,151,11,53,96,11,107,0,107,5,68,34,22.04.2019 00:07,66,4,Zhitomir
720,696,35,359,331,30,361,0,361,11,277,73,22.04.2019 00:10,66,4,Zhitomir
528,521,39,191,298,39,337,0,337,6,191,140,22.04.2019 00:20,66,4,Zhitomir
608,589,30,212,368,28,396,0,396,8,248,140,22.04.2019 00:10,66,4,Zhitomir
192,182,16,89,88,15,103,0,103,0,60,43,22.04.2019 00:15,66,4,Zhitomir
464,456,39,214,213,37,250,0,250,8,167,75,22.04.2019 00:55,66,4,Zhitomir
432,422,30,154,251,27,278,0,278,8,179,91,22.04.2019 00:20,66,4,Zhitomir
1040,1023,38,473,529,38,567,0,567,11,369,187,22.04.2019 01:10,66,4,Zhitomir
160,148,16,51,94,15,109,0,109,0,80,29,22.04.2019 00:05,66,4,Zhitomir
80,66,7,34,39,7,46,0,46,2,28,16,22.04.2019 01:35,66,4,Zhitomir
64,61,6,24,34,6,40,0,40,1,20,19,22.04.2019 00:15,66,4,Zhitomir
368,372,22,158,189,21,210,0,210,3,127,80,22.04.2019 01:42,66,4,Zhitomir
384,380,27,162,195,27,222,0,222,7,129,86,22.04.2019 00:13,66,4,Zhitomir
352,340,35,176,141,35,176,0,176,3,105,68,22.04.2019 00:20,66,4,Zhitomir
464,452,27,211,229,24,253,0,253,5,165,83,22.04.2019 00:20,66,4,Zhitomir
320,315,34,101,187,32,219,0,219,2,97,120,22.04.2019 00:30,66,4,Zhitomir
64,62,10,16,38,10,48,0,48,0,15,33,22.04.2019 00:30,66,4,Zhitomir
112,100,20,34,58,20,78,0,78,0,28,50,22.04.2019 00:45,66,4,Zhitomir
384,365,25,147,212,25,237,0,237,3,119,115,22.04.2019 02:15,66,4,Zhitomir
496,499,46,217,235,44,279,0,279,5,174,100,22.04.2019 00:25,66,4,Zhitomir
112,120,9,27,76,9,85,0,85,0,40,45,22.04.2019 00:10,66,4,Zhitomir
688,671,59,273,356,59,415,0,415,8,310,97,22.04.2019 00:08,66,4,Zhitomir
208,198,34,63,111,34,145,0,145,1,76,68,22.04.2019 00:05,66,4,Zhitomir
144,141,23,42,79,23,102,0,102,5,55,42,22.04.2019 00:15,66,4,Zhitomir
816,805,93,156,571,89,660,0,660,11,414,235,21.04.2019 22:00,66,4,Zhitomir
1024,1005,4,501,519,4,523,0,523,17,369,137,22.04.2019 00:12,66,4,Zhitomir
288,271,31,114,143,31,174,0,174,2,126,46,22.04.2019 02:00,66,4,Zhitomir
209,198,7,90,112,7,119,0,119,6,75,38,22.04.2019 00:10,66,4,Zhitomir
175,167,31,54,90,31,121,0,121,1,83,37,22.04.2019 02:20,66,4,Zhitomir
512,495,11,240,261,11,272,0,272,6,193,73,22.04.2019 00:15,66,4,Zhitomir
160,144,5,89,66,5,71,0,71,1,45,25,22.04.2019 00:10,66,4,Zhitomir
64,64,4,26,34,4,38,0,38,0,20,18,22.04.2019 00:02,66,4,Zhitomir
160,158,6,68,86,6,92,0,92,3,43,46,22.04.2019 00:10,66,4,Zhitomir
80,77,18,23,39,18,57,0,57,1,23,33,22.04.2019 00:15,66,4,Zhitomir
288,268,19,129,140,19,159,0,159,3,110,46,22.04.2019 00:10,66,4,Zhitomir
80,67,6,38,36,6,42,0,42,0,29,13,22.04.2019 00:06,66,4,Zhitomir
352,349,23,132,197,23,220,0,220,4,107,109,21.04.2019 20:40,66,4,Zhitomir
144,129,15,44,85,15,100,0,100,2,62,36,22.04.2019 00:58,66,4,Zhitomir
400,392,38,170,197,33,230,0,230,7,104,119,22.04.2019 00:15,66,4,Zhitomir
1376,1351,18,599,759,18,777,0,777,20,537,220,22.04.2019 02:30,66,4,Zhitomir
208,197,23,85,100,23,123,0,123,1,62,60,22.04.2019 01:02,66,4,Zhitomir
192,189,29,66,99,27,126,0,126,1,81,44,22.04.2019 01:40,66,4,Zhitomir
416,417,50,128,241,47,288,0,288,5,145,138,22.04.2019 00:15,66,4,Zhitomir
144,17,1,127,16,1,17,0,17,0,11,6,22.04.2019 00:15,66,4,Zhitomir
1792,1750,12,769,1013,10,1023,0,1023,26,800,197,22.04.2019 00:10,66,4,Zhitomir
2176,2144,9,895,1274,7,1281,0,1281,29,925,327,22.04.2019 01:35,66,4,Zhitomir
1888,1868,14,788,1090,10,1100,0,1100,14,878,208,22.04.2019 00:40,66,4,Zhitomir
2144,2115,14,907,1226,11,1237,0,1237,27,914,296,22.04.2019 01:35,66,4,Zhitomir
432,415,8,201,223,8,231,0,231,5,174,52,22.04.2019 00:35,66,4,Zhitomir
928,905,18,373,538,17,555,0,555,7,389,159,22.04.2019 00:15,66,4,Zhitomir
320,318,14,123,183,14,197,0,197,5,115,77,22.04.2019 00:15,66,4,Zhitomir
416,402,6,188,223,5,228,0,228,3,182,43,22.04.2019 00:30,66,4,Zhitomir
384,374,23,109,253,22,275,0,275,4,121,150,22.04.2019 02:40,66,4,Zhitomir
560,543,47,254,260,46,306,0,306,3,208,95,22.04.2019 00:25,66,4,Zhitomir
96,95,12,43,44,9,53,0,53,0,41,12,22.04.2019 03:15,66,4,Zhitomir
512,491,43,245,231,36,267,0,267,7,190,70,22.04.2019 02:13,66,4,Zhitomir
160,150,16,60,84,16,100,0,100,1,64,35,22.04.2019 00:20,66,4,Zhitomir
224,205,9,96,119,9,128,0,128,2,76,50,22.04.2019 04:00,66,4,Zhitomir
784,766,39,400,346,38,384,0,384,8,246,130,22.04.2019 00:40,66,4,Zhitomir
320,299,8,182,130,8,138,0,138,1,96,41,22.04.2019 00:05,66,4,Zhitomir
480,474,21,150,314,16,330,0,330,8,249,73,22.04.2019 04:15,66,4,Zhitomir
176,172,12,62,103,11,114,0,114,1,89,24,22.04.2019 00:35,66,4,Zhitomir
496,485,23,218,255,23,278,0,278,6,181,91,22.04.2019 00:11,66,4,Zhitomir
320,307,51,118,156,46,202,0,202,3,137,62,22.04.2019 01:05,66,4,Zhitomir
544,529,20,222,305,17,322,0,322,2,247,73,22.04.2019 01:10,66,4,Zhitomir
480,472,14,262,206,12,218,0,218,1,140,77,22.04.2019 00:15,66,4,Zhitomir
384,380,36,135,217,32,249,0,249,2,179,68,22.04.2019 00:50,66,4,Zhitomir
192,178,24,72,100,20,120,0,120,7,86,27,22.04.2019 01:20,66,4,Zhitomir
256,243,10,104,146,6,152,0,152,4,88,60,22.04.2019 00:40,66,4,Zhitomir
320,309,17,121,184,15,199,0,199,3,130,66,22.04.2019 01:00,66,4,Zhitomir
176,167,8,70,98,8,106,0,106,2,62,42,22.04.2019 00:10,66,4,Zhitomir
272,269,6,141,126,5,131,0,131,1,84,46,22.04.2019 00:15,66,4,Zhitomir
288,282,18,120,151,17,168,0,168,3,117,48,22.04.2019 00:15,66,4,Zhitomir
128,124,16,50,63,15,78,0,78,0,52,26,22.04.2019 00:30,66,4,Zhitomir
496,478,44,217,242,37,279,0,279,9,199,71,22.04.2019 00:45,66,4,Zhitomir
288,284,10,144,135,9,144,0,144,0,107,37,22.04.2019 00:30,66,4,Zhitomir
256,251,13,91,155,10,165,0,165,1,113,51,22.04.2019 00:45,66,4,Zhitomir
288,271,22,119,147,22,169,0,169,3,110,56,22.04.2019 01:00,66,4,Zhitomir
240,226,14,99,129,12,141,0,141,0,85,56,22.04.2019 00:10,66,4,Zhitomir
160,159,21,43,100,17,117,0,117,0,92,25,22.04.2019 00:10,66,4,Zhitomir
304,292,19,121,166,17,183,0,183,5,110,68,22.04.2019 00:45,66,4,Zhitomir
160,144,11,77,76,7,83,0,83,0,59,24,22.04.2019 01:00,66,4,Zhitomir
512,503,46,173,298,41,339,0,339,8,217,114,22.04.2019 00:30,66,4,Zhitomir
112,100,1,56,55,1,56,0,56,0,37,19,22.04.2019 00:10,66,4,Zhitomir
256,249,0,135,121,0,121,0,121,2,94,25,22.04.2019 00:45,66,4,Zhitomir
160,151,8,65,88,7,95,0,95,3,69,23,22.04.2019 00:10,66,4,Zhitomir
224,217,7,107,112,5,117,0,117,2,84,31,22.04.2019 00:20,66,4,Zhitomir
176,172,2,79,95,2,97,0,97,2,68,27,22.04.2019 01:15,66,4,Zhitomir
1232,1216,52,604,581,47,628,0,628,14,452,162,22.04.2019 00:04,66,4,Zhitomir
400,395,33,170,199,31,230,0,230,5,158,67,22.04.2019 00:10,66,4,Zhitomir
144,35,9,118,18,8,26,0,26,1,16,9,22.04.2019 00:15,66,4,Zhitomir
2208,2170,24,884,1304,20,1324,0,1324,30,895,399,22.04.2019 00:30,66,4,Zhitomir
2400,2371,14,922,1466,12,1478,0,1478,38,1106,334,22.04.2019 00:20,66,4,Zhitomir
2192,2172,4,884,1304,4,1308,0,1308,32,916,360,22.04.2019 00:18,66,4,Zhitomir
1520,1496,6,640,874,6,880,0,880,15,615,250,22.04.2019 01:45,66,4,Zhitomir
2080,2042,10,790,1281,9,1290,0,1290,31,829,430,22.04.2019 00:05,66,4,Zhitomir
2288,2251,9,914,1367,7,1374,0,1374,19,971,384,22.04.2019 00:45,66,4,Zhitomir
2384,2349,31,914,1446,24,1470,0,1470,28,1007,435,22.04.2019 00:15,66,4,Zhitomir
1824,1784,22,741,1068,15,1083,0,1083,20,718,345,22.04.2019 00:05,66,4,Zhitomir
2368,2355,20,884,1467,17,1484,0,1484,39,1001,444,22.04.2019 00:40,66,4,Zhitomir
2368,2334,7,947,1415,6,1421,0,1421,32,1018,371,22.04.2019 00:45,66,4,Zhitomir
224,19,2,206,16,2,18,0,18,0,9,9,22.04.2019 00:04,66,4,Zhitomir
2480,2324,3,1158,1319,3,1322,0,1322,24,1031,267,22.04.2019 00:23,66,4,Zhitomir
496,113,0,399,97,0,97,0,97,2,78,17,21.04.2019 20:30,67,4,Zhitomir
944,922,26,420,499,25,524,0,524,10,388,126,21.04.2019 23:55,67,4,Zhitomir
512,504,5,167,340,5,345,0,345,4,277,64,22.04.2019 00:25,67,4,Zhitomir
320,313,23,145,153,22,175,0,175,0,140,35,22.04.2019 00:35,67,4,Zhitomir
320,313,23,144,153,23,176,0,176,8,120,48,22.04.2019 00:05,67,4,Zhitomir
352,347,12,147,194,11,205,0,205,1,157,47,22.04.2019 01:42,67,4,Zhitomir
304,274,24,132,149,23,172,0,172,6,124,42,22.04.2019 00:30,67,4,Zhitomir
208,206,19,78,113,17,130,0,130,4,92,34,22.04.2019 00:17,67,4,Zhitomir
640,626,37,317,291,32,323,0,323,6,238,79,21.04.2019 21:00,67,4,Zhitomir
1696,1670,17,665,1017,14,1031,0,1031,22,783,226,22.04.2019 01:30,67,4,Zhitomir
608,588,23,204,382,22,404,0,404,9,71,324,22.04.2019 01:30,67,4,Zhitomir
128,116,0,68,60,0,60,0,60,2,41,17,22.04.2019 00:15,67,4,Zhitomir
352,333,16,151,185,16,201,0,201,5,138,58,22.04.2019 01:20,67,4,Zhitomir
384,366,9,191,184,9,193,0,193,1,140,52,22.04.2019 00:03,67,4,Zhitomir
1312,1278,13,592,711,9,720,0,720,14,572,134,22.04.2019 00:18,67,4,Zhitomir
320,297,21,158,141,21,162,0,162,3,112,47,22.04.2019 00:20,67,4,Zhitomir
128,114,10,46,72,10,82,0,82,0,72,10,22.04.2019 00:30,67,4,Zhitomir
632,594,15,371,246,15,261,0,261,7,175,79,22.04.2019 00:20,67,4,Zhitomir
360,375,28,131,202,27,229,0,229,2,157,70,22.04.2019 01:45,67,4,Zhitomir
2304,2291,7,897,1400,7,1407,0,1406,29,968,409,22.04.2019 02:00,67,4,Zhitomir
480,462,4,198,278,4,282,0,282,7,226,49,22.04.2019 01:10,67,4,Zhitomir
480,472,16,175,289,16,305,0,305,6,195,104,22.04.2019 00:30,67,4,Zhitomir
976,967,26,381,572,23,595,0,595,20,443,132,22.04.2019 00:10,67,4,Zhitomir
208,195,16,106,87,15,102,0,101,2,84,15,22.04.2019 00:56,67,4,Zhitomir
2124,2076,28,819,1281,24,1305,0,1305,32,983,290,22.04.2019 00:20,67,4,Zhitomir
180,186,1,82,97,1,98,0,98,3,59,36,22.04.2019 00:15,67,4,Zhitomir
1792,1796,31,755,1011,26,1037,0,1037,20,799,218,22.04.2019 01:25,67,4,Zhitomir
192,185,35,17,140,35,175,0,175,16,87,72,22.04.2019 00:15,67,4,Zhitomir
896,894,40,376,481,39,520,0,520,11,376,133,21.04.2019 22:14,67,4,Zhitomir
320,317,10,132,180,8,188,0,188,2,151,35,22.04.2019 00:20,67,4,Zhitomir
608,594,30,265,321,22,343,0,343,7,276,60,22.04.2019 01:15,67,4,Zhitomir
1088,1083,4,362,724,2,726,0,726,13,540,173,22.04.2019 00:40,67,4,Zhitomir
528,516,1,206,321,1,322,0,322,9,267,46,21.04.2019 23:20,67,4,Zhitomir
1520,1499,70,673,786,61,847,0,847,16,660,171,22.04.2019 02:15,67,4,Zhitomir
384,366,25,149,216,19,235,0,235,0,181,54,21.04.2019 20:50,67,4,Zhitomir
192,180,9,68,115,9,124,0,124,1,79,44,21.04.2019 23:51,67,4,Zhitomir
2352,2328,15,1060,1278,14,1292,0,1292,27,956,309,22.04.2019 00:15,67,4,Zhitomir
528,523,2,151,377,0,377,0,377,9,284,84,22.04.2019 00:15,67,4,Zhitomir
512,501,25,204,284,24,308,0,308,1,209,98,22.04.2019 02:00,67,4,Zhitomir
1104,1083,93,453,568,83,651,0,651,19,443,189,22.04.2019 02:05,67,4,Zhitomir
1072,1045,85,337,654,81,735,0,735,22,530,183,22.04.2019 01:10,67,4,Zhitomir
384,377,24,81,279,24,303,0,303,4,221,78,22.04.2019 00:45,67,4,Zhitomir
560,542,24,237,299,24,323,0,323,5,199,119,22.04.2019 00:10,67,4,Zhitomir
944,975,8,338,600,6,606,0,606,22,441,143,22.04.2019 00:05,67,4,Zhitomir
1920,1890,5,703,1212,5,1217,0,1217,32,990,195,22.04.2019 00:28,67,4,Zhitomir
1936,1917,10,628,1301,7,1308,0,1308,35,987,286,22.04.2019 00:35,67,4,Zhitomir
1664,1631,29,516,1126,22,1148,0,1148,28,895,225,22.04.2019 00:30,67,4,Zhitomir
1152,1129,18,361,774,17,791,0,791,15,605,171,22.04.2019 01:10,67,4,Zhitomir
1808,1755,29,686,1102,20,1122,0,1122,13,888,221,22.04.2019 00:15,67,4,Zhitomir
576,566,43,264,273,39,312,0,312,10,231,71,22.04.2019 00:50,67,4,Zhitomir
1472,1455,38,523,916,33,949,0,949,10,691,248,22.04.2019 00:45,67,4,Zhitomir
320,304,14,152,154,14,168,0,168,3,126,39,22.04.2019 00:15,67,4,Zhitomir
1088,1063,74,263,751,74,825,0,825,22,655,148,22.04.2019 01:00,67,4,Zhitomir
544,528,13,213,319,12,331,0,331,4,278,49,22.04.2019 00:19,67,4,Zhitomir
272,266,41,97,138,37,175,0,175,3,107,65,22.04.2019 00:20,67,4,Zhitomir
128,127,26,33,69,26,95,0,95,0,63,32,21.04.2019 21:05,67,4,Zhitomir
144,141,21,35,88,21,109,0,109,1,67,41,22.04.2019 02:00,67,4,Zhitomir
832,825,43,385,408,39,447,0,447,5,324,118,22.04.2019 00:40,67,4,Zhitomir
1504,1509,6,589,909,6,915,0,915,33,692,190,22.04.2019 00:32,67,4,Zhitomir
1072,1050,5,422,645,5,650,0,650,11,507,132,22.04.2019 02:05,67,4,Zhitomir
432,413,20,207,205,20,225,0,225,8,173,44,22.04.2019 00:10,67,4,Zhitomir
304,297,7,113,184,7,191,0,191,3,134,54,22.04.2019 02:45,67,4,Zhitomir
1744,1712,45,735,981,28,1009,0,1009,13,752,244,22.04.2019 00:30,67,4,Zhitomir
656,635,23,250,386,20,406,0,406,14,331,61,22.04.2019 00:32,67,4,Zhitomir
2320,2280,35,965,1322,33,1355,0,1355,28,1020,307,22.04.2019 01:40,67,4,Zhitomir
1360,1337,14,713,633,14,647,0,647,17,468,162,22.04.2019 00:20,67,4,Zhitomir
256,243,19,117,120,19,139,0,139,4,113,22,22.04.2019 00:46,67,4,Zhitomir
160,59,0,124,36,0,36,0,36,0,28,8,22.04.2019 01:29,67,4,Zhitomir
480,324,41,208,234,38,272,0,272,18,181,73,22.04.2019 00:44,67,4,Zhitomir
224,78,46,151,31,42,73,0,73,2,49,22,22.04.2019 01:40,67,4,Zhitomir
416,48,0,383,33,0,33,0,33,0,23,10,22.04.2019 01:30,67,4,Zhitomir
352,81,4,275,73,4,77,0,77,5,57,15,22.04.2019 00:50,67,4,Zhitomir
1696,1664,15,683,1001,12,1013,0,1013,27,789,197,21.04.2019 22:45,67,4,Zhitomir
656,636,27,276,356,24,380,0,380,8,249,123,21.04.2019 21:33,67,4,Zhitomir
288,283,17,37,234,17,251,0,251,1,165,85,21.04.2019 20:45,67,4,Zhitomir
448,434,33,126,292,30,322,0,322,1,237,84,21.04.2019 22:30,67,4,Zhitomir
416,404,47,106,267,43,310,0,310,10,233,67,22.04.2019 00:30,67,4,Zhitomir
160,155,11,59,90,11,101,0,101,2,83,16,22.04.2019 00:15,67,4,Zhitomir
608,588,29,277,303,28,331,0,331,11,199,121,22.04.2019 00:20,67,4,Zhitomir
192,173,18,69,107,16,123,0,123,1,92,30,21.04.2019 21:15,67,4,Zhitomir
544,532,54,196,296,52,348,0,348,9,258,81,22.04.2019 00:50,67,4,Zhitomir
464,451,34,209,233,22,255,0,255,2,185,68,22.04.2019 00:04,67,4,Zhitomir
144,137,11,50,84,10,94,0,94,1,49,44,21.04.2019 22:35,67,4,Zhitomir
112,109,11,39,63,10,73,0,73,4,48,21,21.04.2019 22:00,67,4,Zhitomir
224,219,27,94,107,23,130,0,130,1,87,42,22.04.2019 00:10,67,4,Zhitomir
352,342,24,117,215,20,235,0,235,4,184,47,22.04.2019 02:00,67,4,Zhitomir
336,331,24,106,209,21,230,0,230,4,153,73,22.04.2019 00:10,67,4,Zhitomir
128,113,5,60,64,4,68,0,68,1,51,16,21.04.2019 21:50,67,4,Zhitomir
240,222,6,79,155,6,161,0,161,0,135,26,21.04.2019 21:40,67,4,Zhitomir
176,173,173,68,105,3,108,0,108,2,85,21,22.04.2019 01:10,67,4,Zhitomir
208,199,18,91,100,17,117,0,117,5,89,23,21.04.2019 20:40,67,4,Zhitomir
384,365,26,168,196,20,216,0,216,1,137,78,22.04.2019 00:40,67,4,Zhitomir
1264,1240,41,490,736,38,774,0,774,12,579,183,22.04.2019 00:50,67,4,Zhitomir
720,709,28,316,378,26,404,0,404,9,325,70,22.04.2019 00:18,67,4,Zhitomir
192,191,4,72,116,4,120,0,120,1,94,25,21.04.2019 23:50,67,4,Zhitomir
624,610,30,115,480,29,509,0,509,18,307,184,21.04.2019 20:40,67,4,Zhitomir
352,342,22,141,191,20,211,0,211,1,163,47,21.04.2019 20:30,67,4,Zhitomir
656,597,59,240,363,53,416,0,416,4,289,123,22.04.2019 00:10,67,4,Zhitomir
176,162,14,57,108,11,119,0,119,4,68,47,21.04.2019 23:15,67,4,Zhitomir
240,235,18,108,119,13,132,0,132,2,103,27,22.04.2019 00:35,67,4,Zhitomir
96,94,8,39,52,5,57,0,57,1,32,24,22.04.2019 00:12,67,4,Zhitomir
960,942,54,333,581,46,627,0,627,11,511,105,22.04.2019 00:20,67,4,Zhitomir
1024,1015,76,389,577,58,635,0,635,10,466,159,22.04.2019 00:15,67,4,Zhitomir
464,454,41,176,250,38,288,0,288,7,181,100,22.04.2019 01:22,67,4,Zhitomir
1152,1138,28,484,647,21,668,0,668,8,516,144,22.04.2019 00:15,67,4,Zhitomir
368,347,11,134,224,10,234,0,234,5,191,38,21.04.2019 21:50,67,4,Zhitomir
1200,1181,2,561,637,2,639,0,639,12,507,120,21.04.2019 23:15,67,4,Zhitomir
448,429,32,158,262,28,290,0,290,3,206,81,22.04.2019 00:03,67,4,Zhitomir
288,272,22,98,171,19,190,0,190,1,124,65,22.04.2019 00:25,67,4,Zhitomir
784,770,54,360,377,47,424,0,424,8,309,107,22.04.2019 00:30,67,4,Zhitomir
240,237,13,79,149,12,161,0,161,5,104,52,22.04.2019 01:26,67,4,Zhitomir
208,204,16,77,119,12,131,0,131,1,100,30,22.04.2019 01:45,67,4,Zhitomir
432,424,40,182,215,35,250,0,250,2,190,58,21.04.2019 20:30,67,4,Zhitomir
896,888,19,334,543,19,562,0,562,10,446,106,22.04.2019 00:30,67,4,Zhitomir
688,677,13,267,410,11,421,0,421,7,336,78,22.04.2019 01:25,67,4,Zhitomir
128,29,3,101,25,2,27,0,27,0,18,9,21.04.2019 22:11,67,4,Zhitomir
1424,1412,71,555,801,68,869,0,869,11,657,201,22.04.2019 00:32,67,4,Zhitomir
224,219,11,69,144,11,155,0,155,2,114,39,21.04.2019 21:20,67,4,Zhitomir
1616,1573,31,716,873,27,900,0,900,17,648,235,22.04.2019 00:20,67,4,Zhitomir
1584,1554,46,768,776,40,816,0,816,20,605,191,22.04.2019 00:25,67,4,Zhitomir
1760,1727,38,721,1007,32,1039,0,1039,20,781,238,22.04.2019 00:10,67,4,Zhitomir
1040,1019,23,413,605,22,627,0,627,9,451,167,21.04.2019 21:54,67,4,Zhitomir
816,793,18,414,389,13,402,0,402,7,306,89,22.04.2019 00:20,67,4,Zhitomir
1248,1203,17,512,723,13,736,0,736,13,492,231,22.04.2019 00:10,67,4,Zhitomir
608,600,33,255,326,27,353,0,353,5,251,97,21.04.2019 21:30,67,4,Zhitomir
1072,1043,20,530,527,15,542,0,542,10,372,160,22.04.2019 00:10,67,4,Zhitomir
240,229,10,104,127,9,136,0,136,1,105,30,21.04.2019 22:25,67,4,Zhitomir
304,297,13,137,157,10,167,0,167,4,105,58,22.04.2019 00:15,67,4,Zhitomir
304,294,11,114,180,10,190,0,190,2,159,29,22.04.2019 00:27,67,4,Zhitomir
512,517,49,158,305,49,354,0,354,4,262,88,21.04.2019 20:55,67,4,Zhitomir
736,725,25,315,402,19,421,0,421,6,265,150,21.04.2019 21:22,67,4,Zhitomir
256,238,34,85,139,32,171,0,171,4,104,63,21.04.2019 21:30,67,4,Zhitomir
144,132,16,56,73,15,88,0,88,0,56,32,21.04.2019 21:00,67,4,Zhitomir
448,437,27,185,241,22,263,0,263,5,169,89,21.04.2019 21:20,67,4,Zhitomir
560,537,51,222,293,45,338,0,338,13,216,109,21.04.2019 21:00,67,4,Zhitomir
160,146,10,73,77,10,87,0,87,1,65,21,21.04.2019 20:30,67,4,Zhitomir
640,624,46,303,295,42,337,0,337,4,228,105,22.04.2019 00:05,67,4,Zhitomir
80,83,10,23,48,9,57,0,57,1,45,11,21.04.2019 20:50,67,4,Zhitomir
192,182,12,70,112,10,122,0,122,6,85,31,21.04.2019 22:30,67,4,Zhitomir
128,125,5,32,91,5,96,0,96,1,48,47,22.04.2019 00:40,67,4,Zhitomir
400,394,35,142,226,32,258,0,258,3,202,53,22.04.2019 00:12,67,4,Zhitomir
176,171,10,88,78,10,88,0,88,3,56,29,21.04.2019 22:00,67,4,Zhitomir
192,187,13,70,111,11,122,0,122,1,100,21,21.04.2019 22:40,67,4,Zhitomir
128,127,8,43,80,5,85,0,85,0,57,28,21.04.2019 23:15,67,4,Zhitomir
80,78,2,24,54,2,56,0,56,1,47,8,21.04.2019 20:40,67,4,Zhitomir
240,228,25,68,149,23,172,0,172,2,134,36,21.04.2019 21:30,67,4,Zhitomir
848,829,55,379,421,48,469,0,469,9,376,84,22.04.2019 00:12,67,4,Zhitomir
256,238,13,102,143,11,154,0,154,2,124,28,21.04.2019 22:20,67,4,Zhitomir
176,170,28,71,82,23,105,0,105,4,69,32,21.04.2019 20:55,67,4,Zhitomir
240,233,22,98,126,16,142,0,142,2,100,40,21.04.2019 20:30,67,4,Zhitomir
384,380,38,145,201,38,239,0,239,1,157,81,21.04.2019 21:00,67,4,Zhitomir
368,350,27,142,205,21,226,0,226,5,150,71,22.04.2019 00:35,67,4,Zhitomir
160,149,17,55,90,15,105,0,105,4,79,22,21.04.2019 20:30,67,4,Zhitomir
272,268,5,62,205,5,210,0,210,3,130,77,22.04.2019 00:10,67,4,Zhitomir
128,128,6,52,70,6,76,0,76,1,54,21,21.04.2019 22:00,67,4,Zhitomir
128,112,3,65,63,0,63,0,63,0,45,18,21.04.2019 21:45,67,4,Zhitomir
240,223,4,77,160,3,163,0,163,5,120,38,21.04.2019 22:50,67,4,Zhitomir
128,120,3,52,73,3,76,0,76,2,54,20,21.04.2019 20:25,67,4,Zhitomir
384,370,18,171,199,14,213,0,213,4,149,60,21.04.2019 21:20,67,4,Zhitomir
288,275,19,98,174,16,190,0,190,2,126,62,22.04.2019 00:20,67,4,Zhitomir
240,231,19,86,136,18,154,0,154,1,108,45,21.04.2019 21:05,67,4,Zhitomir
64,57,5,23,37,4,41,0,41,0,19,22,22.04.2019 00:08,67,4,Zhitomir
304,291,35,139,136,29,165,0,165,2,97,66,22.04.2019 00:18,67,4,Zhitomir
80,69,12,41,32,7,39,0,39,0,24,15,21.04.2019 22:40,67,4,Zhitomir
128,117,10,66,55,7,62,0,62,0,29,33,21.04.2019 21:20,67,4,Zhitomir
272,265,18,102,155,15,170,0,170,2,129,39,22.04.2019 00:20,67,4,Zhitomir
128,26,5,106,19,3,22,0,22,1,16,5,21.04.2019 20:35,67,4,Zhitomir
1152,1129,20,485,647,20,667,0,667,18,491,158,22.04.2019 01:10,67,4,Zhitomir
1184,1163,42,480,662,42,704,0,704,18,491,195,22.04.2019 00:45,67,4,Zhitomir
1168,1154,20,444,704,20,724,0,724,17,506,201,22.04.2019 00:15,67,4,Zhitomir
1408,1299,20,596,794,18,812,0,812,15,565,232,22.04.2019 00:20,67,4,Zhitomir
1424,1405,32,598,798,28,826,0,826,6,662,158,22.04.2019 00:25,67,4,Zhitomir
960,937,42,356,566,38,604,0,604,25,421,158,22.04.2019 00:45,67,4,Zhitomir
864,839,34,420,415,29,444,0,444,13,328,103,21.04.2019 23:50,67,4,Zhitomir
224,215,16,88,120,16,136,0,136,4,101,31,22.04.2019 00:30,67,4,Zhitomir
880,865,33,420,427,33,460,0,460,16,372,72,22.04.2019 00:20,67,4,Zhitomir
992,964,23,521,450,21,471,0,471,13,357,101,21.04.2019 21:10,67,4,Zhitomir
880,864,29,440,411,29,440,0,440,10,351,79,21.04.2019 22:00,67,4,Zhitomir
64,51,2,30,32,2,34,0,34,1,17,16,21.04.2019 22:30,67,4,Zhitomir
432,416,22,180,231,21,252,0,252,7,180,65,22.04.2019 00:35,67,4,Zhitomir
80,65,5,35,40,5,45,0,45,1,26,18,21.04.2019 21:00,67,4,Zhitomir
432,421,87,162,188,82,270,0,270,4,194,72,22.04.2019 00:25,67,4,Zhitomir
688,675,55,198,441,49,490,0,490,7,391,92,21.04.2019 21:12,67,4,Zhitomir
352,336,39,149,173,30,203,0,203,4,127,72,22.04.2019 00:05,67,4,Zhitomir
160,143,14,81,66,13,79,0,79,1,46,32,22.04.2019 00:18,67,4,Zhitomir
1296,1275,43,517,737,42,779,0,779,14,546,219,22.04.2019 00:45,67,4,Zhitomir
448,442,45,154,252,42,294,0,294,9,222,63,22.04.2019 00:05,67,4,Zhitomir
240,240,27,62,152,26,178,0,178,4,128,46,21.04.2019 23:05,67,4,Zhitomir
128,119,17,43,69,16,85,0,85,1,55,29,21.04.2019 21:15,67,4,Zhitomir
80,74,4,42,36,2,38,0,38,0,18,20,21.04.2019 20:55,67,4,Zhitomir
832,815,25,370,442,20,462,0,462,11,362,89,22.04.2019 02:00,67,4,Zhitomir
336,321,33,155,152,29,181,0,181,2,120,59,22.04.2019 01:30,67,4,Zhitomir
352,346,52,142,164,46,210,0,210,3,118,89,21.04.2019 22:45,67,4,Zhitomir
128,123,19,20,89,19,108,0,108,2,65,41,21.04.2019 20:20,67,4,Zhitomir
1280,1267,52,634,600,46,646,0,646,11,510,125,21.04.2019 21:30,67,4,Zhitomir
144,134,7,39,98,7,105,0,105,0,65,40,21.04.2019 21:00,67,4,Zhitomir
352,339,23,155,175,22,197,0,197,4,128,65,22.04.2019 01:20,67,4,Zhitomir
432,420,34,156,243,33,276,0,276,4,205,67,22.04.2019 00:15,67,4,Zhitomir
288,277,33,105,154,29,183,0,183,0,121,62,22.04.2019 00:09,67,4,Zhitomir
176,156,24,53,100,23,123,0,123,2,88,33,21.04.2019 20:32,67,4,Zhitomir
256,253,30,56,174,26,200,0,200,3,161,36,21.04.2019 20:50,67,4,Zhitomir
752,741,61,294,401,57,458,0,458,10,338,110,21.04.2019 21:07,67,4,Zhitomir
592,577,68,234,301,57,358,0,358,7,278,73,22.04.2019 00:20,67,4,Zhitomir
240,227,10,89,141,10,151,0,151,1,98,52,21.04.2019 22:20,67,4,Zhitomir
144,132,6,56,84,4,88,0,88,0,69,19,21.04.2019 21:05,67,4,Zhitomir
432,420,24,167,243,22,265,0,265,8,190,67,21.04.2019 23:00,67,4,Zhitomir
64,68,10,15,40,9,49,0,49,0,26,23,21.04.2019 20:25,67,4,Zhitomir
496,479,34,197,266,33,299,0,299,7,230,62,21.04.2019 23:55,67,4,Zhitomir
144,128,4,68,74,2,76,0,76,2,46,28,21.04.2019 23:20,67,4,Zhitomir
608,598,34,293,288,27,315,0,315,4,135,176,22.04.2019 00:20,67,4,Zhitomir
192,179,4,81,108,3,111,0,111,0,44,67,21.04.2019 22:40,67,4,Zhitomir
112,102,3,52,58,2,60,0,60,0,36,24,22.04.2019 00:10,67,4,Zhitomir
336,326,32,161,146,29,175,0,175,2,107,66,21.04.2019 20:40,67,4,Zhitomir
496,481,36,181,285,30,315,0,315,4,215,96,21.04.2019 23:50,67,4,Zhitomir
576,559,52,241,290,45,335,0,335,10,255,70,22.04.2019 00:20,67,4,Zhitomir
64,45,4,19,42,3,45,0,45,0,36,9,22.04.2019 00:05,67,4,Zhitomir
624,606,42,304,281,39,320,0,320,3,240,77,22.04.2019 00:05,67,4,Zhitomir
320,303,17,151,152,17,169,0,169,3,103,63,21.04.2019 20:50,67,4,Zhitomir
208,200,12,85,112,11,123,0,123,1,74,48,21.04.2019 20:50,67,4,Zhitomir
656,638,54,233,375,48,423,0,423,10,338,75,22.04.2019 00:05,67,4,Zhitomir
176,160,12,52,115,9,124,0,124,6,90,28,21.04.2019 21:40,67,4,Zhitomir
384,380,41,50,297,37,334,0,334,5,235,94,21.04.2019 20:30,67,4,Zhitomir
320,299,19,130,174,16,190,0,190,2,136,52,21.04.2019 21:05,67,4,Zhitomir
128,116,7,49,74,5,79,0,79,2,70,7,22.04.2019 02:20,67,4,Zhitomir
176,62,13,146,17,13,30,0,30,2,19,9,22.04.2019 00:10,67,4,Zhitomir
2048,2025,11,684,1358,6,1364,0,1364,55,1017,292,22.04.2019 00:55,67,4,Zhitomir
1968,1944,9,840,1122,6,1128,0,1128,29,860,239,22.04.2019 00:40,67,4,Zhitomir
2320,2410,8,705,1610,5,1615,0,1615,49,1092,474,22.04.2019 00:01,67,4,Zhitomir
2128,2087,10,728,1394,6,1400,0,1400,35,1002,363,22.04.2019 00:46,67,4,Zhitomir
1728,1716,15,592,1124,12,1136,0,1136,31,886,219,22.04.2019 00:10,67,4,Zhitomir
1888,1868,9,702,1180,6,1186,0,1186,41,897,248,22.04.2019 00:40,67,4,Zhitomir
2080,1223,15,857,1211,12,1223,0,1223,38,936,249,22.04.2019 01:00,67,4,Zhitomir
1680,1673,6,651,1023,6,1029,0,1029,19,767,243,22.04.2019 00:15,67,4,Zhitomir
1728,1717,7,654,1068,6,1074,0,1074,19,801,254,22.04.2019 00:10,67,4,Zhitomir
2384,2374,7,862,1520,2,1522,0,1522,40,1166,316,22.04.2019 01:34,67,4,Zhitomir
1440,1410,12,547,884,9,893,0,893,23,668,202,22.04.2019 00:17,67,4,Zhitomir
2320,2286,20,889,1417,14,1431,0,1431,44,1064,323,22.04.2019 00:15,67,4,Zhitomir
2064,2012,13,875,1181,8,1189,0,1189,31,897,261,22.04.2019 01:50,67,4,Zhitomir
2416,2382,11,949,1459,8,1467,0,1467,45,1131,291,22.04.2019 00:24,67,4,Zhitomir
2464,2427,11,1030,1425,9,1434,0,1434,52,1116,266,22.04.2019 00:45,67,4,Zhitomir
1696,1674,21,565,1119,12,1131,0,1131,30,799,302,22.04.2019 00:15,67,4,Zhitomir
2448,2408,12,860,1578,10,1588,0,1588,43,1145,400,22.04.2019 00:35,67,4,Zhitomir
2336,2316,15,827,1498,11,1509,0,1509,37,1106,366,22.04.2019 00:30,67,4,Zhitomir
2432,2404,16,953,1470,9,1479,0,1479,44,1114,321,22.04.2019 00:07,67,4,Zhitomir
288,283,19,89,181,18,199,0,199,2,165,32,22.04.2019 00:05,67,4,Zhitomir
160,144,9,63,89,8,97,0,97,2,84,11,22.04.2019 00:58,67,4,Zhitomir
336,320,0,18,318,0,318,0,318,41,254,23,22.04.2019 00:10,68,5,Zakarpatie
496,485,0,319,177,0,177,0,177,6,160,11,21.04.2019 21:05,68,5,Zakarpatie
1280,1261,13,578,692,10,702,0,702,21,571,110,22.04.2019 00:05,68,5,Zakarpatie
1136,1119,18,488,635,13,648,0,648,27,530,91,21.04.2019 22:55,68,5,Zakarpatie
400,400,15,168,223,9,232,0,232,6,191,35,22.04.2019 04:20,68,5,Zakarpatie
1760,1735,30,744,998,18,1016,0,1016,30,717,269,22.04.2019 00:15,68,5,Zakarpatie
464,459,6,147,315,2,317,0,317,8,245,64,22.04.2019 00:25,68,5,Zakarpatie
480,465,17,151,315,14,329,0,329,5,258,66,22.04.2019 00:03,68,5,Zakarpatie
368,349,12,132,226,10,236,0,236,2,190,44,21.04.2019 22:25,68,5,Zakarpatie
640,628,27,265,348,27,375,0,375,7,318,50,22.04.2019 00:05,68,5,Zakarpatie
176,181,8,56,114,6,120,0,120,0,82,38,22.04.2019 00:20,68,5,Zakarpatie
208,203,7,102,101,5,106,0,106,4,67,35,21.04.2019 21:10,68,5,Zakarpatie
336,340,0,112,224,0,224,0,224,3,157,64,21.04.2019 22:30,68,5,Zakarpatie
592,590,28,221,349,22,371,0,371,8,275,88,22.04.2019 00:02,68,5,Zakarpatie
624,611,20,228,377,19,396,0,396,18,315,63,22.04.2019 00:20,68,5,Zakarpatie
320,313,12,119,191,10,201,0,201,2,171,28,21.04.2019 21:30,68,5,Zakarpatie
752,731,31,291,433,28,461,0,461,16,363,82,22.04.2019 00:15,68,5,Zakarpatie
1152,1132,22,512,620,20,640,0,640,15,532,93,22.04.2019 04:50,68,5,Zakarpatie
752,744,19,372,364,16,380,0,380,6,295,79,22.04.2019 00:15,68,5,Zakarpatie
224,205,2,87,135,2,137,0,137,1,116,20,22.04.2019 00:15,68,5,Zakarpatie
320,321,19,127,174,19,193,0,193,3,157,33,22.04.2019 01:10,68,5,Zakarpatie
400,391,13,170,222,8,230,0,230,9,187,34,22.04.2019 02:05,68,5,Zakarpatie
1504,1514,60,568,879,57,936,0,936,33,758,145,22.04.2019 02:05,68,5,Zakarpatie
240,233,8,77,156,7,163,0,163,2,125,36,21.04.2019 20:41,68,5,Zakarpatie
832,823,13,312,511,9,520,0,520,15,386,119,22.04.2019 00:30,68,5,Zakarpatie
2128,2111,9,788,1334,6,1340,0,1340,41,950,349,22.04.2019 05:40,68,5,Zakarpatie
528,533,6,178,345,5,350,0,350,6,266,78,22.04.2019 00:05,68,5,Zakarpatie
496,478,27,192,283,21,304,0,304,7,212,85,22.04.2019 00:05,68,5,Zakarpatie
352,344,22,161,171,20,191,0,191,1,153,37,22.04.2019 00:15,68,5,Zakarpatie
800,793,5,511,286,3,289,0,289,4,270,15,22.04.2019 00:03,68,5,Zakarpatie
576,559,4,309,264,3,267,0,267,3,253,11,22.04.2019 00:04,68,5,Zakarpatie
96,87,1,50,45,1,46,0,46,1,32,13,21.04.2019 21:58,68,5,Zakarpatie
1264,1255,17,519,731,14,745,0,745,17,596,132,22.04.2019 00:45,68,5,Zakarpatie
320,309,10,136,176,8,184,0,184,6,123,55,21.04.2019 21:00,68,5,Zakarpatie
1360,1345,21,560,781,19,800,0,800,16,641,143,22.04.2019 00:40,68,5,Zakarpatie
368,364,3,146,219,3,222,0,222,5,153,64,22.04.2019 00:10,68,5,Zakarpatie
592,588,6,242,344,6,350,0,350,8,290,52,21.04.2019 22:00,68,5,Zakarpatie
1216,1192,21,661,536,19,555,0,555,13,418,124,22.04.2019 00:30,68,5,Zakarpatie
464,451,9,246,209,9,218,0,218,4,178,36,21.04.2019 20:40,68,5,Zakarpatie
672,656,17,302,355,15,370,0,370,15,279,76,21.04.2019 21:40,68,5,Zakarpatie
736,733,21,420,299,17,316,0,316,5,269,42,22.04.2019 00:15,68,5,Zakarpatie
1072,1073,5,535,532,5,537,0,537,22,432,83,22.04.2019 00:05,68,5,Zakarpatie
1120,1115,12,491,617,12,629,0,629,13,466,150,22.04.2019 00:10,68,5,Zakarpatie
1920,1918,8,643,1271,6,1277,0,1277,52,819,406,22.04.2019 00:30,68,5,Zakarpatie
1568,1591,9,617,944,7,951,0,951,33,700,218,22.04.2019 00:15,68,5,Zakarpatie
1312,1308,6,590,717,5,722,0,722,20,556,146,21.04.2019 21:20,68,5,Zakarpatie
1056,1034,16,456,589,11,600,0,600,21,475,104,22.04.2019 00:20,68,5,Zakarpatie
1168,1151,34,689,453,26,479,0,479,9,424,46,22.04.2019 00:20,68,5,Zakarpatie
1088,1139,35,491,575,22,597,0,597,7,528,62,21.04.2019 21:45,68,5,Zakarpatie
640,625,15,390,235,15,250,0,250,7,222,21,21.04.2019 21:35,68,5,Zakarpatie
224,220,0,110,114,0,114,0,114,5,101,8,22.04.2019 00:05,68,5,Zakarpatie
1312,1289,17,1035,274,3,277,0,277,6,260,11,21.04.2019 21:05,68,5,Zakarpatie
640,671,6,390,246,4,250,0,250,3,240,7,21.04.2019 21:30,68,5,Zakarpatie
336,320,4,109,223,4,227,0,227,6,187,34,22.04.2019 00:15,68,5,Zakarpatie
640,624,1,234,405,1,406,0,406,16,346,44,21.04.2019 23:19,68,5,Zakarpatie
528,521,2,362,166,0,166,0,166,4,157,5,21.04.2019 20:10,68,5,Zakarpatie
1424,1399,5,998,421,5,426,0,426,3,408,15,21.04.2019 20:45,68,5,Zakarpatie
320,310,20,180,121,19,140,0,140,2,129,9,21.04.2019 20:28,68,5,Zakarpatie
2160,2148,7,1655,499,6,505,0,505,9,483,13,22.04.2019 00:20,68,5,Zakarpatie
2176,2162,9,1588,579,9,588,0,588,15,544,29,22.04.2019 00:30,68,5,Zakarpatie
736,723,9,388,339,9,348,0,348,5,285,58,21.04.2019 21:15,68,5,Zakarpatie
304,297,3,157,144,3,147,0,147,3,119,25,21.04.2019 22:40,68,5,Zakarpatie
480,462,4,279,198,3,201,0,201,2,172,27,21.04.2019 23:00,68,5,Zakarpatie
400,388,11,191,198,11,209,0,209,4,189,16,21.04.2019 21:30,68,5,Zakarpatie
192,185,4,93,95,4,99,0,99,3,84,12,21.04.2019 21:10,68,5,Zakarpatie
336,321,16,157,166,13,179,0,179,6,161,12,21.04.2019 20:15,68,5,Zakarpatie
816,832,14,483,326,7,333,0,333,5,299,29,22.04.2019 04:16,68,5,Zakarpatie
1552,1534,25,1032,506,14,520,0,520,16,466,38,21.04.2019 22:32,68,5,Zakarpatie
496,480,23,292,188,16,204,0,204,2,186,16,21.04.2019 21:12,68,5,Zakarpatie
1936,1938,4,749,1184,3,1187,0,1187,38,791,358,22.04.2019 00:25,68,5,Zakarpatie
1248,1259,6,503,741,4,745,0,745,25,473,247,22.04.2019 00:15,68,5,Zakarpatie
1328,1278,0,774,554,0,554,0,554,13,366,175,22.04.2019 00:06,68,5,Zakarpatie
800,805,0,492,308,0,308,0,308,10,215,83,22.04.2019 00:04,68,5,Zakarpatie
1712,1727,22,642,1053,17,1070,0,1070,54,709,307,22.04.2019 01:40,68,5,Zakarpatie
1728,1722,1,644,1083,1,1084,0,1084,42,750,292,22.04.2019 00:11,68,5,Zakarpatie
1648,1632,0,653,995,0,995,0,995,31,714,250,21.04.2019 21:06,68,5,Zakarpatie
1664,1640,13,653,1003,8,1011,0,1011,40,659,312,22.04.2019 01:00,68,5,Zakarpatie
1840,1818,4,727,1109,4,1113,0,1113,49,775,289,22.04.2019 00:15,68,5,Zakarpatie
1456,1446,4,590,863,3,866,0,866,39,598,229,22.04.2019 00:10,68,5,Zakarpatie
1536,1543,0,650,886,0,886,0,886,36,604,246,21.04.2019 21:20,68,5,Zakarpatie
1520,1546,3,613,905,2,907,0,907,34,574,299,22.04.2019 00:10,68,5,Zakarpatie
1184,1210,7,446,732,6,738,0,738,36,466,236,21.04.2019 22:20,68,5,Zakarpatie
1840,1814,2,686,1152,2,1154,0,1154,68,688,398,22.04.2019 07:00,68,5,Zakarpatie
2080,2066,8,815,1259,6,1265,0,1265,36,855,374,22.04.2019 00:30,68,5,Zakarpatie
1856,1839,6,765,1085,6,1091,0,1091,37,754,300,22.04.2019 00:10,68,5,Zakarpatie
1232,1276,4,418,810,4,814,0,814,27,531,256,22.04.2019 02:05,68,5,Zakarpatie
1152,1165,4,478,670,4,674,0,674,24,422,228,22.04.2019 00:10,68,5,Zakarpatie
1040,1130,2,325,714,1,715,0,715,20,438,257,22.04.2019 00:05,68,5,Zakarpatie
1536,1530,4,899,635,2,637,0,637,24,466,147,22.04.2019 00:33,68,5,Zakarpatie
1600,1575,4,972,626,2,628,0,628,21,512,95,21.04.2019 21:40,68,5,Zakarpatie
1504,1499,2,691,811,2,813,0,813,32,576,205,22.04.2019 00:05,68,5,Zakarpatie
1376,1360,6,772,602,2,604,0,604,24,439,141,22.04.2019 00:03,68,5,Zakarpatie
1856,1826,8,847,1004,5,1009,0,1009,28,757,224,21.04.2019 21:45,68,5,Zakarpatie
1504,1499,6,677,824,3,827,0,827,30,630,167,21.04.2019 22:35,68,5,Zakarpatie
1840,1805,3,784,1054,2,1056,0,1056,41,745,270,22.04.2019 02:04,68,5,Zakarpatie
1584,1566,8,749,827,8,835,0,835,17,614,204,22.04.2019 00:15,68,5,Zakarpatie
1328,1322,7,567,757,4,761,0,761,33,531,197,22.04.2019 00:21,68,5,Zakarpatie
960,954,6,386,569,5,574,0,574,23,378,173,22.04.2019 03:07,68,5,Zakarpatie
1520,1488,4,567,950,3,953,0,953,34,647,272,21.04.2019 23:03,68,5,Zakarpatie
1888,1872,7,754,1128,6,1134,0,1134,51,740,343,22.04.2019 00:10,68,5,Zakarpatie
1808,1789,2,711,1097,0,1097,0,1097,30,781,286,22.04.2019 00:10,68,5,Zakarpatie
1696,1702,5,649,1042,5,1047,0,1047,48,708,291,22.04.2019 00:03,68,5,Zakarpatie
1792,1771,6,707,1082,3,1085,0,1085,35,728,322,22.04.2019 00:35,68,5,Zakarpatie
1680,1660,0,697,983,0,983,0,983,40,621,322,22.04.2019 00:15,68,5,Zakarpatie
1632,1624,4,628,1000,4,1004,0,1004,40,656,308,22.04.2019 00:05,68,5,Zakarpatie
1456,1448,4,535,918,3,921,0,921,35,580,306,22.04.2019 00:30,68,5,Zakarpatie
1824,1806,2,686,1136,2,1138,0,1138,51,727,360,22.04.2019 00:22,68,5,Zakarpatie
1664,1643,0,688,976,0,976,0,976,35,631,310,22.04.2019 00:08,68,5,Zakarpatie
1408,1387,2,619,788,1,789,0,789,24,548,217,22.04.2019 00:02,68,5,Zakarpatie
1248,1246,4,471,774,3,777,0,777,25,555,197,22.04.2019 00:10,68,5,Zakarpatie
1280,1261,3,559,719,2,721,0,721,26,486,209,22.04.2019 06:00,68,5,Zakarpatie
1072,1051,1,461,610,1,611,0,611,27,419,165,21.04.2019 23:30,68,5,Zakarpatie
1664,1632,2,722,940,2,942,0,942,23,674,245,22.04.2019 00:30,68,5,Zakarpatie
1952,1958,3,759,1192,1,1193,0,1193,45,795,353,21.04.2019 22:23,68,5,Zakarpatie
1328,1317,1,506,821,1,822,0,822,34,535,253,22.04.2019 00:15,68,5,Zakarpatie
1472,1464,6,589,879,4,883,0,883,30,612,241,21.04.2019 21:30,68,5,Zakarpatie
1280,1304,1,430,849,1,850,0,850,29,529,292,22.04.2019 00:15,68,5,Zakarpatie
1632,1632,3,651,978,3,981,0,981,29,659,293,22.04.2019 00:05,68,5,Zakarpatie
1536,1519,2,646,889,1,890,0,890,35,592,263,22.04.2019 00:10,68,5,Zakarpatie
1424,1419,12,489,923,12,935,0,935,33,612,290,22.04.2019 00:51,68,5,Zakarpatie
1584,1590,3,545,1036,3,1039,0,1039,37,710,292,22.04.2019 00:25,68,5,Zakarpatie
1664,1656,3,703,958,3,961,0,961,40,657,264,22.04.2019 00:17,68,5,Zakarpatie
1328,1326,5,555,768,5,773,0,773,36,537,200,22.04.2019 00:23,68,5,Zakarpatie
1680,1651,1,738,941,1,942,0,942,40,650,252,22.04.2019 00:15,68,5,Zakarpatie
1408,1377,3,621,785,2,787,0,787,15,529,243,21.04.2019 20:45,68,5,Zakarpatie
1776,1756,10,690,1079,7,1086,0,1086,40,727,319,21.04.2019 23:10,68,5,Zakarpatie
1232,1196,5,605,622,5,627,0,627,24,446,157,22.04.2019 00:40,68,5,Zakarpatie
1584,1549,6,674,904,6,910,0,910,29,637,244,22.04.2019 00:15,68,5,Zakarpatie
128,41,10,89,29,10,39,0,39,0,34,5,21.04.2019 21:05,68,5,Zakarpatie
384,154,66,242,88,54,142,0,142,6,102,34,21.04.2019 20:50,68,5,Zakarpatie
272,70,13,209,52,11,63,0,63,2,46,15,22.04.2019 00:14,68,5,Zakarpatie
528,95,17,433,79,16,95,0,95,3,79,13,22.04.2019 00:10,68,5,Zakarpatie
592,302,142,324,145,123,268,0,268,8,216,44,22.04.2019 00:08,68,5,Zakarpatie
96,39,0,60,36,0,36,0,36,0,29,7,22.04.2019 00:05,68,5,Zakarpatie
160,39,4,121,35,4,39,0,39,3,31,5,22.04.2019 06:49,68,5,Zakarpatie
256,87,15,188,56,12,68,0,68,0,52,16,22.04.2019 00:15,68,5,Zakarpatie
176,54,0,133,43,0,43,0,43,0,33,10,21.04.2019 22:40,68,5,Zakarpatie
128,35,8,106,16,6,22,0,22,1,15,6,22.04.2019 00:05,68,5,Zakarpatie
64,20,0,44,20,0,20,0,20,1,15,4,22.04.2019 00:05,68,5,Zakarpatie
2512,2482,6,1432,1076,4,1080,0,1080,22,901,157,22.04.2019 00:10,68,5,Zakarpatie
2336,2302,9,1118,1212,6,1218,0,1218,37,955,226,22.04.2019 00:05,68,5,Zakarpatie
2352,2215,10,1197,1149,6,1155,0,1155,35,956,164,22.04.2019 04:42,68,5,Zakarpatie
1504,1490,10,556,939,9,948,0,948,41,673,234,22.04.2019 00:10,68,5,Zakarpatie
1360,1344,17,939,407,14,421,0,421,10,388,23,21.04.2019 20:00,69,5,Zakarpatie
2160,2137,8,1325,831,4,835,0,835,16,743,76,22.04.2019 04:46,69,5,Zakarpatie
560,563,23,306,231,23,254,0,254,4,240,10,21.04.2019 23:35,69,5,Zakarpatie
1360,1374,24,879,461,20,481,0,481,5,452,24,21.04.2019 23:45,69,5,Zakarpatie
944,924,9,632,304,8,312,0,312,2,300,10,22.04.2019 00:12,69,5,Zakarpatie
2224,2210,14,1664,546,14,560,0,560,15,519,26,21.04.2019 22:20,69,5,Zakarpatie
992,977,22,734,244,14,258,0,258,1,253,4,22.04.2019 00:15,69,5,Zakarpatie
1344,1333,22,914,422,8,430,0,430,8,413,9,21.04.2019 20:30,69,5,Zakarpatie
1728,1735,12,1270,448,10,458,0,458,9,412,37,21.04.2019 21:01,69,5,Zakarpatie
816,805,17,600,212,4,216,0,216,11,197,8,21.04.2019 21:13,69,5,Zakarpatie
528,523,25,341,168,19,187,0,187,3,162,22,22.04.2019 00:05,69,5,Zakarpatie
704,694,9,532,163,9,172,0,172,6,155,11,22.04.2019 02:07,69,5,Zakarpatie
2208,2184,35,1199,975,34,1009,0,1009,21,862,126,22.04.2019 00:10,69,5,Zakarpatie
1040,1028,21,663,359,18,377,0,377,5,353,19,21.04.2019 20:45,69,5,Zakarpatie
576,569,14,408,154,14,168,0,168,2,150,16,22.04.2019 00:30,69,5,Zakarpatie
1968,1944,17,1278,674,16,690,0,690,24,612,54,22.04.2019 00:20,69,5,Zakarpatie
1232,1221,27,501,704,27,731,0,731,14,651,66,22.04.2019 04:55,69,5,Zakarpatie
2048,2018,32,1050,968,30,998,0,998,11,852,135,22.04.2019 03:55,69,5,Zakarpatie
1280,1270,15,678,590,12,602,0,602,10,544,48,22.04.2019 00:01,69,5,Zakarpatie
1424,1407,43,686,695,43,738,0,738,12,663,63,22.04.2019 04:50,69,5,Zakarpatie
1824,1805,4,1092,728,4,732,0,732,14,607,111,21.04.2019 21:25,69,5,Zakarpatie
1712,1723,30,855,829,28,857,0,857,19,697,141,22.04.2019 00:04,69,5,Zakarpatie
1808,1789,4,971,833,4,837,0,837,22,694,121,21.04.2019 21:19,69,5,Zakarpatie
1200,1187,50,657,501,42,543,0,543,9,454,80,22.04.2019 00:10,69,5,Zakarpatie
656,639,25,286,345,25,370,0,370,4,319,47,21.04.2019 20:35,69,5,Zakarpatie
368,356,11,178,179,11,190,0,190,3,157,30,22.04.2019 00:59,69,5,Zakarpatie
256,243,13,98,145,13,158,0,158,0,136,22,22.04.2019 00:10,69,5,Zakarpatie
128,116,2,57,69,2,71,0,71,2,52,17,21.04.2019 21:30,69,5,Zakarpatie
736,715,22,376,338,22,360,0,360,11,312,37,22.04.2019 02:50,69,5,Zakarpatie
416,411,29,116,271,29,300,0,300,3,229,68,22.04.2019 00:15,69,5,Zakarpatie
784,772,30,224,530,30,560,0,560,4,511,45,22.04.2019 01:30,69,5,Zakarpatie
256,247,9,105,142,9,151,0,151,0,141,10,22.04.2019 00:10,69,5,Zakarpatie
208,196,1,114,94,0,94,0,94,5,71,18,22.04.2019 00:05,69,5,Zakarpatie
560,551,25,344,204,12,216,0,216,3,184,29,22.04.2019 00:15,69,5,Zakarpatie
592,580,24,269,303,20,323,0,323,11,275,37,22.04.2019 00:50,69,5,Zakarpatie
1104,1092,53,656,399,49,448,0,448,18,396,34,22.04.2019 01:05,69,5,Zakarpatie
544,525,22,261,264,19,283,0,283,4,238,41,22.04.2019 00:15,69,5,Zakarpatie
1488,1464,36,730,726,32,758,0,758,13,646,99,22.04.2019 00:45,69,5,Zakarpatie
768,759,25,370,374,24,398,0,398,11,353,34,22.04.2019 00:25,69,5,Zakarpatie
1872,1846,33,1157,686,29,715,0,715,10,597,108,22.04.2019 00:10,69,5,Zakarpatie
2016,1989,21,1239,758,19,777,0,777,17,677,83,22.04.2019 01:45,69,5,Zakarpatie
1424,1402,20,903,509,12,521,0,521,14,455,52,22.04.2019 00:05,69,5,Zakarpatie
1344,1328,39,859,447,38,485,0,485,13,431,41,22.04.2019 00:45,69,5,Zakarpatie
2192,2132,16,1224,962,6,968,0,968,33,814,121,22.04.2019 00:15,69,5,Zakarpatie
1008,988,3,642,364,2,366,0,366,16,304,46,22.04.2019 00:10,69,5,Zakarpatie
2160,2141,11,1555,594,11,605,0,605,12,580,13,22.04.2019 00:05,69,5,Zakarpatie
1712,1697,22,1261,442,9,451,0,451,7,394,50,21.04.2019 21:10,69,5,Zakarpatie
448,433,18,222,209,17,226,0,226,0,193,33,22.04.2019 00:50,69,5,Zakarpatie
1296,1278,50,447,803,46,849,0,849,12,750,87,22.04.2019 00:15,69,5,Zakarpatie
1376,1361,29,583,773,20,793,0,793,12,688,93,21.04.2019 23:25,69,5,Zakarpatie
1392,1379,27,724,649,19,668,0,668,19,526,123,22.04.2019 00:05,69,5,Zakarpatie
400,396,2,200,198,2,200,0,200,1,182,17,22.04.2019 00:30,69,5,Zakarpatie
208,208,10,100,98,10,108,0,108,1,87,20,22.04.2019 01:00,69,5,Zakarpatie
1424,1416,23,846,572,6,578,0,578,13,520,45,22.04.2019 01:30,69,5,Zakarpatie
608,591,9,181,418,9,427,0,427,10,363,54,22.04.2019 00:04,69,5,Zakarpatie
1008,998,8,497,503,8,511,0,511,22,384,105,22.04.2019 05:21,69,5,Zakarpatie
496,490,17,195,284,17,301,0,301,7,238,56,21.04.2019 20:40,69,5,Zakarpatie
1552,1538,12,800,742,10,752,0,752,17,656,79,21.04.2019 21:03,69,5,Zakarpatie
640,623,38,275,335,30,365,0,365,9,314,42,21.04.2019 21:30,69,5,Zakarpatie
336,329,12,164,162,10,172,0,172,4,127,41,21.04.2019 22:10,69,5,Zakarpatie
208,203,7,105,96,7,103,0,103,1,69,33,21.04.2019 20:30,69,5,Zakarpatie
80,77,3,31,46,3,49,0,49,2,26,21,21.04.2019 22:40,69,5,Zakarpatie
2096,2075,29,1109,967,20,987,0,987,28,803,156,22.04.2019 06:45,69,5,Zakarpatie
560,547,19,217,324,19,343,0,343,5,235,103,22.04.2019 00:25,69,5,Zakarpatie
208,205,5,106,97,5,102,0,102,2,70,30,22.04.2019 00:15,69,5,Zakarpatie
128,124,0,69,59,0,59,0,59,4,41,14,22.04.2019 00:25,69,5,Zakarpatie
208,195,6,125,82,1,83,0,83,0,40,43,22.04.2019 00:30,69,5,Zakarpatie
720,702,20,186,514,20,534,0,534,8,371,155,22.04.2019 00:20,69,5,Zakarpatie
528,515,15,213,300,15,315,0,315,9,250,56,22.04.2019 00:07,69,5,Zakarpatie
1088,1079,36,438,624,26,650,0,650,20,564,66,21.04.2019 21:40,69,5,Zakarpatie
1264,1254,25,601,639,24,663,0,663,17,535,111,22.04.2019 00:55,69,5,Zakarpatie
784,771,10,413,361,10,371,0,371,13,299,59,22.04.2019 00:02,69,5,Zakarpatie
2064,2040,11,1110,946,8,954,0,954,44,778,132,22.04.2019 00:40,69,5,Zakarpatie
944,942,5,518,422,4,426,0,426,14,359,53,22.04.2019 00:05,69,5,Zakarpatie
736,735,39,311,395,30,425,0,425,14,334,77,22.04.2019 00:18,69,5,Zakarpatie
848,832,10,408,433,7,440,0,440,19,341,80,22.04.2019 00:07,69,5,Zakarpatie
592,583,16,218,358,16,374,0,374,6,312,56,22.04.2019 00:10,69,5,Zakarpatie
416,395,20,159,237,20,257,0,257,1,143,113,22.04.2019 00:10,69,5,Zakarpatie
144,132,1,90,53,1,54,0,54,0,37,17,21.04.2019 22:45,69,5,Zakarpatie
288,279,12,111,165,12,177,0,177,19,80,78,22.04.2019 00:15,69,5,Zakarpatie
64,51,2,30,32,2,34,0,34,0,16,18,22.04.2019 00:20,69,5,Zakarpatie
2384,2353,22,1690,684,10,694,0,694,20,609,65,22.04.2019 00:30,69,5,Zakarpatie
1152,1134,3,665,485,2,487,0,487,10,415,62,21.04.2019 23:30,69,5,Zakarpatie
512,506,0,248,264,0,264,0,264,9,209,46,21.04.2019 21:30,69,5,Zakarpatie
832,823,12,445,376,11,387,0,387,10,329,48,22.04.2019 00:25,69,5,Zakarpatie
304,299,4,129,171,4,175,0,175,3,151,21,21.04.2019 22:35,69,5,Zakarpatie
1536,1519,47,1056,433,47,480,0,480,9,405,66,21.04.2019 22:36,69,5,Zakarpatie
1648,1623,22,1163,463,22,485,0,485,7,426,52,22.04.2019 00:15,69,5,Zakarpatie
736,736,21,294,421,21,442,0,442,4,366,72,22.04.2019 00:10,69,5,Zakarpatie
192,186,7,64,122,6,128,0,128,1,88,39,22.04.2019 00:40,69,5,Zakarpatie
1200,1183,25,604,571,25,596,0,596,15,463,118,22.04.2019 02:20,69,5,Zakarpatie
1424,1410,12,823,594,7,601,0,601,28,497,76,22.04.2019 02:05,69,5,Zakarpatie
1152,1138,8,788,360,4,364,0,364,7,343,14,22.04.2019 00:10,69,5,Zakarpatie
1824,1803,0,1298,526,0,526,0,526,11,397,118,21.04.2019 21:29,69,5,Zakarpatie
352,346,4,135,214,3,217,0,217,7,179,31,22.04.2019 00:50,69,5,Zakarpatie
496,486,13,229,254,13,267,0,267,4,245,18,22.04.2019 01:45,69,5,Zakarpatie
208,200,3,70,135,3,138,0,138,3,108,27,22.04.2019 00:15,69,5,Zakarpatie
2480,2469,3,1162,1315,3,1318,0,1318,46,1052,220,22.04.2019 04:50,69,5,Zakarpatie
2400,2378,8,1006,1387,7,1394,0,1394,36,1071,287,22.04.2019 00:10,69,5,Zakarpatie
2352,2347,5,1016,1331,5,1336,0,1336,38,1010,288,21.04.2019 22:10,69,5,Zakarpatie
1984,1965,1,883,1100,1,1101,0,1101,27,844,230,22.04.2019 00:35,69,5,Zakarpatie
2112,2087,5,998,1112,2,1114,0,1114,28,903,183,21.04.2019 21:30,69,5,Zakarpatie
2272,2263,2,1010,1260,2,1262,0,1262,37,978,247,22.04.2019 00:36,69,5,Zakarpatie
2304,2296,12,1024,1270,10,1280,0,1280,46,994,240,22.04.2019 03:13,69,5,Zakarpatie
2176,2154,10,1023,1146,7,1153,0,1153,44,877,232,22.04.2019 00:10,69,5,Zakarpatie
1232,1296,4,534,694,4,698,0,698,30,520,148,22.04.2019 00:07,69,5,Zakarpatie
816,834,1,396,420,0,420,0,420,10,325,85,22.04.2019 00:01,69,5,Zakarpatie
1184,1189,9,547,629,8,637,0,637,13,522,102,22.04.2019 00:07,69,5,Zakarpatie
1648,1662,9,713,930,5,935,0,935,31,746,158,22.04.2019 00:10,69,5,Zakarpatie
1312,1298,3,574,735,3,738,0,738,22,578,138,22.04.2019 00:25,69,5,Zakarpatie
1904,1898,3,851,1050,3,1053,0,1053,37,824,192,22.04.2019 00:40,69,5,Zakarpatie
1840,1820,8,903,932,5,937,0,937,34,737,166,22.04.2019 00:10,69,5,Zakarpatie
2224,2199,15,1103,1113,8,1121,0,1121,38,922,161,22.04.2019 00:35,69,5,Zakarpatie
1584,1571,0,848,736,0,736,0,736,20,593,123,22.04.2019 00:32,69,5,Zakarpatie
1600,1573,0,809,791,0,791,0,791,22,618,151,21.04.2019 23:50,69,5,Zakarpatie
1456,1431,4,814,638,4,642,0,642,22,509,111,22.04.2019 00:01,69,5,Zakarpatie
2062,2049,0,1764,298,0,298,0,298,13,255,30,22.04.2019 00:05,69,5,Zakarpatie
528,524,4,258,267,3,270,0,270,5,222,43,22.04.2019 00:15,69,5,Zakarpatie
2080,2067,63,1052,987,41,1028,0,1028,33,805,190,22.04.2019 00:35,69,5,Zakarpatie
1472,1457,7,750,717,5,722,0,722,26,558,138,22.04.2019 04:20,69,5,Zakarpatie
1152,1147,1,520,631,1,632,0,632,25,489,118,22.04.2019 00:45,69,5,Zakarpatie
2064,2058,6,1063,997,4,1001,0,1001,25,836,140,22.04.2019 00:15,69,5,Zakarpatie
2224,2214,3,1049,1173,2,1175,0,1175,35,925,215,22.04.2019 00:30,69,5,Zakarpatie
1776,1737,4,789,984,3,987,0,987,32,798,157,22.04.2019 04:30,69,5,Zakarpatie
1808,1808,4,852,954,2,956,0,956,27,770,159,22.04.2019 00:20,69,5,Zakarpatie
2016,2012,5,842,1170,4,1174,0,1174,42,953,179,22.04.2019 05:12,69,5,Zakarpatie
1536,1516,4,667,865,4,869,0,869,33,689,147,22.04.2019 00:10,69,5,Zakarpatie
1472,1459,5,692,776,4,780,0,780,28,630,122,22.04.2019 04:38,69,5,Zakarpatie
1840,1810,7,1041,793,6,799,0,799,21,627,151,22.04.2019 02:30,69,5,Zakarpatie
1696,1688,5,753,939,4,943,0,943,28,748,167,22.04.2019 00:45,69,5,Zakarpatie
1200,1338,1,399,800,1,801,0,801,24,599,178,22.04.2019 00:50,69,5,Zakarpatie
912,891,5,382,527,3,530,0,530,10,355,165,22.04.2019 00:07,69,5,Zakarpatie
544,167,60,382,111,51,162,0,162,4,143,15,22.04.2019 00:20,69,5,Zakarpatie
256,245,2,117,137,2,139,0,139,3,107,29,22.04.2019 00:30,70,5,Zakarpatie
144,125,4,95,47,2,49,0,49,3,42,4,22.04.2019 00:20,70,5,Zakarpatie
992,971,22,546,427,19,446,0,446,8,392,46,22.04.2019 01:20,70,5,Zakarpatie
480,473,1,162,317,1,318,0,318,13,261,44,22.04.2019 00:28,70,5,Zakarpatie
144,135,3,59,82,3,85,0,85,4,66,15,22.04.2019 00:30,70,5,Zakarpatie
1824,1838,11,1138,675,11,686,0,686,32,534,120,22.04.2019 00:18,70,5,Zakarpatie
128,110,4,44,81,3,84,0,84,3,47,34,22.04.2019 00:15,70,5,Zakarpatie
144,135,5,23,116,5,121,0,121,2,93,26,22.04.2019 00:50,70,5,Zakarpatie
256,242,8,67,181,8,189,0,189,2,142,45,22.04.2019 00:50,70,5,Zakarpatie
576,564,4,303,269,4,273,0,273,9,224,40,21.04.2019 20:48,70,5,Zakarpatie
368,355,0,170,198,0,198,0,198,7,156,35,22.04.2019 00:16,70,5,Zakarpatie
384,379,3,204,177,3,180,0,180,2,139,39,22.04.2019 00:15,70,5,Zakarpatie
176,158,4,70,102,4,106,0,106,0,82,24,21.04.2019 21:20,70,5,Zakarpatie
240,238,1,110,129,1,130,0,130,3,113,14,21.04.2019 21:30,70,5,Zakarpatie
848,828,8,431,409,8,417,0,417,18,333,66,22.04.2019 00:30,70,5,Zakarpatie
352,346,3,83,266,3,269,0,269,9,221,39,22.04.2019 01:10,70,5,Zakarpatie
608,589,38,341,232,35,267,0,267,7,211,49,22.04.2019 00:30,70,5,Zakarpatie
528,516,9,208,311,9,320,0,320,5,260,55,22.04.2019 00:15,70,5,Zakarpatie
528,508,6,257,265,6,271,0,271,1,226,44,22.04.2019 00:30,70,5,Zakarpatie
672,655,5,302,365,5,370,0,370,6,322,42,22.04.2019 01:10,70,5,Zakarpatie
208,198,0,105,103,0,103,0,103,0,80,23,21.04.2019 21:55,70,5,Zakarpatie
384,365,8,207,169,8,177,0,177,6,130,41,21.04.2019 23:46,70,5,Zakarpatie
352,329,12,159,181,12,193,0,193,0,177,16,22.04.2019 00:17,70,5,Zakarpatie
1152,1135,23,561,570,21,591,0,591,12,453,126,22.04.2019 00:05,70,5,Zakarpatie
336,331,17,120,202,14,216,0,216,1,169,46,22.04.2019 00:25,70,5,Zakarpatie
496,485,12,264,226,6,232,0,232,3,182,47,22.04.2019 00:30,70,5,Zakarpatie
672,662,16,342,314,16,330,0,330,7,265,58,22.04.2019 01:30,70,5,Zakarpatie
432,429,3,233,196,3,199,0,199,4,136,59,21.04.2019 22:10,70,5,Zakarpatie
112,109,0,48,64,0,64,0,64,1,53,10,22.04.2019 00:15,70,5,Zakarpatie
320,315,2,162,156,2,158,0,158,2,125,31,22.04.2019 04:30,70,5,Zakarpatie
64,51,0,14,50,0,50,0,50,3,23,24,22.04.2019 00:20,70,5,Zakarpatie
512,517,9,259,246,7,253,0,253,3,208,42,22.04.2019 00:50,70,5,Zakarpatie
1376,1345,19,609,751,16,767,0,767,23,541,203,22.04.2019 01:10,70,5,Zakarpatie
1440,1423,18,762,664,14,678,0,678,17,525,136,22.04.2019 00:05,70,5,Zakarpatie
1328,1312,8,575,746,7,753,0,753,14,528,211,22.04.2019 00:30,70,5,Zakarpatie
544,541,8,260,276,8,284,0,284,9,213,62,22.04.2019 01:20,70,5,Zakarpatie
1664,1635,37,880,754,30,784,0,784,11,667,106,22.04.2019 00:10,70,5,Zakarpatie
1024,1006,35,447,542,35,577,0,577,11,494,72,22.04.2019 00:05,70,5,Zakarpatie
1760,1738,56,673,1035,52,1087,0,1087,24,902,161,22.04.2019 00:20,70,5,Zakarpatie
784,773,15,316,453,15,468,0,468,8,394,66,21.04.2019 21:05,70,5,Zakarpatie
1872,1836,8,981,884,7,891,0,891,18,712,161,22.04.2019 00:20,70,5,Zakarpatie
320,310,3,162,155,3,158,0,158,0,138,20,22.04.2019 00:10,70,5,Zakarpatie
784,765,9,400,378,6,384,0,384,7,295,82,21.04.2019 21:30,70,5,Zakarpatie
512,492,6,252,255,5,260,0,260,3,203,54,22.04.2019 00:10,70,5,Zakarpatie
176,171,6,81,90,5,95,0,95,2,80,13,22.04.2019 00:23,70,5,Zakarpatie
672,656,44,291,338,43,381,0,381,6,307,68,22.04.2019 00:15,70,5,Zakarpatie
400,380,18,157,228,15,243,0,243,0,173,70,22.04.2019 00:40,70,5,Zakarpatie
432,421,23,168,241,23,264,0,264,5,217,42,21.04.2019 23:50,70,5,Zakarpatie
448,429,3,234,211,3,214,0,214,5,175,34,22.04.2019 00:20,70,5,Zakarpatie
624,609,29,272,323,29,352,0,352,3,316,33,22.04.2019 00:30,70,5,Zakarpatie
1040,1033,43,337,660,43,703,0,703,9,606,88,22.04.2019 00:58,70,5,Zakarpatie
176,162,9,64,103,9,112,0,112,2,83,27,22.04.2019 00:15,70,5,Zakarpatie
128,117,4,49,75,4,79,0,79,0,56,23,22.04.2019 00:15,70,5,Zakarpatie
416,402,2,199,215,2,217,0,217,4,179,34,22.04.2019 00:05,70,5,Zakarpatie
288,170,26,118,144,26,170,0,170,1,132,37,22.04.2019 00:15,70,5,Zakarpatie
336,333,18,113,205,18,223,0,223,2,190,31,22.04.2019 00:25,70,5,Zakarpatie
448,429,2,186,260,2,262,0,262,9,218,35,22.04.2019 01:45,70,5,Zakarpatie
720,715,12,317,392,11,403,0,403,9,325,69,22.04.2019 00:38,70,5,Zakarpatie
1456,1440,16,559,885,12,897,0,897,30,642,225,22.04.2019 00:30,70,5,Zakarpatie
1456,1424,31,747,681,28,709,0,709,16,568,125,22.04.2019 00:30,70,5,Zakarpatie
704,697,21,344,339,21,360,0,360,11,284,65,22.04.2019 00:20,70,5,Zakarpatie
1072,1054,24,351,697,24,721,0,721,7,555,159,22.04.2019 00:46,70,5,Zakarpatie
800,794,19,332,449,19,468,0,468,5,361,102,22.04.2019 01:00,70,5,Zakarpatie
336,330,0,162,174,0,174,0,174,4,102,68,22.04.2019 00:20,70,5,Zakarpatie
432,418,40,181,214,37,251,0,251,1,207,43,22.04.2019 03:20,70,5,Zakarpatie
944,925,31,481,434,29,463,0,463,18,366,79,22.04.2019 00:30,70,5,Zakarpatie
464,458,35,180,253,31,284,0,284,11,185,88,22.04.2019 00:45,70,5,Zakarpatie
64,57,3,27,34,3,37,0,37,0,23,14,22.04.2019 00:15,70,5,Zakarpatie
112,107,4,47,61,4,65,0,65,0,45,20,21.04.2019 22:30,70,5,Zakarpatie
1008,996,53,542,416,50,466,0,466,15,349,102,22.04.2019 01:05,70,5,Zakarpatie
624,623,27,279,320,25,345,0,345,6,262,77,22.04.2019 01:10,70,5,Zakarpatie
528,522,27,197,304,27,331,0,331,3,221,107,22.04.2019 00:20,70,5,Zakarpatie
1408,1368,10,894,504,10,514,0,514,16,387,111,22.04.2019 00:18,70,5,Zakarpatie
224,212,15,57,152,15,167,0,167,1,131,35,22.04.2019 00:45,70,5,Zakarpatie
592,575,13,260,319,13,332,0,332,3,278,51,22.04.2019 00:15,70,5,Zakarpatie
640,633,9,296,335,9,344,0,344,3,309,32,22.04.2019 00:20,70,5,Zakarpatie
208,198,9,89,110,9,119,0,119,0,104,15,22.04.2019 00:15,70,5,Zakarpatie
1344,1316,37,691,620,33,653,0,653,15,535,103,22.04.2019 00:25,70,5,Zakarpatie
848,859,58,349,442,57,499,0,499,8,381,110,22.04.2019 00:20,70,5,Zakarpatie
304,300,21,117,167,20,187,0,187,3,142,42,22.04.2019 00:30,70,5,Zakarpatie
288,273,18,78,195,15,210,0,210,3,146,61,22.04.2019 00:27,70,5,Zakarpatie
320,308,1,145,174,1,175,0,175,1,151,23,22.04.2019 00:40,70,5,Zakarpatie
112,113,2,31,79,2,81,0,81,2,72,7,22.04.2019 00:10,70,5,Zakarpatie
1408,1397,28,850,530,28,558,0,558,26,419,113,22.04.2019 00:10,70,5,Zakarpatie
624,600,35,310,282,32,314,0,314,2,247,65,22.04.2019 00:08,70,5,Zakarpatie
1248,1240,23,538,692,18,710,0,710,18,540,152,21.04.2019 21:00,70,5,Zakarpatie
2272,2255,34,1092,1157,23,1180,0,1180,34,958,188,21.04.2019 22:30,70,5,Zakarpatie
608,605,3,274,331,3,334,0,334,13,266,55,22.04.2019 00:10,70,5,Zakarpatie
992,982,19,507,470,15,485,0,485,15,399,71,22.04.2019 00:03,70,5,Zakarpatie
240,222,7,52,181,7,188,0,188,3,132,53,21.04.2019 21:15,70,5,Zakarpatie
2064,2031,11,1053,1000,11,1011,0,1011,27,814,170,22.04.2019 00:15,70,5,Zakarpatie
1024,1007,4,574,446,4,450,0,450,8,368,74,22.04.2019 05:15,70,5,Zakarpatie
1168,1164,8,636,524,8,532,0,532,18,432,82,22.04.2019 00:58,70,5,Zakarpatie
1024,1020,1,512,511,1,512,0,512,18,370,124,22.04.2019 00:15,70,5,Zakarpatie
288,277,0,78,210,0,210,0,210,2,159,49,22.04.2019 00:10,70,5,Zakarpatie
192,191,0,61,131,0,131,0,131,1,103,27,21.04.2019 22:20,70,5,Zakarpatie
736,727,23,318,396,22,418,0,418,7,344,67,22.04.2019 01:50,70,5,Zakarpatie
256,246,6,97,153,6,159,0,159,5,108,46,22.04.2019 00:20,70,5,Zakarpatie
768,763,7,375,387,6,393,0,393,7,348,38,22.04.2019 00:45,70,5,Zakarpatie
576,558,5,289,282,5,287,0,287,8,239,40,22.04.2019 00:08,70,5,Zakarpatie
1600,1585,37,788,775,37,812,0,812,15,680,117,21.04.2019 20:45,70,5,Zakarpatie
64,48,0,29,35,0,35,0,35,0,13,22,22.04.2019 00:45,70,5,Zakarpatie
496,474,7,289,200,7,207,0,207,2,191,14,22.04.2019 01:30,70,5,Zakarpatie
1104,1084,5,616,483,5,488,0,488,7,426,55,22.04.2019 01:11,70,5,Zakarpatie
208,212,8,64,137,7,144,0,144,1,115,28,22.04.2019 01:10,70,5,Zakarpatie
240,230,6,120,114,6,120,0,120,3,98,19,22.04.2019 01:05,70,5,Zakarpatie
1152,1141,37,482,642,28,670,0,670,22,523,125,22.04.2019 00:20,70,5,Zakarpatie
640,630,18,157,465,18,483,0,483,10,345,128,22.04.2019 00:25,70,5,Zakarpatie
624,603,16,218,393,13,406,0,406,8,312,86,21.04.2019 20:50,70,5,Zakarpatie
1056,1049,24,541,503,12,515,0,515,17,402,96,22.04.2019 07:49,70,5,Zakarpatie
720,711,10,428,282,10,292,0,292,7,236,49,22.04.2019 01:05,70,5,Zakarpatie
752,737,18,377,360,15,375,0,375,8,321,46,22.04.2019 00:10,70,5,Zakarpatie
576,558,18,262,296,18,314,0,314,4,281,29,22.04.2019 00:25,70,5,Zakarpatie
96,90,5,22,69,5,74,0,74,2,47,25,22.04.2019 00:35,70,5,Zakarpatie
208,193,3,83,122,3,125,0,125,3,109,13,22.04.2019 00:18,70,5,Zakarpatie
976,960,16,428,535,13,548,0,548,17,419,112,22.04.2019 01:20,70,5,Zakarpatie
224,211,8,85,134,5,139,0,139,2,123,14,22.04.2019 00:15,70,5,Zakarpatie
224,219,4,78,142,4,146,0,146,0,130,16,22.04.2019 00:11,70,5,Zakarpatie
1632,1622,39,850,747,35,782,0,782,20,638,124,21.04.2019 22:10,70,5,Zakarpatie
448,436,5,220,224,4,228,0,228,3,203,22,22.04.2019 00:30,70,5,Zakarpatie
784,773,5,554,227,3,230,0,230,12,124,94,22.04.2019 00:15,70,5,Zakarpatie
576,570,6,199,371,6,377,0,377,10,328,39,22.04.2019 00:30,70,5,Zakarpatie
416,401,16,129,272,15,287,0,287,4,246,37,21.04.2019 21:50,70,5,Zakarpatie
1376,1363,18,608,750,18,768,0,768,16,645,107,22.04.2019 00:06,70,5,Zakarpatie
720,717,5,292,423,5,428,0,428,11,365,52,22.04.2019 00:30,70,5,Zakarpatie
1248,1224,42,628,586,34,620,0,620,24,482,114,22.04.2019 00:05,70,5,Zakarpatie
768,755,38,287,443,38,481,0,481,11,401,69,22.04.2019 00:15,70,5,Zakarpatie
192,190,5,87,102,3,105,0,105,1,90,14,21.04.2019 20:25,70,5,Zakarpatie
64,51,2,44,20,0,20,0,20,0,11,9,21.04.2019 20:45,70,5,Zakarpatie
96,86,1,38,57,1,58,0,58,2,42,14,21.04.2019 21:50,70,5,Zakarpatie
80,86,8,8,64,8,72,0,72,0,48,24,21.04.2019 21:50,70,5,Zakarpatie
432,422,20,169,243,20,263,0,263,7,190,66,22.04.2019 04:00,70,5,Zakarpatie
1216,1204,34,618,570,28,598,0,598,16,484,98,22.04.2019 01:10,70,5,Zakarpatie
704,692,22,300,383,21,404,0,404,10,356,38,22.04.2019 00:20,70,5,Zakarpatie
32,31,0,11,21,0,21,0,21,0,15,6,22.04.2019 00:15,70,5,Zakarpatie
240,238,4,121,115,4,119,0,119,5,95,19,22.04.2019 00:40,70,5,Zakarpatie
112,103,2,71,39,2,41,0,41,0,32,9,22.04.2019 00:20,70,5,Zakarpatie
976,970,68,434,478,64,542,0,542,10,446,86,22.04.2019 00:20,70,5,Zakarpatie
368,361,11,163,196,9,205,0,205,0,162,43,22.04.2019 00:10,70,5,Zakarpatie
1104,1092,46,537,521,46,567,0,567,13,488,66,22.04.2019 00:25,70,5,Zakarpatie
128,124,1,29,98,1,99,0,99,2,63,34,22.04.2019 00:30,70,5,Zakarpatie
2368,2362,14,1067,1291,10,1301,0,1301,39,1018,244,22.04.2019 00:10,70,5,Zakarpatie
1696,1650,4,742,950,4,954,0,954,32,718,204,22.04.2019 00:25,70,5,Zakarpatie
1664,1643,12,776,877,11,888,0,888,22,732,134,22.04.2019 00:15,70,5,Zakarpatie
1728,1721,15,1083,636,9,645,0,645,17,516,112,22.04.2019 00:50,70,5,Zakarpatie
1776,1764,17,814,951,11,962,0,962,30,737,195,22.04.2019 00:10,70,5,Zakarpatie
1568,1541,12,789,773,6,779,0,779,30,618,131,22.04.2019 00:15,70,5,Zakarpatie
1440,1424,6,738,699,3,702,0,702,17,535,150,22.04.2019 00:20,70,5,Zakarpatie
752,731,5,395,356,1,357,0,357,13,291,53,22.04.2019 00:10,70,5,Zakarpatie
2336,2315,22,1134,1182,20,1202,0,1202,21,1084,97,22.04.2019 00:20,70,5,Zakarpatie
448,441,6,220,224,4,228,0,228,7,195,26,21.04.2019 21:50,70,5,Zakarpatie
2096,2098,30,1029,1041,26,1067,0,1067,24,915,128,22.04.2019 01:40,70,5,Zakarpatie
880,1003,5,275,601,4,605,0,605,18,495,92,22.04.2019 00:10,70,5,Zakarpatie
1184,1172,10,564,610,10,620,0,620,13,555,52,22.04.2019 00:30,70,5,Zakarpatie
1696,1676,0,986,710,0,710,0,710,14,634,62,22.04.2019 00:10,70,5,Zakarpatie
576,569,5,302,269,5,274,0,274,2,264,8,22.04.2019 00:10,70,5,Zakarpatie
192,180,2,67,123,2,125,0,125,0,91,34,22.04.2019 00:10,70,5,Zakarpatie
1632,1619,10,817,805,10,815,0,815,9,718,88,22.04.2019 00:15,70,5,Zakarpatie
1712,1685,4,1005,703,4,707,0,707,24,593,90,22.04.2019 00:10,70,5,Zakarpatie
2400,2366,13,1190,1202,8,1210,0,1210,32,989,189,22.04.2019 00:23,70,5,Zakarpatie
1120,1109,4,403,715,2,717,0,717,17,656,44,22.04.2019 00:30,70,5,Zakarpatie
928,911,7,479,444,5,449,0,449,10,397,42,22.04.2019 00:15,70,5,Zakarpatie
560,542,4,305,251,4,255,0,255,2,227,26,22.04.2019 00:32,70,5,Zakarpatie
336,324,5,147,184,5,189,0,189,2,170,17,22.04.2019 00:05,70,5,Zakarpatie
272,265,7,127,138,7,145,0,145,1,120,24,22.04.2019 00:10,70,5,Zakarpatie
2112,2280,41,697,1375,40,1415,0,1415,32,1155,228,22.04.2019 00:20,70,5,Zakarpatie
320,319,10,73,237,10,247,0,247,6,220,21,22.04.2019 00:12,70,5,Zakarpatie
624,609,4,327,293,4,297,0,297,0,248,49,22.04.2019 00:40,70,5,Zakarpatie
416,401,17,142,257,17,274,0,274,5,222,47,22.04.2019 00:05,70,5,Zakarpatie
1952,1934,21,1028,903,21,924,0,924,22,822,80,22.04.2019 00:10,70,5,Zakarpatie
448,441,0,198,250,0,250,0,250,2,221,27,22.04.2019 00:15,70,5,Zakarpatie
1088,1070,4,543,541,4,545,0,545,12,487,46,22.04.2019 00:10,70,5,Zakarpatie
688,675,18,296,375,17,392,0,392,2,351,39,22.04.2019 01:10,70,5,Zakarpatie
640,633,9,218,414,8,422,0,422,5,371,46,22.04.2019 00:05,70,5,Zakarpatie
1152,1139,19,596,541,15,556,0,556,9,474,73,22.04.2019 04:26,70,5,Zakarpatie
1728,1709,13,910,809,9,818,0,818,25,632,161,22.04.2019 02:50,71,5,Zakarpatie
1856,1830,20,1018,826,12,838,0,838,21,710,107,22.04.2019 00:15,71,5,Zakarpatie
1760,1745,18,891,853,16,869,0,869,24,690,155,22.04.2019 00:05,71,5,Zakarpatie
2096,2077,12,1015,1071,10,1081,0,1081,38,875,168,22.04.2019 01:40,71,5,Zakarpatie
1040,1025,5,569,466,5,471,0,471,13,401,57,22.04.2019 00:50,71,5,Zakarpatie
1664,1643,14,769,885,10,895,0,895,24,775,96,22.04.2019 00:30,71,5,Zakarpatie
1200,1187,4,657,539,4,543,0,543,18,458,67,22.04.2019 00:40,71,5,Zakarpatie
2208,2178,11,1238,960,10,970,0,970,15,832,123,22.04.2019 00:35,71,5,Zakarpatie
2400,2379,30,1344,1030,26,1056,0,1056,32,871,153,22.04.2019 00:15,71,5,Zakarpatie
1504,1491,9,912,583,9,592,0,592,10,510,72,22.04.2019 00:15,71,5,Zakarpatie
2320,2281,21,1571,730,19,749,0,749,20,647,82,22.04.2019 00:20,71,5,Zakarpatie
1504,1481,16,717,771,16,787,0,787,13,626,148,22.04.2019 00:20,71,5,Zakarpatie
1952,1938,5,950,997,5,1002,0,1002,23,878,101,22.04.2019 00:20,71,5,Zakarpatie
896,896,30,428,439,29,468,0,468,14,382,72,22.04.2019 00:35,71,5,Zakarpatie
432,423,7,184,241,7,248,0,248,5,204,39,22.04.2019 00:15,71,5,Zakarpatie
448,443,20,186,242,20,262,0,262,6,198,58,22.04.2019 00:17,71,5,Zakarpatie
1008,1001,7,508,495,5,500,0,500,6,433,61,22.04.2019 00:25,71,5,Zakarpatie
2304,2285,43,1229,1034,41,1075,0,1075,27,924,124,22.04.2019 00:35,71,5,Zakarpatie
400,391,7,209,185,6,191,0,191,6,120,65,22.04.2019 00:36,71,5,Zakarpatie
2320,2283,24,1394,909,17,926,0,926,20,805,101,22.04.2019 01:20,71,5,Zakarpatie
2384,2357,23,1252,1111,21,1132,0,1132,30,966,136,22.04.2019 01:07,71,5,Zakarpatie
2224,2185,26,1351,850,23,873,0,873,11,756,106,22.04.2019 01:20,71,5,Zakarpatie
2080,2064,12,1185,885,10,895,0,895,31,684,180,22.04.2019 00:15,71,5,Zakarpatie
1840,1825,10,1031,803,6,809,0,809,22,641,146,22.04.2019 00:15,71,5,Zakarpatie
2240,2209,10,1331,899,10,909,0,909,24,712,173,22.04.2019 00:17,71,5,Zakarpatie
1824,1812,15,1065,750,9,759,0,759,19,672,68,22.04.2019 00:10,71,5,Zakarpatie
1248,1231,20,734,495,19,514,0,514,9,451,54,22.04.2019 00:31,71,5,Zakarpatie
2112,2086,23,1413,685,14,699,0,699,21,595,83,22.04.2019 00:16,71,5,Zakarpatie
2320,2308,9,1507,806,6,813,0,814,16,722,76,22.04.2019 00:35,71,5,Zakarpatie
864,849,1,580,283,1,284,0,284,4,257,23,22.04.2019 00:10,71,5,Zakarpatie
1360,1335,14,791,556,13,569,0,569,13,488,68,22.04.2019 00:15,71,5,Zakarpatie
1888,1863,39,1049,810,29,839,0,839,17,719,103,22.04.2019 00:30,71,5,Zakarpatie
1424,1407,12,871,541,12,553,0,553,21,500,32,22.04.2019 00:05,71,5,Zakarpatie
1888,1870,11,1089,788,11,799,0,799,18,686,95,22.04.2019 00:25,71,5,Zakarpatie
576,561,3,299,274,3,277,0,277,13,241,23,22.04.2019 00:15,71,5,Zakarpatie
1424,1400,23,638,768,18,786,0,786,16,665,105,22.04.2019 00:20,71,5,Zakarpatie
1232,1211,16,630,588,14,602,0,602,12,480,110,22.04.2019 00:10,71,5,Zakarpatie
1312,1294,26,746,549,17,566,0,566,13,456,97,22.04.2019 01:05,71,5,Zakarpatie
1168,1142,25,780,377,11,388,0,388,4,359,25,22.04.2019 00:45,71,5,Zakarpatie
672,655,11,405,256,11,267,0,267,1,215,51,22.04.2019 00:20,71,5,Zakarpatie
2016,1992,17,1334,674,8,682,0,682,17,572,93,22.04.2019 00:45,71,5,Zakarpatie
1616,1599,9,1152,459,5,464,0,464,19,396,49,22.04.2019 00:55,71,5,Zakarpatie
2192,2165,19,1439,739,14,753,0,753,25,660,68,22.04.2019 00:38,71,5,Zakarpatie
1072,1064,10,640,422,10,432,0,432,9,367,56,22.04.2019 00:27,71,5,Zakarpatie
880,892,6,483,392,5,397,0,397,8,351,38,22.04.2019 00:15,71,5,Zakarpatie
720,762,3,338,380,2,382,0,382,5,305,72,22.04.2019 00:05,71,5,Zakarpatie
1856,1830,36,1122,713,21,734,0,734,22,621,91,22.04.2019 00:22,71,5,Zakarpatie
1584,1576,33,883,679,22,701,0,701,21,623,57,22.04.2019 00:10,71,5,Zakarpatie
1888,1863,23,971,898,19,917,0,917,21,822,74,22.04.2019 00:15,71,5,Zakarpatie
1248,1233,19,733,498,17,515,0,515,9,459,47,22.04.2019 01:55,71,5,Zakarpatie
1392,1372,43,642,707,43,750,0,750,18,667,65,22.04.2019 00:58,71,5,Zakarpatie
1856,1838,31,1202,631,23,654,0,654,20,510,124,22.04.2019 00:56,71,5,Zakarpatie
2368,2340,39,1465,876,27,903,0,903,8,765,130,22.04.2019 01:15,71,5,Zakarpatie
688,670,13,427,251,10,261,0,261,4,212,45,22.04.2019 00:30,71,5,Zakarpatie
1456,1445,8,927,521,8,529,0,529,11,469,49,22.04.2019 00:10,71,5,Zakarpatie
1616,1588,26,872,722,22,744,0,744,26,647,71,22.04.2019 00:01,71,5,Zakarpatie
1520,1495,44,910,572,38,610,0,610,23,528,59,22.04.2019 00:20,71,5,Zakarpatie
2384,2358,34,1258,1100,26,1126,0,1126,17,1013,96,22.04.2019 00:45,71,5,Zakarpatie
2032,2020,27,1144,870,18,888,0,888,25,816,47,22.04.2019 00:45,71,5,Zakarpatie
1056,1033,11,545,500,11,511,0,511,6,438,67,22.04.2019 00:15,71,5,Zakarpatie
2208,2194,26,1130,1055,23,1078,0,1078,18,1001,59,22.04.2019 00:15,71,5,Zakarpatie
1264,1251,22,698,547,19,566,0,566,7,485,74,22.04.2019 00:50,71,5,Zakarpatie
992,979,28,457,512,23,535,0,535,15,424,96,22.04.2019 00:15,71,5,Zakarpatie
1760,1744,14,947,799,14,813,0,813,23,746,44,22.04.2019 00:05,71,5,Zakarpatie
1136,1118,9,671,456,9,465,0,465,26,403,36,22.04.2019 00:25,71,5,Zakarpatie
1824,1798,32,1009,799,16,815,0,815,25,741,49,22.04.2019 00:45,71,5,Zakarpatie
1792,1762,25,992,788,12,800,0,800,24,735,41,22.04.2019 00:10,71,5,Zakarpatie
1056,1036,24,547,493,16,509,0,509,12,473,24,22.04.2019 00:45,71,5,Zakarpatie
2128,2096,50,1154,931,43,974,0,974,16,901,57,22.04.2019 00:23,71,5,Zakarpatie
1152,1136,15,630,510,12,522,0,522,9,497,16,22.04.2019 01:20,71,5,Zakarpatie
1408,1391,36,780,602,26,628,0,628,14,565,49,22.04.2019 00:50,71,5,Zakarpatie
848,827,38,409,401,38,439,0,439,9,337,93,22.04.2019 00:25,71,5,Zakarpatie
224,216,8,119,97,8,105,0,105,2,75,28,22.04.2019 00:50,71,5,Zakarpatie
352,349,15,64,273,15,288,0,288,8,191,89,22.04.2019 00:20,71,5,Zakarpatie
1744,1718,56,901,788,55,843,0,843,39,749,55,22.04.2019 00:15,71,5,Zakarpatie
2256,2233,36,1176,1052,28,1080,0,1080,40,944,96,22.04.2019 00:15,71,5,Zakarpatie
1744,1725,42,864,850,30,880,0,880,17,822,41,22.04.2019 00:25,71,5,Zakarpatie
1984,1956,18,1180,791,13,804,0,804,24,616,164,22.04.2019 00:30,71,5,Zakarpatie
1680,1652,26,933,727,20,747,0,747,33,563,151,22.04.2019 00:42,71,5,Zakarpatie
336,322,1,188,147,1,148,0,148,3,103,42,22.04.2019 00:20,71,5,Zakarpatie
2096,2073,27,1142,928,26,954,0,954,31,810,113,22.04.2019 00:05,71,5,Zakarpatie
1904,1874,36,1162,715,27,742,0,742,21,645,76,22.04.2019 00:25,71,5,Zakarpatie
1600,1578,32,886,696,18,714,0,714,19,590,105,22.04.2019 00:10,71,5,Zakarpatie
304,302,0,157,147,0,147,0,147,3,136,8,22.04.2019 00:25,71,5,Zakarpatie
1376,1366,5,785,586,5,591,0,591,23,511,57,22.04.2019 00:17,71,5,Zakarpatie
640,627,0,291,349,0,349,0,349,9,290,50,22.04.2019 00:15,71,5,Zakarpatie
1680,1654,9,703,971,6,977,0,977,39,761,177,22.04.2019 00:42,71,5,Zakarpatie
1488,1475,10,673,807,8,815,0,815,22,621,172,22.04.2019 00:15,71,5,Zakarpatie
1424,1411,3,663,759,2,761,0,761,20,603,138,22.04.2019 00:15,71,5,Zakarpatie
1328,1309,8,675,648,5,653,0,653,24,494,135,22.04.2019 00:30,71,5,Zakarpatie
1072,1055,8,518,549,5,554,0,554,25,380,149,22.04.2019 00:25,71,5,Zakarpatie
1344,1334,4,773,567,4,571,0,571,15,471,85,22.04.2019 00:15,71,5,Zakarpatie
1200,1189,4,668,530,2,532,0,532,9,433,90,22.04.2019 00:58,71,5,Zakarpatie
1568,1558,8,734,827,7,834,0,834,25,646,163,22.04.2019 00:42,71,5,Zakarpatie
1680,1646,19,775,892,13,905,0,905,28,677,200,22.04.2019 00:10,71,5,Zakarpatie
1184,1185,7,516,662,6,668,0,668,31,525,112,22.04.2019 00:22,71,5,Zakarpatie
1456,1445,10,700,748,8,756,0,756,19,605,132,22.04.2019 00:20,71,5,Zakarpatie
2000,1974,8,1049,943,8,951,0,951,36,778,137,22.04.2019 00:34,71,5,Zakarpatie
1584,1579,29,751,830,3,833,0,833,23,653,157,22.04.2019 00:52,71,5,Zakarpatie
2112,2094,4,1029,1079,4,1083,0,1083,40,836,207,22.04.2019 00:35,71,5,Zakarpatie
1200,1185,1,708,491,1,492,0,492,13,433,46,22.04.2019 00:20,71,5,Zakarpatie
800,782,13,420,367,13,380,0,380,6,331,43,22.04.2019 00:40,71,5,Zakarpatie
864,850,6,459,399,6,405,0,405,13,359,33,22.04.2019 00:10,71,5,Zakarpatie
2096,2082,12,1680,412,4,416,0,416,8,391,17,22.04.2019 01:15,72,5,Zakarpatie
288,280,1,238,49,1,50,0,50,0,46,4,22.04.2019 00:15,72,5,Zakarpatie
2384,2351,14,2099,280,5,285,0,285,9,249,27,22.04.2019 00:15,72,5,Zakarpatie
2176,2164,13,1936,238,2,240,0,240,1,225,14,22.04.2019 00:20,72,5,Zakarpatie
896,885,0,785,111,0,111,0,111,3,81,27,22.04.2019 00:10,72,5,Zakarpatie
1280,1257,17,758,508,14,522,0,522,8,443,71,22.04.2019 00:55,72,5,Zakarpatie
704,689,5,568,132,4,136,0,136,1,128,7,22.04.2019 00:30,72,5,Zakarpatie
2160,2134,24,1480,664,16,680,0,680,17,581,82,22.04.2019 00:50,72,5,Zakarpatie
1776,1757,13,1091,679,6,685,0,685,17,628,40,22.04.2019 01:20,72,5,Zakarpatie
1072,1058,10,826,245,1,246,0,246,2,220,24,22.04.2019 00:20,72,5,Zakarpatie
2416,2382,38,1489,893,34,927,0,927,15,823,89,22.04.2019 00:30,72,5,Zakarpatie
2304,2272,39,1379,893,32,925,0,925,29,651,245,22.04.2019 02:11,72,5,Zakarpatie
2304,2286,82,1303,930,71,1001,0,1001,14,695,292,22.04.2019 00:25,72,5,Zakarpatie
2336,2300,63,1398,889,49,938,0,938,19,731,188,22.04.2019 00:15,72,5,Zakarpatie
1792,1775,21,1135,642,15,657,0,657,18,420,219,22.04.2019 00:10,72,5,Zakarpatie
1264,1240,20,852,395,17,412,0,412,4,288,120,22.04.2019 00:10,72,5,Zakarpatie
832,823,45,425,369,38,407,0,407,7,313,87,22.04.2019 00:32,72,5,Zakarpatie
1504,1474,40,882,587,35,622,0,622,17,455,150,22.04.2019 02:15,72,5,Zakarpatie
432,418,5,221,206,5,211,0,211,7,173,31,22.04.2019 00:35,72,5,Zakarpatie
2016,2046,30,1082,906,28,934,0,934,21,736,177,22.04.2019 00:18,72,5,Zakarpatie
2240,2209,20,1405,818,17,835,0,835,16,660,159,22.04.2019 00:15,72,5,Zakarpatie
1936,1916,12,1430,498,8,506,0,506,4,437,65,22.04.2019 00:32,72,5,Zakarpatie
1584,1565,21,1000,567,17,584,0,584,5,516,63,22.04.2019 00:45,72,5,Zakarpatie
1264,1253,15,815,438,11,449,0,449,9,369,71,22.04.2019 00:21,72,5,Zakarpatie
1840,1814,28,1125,690,25,715,0,715,15,566,134,22.04.2019 00:30,72,5,Zakarpatie
1040,1018,9,432,601,7,608,0,608,5,507,96,22.04.2019 00:30,72,5,Zakarpatie
1264,1241,2,773,489,2,491,0,491,6,389,96,22.04.2019 04:27,72,5,Zakarpatie
2128,2097,18,1113,1002,13,1015,0,1015,29,658,328,22.04.2019 00:30,72,5,Zakarpatie
2256,2219,12,1620,629,7,636,0,636,20,448,168,22.04.2019 01:15,72,5,Zakarpatie
2368,2364,16,1384,973,11,984,0,984,36,657,291,22.04.2019 00:10,72,5,Zakarpatie
2416,2397,13,1729,679,8,687,0,687,13,514,160,22.04.2019 00:50,72,5,Zakarpatie
2016,1994,16,1279,724,13,737,0,737,16,538,183,22.04.2019 02:00,72,5,Zakarpatie
1360,1339,22,814,525,21,546,0,546,14,430,102,22.04.2019 00:15,72,5,Zakarpatie
1744,1818,26,921,800,23,823,0,823,11,612,200,22.04.2019 00:40,72,5,Zakarpatie
1120,1101,7,739,374,7,381,0,381,7,287,87,22.04.2019 00:05,72,5,Zakarpatie
2000,1983,46,1069,892,39,931,0,931,17,665,249,22.04.2019 00:40,72,5,Zakarpatie
2384,2354,24,982,1386,16,1402,0,1402,34,1012,356,22.04.2019 02:30,72,5,Zakarpatie
576,568,8,280,290,6,296,0,296,14,186,96,22.04.2019 03:46,72,5,Zakarpatie
688,684,6,294,388,6,394,0,394,7,261,126,22.04.2019 02:30,72,5,Zakarpatie
1792,1769,24,1023,748,21,769,0,769,18,545,206,22.04.2019 00:35,72,5,Zakarpatie
1136,1114,5,599,532,5,537,0,537,16,405,116,22.04.2019 00:12,72,5,Zakarpatie
2160,2132,31,879,1250,31,1281,0,1281,34,1023,224,22.04.2019 00:43,72,5,Zakarpatie
2288,2275,12,1369,913,6,919,0,919,33,774,112,22.04.2019 00:25,72,5,Zakarpatie
2032,2017,13,1279,747,6,753,0,753,24,647,82,22.04.2019 00:25,72,5,Zakarpatie
1888,1880,3,997,888,3,891,0,891,15,727,149,22.04.2019 01:00,72,5,Zakarpatie
1616,1595,5,934,678,4,682,0,682,17,536,129,22.04.2019 00:15,72,5,Zakarpatie
1232,1219,14,756,462,14,476,0,476,11,434,31,22.04.2019 00:15,72,5,Zakarpatie
896,876,3,563,331,2,333,0,333,9,305,19,22.04.2019 00:19,72,5,Zakarpatie
1872,1849,9,1087,776,9,785,0,785,11,659,115,22.04.2019 00:34,72,5,Zakarpatie
2080,2052,5,1248,827,5,832,0,832,17,702,113,22.04.2019 00:05,72,5,Zakarpatie
2336,2304,9,1466,864,6,870,0,870,22,772,76,22.04.2019 00:45,72,5,Zakarpatie
1488,1469,3,879,607,2,609,0,609,13,518,78,22.04.2019 00:10,72,5,Zakarpatie
2272,2249,8,1610,655,7,662,0,662,18,602,42,22.04.2019 00:15,72,5,Zakarpatie
2272,2247,1,1632,639,1,640,0,640,14,572,54,22.04.2019 00:02,72,5,Zakarpatie
1760,1760,3,1477,282,1,283,0,283,9,263,11,22.04.2019 00:15,72,5,Zakarpatie
1792,1762,5,1087,700,5,705,0,705,19,585,101,22.04.2019 00:20,72,5,Zakarpatie
2000,1983,6,1171,825,4,829,0,829,21,693,115,22.04.2019 00:30,72,5,Zakarpatie
1840,1816,6,1124,711,5,716,0,716,22,609,85,22.04.2019 00:10,72,5,Zakarpatie
1040,1021,16,501,525,14,539,0,539,11,396,132,22.04.2019 00:15,72,5,Zakarpatie
1936,1920,25,1172,742,22,764,0,764,12,657,95,22.04.2019 00:18,72,5,Zakarpatie
1968,1948,6,1351,611,6,617,0,617,10,510,97,22.04.2019 02:15,72,5,Zakarpatie
784,776,19,356,409,19,428,0,428,8,388,32,22.04.2019 00:05,72,5,Zakarpatie
1280,1262,13,861,414,5,419,0,419,10,381,28,22.04.2019 00:15,72,5,Zakarpatie
1760,1747,10,1080,674,6,680,0,680,15,575,90,22.04.2019 00:25,72,5,Zakarpatie
800,790,11,447,342,11,353,0,353,1,316,36,22.04.2019 00:27,72,5,Zakarpatie
304,300,3,168,133,3,136,0,136,0,122,14,22.04.2019 00:30,72,5,Zakarpatie
1168,1148,3,810,355,3,358,0,358,6,326,26,22.04.2019 00:15,72,5,Zakarpatie
2496,2482,48,1522,940,34,974,0,974,29,750,195,22.04.2019 00:15,72,5,Zakarpatie
816,801,19,499,299,18,317,0,317,7,233,77,22.04.2019 02:18,72,5,Zakarpatie
2480,2453,13,1793,678,9,687,0,687,10,616,61,22.04.2019 00:20,72,5,Zakarpatie
1584,1561,9,1154,427,3,430,0,430,15,373,42,22.04.2019 00:25,72,5,Zakarpatie
2400,2375,6,2141,257,2,259,0,259,9,212,38,22.04.2019 00:04,72,5,Zakarpatie
1984,1955,1,1890,94,0,94,0,94,1,85,8,22.04.2019 00:45,72,5,Zakarpatie
2256,2247,10,1598,653,5,658,0,658,8,579,71,22.04.2019 01:58,72,5,Zakarpatie
2320,2304,7,1818,500,2,502,0,502,9,454,39,22.04.2019 00:05,72,5,Zakarpatie
2192,2183,0,1851,341,0,341,0,341,4,323,14,22.04.2019 00:20,72,5,Zakarpatie
1728,1715,5,1447,277,4,281,0,281,4,263,14,22.04.2019 00:50,72,5,Zakarpatie
1840,1822,3,1573,264,3,267,0,267,3,247,17,22.04.2019 00:53,72,5,Zakarpatie
1008,989,0,937,71,0,71,0,71,0,61,10,22.04.2019 00:11,72,5,Zakarpatie
1984,1970,26,1092,867,25,892,0,892,23,802,67,22.04.2019 01:10,72,5,Zakarpatie
1680,1652,18,1010,654,16,670,0,670,9,605,56,22.04.2019 01:30,72,5,Zakarpatie
1120,1104,22,723,379,18,397,0,397,9,363,25,22.04.2019 01:10,72,5,Zakarpatie
1472,1443,8,777,687,8,695,0,695,10,643,42,22.04.2019 00:30,72,5,Zakarpatie
1840,1824,60,999,781,60,841,0,841,22,661,158,22.04.2019 00:13,72,5,Zakarpatie
2384,2357,39,1512,836,36,872,0,872,9,775,88,22.04.2019 00:15,72,5,Zakarpatie
2384,2365,27,1259,1098,27,1125,0,1125,10,562,553,22.04.2019 00:05,72,5,Zakarpatie
1968,1935,15,1133,820,15,835,0,835,18,707,110,22.04.2019 00:30,72,5,Zakarpatie
704,684,11,451,242,11,253,0,253,3,214,36,22.04.2019 00:10,72,5,Zakarpatie
912,899,5,613,294,5,299,0,299,10,261,28,22.04.2019 01:15,72,5,Zakarpatie
2448,2416,48,1365,1044,39,1083,0,1083,29,908,146,22.04.2019 00:50,72,5,Zakarpatie
960,943,13,497,453,10,463,0,463,4,411,48,22.04.2019 00:13,72,5,Zakarpatie
960,954,23,526,417,17,434,0,434,5,322,107,22.04.2019 00:27,72,5,Zakarpatie
400,390,3,134,263,3,266,0,266,3,163,100,22.04.2019 00:54,72,5,Zakarpatie
2256,2228,20,1587,657,12,669,0,669,18,546,105,22.04.2019 00:25,72,5,Zakarpatie
2400,2370,9,1537,857,6,863,0,863,10,735,118,22.04.2019 00:20,72,5,Zakarpatie
2432,2402,5,1730,697,5,702,0,702,12,642,48,22.04.2019 00:30,72,5,Zakarpatie
1680,1659,5,1131,544,5,549,0,549,9,496,44,22.04.2019 00:45,72,5,Zakarpatie
1840,1822,0,1657,183,0,183,0,183,3,158,22,22.04.2019 00:20,72,5,Zakarpatie
1808,1776,26,1058,727,23,750,0,750,10,652,88,22.04.2019 01:30,72,5,Zakarpatie
1504,1492,15,974,515,15,530,0,530,9,455,66,22.04.2019 01:10,72,5,Zakarpatie
944,931,27,551,369,24,393,0,393,7,338,48,22.04.2019 00:25,72,5,Zakarpatie
1856,1835,19,1201,637,18,655,0,655,26,579,50,22.04.2019 00:20,72,5,Zakarpatie
1856,1841,26,1107,723,26,749,0,749,17,687,45,22.04.2019 01:47,72,5,Zakarpatie
1440,1424,12,960,472,8,480,0,480,8,422,50,22.04.2019 01:15,72,5,Zakarpatie
496,517,6,309,183,4,187,0,187,4,172,11,22.04.2019 00:30,73,5,Zakarpatie
1270,1286,11,799,460,11,471,0,471,5,458,8,22.04.2019 00:10,73,5,Zakarpatie
1040,1026,11,689,343,8,351,0,351,9,333,9,22.04.2019 00:20,73,5,Zakarpatie
1456,1442,7,924,528,4,532,0,532,15,495,22,22.04.2019 00:40,73,5,Zakarpatie
1104,1102,5,767,333,4,337,0,337,6,314,17,21.04.2019 22:30,73,5,Zakarpatie
2272,2255,5,1797,470,5,475,0,475,19,446,10,22.04.2019 00:10,73,5,Zakarpatie
848,823,10,450,390,8,398,0,398,10,308,80,22.04.2019 00:05,73,5,Zakarpatie
2016,2004,11,1378,628,10,638,0,638,17,597,24,22.04.2019 02:10,73,5,Zakarpatie
576,570,8,349,220,7,227,0,227,4,219,4,21.04.2019 22:25,73,5,Zakarpatie
752,754,12,479,264,9,273,0,273,8,256,9,21.04.2019 21:50,73,5,Zakarpatie
1584,1578,1,1059,524,1,525,0,525,8,503,14,22.04.2019 00:55,73,5,Zakarpatie
672,666,7,358,308,6,314,0,314,6,262,46,21.04.2019 21:15,73,5,Zakarpatie
704,684,8,434,265,5,270,0,270,1,258,11,21.04.2019 21:10,73,5,Zakarpatie
528,511,23,297,211,20,231,0,231,2,215,14,22.04.2019 00:08,73,5,Zakarpatie
256,241,23,79,156,21,177,0,177,3,154,20,22.04.2019 00:05,73,5,Zakarpatie
1520,1499,16,965,547,8,555,0,555,12,508,35,21.04.2019 22:10,73,5,Zakarpatie
560,545,13,315,234,11,245,0,245,5,210,30,22.04.2019 00:11,73,5,Zakarpatie
448,441,12,240,196,12,208,0,208,1,170,37,22.04.2019 00:10,73,5,Zakarpatie
656,645,8,355,294,7,301,0,301,3,291,7,21.04.2019 21:45,73,5,Zakarpatie
592,575,4,408,183,1,184,0,184,3,172,9,21.04.2019 20:35,73,5,Zakarpatie
704,694,13,446,249,9,258,0,258,4,233,21,22.04.2019 00:57,73,5,Zakarpatie
2096,2151,9,1418,674,4,678,0,678,20,593,65,22.04.2019 00:15,73,5,Zakarpatie
2224,2205,4,1020,1200,4,1204,0,1204,26,970,208,21.04.2019 22:30,73,5,Zakarpatie
1552,1532,7,922,625,5,630,0,630,15,552,63,22.04.2019 00:12,73,5,Zakarpatie
2448,2419,5,1612,831,5,836,0,836,13,676,147,22.04.2019 01:30,73,5,Zakarpatie
720,715,4,304,412,4,416,0,416,9,356,51,22.04.2019 00:44,73,5,Zakarpatie
1744,1716,6,1177,562,5,567,0,567,28,470,69,22.04.2019 00:04,73,5,Zakarpatie
1360,1342,8,701,651,8,659,0,659,17,540,102,22.04.2019 00:12,73,5,Zakarpatie
1184,1167,12,621,553,10,563,0,563,18,470,75,22.04.2019 00:06,73,5,Zakarpatie
1344,1340,15,1013,317,14,331,0,331,3,324,4,21.04.2019 22:15,73,5,Zakarpatie
720,725,0,545,175,0,175,0,175,7,164,4,21.04.2019 21:05,73,5,Zakarpatie
1568,1548,7,777,784,7,791,0,791,9,697,85,21.04.2019 22:20,73,5,Zakarpatie
448,443,3,225,221,2,223,0,223,3,185,35,22.04.2019 00:03,73,5,Zakarpatie
1792,1780,9,1270,515,7,522,0,522,11,502,9,21.04.2019 21:10,73,5,Zakarpatie
1520,1500,2,887,631,2,633,0,633,19,547,67,22.04.2019 00:15,73,5,Zakarpatie
1136,1139,0,680,456,0,456,0,456,17,433,6,21.04.2019 20:35,73,5,Zakarpatie
976,967,37,487,455,34,489,0,489,13,409,67,21.04.2019 21:00,73,5,Zakarpatie
1184,1168,21,677,493,14,507,0,507,12,474,21,22.04.2019 00:10,73,5,Zakarpatie
1344,1229,3,883,458,3,461,0,461,15,425,21,21.04.2019 21:10,73,5,Zakarpatie
672,654,2,387,283,2,285,0,285,7,270,8,21.04.2019 21:07,73,5,Zakarpatie
288,279,0,162,126,0,126,0,126,6,119,1,21.04.2019 21:00,73,5,Zakarpatie
416,411,0,290,126,0,126,0,126,2,121,3,21.04.2019 20:05,73,5,Zakarpatie
240,229,0,170,70,0,70,0,70,0,57,13,21.04.2019 21:20,73,5,Zakarpatie
976,962,42,556,383,37,420,0,420,6,368,46,21.04.2019 22:15,73,5,Zakarpatie
1376,1364,21,869,486,21,507,0,507,16,459,32,21.04.2019 21:03,73,5,Zakarpatie
2000,1986,4,1172,824,4,828,0,828,27,683,118,21.04.2019 22:50,73,5,Zakarpatie
1520,1499,1,853,666,1,667,0,667,19,525,123,22.04.2019 00:20,73,5,Zakarpatie
2304,2276,75,1094,1140,70,1210,0,1210,24,1014,172,22.04.2019 00:38,73,5,Zakarpatie
1952,1934,12,1405,535,12,547,0,547,13,468,66,22.04.2019 00:10,73,5,Zakarpatie
1760,1741,13,997,755,8,763,0,763,24,642,97,22.04.2019 00:09,73,5,Zakarpatie
560,557,1,304,255,1,256,0,256,5,246,5,21.04.2019 20:45,73,5,Zakarpatie
304,302,1,163,140,1,141,0,141,5,127,9,21.04.2019 21:15,73,5,Zakarpatie
1600,1591,4,1118,480,2,482,0,482,4,468,10,22.04.2019 00:32,73,5,Zakarpatie
1664,1643,9,1233,426,5,431,0,431,9,416,6,22.04.2019 00:10,73,5,Zakarpatie
592,575,0,422,170,0,170,0,170,3,162,5,21.04.2019 20:37,73,5,Zakarpatie
1120,1097,16,647,457,16,473,0,473,13,388,72,21.04.2019 21:30,73,5,Zakarpatie
1792,1768,18,837,940,15,955,0,955,29,805,121,22.04.2019 00:10,73,5,Zakarpatie
432,417,3,241,189,2,191,0,191,3,169,19,22.04.2019 00:01,73,5,Zakarpatie
1216,1201,19,666,534,16,550,0,550,18,477,55,21.04.2019 22:10,73,5,Zakarpatie
1680,1656,11,992,678,10,688,0,688,12,618,58,22.04.2019 00:05,73,5,Zakarpatie
1664,1637,8,987,669,8,677,0,677,15,630,32,22.04.2019 00:20,73,5,Zakarpatie
1296,1281,7,723,566,7,573,0,573,22,488,63,22.04.2019 01:35,73,5,Zakarpatie
1520,1503,12,851,658,11,669,0,669,20,611,38,21.04.2019 22:00,73,5,Zakarpatie
640,624,6,316,319,5,324,0,324,9,296,19,22.04.2019 00:05,73,5,Zakarpatie
304,287,3,183,118,3,121,0,121,2,104,15,21.04.2019 23:19,73,5,Zakarpatie
1664,1650,23,999,650,15,665,0,665,11,598,56,21.04.2019 21:28,73,5,Zakarpatie
528,509,23,244,264,20,284,0,284,7,253,24,21.04.2019 21:45,73,5,Zakarpatie
1632,1618,14,866,752,14,766,0,766,31,651,84,21.04.2019 22:00,73,5,Zakarpatie
2288,2263,13,1533,744,11,755,0,755,18,698,39,21.04.2019 21:40,73,5,Zakarpatie
1856,1842,28,1144,685,27,712,0,712,21,612,79,22.04.2019 01:00,73,5,Zakarpatie
1200,1227,4,773,424,3,427,0,427,9,390,28,21.04.2019 21:00,73,5,Zakarpatie
1296,1283,6,997,295,4,299,0,299,3,284,12,21.04.2019 22:40,73,5,Zakarpatie
1824,1800,20,997,812,15,827,0,827,15,674,138,22.04.2019 00:03,73,5,Zakarpatie
1856,1830,12,1033,811,12,823,0,823,19,728,76,22.04.2019 00:10,73,5,Zakarpatie
2480,2455,8,2025,448,7,455,0,455,10,397,48,22.04.2019 00:35,73,5,Zakarpatie
2320,2297,4,1251,1066,3,1069,0,1069,34,854,181,22.04.2019 00:15,73,5,Zakarpatie
2448,2448,167,1226,1081,141,1222,0,1222,45,974,203,22.04.2019 00:20,73,5,Zakarpatie
1472,1459,7,791,674,7,681,0,681,24,559,98,22.04.2019 00:05,73,5,Zakarpatie
2192,2188,6,1211,975,6,981,0,981,26,813,142,22.04.2019 00:30,73,5,Zakarpatie
1312,1291,3,726,584,2,586,0,586,28,477,81,22.04.2019 00:16,73,5,Zakarpatie
1744,1725,8,862,875,7,882,0,882,31,716,135,21.04.2019 21:50,73,5,Zakarpatie
1584,1592,9,861,717,6,723,0,723,13,615,95,22.04.2019 00:05,73,5,Zakarpatie
2032,1996,6,1089,939,4,943,0,943,19,780,144,22.04.2019 00:10,73,5,Zakarpatie
2048,2026,7,1054,988,6,994,0,994,26,800,168,22.04.2019 00:20,73,5,Zakarpatie
2160,2133,3,1081,1077,2,1079,0,1079,34,830,215,21.04.2019 21:30,73,5,Zakarpatie
784,767,1,443,340,1,341,0,341,11,292,38,22.04.2019 00:03,73,5,Zakarpatie
416,40,29,378,11,27,38,0,38,1,31,6,21.04.2019 21:15,73,5,Zakarpatie
1952,1924,14,1101,837,14,851,0,851,19,719,113,22.04.2019 00:05,73,5,Zakarpatie
640,621,0,253,387,0,387,0,387,11,330,46,21.04.2019 21:20,73,5,Zakarpatie
1472,1442,45,892,537,43,580,0,580,11,510,59,21.04.2019 21:00,73,5,Zakarpatie
992,992,9,437,550,5,555,0,555,24,340,191,21.04.2019 20:30,73,5,Zakarpatie
1776,1764,55,858,863,55,918,0,918,11,795,112,22.04.2019 00:05,73,5,Zakarpatie
544,529,24,313,207,24,231,0,231,0,208,23,22.04.2019 00:10,73,5,Zakarpatie
944,935,18,440,486,18,504,0,504,6,409,89,22.04.2019 00:45,73,5,Zakarpatie
2352,2335,50,917,1388,47,1435,0,1435,32,1274,129,22.04.2019 00:30,73,5,Zakarpatie
1600,1586,6,959,635,6,641,0,641,22,501,118,22.04.2019 00:15,73,5,Zakarpatie
1552,1538,8,957,588,7,595,0,595,18,457,120,22.04.2019 00:17,73,5,Zakarpatie
1136,1117,17,669,457,10,467,0,467,12,397,58,22.04.2019 00:10,73,5,Zakarpatie
368,357,9,168,191,9,200,0,200,7,168,25,22.04.2019 00:40,73,5,Zakarpatie
176,169,0,100,76,0,76,0,76,0,69,7,22.04.2019 00:05,73,5,Zakarpatie
624,605,14,324,286,14,300,0,300,12,244,44,22.04.2019 00:11,73,5,Zakarpatie
1664,1664,10,981,679,4,683,0,683,18,552,113,22.04.2019 00:01,73,5,Zakarpatie
2272,2250,17,1334,929,9,938,0,938,18,752,168,22.04.2019 00:10,73,5,Zakarpatie
1216,1240,4,658,555,3,558,0,558,12,442,104,22.04.2019 00:05,73,5,Zakarpatie
2272,2255,12,1430,836,6,842,0,842,31,728,83,22.04.2019 00:30,73,5,Zakarpatie
1184,1198,22,804,370,10,380,0,380,9,325,46,22.04.2019 00:05,73,5,Zakarpatie
2224,2210,15,1446,770,8,778,0,778,25,628,125,22.04.2019 01:01,73,5,Zakarpatie
1920,1927,7,1229,689,2,691,0,691,27,540,124,22.04.2019 02:00,73,5,Zakarpatie
1408,1413,11,805,601,2,603,0,603,18,492,93,22.04.2019 00:10,73,5,Zakarpatie
2144,2119,7,1244,893,7,900,0,900,17,718,165,22.04.2019 00:07,73,5,Zakarpatie
1040,1024,0,696,344,0,344,0,344,17,314,13,22.04.2019 00:47,73,5,Zakarpatie
384,379,10,148,228,8,236,0,236,3,197,36,22.04.2019 00:15,73,5,Zakarpatie
1216,1195,3,1004,211,1,212,0,212,19,157,36,22.04.2019 00:35,73,5,Zakarpatie
336,81,49,256,31,49,80,0,80,8,66,6,22.04.2019 00:30,73,5,Zakarpatie
176,23,12,155,9,12,21,0,21,0,19,2,22.04.2019 00:05,73,5,Zakarpatie
832,680,0,155,677,0,677,0,677,83,575,19,22.04.2019 00:05,74,6,Zaporozhie
2224,2195,23,737,1471,16,1487,0,1487,33,1206,248,22.04.2019 00:21,74,6,Zaporozhie
1984,1973,30,572,1389,23,1412,0,1412,35,1141,236,22.04.2019 00:20,74,6,Zaporozhie
2272,2257,14,683,1580,9,1589,0,1589,36,1285,268,22.04.2019 00:01,74,6,Zaporozhie
1840,1819,12,606,1225,9,1234,0,1234,39,976,219,22.04.2019 00:10,74,6,Zaporozhie
2144,2111,19,790,1343,11,1354,0,1354,38,1053,263,22.04.2019 00:05,74,6,Zaporozhie
2160,2134,11,721,1434,5,1439,0,1439,34,1158,247,22.04.2019 00:27,74,6,Zaporozhie
2192,2157,15,800,1382,10,1392,0,1392,29,1165,198,22.04.2019 00:06,74,6,Zaporozhie
2320,2338,19,745,1561,14,1575,0,1575,38,1235,302,22.04.2019 00:30,74,6,Zaporozhie
2272,2253,30,674,1579,19,1598,0,1598,36,1295,267,22.04.2019 00:15,74,6,Zaporozhie
2256,2217,14,857,1388,11,1399,0,1399,35,1155,209,22.04.2019 00:50,74,6,Zaporozhie
2304,2293,17,763,1528,13,1541,0,1541,34,1250,257,22.04.2019 00:20,74,6,Zaporozhie
2336,2289,4,1027,1306,3,1309,0,1309,42,1098,169,22.04.2019 00:55,74,6,Zaporozhie
2400,2366,13,1019,1374,7,1381,0,1381,48,1123,210,22.04.2019 00:25,74,6,Zaporozhie
2096,2053,13,904,1183,9,1192,0,1192,20,960,212,22.04.2019 01:00,74,6,Zaporozhie
2192,2170,18,842,1337,13,1350,0,1350,34,1102,214,22.04.2019 00:45,74,6,Zaporozhie
176,12,3,164,9,3,12,0,12,0,11,1,22.04.2019 00:12,74,6,Zaporozhie
128,27,0,102,26,0,26,0,26,0,23,3,22.04.2019 00:06,74,6,Zaporozhie
208,27,0,183,25,0,25,0,25,0,20,5,21.04.2019 20:35,74,6,Zaporozhie
1632,1614,4,661,969,2,971,0,971,13,851,107,22.04.2019 00:02,74,6,Zaporozhie
1568,1543,5,682,884,2,886,0,886,7,785,94,22.04.2019 00:03,74,6,Zaporozhie
2000,1963,9,819,1174,7,1181,0,1181,28,1012,141,22.04.2019 00:09,74,6,Zaporozhie
1872,1865,9,715,1151,6,1157,0,1157,23,991,143,22.04.2019 00:20,74,6,Zaporozhie
1904,1801,12,716,1180,8,1188,0,1188,14,986,188,22.04.2019 01:57,74,6,Zaporozhie
2256,2185,12,783,1462,11,1473,0,1473,25,1310,137,22.04.2019 06:58,74,6,Zaporozhie
2335,2295,14,735,1589,11,1600,0,1600,27,1369,204,22.04.2019 00:30,74,6,Zaporozhie
2224,2193,8,1113,1104,7,1111,0,1111,29,942,140,22.04.2019 00:10,74,6,Zaporozhie
2448,2408,10,1242,1199,7,1206,0,1206,21,1064,121,22.04.2019 05:00,74,6,Zaporozhie
2064,2047,11,761,1294,9,1303,0,1303,21,1131,151,22.04.2019 00:30,74,6,Zaporozhie
1952,1918,1,1010,941,1,942,0,942,25,819,98,22.04.2019 00:07,74,6,Zaporozhie
1600,1562,5,792,803,5,808,0,808,25,681,102,22.04.2019 00:03,74,6,Zaporozhie
2352,2325,15,866,1473,13,1486,0,1486,26,1293,167,22.04.2019 00:15,74,6,Zaporozhie
2288,2263,15,964,1311,13,1324,0,1324,29,1135,160,22.04.2019 00:05,74,6,Zaporozhie
2272,2243,11,880,1385,7,1392,0,1392,23,1173,196,22.04.2019 00:05,74,6,Zaporozhie
2240,2218,18,851,1376,13,1389,0,1389,36,1197,156,22.04.2019 00:30,74,6,Zaporozhie
2288,2251,13,794,1483,11,1494,0,1494,19,1280,195,22.04.2019 00:10,74,6,Zaporozhie
2240,2218,8,804,1429,7,1436,0,1436,32,1153,251,22.04.2019 00:10,74,6,Zaporozhie
2192,2181,16,786,1394,12,1406,0,1406,30,1177,199,22.04.2019 00:15,74,6,Zaporozhie
2288,2263,9,793,1489,6,1495,0,1495,29,1269,197,22.04.2019 06:50,74,6,Zaporozhie
2304,2298,12,722,1573,9,1582,0,1582,37,1326,217,22.04.2019 00:05,74,6,Zaporozhie
2272,2259,15,756,1509,7,1516,0,1516,36,1261,219,22.04.2019 00:30,74,6,Zaporozhie
2160,2144,15,692,1457,11,1468,0,1468,47,1205,216,22.04.2019 00:10,74,6,Zaporozhie
2016,1986,12,686,1321,9,1330,0,1330,15,1097,218,22.04.2019 00:20,74,6,Zaporozhie
1968,1945,2,727,1239,2,1241,0,1241,23,1065,153,22.04.2019 00:10,74,6,Zaporozhie
2112,2070,20,734,1361,17,1378,0,1378,28,1141,209,22.04.2019 00:10,74,6,Zaporozhie
2032,1999,13,646,1377,9,1386,0,1386,24,1176,186,22.04.2019 06:50,74,6,Zaporozhie
2128,2102,7,675,1449,4,1453,0,1453,43,1196,214,22.04.2019 00:20,74,6,Zaporozhie
2192,2163,17,681,1500,11,1511,0,1511,28,1241,242,22.04.2019 02:10,74,6,Zaporozhie
2128,2101,15,758,1360,10,1370,0,1370,28,1132,210,22.04.2019 00:20,74,6,Zaporozhie
2080,2048,23,702,1362,16,1378,0,1378,34,1154,190,22.04.2019 00:25,74,6,Zaporozhie
2128,2121,200,623,1317,188,1505,0,1505,42,1228,235,22.04.2019 00:06,74,6,Zaporozhie
2224,2181,21,722,1484,18,1502,0,1502,19,1262,221,22.04.2019 00:06,74,6,Zaporozhie
2096,2069,14,775,1309,12,1321,0,1321,25,1141,155,22.04.2019 00:10,74,6,Zaporozhie
1520,1498,4,596,922,2,924,0,924,21,807,96,22.04.2019 00:12,74,6,Zaporozhie
2336,2305,12,787,1543,6,1549,0,1549,25,1324,199,22.04.2019 06:15,74,6,Zaporozhie
2176,2146,21,689,1475,12,1487,0,1487,31,1233,223,21.04.2019 23:45,74,6,Zaporozhie
2160,2116,11,702,1448,10,1458,0,1458,21,1211,226,22.04.2019 00:13,74,6,Zaporozhie
2320,2284,14,743,1569,8,1577,0,1577,40,1311,226,22.04.2019 00:10,74,6,Zaporozhie
2048,2023,16,648,1391,9,1400,0,1400,27,1167,206,22.04.2019 00:10,74,6,Zaporozhie
2336,2300,13,756,1567,13,1580,0,1580,34,1357,189,22.04.2019 00:10,74,6,Zaporozhie
2176,2152,17,709,1451,16,1467,0,1467,21,1229,217,22.04.2019 02:45,74,6,Zaporozhie
2192,2148,8,687,1498,7,1505,0,1505,43,1241,221,22.04.2019 00:18,74,6,Zaporozhie
1904,1865,7,627,1272,5,1277,0,1277,27,1073,177,22.04.2019 00:10,74,6,Zaporozhie
2272,2246,9,723,1547,2,1549,0,1549,138,1228,183,22.04.2019 00:31,74,6,Zaporozhie
1872,1893,4,507,1362,3,1365,0,1365,34,1081,250,22.04.2019 00:30,74,6,Zaporozhie
2224,2192,10,700,1515,9,1524,0,1524,28,1271,225,22.04.2019 00:30,74,6,Zaporozhie
2432,2413,10,742,1684,6,1690,0,1690,61,1375,254,22.04.2019 00:10,74,6,Zaporozhie
832,270,176,604,80,148,228,0,228,6,207,15,22.04.2019 00:20,74,6,Zaporozhie
464,319,0,174,290,0,290,0,290,14,238,38,22.04.2019 00:02,74,6,Zaporozhie
320,101,11,240,74,6,80,0,80,1,69,10,22.04.2019 00:20,74,6,Zaporozhie
240,61,13,180,48,12,60,0,60,3,49,8,22.04.2019 00:35,74,6,Zaporozhie
176,115,1,62,114,0,114,0,114,3,91,20,22.04.2019 00:20,74,6,Zaporozhie
80,28,0,52,28,0,28,0,28,1,25,2,22.04.2019 00:05,74,6,Zaporozhie
64,50,0,16,48,0,48,0,48,0,40,8,22.04.2019 00:13,74,6,Zaporozhie
2400,2368,16,845,1544,11,1555,0,1555,29,1368,158,22.04.2019 00:19,75,6,Zaporozhie
1888,1854,11,695,1183,10,1193,0,1193,34,1043,116,22.04.2019 01:00,75,6,Zaporozhie
1600,1580,15,531,1058,11,1069,0,1069,21,941,107,21.04.2019 21:30,75,6,Zaporozhie
2096,2076,14,728,1357,11,1368,0,1368,31,1231,106,22.04.2019 00:05,75,6,Zaporozhie
992,973,14,360,620,12,632,0,632,14,560,58,21.04.2019 22:30,75,6,Zaporozhie
2336,2296,24,858,1459,19,1478,0,1478,21,1307,150,22.04.2019 00:05,75,6,Zaporozhie
2368,2319,24,883,1465,20,1485,0,1485,33,1298,154,22.04.2019 00:05,75,6,Zaporozhie
2224,2197,12,802,1413,9,1422,0,1422,28,1224,170,21.04.2019 21:39,75,6,Zaporozhie
2128,2099,10,770,1350,8,1358,0,1358,37,1195,126,21.04.2019 22:10,75,6,Zaporozhie
1936,1900,14,644,1283,9,1292,0,1292,33,1089,170,22.04.2019 00:05,75,6,Zaporozhie
1984,1944,12,669,1311,4,1315,0,1315,29,1146,140,21.04.2019 22:12,75,6,Zaporozhie
1648,1632,12,596,1043,9,1052,0,1052,24,931,97,22.04.2019 00:26,75,6,Zaporozhie
1872,1841,11,652,1212,8,1220,0,1220,26,1077,117,21.04.2019 22:01,75,6,Zaporozhie
2304,2279,10,854,1442,8,1450,0,1450,23,1270,157,21.04.2019 22:15,75,6,Zaporozhie
2112,2085,20,712,1382,18,1400,0,1400,22,1254,124,21.04.2019 20:50,75,6,Zaporozhie
480,86,15,398,67,15,82,0,82,1,74,7,22.04.2019 05:13,75,6,Zaporozhie
224,17,0,207,17,0,17,0,17,0,16,1,21.04.2019 22:30,75,6,Zaporozhie
2112,2103,18,733,1367,12,1379,0,1379,36,1103,240,22.04.2019 00:15,75,6,Zaporozhie
1888,1849,23,638,1233,17,1250,0,1250,29,1001,220,22.04.2019 00:20,75,6,Zaporozhie
2096,2062,19,710,1379,7,1386,0,1386,28,1107,251,22.04.2019 00:05,75,6,Zaporozhie
1840,1810,26,661,1161,18,1179,0,1179,32,906,241,22.04.2019 00:05,75,6,Zaporozhie
1696,1667,15,561,1121,14,1135,0,1135,21,914,200,22.04.2019 00:35,75,6,Zaporozhie
1808,1797,23,574,1217,17,1234,0,1234,37,964,233,22.04.2019 00:10,75,6,Zaporozhie
1296,1273,33,422,847,27,874,0,874,23,744,107,22.04.2019 01:20,75,6,Zaporozhie
2384,2343,12,861,1515,8,1523,0,1523,32,1254,237,22.04.2019 00:05,75,6,Zaporozhie
2384,2366,10,683,1694,7,1701,0,1701,41,1385,275,22.04.2019 00:03,75,6,Zaporozhie
2368,2338,17,696,1657,15,1672,0,1672,37,1397,238,21.04.2019 22:59,75,6,Zaporozhie
2272,2243,13,643,1619,10,1629,0,1629,45,1303,281,22.04.2019 00:05,75,6,Zaporozhie
2176,2150,24,673,1486,17,1503,0,1503,40,1217,246,22.04.2019 00:15,75,6,Zaporozhie
2176,2135,19,697,1461,18,1479,0,1479,31,1217,231,22.04.2019 00:15,75,6,Zaporozhie
2288,2262,20,670,1606,12,1618,0,1618,46,1337,235,22.04.2019 00:05,75,6,Zaporozhie
2208,2185,21,703,1490,15,1505,0,1505,30,1241,234,22.04.2019 00:05,75,6,Zaporozhie
2208,2176,17,675,1521,12,1533,0,1533,26,1249,258,22.04.2019 00:07,75,6,Zaporozhie
2368,2349,12,762,1595,11,1606,0,1606,29,1307,270,21.04.2019 22:08,75,6,Zaporozhie
2224,2199,21,628,1584,12,1596,0,1596,47,1308,241,21.04.2019 21:45,75,6,Zaporozhie
2496,2447,15,1072,1411,13,1424,0,1424,29,1123,272,22.04.2019 00:10,75,6,Zaporozhie
2272,2248,22,793,1465,14,1479,0,1479,38,1211,230,22.04.2019 00:01,75,6,Zaporozhie
2304,2256,21,936,1348,20,1368,0,1368,30,1099,239,22.04.2019 00:25,75,6,Zaporozhie
2320,2295,21,839,1464,17,1481,0,1481,28,1243,210,22.04.2019 04:05,75,6,Zaporozhie
2352,2321,32,790,1539,23,1562,0,1562,30,1344,188,22.04.2019 00:10,75,6,Zaporozhie
1968,1942,19,659,1296,13,1309,0,1309,34,1078,197,22.04.2019 05:00,75,6,Zaporozhie
2256,2234,16,773,1470,13,1483,0,1483,27,1268,188,22.04.2019 00:10,75,6,Zaporozhie
2032,2020,14,696,1323,13,1336,0,1336,18,1156,162,22.04.2019 00:10,75,6,Zaporozhie
2032,2000,11,705,1317,10,1327,0,1327,25,1141,161,22.04.2019 00:05,75,6,Zaporozhie
1872,1852,13,597,1267,8,1275,0,1275,38,1067,170,22.04.2019 00:15,75,6,Zaporozhie
2000,1967,8,670,1323,7,1330,0,1330,33,1098,199,21.04.2019 21:15,75,6,Zaporozhie
1824,1813,12,591,1224,9,1233,0,1233,28,1036,169,21.04.2019 21:54,75,6,Zaporozhie
2272,2237,18,780,1481,11,1492,0,1492,27,1221,244,22.04.2019 00:20,75,6,Zaporozhie
2176,2150,27,832,1327,17,1344,0,1344,20,1133,191,22.04.2019 00:31,75,6,Zaporozhie
2320,2279,26,889,1412,19,1431,0,1431,20,1247,164,22.04.2019 01:00,75,6,Zaporozhie
2224,2189,26,775,1429,20,1449,0,1449,44,1102,303,22.04.2019 00:00,75,6,Zaporozhie
640,99,85,557,15,68,83,0,83,1,73,9,22.04.2019 00:20,75,6,Zaporozhie
256,27,16,229,11,16,27,0,27,0,26,1,22.04.2019 00:10,75,6,Zaporozhie
128,102,11,32,88,8,96,0,96,5,77,14,21.04.2019 23:15,75,6,Zaporozhie
128,20,0,108,20,0,20,0,20,1,15,4,21.04.2019 23:50,75,6,Zaporozhie
48,10,0,38,10,0,10,0,10,0,7,3,21.04.2019 22:11,76,6,Zaporozhie
1152,1143,24,367,774,11,785,0,785,17,640,128,22.04.2019 00:02,76,6,Zaporozhie
2000,1979,24,684,1301,15,1316,0,1316,32,1037,247,22.04.2019 00:15,76,6,Zaporozhie
2080,2042,13,723,1344,13,1357,0,1357,34,1099,224,22.04.2019 00:40,76,6,Zaporozhie
2128,2088,13,774,1345,9,1354,0,1354,45,1052,257,22.04.2019 00:12,76,6,Zaporozhie
2320,2285,24,787,1516,17,1533,0,1533,51,1169,313,22.04.2019 00:07,76,6,Zaporozhie
2096,2092,21,657,1423,16,1439,0,1439,41,1131,267,22.04.2019 00:01,76,6,Zaporozhie
2256,2252,36,753,1473,30,1503,0,1503,32,1241,230,22.04.2019 00:45,76,6,Zaporozhie
2112,2074,17,777,1320,15,1335,0,1335,25,1046,264,22.04.2019 00:15,76,6,Zaporozhie
1744,1726,21,543,1185,16,1201,0,1201,39,940,222,22.04.2019 06:25,76,6,Zaporozhie
1552,1528,20,527,1007,18,1025,0,1024,36,785,203,22.04.2019 00:20,76,6,Zaporozhie
1824,1929,2,496,1326,2,1328,0,1328,12,1211,105,22.04.2019 00:10,76,6,Zaporozhie
2048,2038,16,664,1370,14,1384,0,1384,26,1094,264,22.04.2019 00:30,76,6,Zaporozhie
1920,1880,9,825,1088,7,1095,0,1095,30,887,178,22.04.2019 00:45,76,6,Zaporozhie
1792,1775,10,616,1170,6,1176,0,1176,36,881,259,22.04.2019 00:10,76,6,Zaporozhie
1568,1541,27,503,1049,16,1065,0,1065,18,861,186,22.04.2019 00:35,76,6,Zaporozhie
2064,2048,15,745,1304,15,1319,0,1319,33,1068,218,22.04.2019 00:05,76,6,Zaporozhie
2064,2059,9,711,1344,9,1353,0,1353,30,1101,222,22.04.2019 00:10,76,6,Zaporozhie
2176,2156,10,634,1532,10,1542,0,1542,31,1229,282,22.04.2019 00:40,76,6,Zaporozhie
2096,2085,15,707,1380,9,1389,0,1389,23,1127,239,22.04.2019 01:10,76,6,Zaporozhie
2032,2002,16,824,1193,15,1208,0,1206,41,1006,159,22.04.2019 05:25,76,6,Zaporozhie
2016,2008,22,763,1237,16,1253,0,1253,23,1023,207,22.04.2019 00:30,76,6,Zaporozhie
1968,1944,10,685,1275,8,1283,0,1283,27,999,257,22.04.2019 00:30,76,6,Zaporozhie
1920,1904,18,701,1207,12,1219,0,1219,24,1021,174,22.04.2019 00:15,76,6,Zaporozhie
1952,1929,17,651,1289,12,1301,0,1301,31,1043,227,22.04.2019 00:10,76,6,Zaporozhie
2096,2077,24,694,1383,19,1402,0,1402,32,1134,236,22.04.2019 00:30,76,6,Zaporozhie
1632,1634,15,540,1078,14,1092,0,1092,21,917,154,22.04.2019 00:12,76,6,Zaporozhie
2225,2158,13,841,1375,9,1384,0,1383,38,1103,242,22.04.2019 06:40,76,6,Zaporozhie
1808,1805,10,647,1155,6,1161,0,1161,26,914,221,22.04.2019 00:21,76,6,Zaporozhie
1552,1537,12,569,974,9,983,0,983,23,776,184,22.04.2019 00:05,76,6,Zaporozhie
2144,2125,15,734,1398,12,1410,0,1410,39,1064,307,22.04.2019 00:15,76,6,Zaporozhie
2256,2227,17,865,1376,15,1391,0,1391,36,1133,222,22.04.2019 00:15,76,6,Zaporozhie
2112,2083,23,760,1336,16,1352,0,1352,27,1104,221,21.04.2019 22:55,76,6,Zaporozhie
2160,2156,18,675,1472,13,1485,0,1485,45,1163,277,22.04.2019 00:08,76,6,Zaporozhie
2160,2135,17,768,1379,13,1392,0,1392,20,1151,221,22.04.2019 00:05,76,6,Zaporozhie
304,43,32,262,11,31,42,0,42,0,34,8,21.04.2019 22:10,76,6,Zaporozhie
176,34,11,145,20,11,31,0,31,0,26,5,22.04.2019 00:10,76,6,Zaporozhie
144,32,0,112,32,0,32,0,32,1,23,8,22.04.2019 00:07,76,6,Zaporozhie
336,102,0,234,102,0,102,0,102,3,84,15,22.04.2019 00:02,76,6,Zaporozhie
800,141,58,675,70,55,125,0,125,1,109,15,22.04.2019 00:01,76,6,Zaporozhie
480,230,0,277,203,0,203,0,203,13,149,41,22.04.2019 00:24,76,6,Zaporozhie
144,57,11,92,41,11,52,0,52,0,42,10,22.04.2019 00:05,76,6,Zaporozhie
176,76,12,105,60,11,71,0,71,1,60,10,22.04.2019 00:05,76,6,Zaporozhie
2096,2060,13,674,1413,9,1422,0,1422,32,1197,193,22.04.2019 00:10,76,6,Zaporozhie
2128,2096,12,693,1426,9,1435,0,1437,31,1198,208,21.04.2019 22:40,76,6,Zaporozhie
2416,2383,10,799,1610,7,1617,0,1617,30,1361,226,22.04.2019 00:05,76,6,Zaporozhie
2096,2070,11,693,1395,8,1403,0,1403,32,1177,194,22.04.2019 00:26,76,6,Zaporozhie
2048,2014,20,649,1385,14,1399,0,1399,35,1182,182,22.04.2019 00:07,76,6,Zaporozhie
1904,1875,13,581,1313,10,1323,0,1323,27,1096,200,22.04.2019 00:20,76,6,Zaporozhie
1920,1895,13,628,1288,4,1292,0,1292,26,1090,176,22.04.2019 00:25,76,6,Zaporozhie
2176,2153,12,713,1454,9,1463,0,1463,38,1218,207,22.04.2019 00:03,76,6,Zaporozhie
2064,2035,14,658,1396,10,1406,0,1406,35,1149,222,22.04.2019 01:05,76,6,Zaporozhie
1904,1881,18,599,1290,15,1305,0,1305,16,1093,196,22.04.2019 00:16,76,6,Zaporozhie
2080,2064,14,643,1427,10,1437,0,1437,27,1177,233,22.04.2019 00:25,76,6,Zaporozhie
1776,1758,15,601,1163,12,1175,0,1175,21,977,177,22.04.2019 00:10,76,6,Zaporozhie
1952,1934,24,633,1304,15,1319,0,1319,42,1112,165,22.04.2019 00:15,76,6,Zaporozhie
2096,1442,23,654,1429,13,1442,0,1442,30,1210,202,22.04.2019 00:35,76,6,Zaporozhie
2096,2060,19,697,1383,16,1399,0,1399,34,1156,209,22.04.2019 00:45,76,6,Zaporozhie
1808,1788,21,580,1214,14,1228,0,1228,33,1020,175,22.04.2019 00:35,76,6,Zaporozhie
1584,1559,7,493,1087,4,1091,0,1091,29,907,155,22.04.2019 00:20,76,6,Zaporozhie
2016,1994,23,626,1374,16,1390,0,1390,44,1144,202,22.04.2019 00:02,76,6,Zaporozhie
1536,1513,17,474,1047,15,1062,0,1062,21,886,155,22.04.2019 02:20,76,6,Zaporozhie
1584,1563,22,466,1102,16,1118,0,1118,26,907,185,22.04.2019 00:40,76,6,Zaporozhie
1648,1609,12,514,1124,10,1134,0,1134,30,938,166,22.04.2019 00:30,76,6,Zaporozhie
1792,1782,9,591,1198,3,1201,0,1201,30,986,185,22.04.2019 00:16,76,6,Zaporozhie
1808,1782,13,587,1212,9,1221,0,1221,29,1013,179,22.04.2019 00:36,76,6,Zaporozhie
2000,1961,28,668,1315,17,1332,0,1332,33,1095,204,22.04.2019 00:25,76,6,Zaporozhie
1968,1942,34,637,1308,23,1331,0,1331,29,1112,190,22.04.2019 00:20,76,6,Zaporozhie
2176,2136,31,687,1467,22,1489,0,1489,38,1254,197,22.04.2019 00:32,76,6,Zaporozhie
2016,1992,30,634,1356,26,1382,0,1381,22,1129,230,22.04.2019 04:15,76,6,Zaporozhie
2080,2063,29,626,1433,21,1454,0,1454,32,1199,223,22.04.2019 00:16,76,6,Zaporozhie
1920,1896,23,621,1288,11,1299,0,1299,30,1117,152,22.04.2019 00:18,76,6,Zaporozhie
1440,1396,7,502,933,5,938,0,938,22,771,145,22.04.2019 00:40,76,6,Zaporozhie
1952,1926,22,623,1315,14,1329,0,1329,27,1124,178,22.04.2019 00:22,76,6,Zaporozhie
1920,1908,13,615,1295,10,1305,0,1305,40,1068,197,22.04.2019 00:15,76,6,Zaporozhie
2400,2360,14,892,1500,8,1508,0,1508,32,1272,204,22.04.2019 00:23,76,6,Zaporozhie
1904,1873,14,642,1253,9,1262,0,1262,24,1096,142,22.04.2019 00:45,76,6,Zaporozhie
2048,2020,20,679,1352,17,1369,0,1369,29,1095,245,22.04.2019 00:40,76,6,Zaporozhie
2064,2046,16,676,1375,13,1388,0,1388,37,1167,184,22.04.2019 00:17,76,6,Zaporozhie
1424,1408,14,455,959,10,969,0,969,24,819,126,22.04.2019 00:05,76,6,Zaporozhie
2080,2052,30,783,1277,20,1297,0,1297,25,1126,146,22.04.2019 00:05,76,6,Zaporozhie
2000,1977,29,604,1374,22,1396,0,1396,37,1151,208,22.04.2019 00:20,76,6,Zaporozhie
1824,1807,24,565,1242,17,1259,0,1259,27,1012,220,22.04.2019 00:10,76,6,Zaporozhie
2032,2003,20,625,1394,13,1407,0,1405,29,1155,221,22.04.2019 00:25,76,6,Zaporozhie
128,39,0,89,39,0,39,0,39,1,35,3,22.04.2019 06:12,76,6,Zaporozhie
2176,2161,20,754,1405,17,1422,0,1422,34,1140,248,22.04.2019 00:40,77,6,Zaporozhie
2080,2066,19,680,1387,13,1400,0,1400,41,1115,244,22.04.2019 01:10,77,6,Zaporozhie
2240,2212,19,828,1400,12,1412,0,1412,34,1166,212,22.04.2019 05:55,77,6,Zaporozhie
2256,2215,22,822,1428,6,1434,0,1433,28,1194,211,22.04.2019 00:25,77,6,Zaporozhie
2224,2180,14,841,1372,11,1383,0,1383,23,1118,242,22.04.2019 00:10,77,6,Zaporozhie
2368,2345,23,799,1552,17,1569,0,1569,32,1333,204,22.04.2019 00:10,77,6,Zaporozhie
2144,2102,12,677,1460,7,1467,0,1467,32,1178,257,22.04.2019 00:20,77,6,Zaporozhie
2112,2098,21,637,1460,15,1475,0,1475,44,1177,254,22.04.2019 00:10,77,6,Zaporozhie
1968,1943,25,769,1185,14,1199,0,1199,22,1011,166,22.04.2019 00:30,77,6,Zaporozhie
2096,2062,5,831,1262,3,1265,0,1265,35,1074,156,22.04.2019 01:50,77,6,Zaporozhie
1792,1773,6,688,1098,6,1104,0,1104,28,915,161,22.04.2019 00:30,77,6,Zaporozhie
2320,2278,8,840,1475,5,1480,0,1480,17,1281,182,22.04.2019 00:30,77,6,Zaporozhie
2352,2321,11,804,1542,6,1548,0,1548,28,1327,193,22.04.2019 00:25,77,6,Zaporozhie
1824,1803,9,620,1196,8,1204,0,1204,147,1040,17,22.04.2019 01:30,77,6,Zaporozhie
1728,1698,7,642,1079,7,1086,0,1086,15,924,147,22.04.2019 00:15,77,6,Zaporozhie
2416,2396,9,905,1503,8,1511,0,1511,45,1297,169,22.04.2019 00:43,77,6,Zaporozhie
2400,2378,11,880,1513,7,1520,0,1520,25,1354,141,22.04.2019 00:05,77,6,Zaporozhie
1200,1169,13,451,739,10,749,0,749,11,632,106,22.04.2019 00:35,77,6,Zaporozhie
2176,2142,12,727,1440,9,1449,0,1449,32,1230,187,22.04.2019 06:45,77,6,Zaporozhie
2304,2300,10,866,1429,9,1438,0,1438,26,1169,243,22.04.2019 05:25,77,6,Zaporozhie
1648,1630,4,598,1047,3,1050,0,1050,28,862,160,22.04.2019 00:15,77,6,Zaporozhie
1824,1809,6,673,1147,4,1151,0,1151,18,988,145,22.04.2019 01:40,77,6,Zaporozhie
2000,1975,13,720,1270,10,1280,0,1280,26,1074,180,22.04.2019 00:35,77,6,Zaporozhie
1728,1700,3,566,1159,3,1162,0,1162,25,980,157,22.04.2019 00:15,77,6,Zaporozhie
2016,1988,8,725,1283,8,1291,0,1291,26,1076,189,22.04.2019 00:20,77,6,Zaporozhie
2096,2068,5,562,1529,5,1534,0,1534,26,1304,204,22.04.2019 00:10,77,6,Zaporozhie
2064,2035,4,691,1369,4,1373,0,1373,35,1156,182,22.04.2019 07:00,77,6,Zaporozhie
1888,1861,4,600,1286,2,1288,0,1288,29,1068,191,22.04.2019 00:15,77,6,Zaporozhie
1952,1918,8,605,1342,5,1347,0,1347,17,1138,192,22.04.2019 00:05,77,6,Zaporozhie
1968,1952,7,620,1342,6,1348,0,1348,36,1135,177,22.04.2019 00:20,77,6,Zaporozhie
2288,2257,8,808,1472,8,1480,0,1480,26,1307,147,22.04.2019 00:18,77,6,Zaporozhie
2032,2017,8,618,1408,6,1414,0,1414,25,1197,192,22.04.2019 00:10,77,6,Zaporozhie
2016,1996,13,655,1352,9,1361,0,1361,19,1134,208,22.04.2019 00:15,77,6,Zaporozhie
1840,1823,10,588,1243,9,1252,0,1252,23,1060,169,22.04.2019 00:05,77,6,Zaporozhie
2016,1995,8,654,1357,5,1362,0,1362,27,1157,178,22.04.2019 01:45,77,6,Zaporozhie
2144,2110,9,622,1514,8,1522,0,1522,35,1290,197,22.04.2019 00:30,77,6,Zaporozhie
1952,1928,12,612,1333,7,1340,0,1340,24,1138,178,22.04.2019 00:35,77,6,Zaporozhie
2016,1976,15,648,1360,8,1368,0,1368,40,1123,205,22.04.2019 06:05,77,6,Zaporozhie
2032,2000,14,609,1413,10,1423,0,1423,22,1179,222,22.04.2019 00:10,77,6,Zaporozhie
1824,1796,9,575,1242,7,1249,0,1249,19,1053,177,22.04.2019 00:05,77,6,Zaporozhie
2112,2095,8,646,1461,5,1466,0,1466,14,1240,212,22.04.2019 00:03,77,6,Zaporozhie
2064,2039,8,607,1451,6,1457,0,1457,25,1207,225,22.04.2019 00:10,77,6,Zaporozhie
2016,2003,5,637,1374,5,1379,0,1379,41,1168,170,22.04.2019 00:15,77,6,Zaporozhie
2000,1978,5,644,1353,3,1356,0,1356,28,1156,172,22.04.2019 01:45,77,6,Zaporozhie
2000,1968,5,605,1392,3,1395,0,1395,25,1188,182,22.04.2019 01:55,77,6,Zaporozhie
2000,1988,10,611,1383,6,1389,0,1389,29,1172,188,22.04.2019 01:15,77,6,Zaporozhie
1952,1924,10,607,1338,7,1345,0,1345,21,1158,166,22.04.2019 00:15,77,6,Zaporozhie
1952,1942,23,548,1386,18,1404,0,1404,42,1170,192,22.04.2019 01:50,77,6,Zaporozhie
1920,1906,15,477,1434,9,1443,0,1443,30,1215,198,22.04.2019 00:07,77,6,Zaporozhie
1296,1304,11,517,769,10,779,0,779,19,702,58,22.04.2019 00:05,77,6,Zaporozhie
1776,1745,6,774,998,4,1002,0,1002,18,924,60,22.04.2019 00:30,77,6,Zaporozhie
2032,2001,13,759,1261,12,1273,0,1273,22,1106,145,22.04.2019 00:05,77,6,Zaporozhie
2032,2010,11,764,1258,10,1268,0,1268,24,1110,134,22.04.2019 03:40,77,6,Zaporozhie
2032,1995,7,749,1280,3,1283,0,1283,22,1072,188,22.04.2019 00:20,77,6,Zaporozhie
1584,1565,11,558,1015,11,1026,0,1026,26,856,144,22.04.2019 00:15,77,6,Zaporozhie
1744,1716,10,660,1076,8,1084,0,1084,19,942,123,22.04.2019 00:30,77,6,Zaporozhie
1568,1544,9,514,1045,9,1054,0,1054,18,933,103,22.04.2019 02:46,77,6,Zaporozhie
1808,1778,5,604,1200,4,1204,0,1204,22,1056,126,22.04.2019 00:05,77,6,Zaporozhie
2176,2147,8,787,1384,5,1389,0,1389,25,1225,139,22.04.2019 01:23,77,6,Zaporozhie
1872,1856,9,700,1165,7,1172,0,1172,22,1059,91,22.04.2019 00:35,77,6,Zaporozhie
2320,2281,12,917,1397,6,1403,0,1403,21,1207,175,22.04.2019 00:15,77,6,Zaporozhie
2384,2357,11,856,1517,11,1528,0,1528,52,1351,125,22.04.2019 00:25,77,6,Zaporozhie
2000,1917,9,779,1213,8,1221,0,1221,10,1104,107,22.04.2019 01:15,77,6,Zaporozhie
2288,2258,9,900,1381,7,1388,0,1388,27,1233,128,22.04.2019 03:00,77,6,Zaporozhie
1856,1836,5,696,1155,5,1160,0,1160,26,1002,132,22.04.2019 01:30,77,6,Zaporozhie
272,261,2,122,150,0,150,0,150,8,128,14,22.04.2019 00:12,77,6,Zaporozhie
176,51,28,125,23,28,51,0,51,1,43,7,22.04.2019 00:05,77,6,Zaporozhie
320,69,16,251,53,16,69,0,69,2,61,6,22.04.2019 00:10,77,6,Zaporozhie
144,16,0,128,16,0,16,0,16,0,13,3,22.04.2019 00:04,77,6,Zaporozhie
80,26,7,54,19,7,26,0,26,0,24,2,22.04.2019 00:10,77,6,Zaporozhie
320,286,146,40,137,143,280,0,280,5,237,38,22.04.2019 00:17,78,6,Zaporozhie
1328,1303,69,562,699,67,766,0,766,10,701,55,22.04.2019 00:50,78,6,Zaporozhie
1056,1034,74,446,541,69,610,0,610,5,576,29,22.04.2019 00:10,78,6,Zaporozhie
784,771,46,340,400,44,444,0,444,5,415,24,22.04.2019 00:12,78,6,Zaporozhie
448,442,21,192,239,17,256,0,256,2,231,23,22.04.2019 00:24,78,6,Zaporozhie
1008,984,33,393,582,33,615,0,615,12,568,35,22.04.2019 00:15,78,6,Zaporozhie
992,961,34,429,532,31,563,0,563,9,519,35,22.04.2019 00:55,78,6,Zaporozhie
192,197,21,74,97,21,118,0,118,1,107,10,22.04.2019 00:10,78,6,Zaporozhie
656,632,32,213,412,31,443,0,443,4,408,31,22.04.2019 00:08,78,6,Zaporozhie
416,404,50,140,226,50,276,0,276,6,256,14,22.04.2019 00:07,78,6,Zaporozhie
576,559,36,204,336,36,372,0,372,7,326,39,22.04.2019 00:15,78,6,Zaporozhie
1808,1775,81,767,977,64,1041,0,1041,13,986,42,22.04.2019 00:35,78,6,Zaporozhie
128,117,3,60,67,1,68,0,68,4,57,7,22.04.2019 00:15,78,6,Zaporozhie
464,453,27,212,225,27,252,0,252,3,232,17,22.04.2019 00:10,78,6,Zaporozhie
416,399,31,159,231,26,257,0,257,1,239,17,22.04.2019 00:25,78,6,Zaporozhie
752,738,16,325,414,13,427,0,427,4,379,44,22.04.2019 00:05,78,6,Zaporozhie
2000,2138,36,773,1201,26,1227,0,1227,18,1109,100,21.04.2019 21:32,78,6,Zaporozhie
1104,1073,47,502,564,38,602,0,602,4,551,47,22.04.2019 00:05,78,6,Zaporozhie
1568,1543,58,699,812,57,869,0,869,7,778,84,21.04.2019 23:00,78,6,Zaporozhie
848,842,32,385,437,26,463,0,463,4,409,50,22.04.2019 00:30,78,6,Zaporozhie
800,786,64,318,430,52,482,0,482,8,432,42,22.04.2019 00:28,78,6,Zaporozhie
1536,1523,74,634,840,62,902,0,902,13,814,75,22.04.2019 00:25,78,6,Zaporozhie
1312,1313,40,597,684,31,715,0,715,13,632,70,22.04.2019 00:55,78,6,Zaporozhie
496,489,26,170,302,24,326,0,326,4,293,29,22.04.2019 02:15,78,6,Zaporozhie
848,825,71,327,464,57,521,0,521,6,487,28,22.04.2019 01:50,78,6,Zaporozhie
336,345,21,112,205,19,224,0,224,2,207,15,22.04.2019 00:10,78,6,Zaporozhie
1984,1921,46,777,1166,41,1207,0,1207,17,1000,190,22.04.2019 00:10,78,6,Zaporozhie
1520,1483,43,604,875,41,916,0,916,20,778,118,22.04.2019 01:40,78,6,Zaporozhie
1264,1244,24,531,712,21,733,0,733,17,594,122,21.04.2019 21:18,78,6,Zaporozhie
1328,1306,20,463,850,15,865,0,865,5,737,123,22.04.2019 00:30,78,6,Zaporozhie
544,515,24,189,334,21,355,0,355,8,307,40,22.04.2019 00:05,78,6,Zaporozhie
1776,1750,64,746,974,56,1030,0,1030,11,904,115,22.04.2019 00:25,78,6,Zaporozhie
992,977,91,361,544,87,631,0,631,6,560,65,22.04.2019 00:26,78,6,Zaporozhie
240,241,38,53,155,32,187,0,187,2,173,12,22.04.2019 00:15,78,6,Zaporozhie
1136,1117,137,413,601,122,723,0,723,15,637,71,22.04.2019 00:10,78,6,Zaporozhie
416,395,59,85,272,59,331,0,331,0,289,42,22.04.2019 00:10,78,6,Zaporozhie
736,723,72,316,361,59,420,0,420,1,385,34,22.04.2019 00:15,78,6,Zaporozhie
256,263,34,96,133,27,160,0,160,2,140,18,22.04.2019 00:10,78,6,Zaporozhie
384,367,41,133,218,33,251,0,251,4,227,20,22.04.2019 02:25,78,6,Zaporozhie
464,453,54,156,264,44,308,0,308,3,265,40,22.04.2019 00:10,78,6,Zaporozhie
784,744,64,322,409,53,462,0,462,10,376,76,22.04.2019 00:30,78,6,Zaporozhie
240,232,25,104,114,22,136,0,136,0,127,9,22.04.2019 00:15,78,6,Zaporozhie
432,419,31,163,241,28,269,0,269,5,228,36,22.04.2019 00:05,78,6,Zaporozhie
208,200,10,85,116,7,123,0,123,2,95,26,22.04.2019 00:10,78,6,Zaporozhie
832,811,61,348,432,52,484,0,484,14,401,69,22.04.2019 00:50,78,6,Zaporozhie
896,871,52,314,535,47,582,0,582,14,508,60,22.04.2019 00:35,78,6,Zaporozhie
384,380,28,115,241,28,269,0,269,1,217,51,22.04.2019 00:05,78,6,Zaporozhie
432,421,49,156,232,44,276,0,276,1,236,39,22.04.2019 00:05,78,6,Zaporozhie
816,809,68,327,429,60,489,0,489,6,421,62,21.04.2019 22:35,78,6,Zaporozhie
1759,1744,40,773,958,28,986,0,986,17,890,79,22.04.2019 00:05,78,6,Zaporozhie
1696,1661,38,767,894,35,929,0,929,14,836,79,22.04.2019 00:50,78,6,Zaporozhie
400,393,41,163,200,37,237,0,237,4,220,13,22.04.2019 00:10,78,6,Zaporozhie
384,373,29,163,203,18,221,0,221,4,201,16,22.04.2019 02:10,78,6,Zaporozhie
288,278,38,100,155,33,188,0,188,2,159,27,22.04.2019 01:40,78,6,Zaporozhie
448,432,22,135,291,22,313,0,313,2,262,49,21.04.2019 21:00,78,6,Zaporozhie
352,337,14,148,190,14,204,0,204,3,179,22,22.04.2019 00:15,78,6,Zaporozhie
272,266,15,88,169,15,184,0,184,1,173,10,22.04.2019 00:20,78,6,Zaporozhie
272,266,2,86,184,2,186,0,186,1,181,4,22.04.2019 00:05,78,6,Zaporozhie
576,559,26,251,304,21,325,0,325,6,258,61,22.04.2019 00:05,78,6,Zaporozhie
672,660,32,306,336,30,366,0,366,0,325,41,22.04.2019 00:54,78,6,Zaporozhie
528,517,55,242,238,48,286,0,286,4,262,20,22.04.2019 00:10,78,6,Zaporozhie
1776,1748,35,715,1026,35,1061,0,1061,21,947,93,22.04.2019 00:03,78,6,Zaporozhie
1616,1589,33,648,939,29,968,0,968,16,875,77,21.04.2019 21:15,78,6,Zaporozhie
1088,1064,13,444,633,11,644,0,644,17,586,41,22.04.2019 00:40,78,6,Zaporozhie
960,931,51,405,506,49,555,0,555,5,512,38,22.04.2019 00:10,78,6,Zaporozhie
384,376,32,133,219,32,251,0,251,4,234,13,21.04.2019 23:10,78,6,Zaporozhie
224,209,15,90,121,13,134,0,134,0,112,22,22.04.2019 00:05,78,6,Zaporozhie
560,551,37,205,324,31,355,0,355,6,305,44,22.04.2019 00:10,78,6,Zaporozhie
352,337,54,117,184,51,235,0,235,3,217,15,22.04.2019 00:20,78,6,Zaporozhie
736,716,49,284,404,48,452,0,452,7,404,41,22.04.2019 00:02,78,6,Zaporozhie
816,807,71,299,450,67,517,0,517,9,429,79,21.04.2019 23:58,78,6,Zaporozhie
608,591,61,228,320,60,380,0,380,1,358,21,22.04.2019 00:30,78,6,Zaporozhie
528,508,74,219,242,67,309,0,309,4,268,37,21.04.2019 22:15,78,6,Zaporozhie
1088,1057,52,416,620,52,672,0,672,15,627,30,21.04.2019 22:10,78,6,Zaporozhie
192,200,24,34,134,24,158,0,158,0,135,23,22.04.2019 00:05,78,6,Zaporozhie
480,459,41,181,261,38,299,0,299,3,246,50,22.04.2019 00:50,78,6,Zaporozhie
304,303,24,109,172,23,195,0,195,4,169,22,21.04.2019 21:00,78,6,Zaporozhie
624,595,103,236,285,103,388,0,388,3,347,38,21.04.2019 23:15,78,6,Zaporozhie
624,616,56,245,327,52,379,0,379,3,343,33,22.04.2019 01:20,78,6,Zaporozhie
400,392,29,128,244,28,272,0,272,2,250,20,22.04.2019 00:18,78,6,Zaporozhie
464,449,40,166,259,39,298,0,298,2,258,38,22.04.2019 00:47,78,6,Zaporozhie
240,231,15,73,154,13,167,0,167,0,155,12,22.04.2019 00:05,78,6,Zaporozhie
352,340,27,155,170,27,197,0,197,1,174,22,21.04.2019 23:00,78,6,Zaporozhie
368,360,16,153,199,16,215,0,215,4,187,24,21.04.2019 23:45,78,6,Zaporozhie
2240,2219,34,772,1440,28,1468,0,1468,33,1328,107,22.04.2019 00:10,78,6,Zaporozhie
2272,2327,52,774,1461,37,1498,0,1498,34,1324,140,22.04.2019 00:15,78,6,Zaporozhie
2112,2106,32,779,1314,19,1333,0,1333,36,1182,115,22.04.2019 00:10,78,6,Zaporozhie
2112,2098,13,782,1320,10,1330,0,1330,37,1186,107,22.04.2019 00:05,78,6,Zaporozhie
2304,2277,40,856,1419,29,1448,0,1448,25,1286,137,22.04.2019 00:25,78,6,Zaporozhie
1296,1271,32,529,747,20,767,0,767,15,679,73,22.04.2019 00:15,78,6,Zaporozhie
1520,1488,14,610,898,12,910,0,910,17,812,81,22.04.2019 00:10,78,6,Zaporozhie
2224,2214,15,821,1393,10,1403,0,1403,24,1242,137,22.04.2019 00:07,78,6,Zaporozhie
2144,2122,15,734,1400,10,1410,0,1410,18,1241,151,22.04.2019 00:46,78,6,Zaporozhie
1792,1760,16,711,1068,13,1081,0,1081,16,953,112,22.04.2019 00:10,78,6,Zaporozhie
2048,2023,20,817,1217,14,1231,0,1231,20,1091,120,21.04.2019 22:30,78,6,Zaporozhie
2160,2125,14,758,1391,11,1402,0,1402,34,1223,145,22.04.2019 00:15,78,6,Zaporozhie
1824,1815,22,678,1128,18,1146,0,1146,18,991,137,22.04.2019 00:03,78,6,Zaporozhie
2128,2115,15,757,1361,10,1371,0,1371,30,1176,165,22.04.2019 00:07,78,6,Zaporozhie
2095,2073,29,802,1272,21,1293,0,1293,24,1147,122,22.04.2019 00:10,78,6,Zaporozhie
1904,1895,15,652,1243,9,1252,0,1252,25,1064,163,22.04.2019 00:10,78,6,Zaporozhie
2048,2024,16,680,1355,13,1368,0,1368,28,1190,150,22.04.2019 00:10,78,6,Zaporozhie
1936,1916,9,729,1202,5,1207,0,1207,30,1038,139,22.04.2019 00:05,78,6,Zaporozhie
1984,1955,16,739,1235,10,1245,0,1245,29,1048,168,22.04.2019 00:05,78,6,Zaporozhie
1904,1879,7,769,1130,5,1135,0,1135,26,1003,106,22.04.2019 00:20,78,6,Zaporozhie
2128,2094,8,694,1428,6,1434,0,1434,32,1240,162,22.04.2019 00:05,78,6,Zaporozhie
1824,1820,8,627,1191,6,1197,0,1197,18,1059,120,22.04.2019 02:09,78,6,Zaporozhie
2112,2068,22,738,1356,18,1374,0,1374,22,1245,107,22.04.2019 00:20,78,6,Zaporozhie
1584,1600,9,608,972,4,976,0,976,13,883,80,22.04.2019 00:10,78,6,Zaporozhie
1872,1854,29,728,1122,22,1144,0,1144,28,1030,86,22.04.2019 00:01,78,6,Zaporozhie
1504,1503,28,616,865,23,888,0,888,13,789,86,22.04.2019 01:00,78,6,Zaporozhie
2112,2117,21,746,1350,16,1366,0,1366,20,1199,147,22.04.2019 00:05,78,6,Zaporozhie
2256,2251,21,831,1408,17,1425,0,1425,30,1264,131,22.04.2019 00:02,78,6,Zaporozhie
1728,1449,20,868,845,15,860,0,860,16,747,97,22.04.2019 00:15,78,6,Zaporozhie
1264,1258,10,447,813,4,817,0,817,13,735,69,22.04.2019 00:05,78,6,Zaporozhie
1536,1547,27,529,989,18,1007,0,1007,21,860,126,22.04.2019 00:10,78,6,Zaporozhie
2000,2019,30,651,1324,25,1349,0,1349,21,1181,147,22.04.2019 00:55,78,6,Zaporozhie
2080,2055,9,755,1318,7,1325,0,1325,38,1127,160,22.04.2019 00:01,78,6,Zaporozhie
2112,2099,23,717,1376,19,1395,0,1395,26,1203,166,22.04.2019 00:30,78,6,Zaporozhie
944,1020,10,298,637,9,646,0,646,21,543,82,22.04.2019 00:03,78,6,Zaporozhie
2144,2166,16,757,1379,8,1387,0,1387,30,1192,165,22.04.2019 00:30,78,6,Zaporozhie
1936,1931,19,685,1234,17,1251,0,1251,33,1060,158,22.04.2019 00:40,78,6,Zaporozhie
960,926,14,420,530,10,540,0,540,16,452,72,21.04.2019 22:50,78,6,Zaporozhie
768,829,6,209,554,5,559,0,559,18,467,74,22.04.2019 00:01,78,6,Zaporozhie
1088,1115,11,428,652,8,660,0,660,13,570,77,22.04.2019 00:03,78,6,Zaporozhie
736,738,11,242,485,9,494,0,494,6,415,73,22.04.2019 00:30,78,6,Zaporozhie
752,729,3,281,468,3,471,0,471,9,421,41,22.04.2019 00:10,78,6,Zaporozhie
1312,1310,15,511,793,8,801,0,801,21,704,76,22.04.2019 00:08,78,6,Zaporozhie
1600,1604,25,568,1013,19,1032,0,1032,25,916,91,22.04.2019 00:10,78,6,Zaporozhie
1184,1194,9,396,781,7,788,0,788,12,716,60,22.04.2019 00:02,78,6,Zaporozhie
416,417,8,161,250,5,255,0,255,3,224,28,22.04.2019 00:15,78,6,Zaporozhie
1024,1013,10,449,567,8,575,0,575,8,517,50,22.04.2019 00:55,78,6,Zaporozhie
1072,1055,15,394,667,11,678,0,678,7,610,61,22.04.2019 00:30,78,6,Zaporozhie
1840,1821,19,648,1178,14,1192,0,1192,15,1055,122,22.04.2019 00:07,78,6,Zaporozhie
1792,1774,22,718,1056,18,1074,0,1074,17,981,76,22.04.2019 00:10,78,6,Zaporozhie
2064,2026,29,964,1075,25,1100,0,1100,10,1017,73,21.04.2019 22:00,78,6,Zaporozhie
560,540,30,245,288,27,315,0,315,3,299,13,22.04.2019 00:01,78,6,Zaporozhie
144,53,0,92,52,0,52,0,52,1,45,6,22.04.2019 00:15,78,6,Zaporozhie
127,40,0,89,38,0,38,0,38,1,34,3,22.04.2019 00:10,78,6,Zaporozhie
592,82,82,511,0,81,81,0,81,0,75,6,22.04.2019 00:01,78,6,Zaporozhie
656,362,0,324,332,0,332,0,332,4,262,66,22.04.2019 00:05,78,6,Zaporozhie
2000,1955,31,647,1331,22,1353,0,1353,28,1191,134,22.04.2019 00:05,79,6,Zaporozhie
1376,1371,18,474,885,17,902,0,902,15,774,113,22.04.2019 00:10,79,6,Zaporozhie
1696,1683,50,567,1098,31,1129,0,1129,12,971,146,22.04.2019 00:10,79,6,Zaporozhie
1520,1501,19,545,963,12,975,0,975,17,861,97,22.04.2019 00:02,79,6,Zaporozhie
1136,1111,14,474,651,11,662,0,662,7,609,46,22.04.2019 00:20,79,6,Zaporozhie
1360,1338,23,579,768,13,781,0,781,12,703,66,22.04.2019 01:15,79,6,Zaporozhie
1904,1865,18,779,1109,16,1125,0,1125,12,1032,81,22.04.2019 00:10,79,6,Zaporozhie
1456,1440,25,506,929,21,950,0,950,21,873,56,22.04.2019 00:02,79,6,Zaporozhie
1760,1731,25,679,1067,14,1081,0,1081,25,988,68,22.04.2019 00:30,79,6,Zaporozhie
2016,1985,28,729,1266,21,1287,0,1287,32,1157,98,22.04.2019 00:50,79,6,Zaporozhie
1392,1364,10,562,823,7,830,0,830,21,752,57,21.04.2019 21:30,79,6,Zaporozhie
1360,1337,15,536,810,14,824,0,824,22,750,52,22.04.2019 00:15,79,6,Zaporozhie
1184,1157,15,418,755,11,766,0,766,4,692,70,22.04.2019 01:50,79,6,Zaporozhie
1696,1673,13,595,1095,6,1101,0,1101,30,966,105,22.04.2019 00:01,79,6,Zaporozhie
1632,1601,0,615,1017,0,1017,0,1017,14,920,83,22.04.2019 01:50,79,6,Zaporozhie
2032,1986,10,697,1328,7,1335,0,1335,29,1184,122,22.04.2019 00:15,79,6,Zaporozhie
640,628,12,226,406,8,414,0,414,4,364,46,22.04.2019 00:10,79,6,Zaporozhie
992,972,19,452,521,19,540,0,540,8,500,32,22.04.2019 00:05,79,6,Zaporozhie
1616,1594,12,768,838,10,848,0,848,22,757,69,22.04.2019 00:15,79,6,Zaporozhie
1472,1432,7,693,774,5,779,0,779,11,699,69,22.04.2019 00:20,79,6,Zaporozhie
1248,1228,17,524,711,13,724,0,724,19,656,49,22.04.2019 00:15,79,6,Zaporozhie
1392,1368,29,621,742,29,771,0,771,13,701,57,22.04.2019 00:20,79,6,Zaporozhie
976,955,17,361,599,16,615,0,615,9,571,35,22.04.2019 00:10,79,6,Zaporozhie
736,723,16,274,448,14,462,0,462,8,427,27,22.04.2019 00:10,79,6,Zaporozhie
1184,1163,36,481,670,33,703,0,703,9,615,79,22.04.2019 00:37,79,6,Zaporozhie
1728,1708,59,798,881,49,930,0,930,11,853,66,22.04.2019 00:45,79,6,Zaporozhie
240,233,4,97,139,4,143,0,143,0,126,17,22.04.2019 00:18,79,6,Zaporozhie
448,437,8,166,275,7,282,0,282,4,268,10,22.04.2019 00:30,79,6,Zaporozhie
992,978,25,384,583,25,608,0,608,5,549,54,22.04.2019 00:05,79,6,Zaporozhie
880,876,56,300,526,54,580,0,580,8,528,44,22.04.2019 01:10,79,6,Zaporozhie
1088,1074,55,369,667,52,719,0,719,5,665,49,22.04.2019 00:10,79,6,Zaporozhie
1056,1041,53,406,598,52,650,0,650,14,562,74,21.04.2019 21:10,79,6,Zaporozhie
1328,1309,67,548,718,62,780,0,780,20,693,67,22.04.2019 01:15,79,6,Zaporozhie
864,842,14,351,503,10,513,0,513,7,475,31,22.04.2019 01:30,79,6,Zaporozhie
384,376,6,146,233,5,238,0,238,1,216,21,22.04.2019 00:07,79,6,Zaporozhie
480,457,23,172,285,23,308,0,308,3,288,17,22.04.2019 00:10,79,6,Zaporozhie
608,601,24,226,360,22,382,0,382,8,333,41,22.04.2019 00:15,79,6,Zaporozhie
1472,1443,30,609,835,28,863,0,863,13,788,62,22.04.2019 00:20,79,6,Zaporozhie
720,704,24,351,345,24,369,0,369,3,334,32,22.04.2019 00:12,79,6,Zaporozhie
736,707,24,309,405,22,427,0,427,3,401,23,22.04.2019 00:10,79,6,Zaporozhie
176,171,4,59,114,3,117,0,117,4,92,21,22.04.2019 00:30,79,6,Zaporozhie
336,325,17,136,184,16,200,0,200,3,164,33,22.04.2019 00:15,79,6,Zaporozhie
320,307,24,118,178,24,202,0,202,0,189,13,22.04.2019 00:05,79,6,Zaporozhie
848,833,20,322,507,19,526,0,526,8,486,32,22.04.2019 00:15,79,6,Zaporozhie
656,650,19,248,389,19,408,0,408,6,378,24,22.04.2019 00:01,79,6,Zaporozhie
416,402,24,137,255,24,279,0,279,4,243,32,22.04.2019 00:45,79,6,Zaporozhie
560,545,22,267,271,22,293,0,293,8,262,23,22.04.2019 00:10,79,6,Zaporozhie
640,630,27,251,363,26,389,0,389,8,342,39,22.04.2019 00:05,79,6,Zaporozhie
384,375,22,185,185,14,199,0,199,2,173,24,22.04.2019 00:15,79,6,Zaporozhie
176,11,0,165,11,0,11,0,11,0,6,5,22.04.2019 00:02,79,6,Zaporozhie
176,15,7,161,8,7,15,0,15,0,14,1,22.04.2019 00:05,79,6,Zaporozhie
688,682,37,259,397,32,429,0,429,4,392,33,22.04.2019 00:20,79,6,Zaporozhie
1248,1235,49,518,691,39,730,0,730,19,630,81,22.04.2019 00:40,79,6,Zaporozhie
560,549,38,188,341,31,372,0,372,5,342,25,22.04.2019 01:00,79,6,Zaporozhie
464,449,56,161,247,56,303,0,303,5,266,32,22.04.2019 00:10,79,6,Zaporozhie
1008,1000,73,403,542,63,605,0,605,10,547,48,22.04.2019 00:01,79,6,Zaporozhie
640,628,47,228,367,45,412,0,412,6,376,30,22.04.2019 00:15,79,6,Zaporozhie
464,464,40,140,286,38,324,0,324,2,309,13,22.04.2019 00:06,79,6,Zaporozhie
128,122,15,49,66,13,79,0,79,1,72,6,22.04.2019 00:01,79,6,Zaporozhie
848,825,71,331,451,66,517,0,517,2,492,23,22.04.2019 00:20,79,6,Zaporozhie
1600,1585,27,641,941,18,959,0,959,12,889,58,22.04.2019 01:20,79,6,Zaporozhie
1392,1369,8,558,828,6,834,0,834,20,762,52,22.04.2019 00:20,79,6,Zaporozhie
1920,1891,24,766,1141,13,1154,0,1154,25,1057,72,22.04.2019 00:35,79,6,Zaporozhie
1296,1271,19,508,772,16,788,0,788,13,723,52,22.04.2019 01:40,79,6,Zaporozhie
880,874,16,319,550,11,561,0,561,2,519,40,22.04.2019 00:05,79,6,Zaporozhie
1264,1237,22,553,696,15,711,0,711,10,670,31,22.04.2019 00:10,79,6,Zaporozhie
1568,1557,18,565,987,16,1003,0,1003,5,946,52,22.04.2019 00:30,79,6,Zaporozhie
544,528,7,251,287,6,293,0,293,3,265,25,22.04.2019 00:10,79,6,Zaporozhie
416,400,5,236,175,5,180,0,180,3,159,18,22.04.2019 00:10,79,6,Zaporozhie
1072,1039,19,484,573,15,588,0,588,12,541,35,22.04.2019 00:40,79,6,Zaporozhie
864,849,22,414,433,17,450,0,450,4,416,30,22.04.2019 02:15,79,6,Zaporozhie
1088,1058,14,554,520,14,534,0,534,6,506,22,22.04.2019 00:03,79,6,Zaporozhie
944,922,15,474,458,12,470,0,470,9,440,21,22.04.2019 00:05,79,6,Zaporozhie
896,873,24,443,429,24,453,0,453,4,435,14,22.04.2019 02:20,79,6,Zaporozhie
704,682,8,334,362,8,370,0,370,4,358,8,22.04.2019 00:07,79,6,Zaporozhie
640,633,9,304,327,9,336,0,336,7,320,9,22.04.2019 00:05,79,6,Zaporozhie
560,548,9,309,243,8,251,0,251,4,238,9,22.04.2019 00:05,79,6,Zaporozhie
896,878,13,444,441,11,452,0,452,5,431,16,22.04.2019 00:10,79,6,Zaporozhie
1568,1547,13,547,1010,11,1021,0,1021,20,968,33,22.04.2019 00:03,79,6,Zaporozhie
1248,1225,19,518,716,14,730,0,730,17,677,36,22.04.2019 00:45,79,6,Zaporozhie
1264,1252,18,476,774,14,788,0,788,14,746,28,22.04.2019 00:10,79,6,Zaporozhie
992,984,56,405,531,56,587,0,587,1,564,22,22.04.2019 00:05,79,6,Zaporozhie
736,725,47,225,464,47,511,0,511,7,485,19,22.04.2019 00:10,79,6,Zaporozhie
896,883,44,354,498,44,542,0,542,4,520,18,22.04.2019 00:38,79,6,Zaporozhie
960,933,24,362,579,19,598,0,598,7,562,29,22.04.2019 00:02,79,6,Zaporozhie
1712,1677,56,650,1014,48,1062,0,1062,14,974,74,22.04.2019 00:10,79,6,Zaporozhie
1120,1093,54,209,857,54,911,0,911,10,825,76,22.04.2019 00:15,79,6,Zaporozhie
336,326,29,123,185,28,213,0,213,4,187,22,22.04.2019 00:10,79,6,Zaporozhie
1120,1104,96,314,710,96,806,0,806,8,765,33,22.04.2019 00:15,79,6,Zaporozhie
208,204,12,73,125,10,135,0,135,2,127,6,22.04.2019 00:05,79,6,Zaporozhie
112,102,7,42,63,7,70,0,70,1,68,1,21.04.2019 23:59,79,6,Zaporozhie
96,16,6,80,10,6,16,0,16,0,15,1,22.04.2019 00:05,79,6,Zaporozhie
2208,2180,21,810,1382,16,1398,0,1398,30,1196,172,22.04.2019 01:30,79,6,Zaporozhie
1808,1786,39,718,1068,22,1090,0,1090,25,993,72,22.04.2019 01:00,79,6,Zaporozhie
1696,1678,32,628,1045,23,1068,0,1068,26,893,149,22.04.2019 00:30,79,6,Zaporozhie
864,851,20,358,494,12,506,0,506,5,455,46,22.04.2019 00:15,79,6,Zaporozhie
1456,1428,35,651,778,27,805,0,805,13,734,58,22.04.2019 00:10,79,6,Zaporozhie
1520,1498,28,593,909,18,927,0,927,20,829,78,22.04.2019 00:50,79,6,Zaporozhie
1936,1912,38,754,1158,24,1182,0,1182,21,1063,98,22.04.2019 00:40,79,6,Zaporozhie
1472,1435,25,653,799,20,819,0,819,9,745,65,22.04.2019 00:55,79,6,Zaporozhie
2000,1978,63,800,1151,49,1200,0,1200,34,1049,117,22.04.2019 00:30,79,6,Zaporozhie
2240,2198,65,940,1239,61,1300,0,1300,20,1148,132,22.04.2019 01:50,79,6,Zaporozhie
400,379,41,199,164,37,201,0,201,4,172,25,22.04.2019 00:30,79,6,Zaporozhie
1392,1360,47,530,817,45,862,0,862,10,748,104,22.04.2019 00:10,79,6,Zaporozhie
720,699,60,303,361,56,417,0,417,3,380,34,22.04.2019 00:10,79,6,Zaporozhie
1648,1627,131,741,803,104,907,0,907,12,815,80,22.04.2019 00:54,79,6,Zaporozhie
368,347,22,155,192,21,213,0,213,8,185,20,22.04.2019 00:05,79,6,Zaporozhie
1952,1917,114,844,1016,92,1108,0,1108,27,960,121,22.04.2019 00:20,79,6,Zaporozhie
672,656,9,287,380,5,385,0,385,2,354,29,22.04.2019 00:15,79,6,Zaporozhie
1056,1044,19,434,603,19,622,0,622,11,562,49,22.04.2019 00:45,79,6,Zaporozhie
480,472,42,167,275,38,313,0,313,7,290,16,22.04.2019 00:24,79,6,Zaporozhie
688,663,39,298,355,35,390,0,390,5,362,23,22.04.2019 00:15,79,6,Zaporozhie
576,564,41,218,319,39,358,0,358,0,307,51,22.04.2019 00:03,79,6,Zaporozhie
448,434,42,190,221,37,258,0,258,5,235,18,22.04.2019 00:20,79,6,Zaporozhie
1008,991,17,396,603,9,612,0,612,11,560,41,22.04.2019 00:15,79,6,Zaporozhie
336,330,33,125,180,31,211,0,211,2,199,10,22.04.2019 00:10,79,6,Zaporozhie
336,321,31,132,176,28,204,0,204,1,183,20,22.04.2019 00:05,79,6,Zaporozhie
288,276,31,114,145,29,174,0,174,2,155,17,22.04.2019 00:01,79,6,Zaporozhie
400,382,9,162,230,8,238,0,238,5,205,28,22.04.2019 00:27,79,6,Zaporozhie
336,324,15,108,214,14,228,0,228,1,213,14,22.04.2019 00:15,79,6,Zaporozhie
944,931,33,375,539,30,569,0,569,7,497,65,22.04.2019 00:10,79,6,Zaporozhie
1856,1825,52,751,1067,38,1105,0,1105,20,990,95,22.04.2019 00:10,79,6,Zaporozhie
544,527,29,250,269,25,294,0,294,6,246,42,22.04.2019 00:05,79,6,Zaporozhie
1072,1050,60,502,515,55,570,0,570,10,513,47,22.04.2019 00:03,79,6,Zaporozhie
416,392,31,167,225,24,249,0,249,5,210,34,22.04.2019 01:00,79,6,Zaporozhie
224,25,13,200,12,12,24,0,24,0,20,4,22.04.2019 03:10,79,6,Zaporozhie
1440,463,0,989,451,0,451,0,451,28,406,17,22.04.2019 00:30,79,6,Zaporozhie
1872,1845,7,725,1142,5,1147,0,1147,21,1011,115,22.04.2019 00:01,79,6,Zaporozhie
2400,2359,20,863,1521,16,1537,0,1537,33,1315,189,22.04.2019 00:10,79,6,Zaporozhie
1712,1738,6,452,1255,5,1260,0,1260,22,1055,183,22.04.2019 00:58,79,6,Zaporozhie
1760,1730,2,508,1250,2,1252,0,1252,12,1080,160,22.04.2019 00:15,79,6,Zaporozhie
2160,2125,16,772,1375,13,1388,0,1388,33,1189,166,22.04.2019 00:35,79,6,Zaporozhie
1680,1643,3,581,1096,3,1099,0,1099,18,974,107,22.04.2019 00:02,79,6,Zaporozhie
1792,1749,11,568,1217,7,1224,0,1224,15,1027,182,22.04.2019 00:05,79,6,Zaporozhie
1968,1928,5,629,1335,4,1339,0,1339,12,1145,182,22.04.2019 00:48,79,6,Zaporozhie
1696,1674,4,576,1116,4,1120,0,1120,24,956,140,22.04.2019 00:15,79,6,Zaporozhie
1840,1797,10,600,1231,9,1240,0,1240,40,1014,186,22.04.2019 01:00,79,6,Zaporozhie
2144,2089,6,696,1445,3,1448,0,1448,33,1239,176,22.04.2019 00:01,79,6,Zaporozhie
1776,1746,8,568,1201,7,1208,0,1208,22,1025,161,22.04.2019 00:17,79,6,Zaporozhie
2064,2021,18,651,1402,11,1413,0,1413,26,1220,167,22.04.2019 00:20,79,6,Zaporozhie
2304,2281,7,720,1579,5,1584,0,1584,28,1363,193,22.04.2019 00:40,79,6,Zaporozhie
2128,2106,4,680,1446,2,1448,0,1448,25,1252,171,22.04.2019 01:40,79,6,Zaporozhie
2352,2317,3,768,1582,2,1584,0,1584,31,1358,195,22.04.2019 00:20,79,6,Zaporozhie
2240,2199,2,764,1474,2,1476,0,1476,24,1254,198,22.04.2019 00:30,79,6,Zaporozhie
2400,2355,4,797,1602,1,1603,0,1603,31,1380,192,22.04.2019 00:20,79,6,Zaporozhie
2352,2315,3,779,1571,2,1573,0,1573,31,1388,154,22.04.2019 00:05,79,6,Zaporozhie
2384,2334,2,760,1623,1,1624,0,1624,26,1441,157,22.04.2019 00:05,79,6,Zaporozhie
256,92,18,167,71,18,89,0,89,1,82,6,22.04.2019 00:35,79,6,Zaporozhie
848,852,13,294,542,12,554,0,554,7,516,31,21.04.2019 21:31,80,6,Zaporozhie
880,869,22,374,485,21,506,0,506,2,486,18,21.04.2019 21:25,80,6,Zaporozhie
224,219,7,79,138,7,145,0,145,0,138,7,21.04.2019 20:35,80,6,Zaporozhie
2256,2234,15,914,1327,15,1342,0,1342,23,1265,54,22.04.2019 01:40,80,6,Zaporozhie
1824,1800,16,626,1183,15,1198,0,1198,8,1135,55,21.04.2019 22:10,80,6,Zaporozhie
1760,1731,9,658,1096,6,1102,0,1102,19,1033,50,22.04.2019 00:05,80,6,Zaporozhie
1776,1759,13,667,1100,9,1109,0,1109,18,1020,71,22.04.2019 00:00,80,6,Zaporozhie
1936,1906,17,716,1207,13,1220,0,1220,19,1121,80,22.04.2019 00:15,80,6,Zaporozhie
1728,1709,20,639,1071,18,1089,0,1089,19,1012,58,22.04.2019 00:40,80,6,Zaporozhie
2240,2219,8,882,1351,7,1358,0,1358,13,1274,71,22.04.2019 00:30,80,6,Zaporozhie
736,717,16,253,468,15,483,0,483,10,454,19,22.04.2019 00:12,80,6,Zaporozhie
960,959,29,383,548,29,577,0,577,3,548,26,22.04.2019 00:42,80,6,Zaporozhie
624,606,19,241,365,18,383,0,383,3,349,31,22.04.2019 00:02,80,6,Zaporozhie
1024,1018,36,351,642,31,673,0,673,14,610,49,21.04.2019 21:35,80,6,Zaporozhie
576,562,23,238,321,17,338,0,338,6,310,22,22.04.2019 00:30,80,6,Zaporozhie
496,484,18,161,318,17,335,0,335,5,302,28,21.04.2019 20:45,80,6,Zaporozhie
1440,1414,17,648,775,17,792,0,792,14,710,68,21.04.2019 23:40,80,6,Zaporozhie
1088,1058,16,466,607,15,622,0,622,8,566,48,21.04.2019 22:00,80,6,Zaporozhie
496,489,21,179,297,20,317,0,317,4,271,42,21.04.2019 21:15,80,6,Zaporozhie
240,236,25,77,138,25,163,0,163,1,144,18,22.04.2019 00:07,80,6,Zaporozhie
1376,1378,52,518,809,49,858,0,858,2,791,65,22.04.2019 00:05,80,6,Zaporozhie
512,504,11,206,295,11,306,0,306,5,291,10,21.04.2019 21:55,80,6,Zaporozhie
720,703,30,280,416,24,440,0,440,6,407,27,21.04.2019 20:45,80,6,Zaporozhie
240,234,6,99,136,5,141,0,141,1,131,9,21.04.2019 21:00,80,6,Zaporozhie
592,572,36,257,305,30,335,0,335,4,299,32,21.04.2019 22:40,80,6,Zaporozhie
400,384,11,198,196,6,202,0,202,4,166,32,21.04.2019 20:50,80,6,Zaporozhie
624,616,20,262,345,17,362,0,362,5,322,35,22.04.2019 00:10,80,6,Zaporozhie
464,459,20,196,254,14,268,0,268,6,247,15,22.04.2019 02:40,80,6,Zaporozhie
880,858,30,370,486,24,510,0,510,2,458,50,21.04.2019 23:00,80,6,Zaporozhie
720,717,59,250,411,59,470,0,470,6,323,141,21.04.2019 22:00,80,6,Zaporozhie
1184,1151,52,391,741,52,793,0,793,9,735,49,22.04.2019 00:55,80,6,Zaporozhie
528,516,35,185,310,33,343,0,343,6,313,24,21.04.2019 21:20,80,6,Zaporozhie
384,382,34,140,217,27,244,0,244,0,231,13,21.04.2019 21:07,80,6,Zaporozhie
1664,1637,11,771,884,9,893,0,893,14,814,65,21.04.2019 22:00,80,6,Zaporozhie
1616,1579,17,637,964,15,979,0,979,12,902,65,22.04.2019 02:10,80,6,Zaporozhie
352,351,7,145,202,5,207,0,207,2,167,38,22.04.2019 01:05,80,6,Zaporozhie
544,539,17,216,314,14,328,0,328,3,293,32,22.04.2019 04:00,80,6,Zaporozhie
192,181,18,78,99,15,114,0,114,1,108,5,21.04.2019 23:40,80,6,Zaporozhie
160,163,4,48,108,4,112,0,112,2,98,12,21.04.2019 21:30,80,6,Zaporozhie
928,899,12,348,568,12,580,0,580,10,534,36,22.04.2019 02:40,80,6,Zaporozhie
816,798,15,358,446,12,458,0,458,4,434,20,22.04.2019 00:10,80,6,Zaporozhie
1664,1616,30,636,1004,24,1028,0,1028,17,942,69,22.04.2019 00:15,80,6,Zaporozhie
256,18,0,238,18,0,18,0,18,0,11,7,22.04.2019 00:05,80,6,Zaporozhie
2064,2048,6,809,1250,5,1255,0,1255,15,1107,133,22.04.2019 00:05,80,6,Zaporozhie
2096,2075,23,824,1253,19,1272,0,1272,17,1131,124,22.04.2019 00:07,80,6,Zaporozhie
1584,1566,16,604,967,13,980,0,980,24,852,104,22.04.2019 00:02,80,6,Zaporozhie
2336,2316,2,940,1395,1,1396,0,1396,12,1247,137,22.04.2019 00:12,80,6,Zaporozhie
2304,2276,16,914,1374,16,1390,0,1390,13,1276,101,22.04.2019 00:16,80,6,Zaporozhie
2352,2314,3,895,1454,3,1457,0,1457,20,1310,127,21.04.2019 23:00,80,6,Zaporozhie
2272,2237,5,829,1438,5,1443,0,1443,27,1233,183,22.04.2019 01:15,80,6,Zaporozhie
1424,1406,7,535,883,6,889,0,889,20,802,67,21.04.2019 23:23,80,6,Zaporozhie
1856,1836,17,810,1031,15,1046,0,1046,18,906,122,22.04.2019 00:30,80,6,Zaporozhie
2160,2138,11,852,1301,7,1308,0,1308,31,1125,152,22.04.2019 01:25,80,6,Zaporozhie
1552,1542,14,602,940,10,950,0,950,17,846,87,22.04.2019 00:43,80,6,Zaporozhie
592,578,10,236,349,7,356,0,356,2,315,39,21.04.2019 21:23,80,6,Zaporozhie
1840,1824,16,735,1092,13,1105,0,1105,19,968,118,22.04.2019 00:02,80,6,Zaporozhie
2176,2156,13,907,1258,11,1269,0,1269,22,1118,129,22.04.2019 04:42,80,6,Zaporozhie
1568,1552,5,732,832,4,836,0,836,14,748,74,22.04.2019 00:10,80,6,Zaporozhie
1040,1027,7,412,624,4,628,0,628,9,556,63,22.04.2019 00:10,80,6,Zaporozhie
1584,1568,6,546,1032,6,1038,0,1038,12,931,95,22.04.2019 00:50,80,6,Zaporozhie
2160,2127,16,832,1314,14,1328,0,1328,28,1179,121,22.04.2019 00:10,80,6,Zaporozhie
2096,2051,8,716,1374,6,1380,0,1380,27,1210,143,22.04.2019 00:45,80,6,Zaporozhie
816,793,3,284,531,1,532,0,532,7,463,62,22.04.2019 00:16,80,6,Zaporozhie
2016,2010,16,677,1323,16,1339,0,1339,28,1181,130,22.04.2019 00:49,80,6,Zaporozhie
1792,1761,7,603,1185,4,1189,0,1189,19,1010,160,22.04.2019 01:50,80,6,Zaporozhie
1760,1730,5,595,1160,5,1165,0,1165,34,974,157,22.04.2019 00:02,80,6,Zaporozhie
2016,1979,7,718,1291,7,1298,0,1298,36,1135,127,22.04.2019 00:09,80,6,Zaporozhie
752,738,0,273,479,0,479,0,479,9,405,65,21.04.2019 21:40,80,6,Zaporozhie
2080,2068,17,820,1249,11,1260,0,1260,24,1115,121,21.04.2019 21:55,80,6,Zaporozhie
1696,1688,6,731,959,6,965,0,965,19,852,94,22.04.2019 00:37,80,6,Zaporozhie
2128,2104,13,664,1451,13,1464,0,1464,28,1259,177,22.04.2019 00:25,80,6,Zaporozhie
1840,1788,11,886,946,8,954,0,954,17,862,75,21.04.2019 21:33,80,6,Zaporozhie
2128,2105,17,809,1303,16,1319,0,1319,17,1151,151,22.04.2019 00:03,80,6,Zaporozhie
2032,2020,11,841,1184,7,1191,0,1191,20,1058,113,21.04.2019 22:00,80,6,Zaporozhie
1760,1746,11,656,1093,11,1104,0,1104,19,987,98,21.04.2019 23:59,80,6,Zaporozhie
2096,2054,12,690,1396,10,1406,0,1406,25,1262,119,22.04.2019 00:45,80,6,Zaporozhie
2032,2008,20,756,1261,15,1276,0,1276,21,1143,112,21.04.2019 21:25,80,6,Zaporozhie
2256,2236,16,772,1471,13,1484,0,1484,17,1310,157,22.04.2019 00:30,80,6,Zaporozhie
2064,2040,26,694,1348,22,1370,0,1370,25,1209,136,22.04.2019 00:10,80,6,Zaporozhie
2016,1994,14,656,1348,12,1360,0,1360,23,1210,127,22.04.2019 00:05,80,6,Zaporozhie
2224,2186,22,744,1462,18,1480,0,1480,25,1314,141,22.04.2019 00:20,80,6,Zaporozhie
2016,1991,13,792,1212,12,1224,0,1224,23,1052,149,22.04.2019 00:03,80,6,Zaporozhie
2176,2148,16,792,1372,12,1384,0,1384,30,1211,143,22.04.2019 00:01,80,6,Zaporozhie
2320,2304,4,906,1410,4,1414,0,1414,20,1270,124,21.04.2019 23:30,80,6,Zaporozhie
2224,2183,13,815,1401,8,1409,0,1409,24,1244,141,22.04.2019 00:01,80,6,Zaporozhie
2240,2206,9,877,1354,9,1363,0,1363,21,1219,123,21.04.2019 21:34,80,6,Zaporozhie
2272,2239,18,804,1452,16,1468,0,1468,23,1322,123,21.04.2019 22:00,80,6,Zaporozhie
1216,1197,3,431,782,3,785,0,785,11,708,66,22.04.2019 00:11,80,6,Zaporozhie
1936,1911,12,740,1184,12,1196,0,1196,18,1108,70,21.04.2019 21:25,80,6,Zaporozhie
2208,2183,5,959,1245,4,1249,0,1249,24,1096,129,22.04.2019 00:10,80,6,Zaporozhie
2016,1987,7,940,1074,2,1076,0,1076,19,952,105,22.04.2019 00:10,80,6,Zaporozhie
2048,2005,14,902,1134,12,1146,0,1146,17,1019,110,21.04.2019 23:10,80,6,Zaporozhie
1648,1625,1,649,998,1,999,0,999,14,900,85,22.04.2019 00:40,80,6,Zaporozhie
1632,1815,14,472,1148,12,1160,0,1160,29,937,194,22.04.2019 04:20,80,6,Zaporozhie
2096,2095,9,774,1313,9,1322,0,1322,22,1105,195,21.04.2019 22:50,80,6,Zaporozhie
2240,2214,2,1013,1225,2,1227,0,1227,16,1100,111,21.04.2019 22:15,80,6,Zaporozhie
1456,1450,5,620,832,4,836,0,836,19,744,73,22.04.2019 00:05,80,6,Zaporozhie
1536,1516,10,606,920,10,930,0,930,14,854,62,22.04.2019 00:02,80,6,Zaporozhie
2096,2081,10,794,1293,9,1302,0,1302,19,1191,92,21.04.2019 23:57,80,6,Zaporozhie
1600,1585,10,587,1004,9,1013,0,1013,20,908,85,21.04.2019 23:30,80,6,Zaporozhie
1920,1910,5,691,1224,5,1229,0,1229,22,1106,101,22.04.2019 02:00,80,6,Zaporozhie
2016,2002,6,704,1306,6,1312,0,1312,13,1205,94,21.04.2019 21:05,80,6,Zaporozhie
2288,2268,12,826,1450,12,1462,0,1462,33,1319,110,22.04.2019 00:05,80,6,Zaporozhie
336,9,9,328,0,8,8,0,8,0,8,0,21.04.2019 23:59,80,6,Zaporozhie
144,9,0,136,8,0,8,0,8,1,7,0,21.04.2019 22:45,80,6,Zaporozhie
112,5,2,107,3,2,5,0,5,0,4,1,21.04.2019 21:55,80,6,Zaporozhie
96,23,9,75,14,7,21,0,21,2,18,1,22.04.2019 00:08,80,6,Zaporozhie
112,12,0,100,12,0,12,0,12,0,11,1,22.04.2019 02:35,80,6,Zaporozhie
208,9,0,199,9,0,9,0,9,0,8,1,21.04.2019 23:45,80,6,Zaporozhie
176,73,0,103,73,0,73,0,73,0,66,7,21.04.2019 22:30,80,6,Zaporozhie
1424,1386,28,509,887,28,915,0,915,25,813,77,22.04.2019 03:35,80,6,Zaporozhie
1568,1520,13,674,886,8,894,0,894,27,794,73,21.04.2019 21:55,81,6,Zaporozhie
1360,1344,15,589,758,13,771,0,771,8,705,58,21.04.2019 20:54,81,6,Zaporozhie
1712,1679,17,754,945,13,958,0,958,19,882,57,22.04.2019 00:15,81,6,Zaporozhie
2016,1969,11,885,1120,11,1131,0,1131,19,1021,91,22.04.2019 00:30,81,6,Zaporozhie
784,774,8,321,455,8,463,0,463,11,424,28,21.04.2019 22:30,81,6,Zaporozhie
1312,1292,15,579,720,13,733,0,733,13,681,39,21.04.2019 21:05,81,6,Zaporozhie
448,442,3,181,264,3,267,0,267,4,255,8,21.04.2019 22:00,81,6,Zaporozhie
240,233,0,128,112,0,112,0,112,0,100,12,21.04.2019 22:15,81,6,Zaporozhie
112,103,0,49,63,0,63,0,63,0,53,10,21.04.2019 23:55,81,6,Zaporozhie
448,421,10,202,236,10,246,0,246,0,227,19,21.04.2019 20:45,81,6,Zaporozhie
208,205,5,79,124,5,129,0,129,0,107,22,21.04.2019 23:20,81,6,Zaporozhie
320,325,7,149,164,7,171,0,171,1,159,11,21.04.2019 23:55,81,6,Zaporozhie
544,530,16,193,336,15,351,0,351,2,324,25,22.04.2019 00:30,81,6,Zaporozhie
400,383,2,159,240,1,241,0,241,2,205,34,22.04.2019 00:05,81,6,Zaporozhie
560,545,2,275,285,0,285,0,285,2,256,27,21.04.2019 21:08,81,6,Zaporozhie
560,538,1,253,307,0,307,0,307,5,271,31,21.04.2019 20:32,81,6,Zaporozhie
592,578,45,211,339,42,381,0,381,3,360,18,21.04.2019 22:30,81,6,Zaporozhie
528,524,22,195,312,21,333,0,333,4,279,50,21.04.2019 21:10,81,6,Zaporozhie
464,443,8,213,243,8,251,0,251,1,228,22,21.04.2019 21:00,81,6,Zaporozhie
352,345,18,144,192,16,208,0,208,1,171,36,21.04.2019 21:10,81,6,Zaporozhie
640,620,28,259,355,26,381,0,381,8,327,46,21.04.2019 21:25,81,6,Zaporozhie
336,319,21,130,186,20,206,0,206,1,181,24,21.04.2019 22:00,81,6,Zaporozhie
464,442,14,176,275,13,288,0,288,5,258,25,21.04.2019 21:15,81,6,Zaporozhie
400,377,14,152,235,13,248,0,248,3,230,15,22.04.2019 02:30,81,6,Zaporozhie
752,735,30,313,410,29,439,0,439,4,387,48,22.04.2019 00:05,81,6,Zaporozhie
704,698,24,301,380,23,403,0,403,9,347,47,21.04.2019 23:00,81,6,Zaporozhie
1504,1492,37,538,942,24,966,0,966,16,836,114,21.04.2019 23:30,81,6,Zaporozhie
880,866,7,326,547,7,554,0,554,7,480,67,22.04.2019 01:10,81,6,Zaporozhie
1392,1372,13,604,779,9,788,0,788,8,704,76,22.04.2019 00:35,81,6,Zaporozhie
1456,1422,18,535,911,10,921,0,921,11,862,48,22.04.2019 00:15,81,6,Zaporozhie
1440,1412,22,573,845,22,867,0,867,19,787,61,21.04.2019 22:35,81,6,Zaporozhie
688,669,16,287,385,16,401,0,401,5,374,22,21.04.2019 20:53,81,6,Zaporozhie
1520,1512,22,645,860,15,875,0,875,16,799,60,21.04.2019 22:00,81,6,Zaporozhie
1024,1006,18,461,547,16,563,0,563,9,519,35,22.04.2019 00:05,81,6,Zaporozhie
192,182,8,54,130,8,138,0,138,3,117,18,21.04.2019 23:50,81,6,Zaporozhie
1056,1036,20,453,590,13,603,0,603,8,558,37,21.04.2019 23:10,81,6,Zaporozhie
896,875,9,427,461,8,469,0,469,10,432,27,21.04.2019 21:26,81,6,Zaporozhie
1184,1160,67,417,705,62,767,0,767,10,703,54,22.04.2019 00:05,81,6,Zaporozhie
720,707,10,303,407,10,417,0,417,5,382,30,21.04.2019 22:50,81,6,Zaporozhie
336,326,30,100,208,28,236,0,236,0,212,24,21.04.2019 22:37,81,6,Zaporozhie
1232,1217,48,417,774,41,815,0,815,16,741,58,22.04.2019 00:45,81,6,Zaporozhie
416,410,28,146,245,25,270,0,270,3,260,7,21.04.2019 23:00,81,6,Zaporozhie
208,205,7,77,126,5,131,0,131,0,122,9,22.04.2019 00:01,81,6,Zaporozhie
1440,1414,13,572,861,7,868,0,868,10,826,32,21.04.2019 22:20,81,6,Zaporozhie
320,320,90,68,171,81,252,0,252,13,185,54,21.04.2019 21:00,81,6,Zaporozhie
240,225,7,116,117,7,124,0,124,1,116,7,21.04.2019 20:45,81,6,Zaporozhie
624,617,31,175,424,25,449,0,449,5,408,36,21.04.2019 21:55,81,6,Zaporozhie
176,169,4,60,113,3,116,0,116,1,103,12,21.04.2019 21:20,81,6,Zaporozhie
176,176,7,42,129,5,134,0,134,0,123,11,21.04.2019 20:50,81,6,Zaporozhie
576,555,53,184,343,49,392,0,392,4,380,8,22.04.2019 00:10,81,6,Zaporozhie
960,937,65,355,544,61,605,0,605,6,589,10,21.04.2019 21:20,81,6,Zaporozhie
1040,1023,43,434,568,38,606,0,606,3,581,22,21.04.2019 23:50,81,6,Zaporozhie
2272,2231,6,877,1390,5,1395,0,1395,25,1277,93,22.04.2019 01:15,81,6,Zaporozhie
1632,1603,8,648,977,7,984,0,984,18,906,60,21.04.2019 22:30,81,6,Zaporozhie
608,604,0,282,326,0,326,0,326,7,285,34,22.04.2019 00:50,81,6,Zaporozhie
1136,1109,2,443,691,2,693,0,693,7,648,38,21.04.2019 22:25,81,6,Zaporozhie
528,526,5,230,293,5,298,0,298,1,290,7,22.04.2019 00:15,81,6,Zaporozhie
144,147,4,34,106,4,110,0,110,0,107,3,21.04.2019 23:50,81,6,Zaporozhie
1888,1844,19,882,987,19,1006,0,1006,13,954,39,21.04.2019 22:00,81,6,Zaporozhie
64,53,0,19,45,0,45,0,45,0,41,4,22.04.2019 00:10,81,6,Zaporozhie
288,276,6,107,175,6,181,0,181,1,177,3,21.04.2019 23:15,81,6,Zaporozhie
256,240,2,110,145,1,146,0,146,0,126,20,21.04.2019 21:30,81,6,Zaporozhie
608,602,2,199,407,2,409,0,409,1,396,12,21.04.2019 22:40,81,6,Zaporozhie
464,466,6,202,256,6,262,0,262,1,247,14,21.04.2019 22:00,81,6,Zaporozhie
1056,1056,43,308,705,43,748,0,748,7,699,42,21.04.2019 22:00,81,6,Zaporozhie
352,352,16,134,202,16,218,0,218,0,205,13,21.04.2019 22:00,81,6,Zaporozhie
432,422,3,160,269,3,272,0,272,3,249,20,21.04.2019 22:30,81,6,Zaporozhie
512,493,10,259,246,7,253,0,253,3,227,23,21.04.2019 21:15,81,6,Zaporozhie
112,110,3,35,76,1,77,0,77,0,69,8,21.04.2019 21:35,81,6,Zaporozhie
400,390,15,164,221,15,236,0,236,1,224,11,21.04.2019 22:55,81,6,Zaporozhie
224,214,12,84,128,12,140,0,140,2,119,19,21.04.2019 21:30,81,6,Zaporozhie
368,349,2,165,201,2,203,0,203,0,191,12,21.04.2019 20:50,81,6,Zaporozhie
304,296,19,95,190,19,209,0,209,3,185,21,22.04.2019 00:15,81,6,Zaporozhie
784,767,53,253,482,49,531,0,531,6,493,32,21.04.2019 22:00,81,6,Zaporozhie
480,471,25,133,322,25,347,0,347,6,310,31,21.04.2019 22:05,81,6,Zaporozhie
256,241,0,117,139,0,139,0,139,2,122,15,22.04.2019 00:10,81,6,Zaporozhie
416,405,3,148,265,3,268,0,268,0,242,26,21.04.2019 21:55,81,6,Zaporozhie
496,491,17,193,292,11,303,0,303,2,273,28,21.04.2019 23:55,81,6,Zaporozhie
224,224,22,75,127,22,149,0,149,1,133,15,22.04.2019 02:20,81,6,Zaporozhie
400,386,26,135,243,22,265,0,265,2,250,13,21.04.2019 21:20,81,6,Zaporozhie
544,532,22,208,317,19,336,0,336,6,295,35,21.04.2019 21:01,81,6,Zaporozhie
400,392,23,169,208,23,231,0,231,2,198,31,21.04.2019 21:30,81,6,Zaporozhie
176,176,5,65,106,5,111,0,111,4,91,16,21.04.2019 23:00,81,6,Zaporozhie
224,211,8,87,129,8,137,0,137,1,120,16,21.04.2019 23:30,81,6,Zaporozhie
672,656,42,226,410,36,446,0,446,8,399,39,21.04.2019 22:55,81,6,Zaporozhie
288,289,18,113,158,17,175,0,175,1,158,16,21.04.2019 21:22,81,6,Zaporozhie
576,572,26,260,293,23,316,0,316,2,297,17,21.04.2019 20:50,81,6,Zaporozhie
800,797,38,274,490,36,526,0,526,9,492,25,22.04.2019 00:30,81,6,Zaporozhie
208,201,12,70,126,12,138,0,138,2,128,8,21.04.2019 20:50,81,6,Zaporozhie
336,336,2,134,200,2,202,0,202,3,183,16,22.04.2019 00:10,81,6,Zaporozhie
656,646,30,249,377,30,407,0,407,16,357,34,21.04.2019 22:30,81,6,Zaporozhie
240,241,9,83,148,9,157,0,157,6,145,6,21.04.2019 20:50,81,6,Zaporozhie
2144,2124,46,859,1248,37,1285,0,1285,32,1132,121,21.04.2019 22:25,81,6,Zaporozhie
2208,2178,38,922,1252,34,1286,0,1286,23,1129,134,22.04.2019 00:10,81,6,Zaporozhie
1376,1356,29,544,806,26,832,0,832,13,750,69,22.04.2019 00:51,81,6,Zaporozhie
2224,2187,35,923,1271,30,1301,0,1301,23,1116,162,22.04.2019 00:10,81,6,Zaporozhie
368,361,7,149,213,6,219,0,219,3,183,33,22.04.2019 00:02,81,6,Zaporozhie
416,410,20,171,230,15,245,0,245,3,216,26,21.04.2019 23:25,81,6,Zaporozhie
880,867,38,313,540,27,567,0,567,8,513,46,22.04.2019 00:05,81,6,Zaporozhie
1200,1175,56,497,657,46,703,0,703,5,600,98,22.04.2019 00:05,81,6,Zaporozhie
560,535,21,196,348,16,364,0,364,4,341,19,22.04.2019 00:45,81,6,Zaporozhie
528,522,31,183,316,29,345,0,345,4,322,19,22.04.2019 01:10,81,6,Zaporozhie
384,364,16,124,244,16,260,0,260,1,221,38,22.04.2019 01:30,81,6,Zaporozhie
288,281,15,107,166,15,181,0,181,1,161,19,21.04.2019 23:20,81,6,Zaporozhie
704,681,21,295,391,18,409,0,409,7,366,36,22.04.2019 02:30,81,6,Zaporozhie
224,224,12,70,144,10,154,0,154,1,145,8,22.04.2019 00:11,81,6,Zaporozhie
640,631,70,272,301,67,368,0,368,10,318,40,22.04.2019 00:20,81,6,Zaporozhie
688,675,25,283,386,19,405,0,405,9,362,34,22.04.2019 00:05,81,6,Zaporozhie
368,356,9,119,241,8,249,0,249,4,220,25,22.04.2019 00:20,81,6,Zaporozhie
96,95,5,43,49,4,53,0,53,0,50,3,22.04.2019 00:05,81,6,Zaporozhie
896,882,58,339,506,51,557,0,557,18,501,38,22.04.2019 00:15,81,6,Zaporozhie
704,716,77,257,389,58,447,0,447,6,415,26,22.04.2019 00:57,81,6,Zaporozhie
368,365,16,155,199,14,213,0,213,1,202,10,22.04.2019 01:00,81,6,Zaporozhie
576,566,29,209,340,27,367,0,367,4,336,27,22.04.2019 00:40,81,6,Zaporozhie
432,421,39,162,234,36,270,0,270,1,248,21,21.04.2019 21:45,81,6,Zaporozhie
432,434,31,171,237,24,261,0,261,1,233,27,22.04.2019 01:05,81,6,Zaporozhie
528,535,13,231,287,10,297,0,297,6,267,24,22.04.2019 00:30,81,6,Zaporozhie
368,355,5,172,191,5,196,0,196,0,166,30,21.04.2019 23:40,81,6,Zaporozhie
640,613,25,286,336,18,354,0,354,10,314,30,22.04.2019 00:20,81,6,Zaporozhie
336,325,9,108,222,6,228,0,228,2,207,19,21.04.2019 23:55,81,6,Zaporozhie
1504,1489,97,547,868,89,957,0,957,47,850,60,22.04.2019 01:00,81,6,Zaporozhie
528,500,27,212,291,25,316,0,316,0,300,16,22.04.2019 00:05,81,6,Zaporozhie
144,50,9,97,39,8,47,0,47,0,40,7,22.04.2019 00:03,81,6,Zaporozhie
672,651,9,325,338,9,347,0,347,5,320,22,22.04.2019 00:25,81,6,Zaporozhie
1264,1235,17,579,672,13,685,0,685,8,631,46,22.04.2019 01:00,81,6,Zaporozhie
752,736,10,308,434,10,444,0,444,7,398,39,22.04.2019 00:20,81,6,Zaporozhie
896,867,27,429,442,25,467,0,467,9,421,37,22.04.2019 00:35,81,6,Zaporozhie
800,784,18,370,414,16,430,0,430,4,397,29,22.04.2019 01:30,81,6,Zaporozhie
496,487,20,218,259,19,278,0,278,8,251,19,22.04.2019 00:35,81,6,Zaporozhie
400,387,29,127,248,25,273,0,273,5,243,25,22.04.2019 00:05,81,6,Zaporozhie
512,493,51,182,286,44,330,0,330,4,306,20,21.04.2019 20:45,81,6,Zaporozhie
528,520,22,204,303,21,324,0,324,7,282,35,22.04.2019 00:05,81,6,Zaporozhie
272,264,16,92,164,16,180,0,180,1,163,16,22.04.2019 00:22,81,6,Zaporozhie
224,211,13,107,104,13,117,0,117,1,97,19,21.04.2019 23:55,81,6,Zaporozhie
288,287,4,79,205,4,209,0,209,1,196,12,22.04.2019 00:15,81,6,Zaporozhie
64,63,1,24,39,1,40,0,40,4,28,8,22.04.2019 00:30,81,6,Zaporozhie
624,614,19,232,374,18,392,0,392,10,321,61,21.04.2019 21:00,81,6,Zaporozhie
240,221,9,99,133,8,141,0,141,4,116,21,21.04.2019 21:00,81,6,Zaporozhie
480,453,27,237,217,26,243,0,243,2,206,35,21.04.2019 21:15,81,6,Zaporozhie
496,476,30,173,294,29,323,0,323,6,253,64,21.04.2019 21:45,81,6,Zaporozhie
256,239,14,113,130,13,143,0,143,0,108,35,21.04.2019 22:15,81,6,Zaporozhie
720,707,33,291,398,31,429,0,429,2,374,53,22.04.2019 01:55,81,6,Zaporozhie
448,428,20,190,242,16,258,0,258,3,222,33,22.04.2019 00:10,81,6,Zaporozhie
720,698,24,296,401,23,424,0,424,3,386,35,21.04.2019 21:10,81,6,Zaporozhie
768,747,7,319,443,6,449,0,449,10,402,37,22.04.2019 00:05,81,6,Zaporozhie
272,259,9,125,138,9,147,0,147,2,128,17,22.04.2019 00:10,81,6,Zaporozhie
704,682,22,304,381,19,400,0,400,6,362,32,22.04.2019 00:10,81,6,Zaporozhie
272,256,27,103,146,23,169,0,169,5,156,8,21.04.2019 21:22,81,6,Zaporozhie
576,560,53,240,288,48,336,0,336,4,303,29,22.04.2019 00:10,81,6,Zaporozhie
304,303,14,104,188,12,200,0,200,3,152,45,22.04.2019 00:15,81,6,Zaporozhie
256,238,4,130,122,4,126,0,126,2,116,8,22.04.2019 00:15,81,6,Zaporozhie
304,292,22,85,197,22,219,0,219,1,196,22,21.04.2019 23:45,81,6,Zaporozhie
304,288,8,150,148,6,154,0,154,0,139,15,22.04.2019 00:10,81,6,Zaporozhie
416,397,39,149,231,36,267,0,267,4,230,33,22.04.2019 00:10,81,6,Zaporozhie
112,110,11,35,68,9,77,0,77,0,68,9,22.04.2019 00:15,81,6,Zaporozhie
624,619,26,255,343,26,369,0,369,3,341,25,22.04.2019 00:15,81,6,Zaporozhie
928,909,26,357,550,21,571,0,571,11,508,52,21.04.2019 23:30,81,6,Zaporozhie
192,42,0,150,42,0,42,0,42,0,35,7,22.04.2019 00:15,81,6,Zaporozhie
48,14,2,35,12,1,13,0,13,0,10,3,22.04.2019 00:10,81,6,Zaporozhie
432,450,6,165,261,6,267,0,267,9,228,30,22.04.2019 00:44,81,6,Zaporozhie
2320,2275,38,984,1307,29,1336,0,1336,24,1177,135,22.04.2019 01:20,81,6,Zaporozhie
2320,2263,27,972,1329,19,1348,0,1348,38,1206,104,22.04.2019 00:05,81,6,Zaporozhie
2256,2202,35,932,1294,30,1324,0,1324,22,1228,74,22.04.2019 00:05,81,6,Zaporozhie
864,860,17,375,476,13,489,0,489,8,455,26,22.04.2019 00:30,81,6,Zaporozhie
1408,1376,18,653,744,11,755,0,755,11,696,48,22.04.2019 00:30,81,6,Zaporozhie
688,665,28,261,402,25,427,0,427,10,375,42,22.04.2019 01:58,81,6,Zaporozhie
208,196,9,107,93,8,101,0,101,8,79,14,21.04.2019 23:00,81,6,Zaporozhie
128,119,3,72,53,3,56,0,56,1,48,7,22.04.2019 05:00,81,6,Zaporozhie
976,954,13,405,560,11,571,0,571,10,531,30,21.04.2019 22:31,81,6,Zaporozhie
112,107,0,36,76,0,76,0,76,0,59,17,21.04.2019 22:00,81,6,Zaporozhie
688,671,10,317,363,8,371,0,371,2,324,45,22.04.2019 01:00,81,6,Zaporozhie
112,100,3,57,52,3,55,0,55,1,40,14,21.04.2019 21:00,81,6,Zaporozhie
576,559,15,189,372,15,387,0,387,1,362,24,22.04.2019 00:35,81,6,Zaporozhie
672,674,17,300,356,16,372,0,372,4,300,68,21.04.2019 21:35,81,6,Zaporozhie
1280,1276,20,439,822,19,841,0,841,13,734,94,21.04.2019 21:30,81,6,Zaporozhie
1552,1522,23,596,935,21,956,0,956,8,864,84,21.04.2019 20:50,81,6,Zaporozhie
176,168,0,64,112,0,112,0,112,2,107,3,22.04.2019 00:30,81,6,Zaporozhie
496,474,20,213,263,20,283,0,283,4,252,27,21.04.2019 21:07,81,6,Zaporozhie
896,872,27,397,477,22,499,0,499,4,466,29,22.04.2019 00:20,81,6,Zaporozhie
464,459,12,158,297,9,306,0,306,4,278,24,21.04.2019 23:27,81,6,Zaporozhie
144,141,6,51,88,5,93,0,93,1,84,8,21.04.2019 20:40,81,6,Zaporozhie
1024,1011,23,417,584,23,607,0,607,8,527,72,22.04.2019 00:15,81,6,Zaporozhie
480,478,10,218,252,10,262,0,262,4,237,21,22.04.2019 00:25,81,6,Zaporozhie
576,561,10,290,279,7,286,0,286,6,259,21,21.04.2019 21:40,81,6,Zaporozhie
112,105,3,28,81,3,84,0,84,0,79,5,21.04.2019 21:30,81,6,Zaporozhie
128,120,10,47,74,7,81,0,81,3,69,9,21.04.2019 22:00,81,6,Zaporozhie
1232,1206,65,488,682,62,744,0,744,7,680,57,21.04.2019 23:50,81,6,Zaporozhie
448,429,18,192,238,18,256,0,256,1,239,16,21.04.2019 21:10,81,6,Zaporozhie
128,121,5,45,79,4,83,0,83,0,74,9,21.04.2019 23:00,81,6,Zaporozhie
576,554,9,239,329,8,337,0,337,3,290,44,21.04.2019 23:20,81,6,Zaporozhie
160,160,3,79,78,3,81,0,81,1,64,16,21.04.2019 21:20,81,6,Zaporozhie
112,114,0,49,63,0,63,0,63,0,49,14,21.04.2019 20:41,81,6,Zaporozhie
880,866,10,395,476,9,485,0,485,3,443,39,21.04.2019 22:05,81,6,Zaporozhie
416,397,17,197,203,16,219,0,219,4,183,32,21.04.2019 23:20,81,6,Zaporozhie
304,297,6,139,162,3,165,0,165,2,144,19,21.04.2019 23:00,81,6,Zaporozhie
320,307,6,116,199,5,204,0,204,0,193,11,21.04.2019 20:50,81,6,Zaporozhie
928,914,9,374,545,9,554,0,554,7,502,45,22.04.2019 00:15,81,6,Zaporozhie
144,127,10,39,95,10,105,0,105,0,93,12,21.04.2019 22:05,81,6,Zaporozhie
224,47,20,184,22,18,40,0,40,0,35,5,22.04.2019 00:20,81,6,Zaporozhie
576,567,4,270,302,4,306,0,306,10,274,22,21.04.2019 21:45,81,6,Zaporozhie
1360,1328,9,590,762,8,770,0,770,15,719,36,22.04.2019 00:20,81,6,Zaporozhie
1632,1601,22,609,1002,21,1023,0,1023,14,928,81,22.04.2019 00:15,81,6,Zaporozhie
1104,1076,24,400,683,21,704,0,704,18,639,47,22.04.2019 00:10,81,6,Zaporozhie
1104,1091,14,422,672,10,682,0,682,14,592,76,22.04.2019 00:20,81,6,Zaporozhie
752,722,7,354,392,6,398,0,398,11,346,41,22.04.2019 00:10,81,6,Zaporozhie
992,964,20,371,603,18,621,0,621,11,542,68,22.04.2019 00:35,81,6,Zaporozhie
1120,1186,23,346,753,21,774,0,774,16,678,80,22.04.2019 00:05,81,6,Zaporozhie
1056,1026,11,403,643,10,653,0,653,11,582,60,22.04.2019 00:07,81,6,Zaporozhie
1200,1177,21,463,718,19,737,0,737,10,651,76,22.04.2019 00:10,81,6,Zaporozhie
1584,1550,12,596,978,10,988,0,988,17,874,97,22.04.2019 00:15,81,6,Zaporozhie
1248,1227,10,545,693,10,703,0,703,12,645,46,22.04.2019 00:55,81,6,Zaporozhie
1120,1107,8,441,671,8,679,0,679,9,571,99,22.04.2019 00:15,81,6,Zaporozhie
880,878,9,367,507,6,513,0,513,2,460,51,22.04.2019 00:10,81,6,Zaporozhie
1008,980,9,457,544,7,551,0,551,9,492,50,22.04.2019 00:05,81,6,Zaporozhie
976,960,6,439,531,6,537,0,537,15,490,32,22.04.2019 00:12,81,6,Zaporozhie
928,907,15,404,510,14,524,0,524,11,468,45,22.04.2019 00:10,81,6,Zaporozhie
1248,1209,22,534,695,19,714,0,714,16,633,65,22.04.2019 00:09,81,6,Zaporozhie
992,966,5,438,550,4,554,0,554,5,506,43,21.04.2019 23:45,81,6,Zaporozhie
832,800,10,403,421,8,429,0,429,5,390,34,22.04.2019 00:15,81,6,Zaporozhie
992,975,9,387,596,9,605,0,605,14,531,60,22.04.2019 00:05,81,6,Zaporozhie
976,954,16,457,504,15,519,0,519,7,468,44,22.04.2019 00:30,81,6,Zaporozhie
944,935,19,405,522,17,539,0,539,10,491,38,22.04.2019 00:15,81,6,Zaporozhie
800,790,6,357,438,5,443,0,443,4,393,46,22.04.2019 01:10,81,6,Zaporozhie
944,921,9,433,504,7,511,0,511,10,455,46,22.04.2019 00:10,81,6,Zaporozhie
896,871,10,429,460,7,467,0,467,7,432,28,22.04.2019 00:30,81,6,Zaporozhie
160,45,21,121,22,17,39,0,39,0,32,7,21.04.2019 21:30,81,6,Zaporozhie
96,81,0,15,81,0,81,0,81,3,77,1,21.04.2019 21:30,81,6,Zaporozhie
352,311,0,42,310,0,310,0,310,24,278,8,22.04.2019 00:30,82,6,Zaporozhie
2048,2039,14,610,1426,12,1438,0,1438,26,1292,120,22.04.2019 01:10,82,6,Zaporozhie
1744,1706,13,671,1063,10,1073,0,1073,23,960,90,22.04.2019 00:45,82,6,Zaporozhie
2336,2293,21,719,1603,14,1617,0,1617,19,1421,177,22.04.2019 00:10,82,6,Zaporozhie
2176,2153,28,752,1402,22,1424,0,1424,25,1234,165,22.04.2019 02:00,82,6,Zaporozhie
2256,2214,42,796,1429,31,1460,0,1460,33,1273,154,22.04.2019 01:30,82,6,Zaporozhie
2192,2162,18,761,1418,13,1431,0,1431,35,1303,93,22.04.2019 00:03,82,6,Zaporozhie
1072,1038,28,392,655,25,680,0,680,10,617,53,21.04.2019 20:50,82,6,Zaporozhie
576,575,32,205,340,31,371,0,371,2,338,31,21.04.2019 22:03,82,6,Zaporozhie
912,901,45,382,493,37,530,0,530,6,472,52,22.04.2019 06:15,82,6,Zaporozhie
848,834,62,315,475,58,533,0,533,7,455,71,21.04.2019 22:10,82,6,Zaporozhie
1152,1144,21,449,686,17,703,0,703,13,636,54,21.04.2019 21:26,82,6,Zaporozhie
640,625,48,223,373,44,417,0,417,8,381,28,21.04.2019 22:30,82,6,Zaporozhie
736,718,14,285,439,12,451,0,451,8,418,25,21.04.2019 23:20,82,6,Zaporozhie
736,720,43,343,365,28,393,0,393,9,321,63,21.04.2019 21:10,82,6,Zaporozhie
896,889,17,268,617,11,628,0,628,9,565,54,21.04.2019 21:50,82,6,Zaporozhie
1072,1047,55,401,627,44,671,0,671,11,607,53,21.04.2019 21:52,82,6,Zaporozhie
512,502,60,196,260,56,316,0,316,8,267,41,22.04.2019 00:01,82,6,Zaporozhie
320,305,17,119,185,16,201,0,201,4,181,16,22.04.2019 00:05,82,6,Zaporozhie
1824,1812,31,546,1254,24,1278,0,1278,27,1144,107,22.04.2019 00:15,82,6,Zaporozhie
1072,1061,27,355,694,23,717,0,717,8,639,70,22.04.2019 00:10,82,6,Zaporozhie
2128,2106,18,740,1373,15,1388,0,1388,28,1253,107,22.04.2019 00:05,82,6,Zaporozhie
800,797,43,322,441,37,478,0,478,9,440,29,22.04.2019 02:30,82,6,Zaporozhie
592,584,12,208,373,11,384,0,384,10,347,27,21.04.2019 21:00,82,6,Zaporozhie
896,888,46,314,542,40,582,0,582,7,530,45,22.04.2019 00:40,82,6,Zaporozhie
304,299,9,108,187,9,196,0,196,2,175,19,22.04.2019 00:38,82,6,Zaporozhie
592,583,24,209,364,19,383,0,383,12,340,31,22.04.2019 00:15,82,6,Zaporozhie
896,888,11,350,536,10,546,0,546,4,505,37,22.04.2019 00:10,82,6,Zaporozhie
1088,1060,66,423,606,59,665,0,665,4,592,69,22.04.2019 00:50,82,6,Zaporozhie
864,852,56,382,435,47,482,0,482,8,430,44,21.04.2019 21:10,82,6,Zaporozhie
1120,1102,48,390,688,42,730,0,730,12,657,61,21.04.2019 23:50,82,6,Zaporozhie
256,224,32,90,144,22,166,0,166,3,146,17,21.04.2019 23:30,82,6,Zaporozhie
656,646,45,320,296,40,336,0,336,7,295,34,21.04.2019 21:40,82,6,Zaporozhie
992,987,30,310,656,26,682,0,682,13,632,37,21.04.2019 20:35,82,6,Zaporozhie
512,583,36,131,347,34,381,0,381,8,331,42,21.04.2019 23:55,82,6,Zaporozhie
224,215,23,90,114,20,134,0,134,1,124,9,21.04.2019 22:25,82,6,Zaporozhie
176,157,49,34,93,49,142,0,142,21,57,64,22.04.2019 00:10,82,6,Zaporozhie
1424,434,64,990,370,64,434,0,434,27,286,121,22.04.2019 01:30,82,6,Zaporozhie
736,521,64,220,452,64,516,0,516,23,387,106,22.04.2019 01:30,82,6,Zaporozhie
800,473,0,327,473,0,473,0,473,25,412,36,21.04.2019 21:00,82,6,Zaporozhie
256,72,0,184,72,0,72,0,72,1,63,8,21.04.2019 21:38,82,6,Zaporozhie
160,158,13,44,103,13,116,0,116,1,113,2,22.04.2019 02:25,82,6,Zaporozhie
112,103,9,37,66,9,75,0,75,1,66,8,22.04.2019 00:10,82,6,Zaporozhie
928,910,17,360,553,15,568,0,568,14,484,70,22.04.2019 00:15,82,6,Zaporozhie
1552,1512,23,656,873,23,896,0,896,12,799,85,22.04.2019 00:15,82,6,Zaporozhie
1616,1584,27,677,915,24,939,0,939,19,818,102,22.04.2019 00:30,82,6,Zaporozhie
1760,1731,24,642,1097,21,1118,0,1118,22,960,136,22.04.2019 00:10,82,6,Zaporozhie
2160,2118,36,767,1358,35,1393,0,1393,22,1239,132,22.04.2019 00:30,82,6,Zaporozhie
1584,1553,10,606,968,10,978,0,978,15,860,103,22.04.2019 01:00,82,6,Zaporozhie
848,830,9,350,489,9,498,0,498,6,444,48,22.04.2019 00:10,82,6,Zaporozhie
800,779,10,347,443,10,453,0,453,8,393,52,22.04.2019 00:20,82,6,Zaporozhie
992,987,15,447,531,14,545,0,545,6,498,41,22.04.2019 02:05,82,6,Zaporozhie
752,719,30,304,421,27,448,0,448,11,405,32,22.04.2019 01:07,82,6,Zaporozhie
768,747,64,306,416,46,462,0,462,5,435,22,22.04.2019 00:25,82,6,Zaporozhie
736,731,62,209,470,57,527,0,527,10,485,32,22.04.2019 00:30,82,6,Zaporozhie
480,470,43,217,226,37,263,0,263,5,238,20,22.04.2019 00:05,82,6,Zaporozhie
432,419,45,151,239,42,281,0,281,2,261,18,22.04.2019 00:30,82,6,Zaporozhie
240,225,19,79,143,18,161,0,161,3,149,9,22.04.2019 01:10,82,6,Zaporozhie
688,664,60,285,350,53,403,0,403,4,366,33,22.04.2019 00:20,82,6,Zaporozhie
544,536,31,193,322,29,351,0,351,5,305,41,22.04.2019 00:08,82,6,Zaporozhie
480,468,51,174,265,41,306,0,306,2,274,30,21.04.2019 22:30,82,6,Zaporozhie
400,391,27,174,204,22,226,0,226,3,203,20,22.04.2019 00:45,82,6,Zaporozhie
640,615,28,253,365,22,387,0,387,7,319,61,22.04.2019 00:15,82,6,Zaporozhie
560,546,70,214,284,62,346,0,346,3,313,30,22.04.2019 01:50,82,6,Zaporozhie
208,207,28,72,111,25,136,0,136,0,120,16,21.04.2019 22:28,82,6,Zaporozhie
656,629,82,242,349,65,414,0,414,3,381,30,22.04.2019 00:20,82,6,Zaporozhie
304,295,28,119,162,23,185,0,185,4,153,28,22.04.2019 00:20,82,6,Zaporozhie
208,205,12,67,130,11,141,0,141,0,125,16,22.04.2019 00:20,82,6,Zaporozhie
368,355,31,151,192,25,217,0,217,2,182,33,22.04.2019 00:10,82,6,Zaporozhie
1104,1075,11,495,600,9,609,0,609,8,568,33,22.04.2019 00:15,82,6,Zaporozhie
336,330,20,155,164,17,181,0,181,2,162,17,22.04.2019 00:45,82,6,Zaporozhie
128,18,3,112,13,3,16,0,16,0,14,2,22.04.2019 00:40,82,6,Zaporozhie
48,19,0,29,19,0,19,0,19,1,16,2,22.04.2019 00:51,82,6,Zaporozhie
80,40,1,42,37,1,38,0,38,0,32,6,21.04.2019 21:15,82,6,Zaporozhie
1200,1184,57,515,634,51,685,0,685,12,618,55,21.04.2019 21:45,82,6,Zaporozhie
1136,1111,72,455,617,64,681,0,681,9,615,57,21.04.2019 21:15,82,6,Zaporozhie
2448,2429,44,852,1561,35,1596,0,1596,27,1390,179,22.04.2019 01:30,82,6,Zaporozhie
2384,2307,54,795,1545,44,1589,0,1589,33,1377,179,22.04.2019 00:52,82,6,Zaporozhie
1312,1302,28,525,765,22,787,0,787,13,702,72,21.04.2019 21:30,82,6,Zaporozhie
1424,1398,35,676,722,26,748,0,748,8,662,78,21.04.2019 21:20,82,6,Zaporozhie
1392,1368,36,588,777,27,804,0,804,15,705,84,22.04.2019 00:25,82,6,Zaporozhie
640,626,62,276,305,59,364,0,364,18,289,57,21.04.2019 22:00,82,6,Zaporozhie
624,615,30,228,366,30,396,0,396,7,360,29,22.04.2019 00:07,82,6,Zaporozhie
1712,1675,25,633,1059,20,1079,0,1079,19,950,110,21.04.2019 21:40,82,6,Zaporozhie
992,971,29,374,592,26,618,0,618,6,568,44,22.04.2019 00:10,82,6,Zaporozhie
816,787,42,327,455,34,489,0,489,8,422,59,21.04.2019 23:30,82,6,Zaporozhie
496,477,19,196,284,16,300,0,300,4,255,41,21.04.2019 22:30,82,6,Zaporozhie
752,731,32,276,448,28,476,0,476,8,396,72,21.04.2019 22:00,82,6,Zaporozhie
368,360,2,137,229,2,231,0,231,1,207,23,21.04.2019 21:00,82,6,Zaporozhie
400,385,18,133,251,16,267,0,267,7,233,27,22.04.2019 00:40,82,6,Zaporozhie
400,387,19,128,254,18,272,0,272,2,241,29,21.04.2019 23:10,82,6,Zaporozhie
2128,2107,28,894,1213,21,1234,0,1234,35,1089,110,21.04.2019 21:40,82,6,Zaporozhie
2096,2062,58,747,1308,41,1349,0,1349,32,1209,108,22.04.2019 01:15,82,6,Zaporozhie
2224,2190,31,839,1360,25,1385,0,1385,36,1244,105,22.04.2019 00:10,82,6,Zaporozhie
784,758,33,309,447,28,475,0,475,5,429,41,22.04.2019 00:12,82,6,Zaporozhie
512,504,25,165,326,21,347,0,347,11,311,25,22.04.2019 00:05,82,6,Zaporozhie
608,602,10,258,342,8,350,0,350,6,318,26,22.04.2019 00:57,82,6,Zaporozhie
992,973,13,415,566,11,577,0,577,10,510,57,21.04.2019 21:30,82,6,Zaporozhie
128,115,4,61,63,4,67,0,67,0,55,12,22.04.2019 00:20,82,6,Zaporozhie
992,971,27,385,583,24,607,0,607,11,529,67,22.04.2019 00:05,82,6,Zaporozhie
1216,1197,24,480,717,19,736,0,736,14,647,75,21.04.2019 23:18,82,6,Zaporozhie
1392,1371,19,661,715,16,731,0,731,15,647,69,21.04.2019 20:50,82,6,Zaporozhie
272,265,6,126,141,5,146,0,146,1,130,15,21.04.2019 22:00,82,6,Zaporozhie
848,835,48,303,502,43,545,0,545,14,479,52,21.04.2019 23:00,82,6,Zaporozhie
752,741,33,224,495,33,528,0,528,7,464,57,21.04.2019 21:27,82,6,Zaporozhie
960,929,32,377,556,27,583,0,583,11,518,54,22.04.2019 00:05,82,6,Zaporozhie
1776,1758,77,617,1101,58,1159,0,1159,11,1076,72,22.04.2019 00:30,82,6,Zaporozhie
1328,1301,48,509,776,43,819,0,819,9,735,75,22.04.2019 00:17,82,6,Zaporozhie
416,403,12,193,216,7,223,0,223,8,200,15,21.04.2019 22:40,82,6,Zaporozhie
1568,1548,43,515,1021,32,1053,0,1053,19,918,116,22.04.2019 00:03,82,6,Zaporozhie
704,674,30,238,441,25,466,0,466,4,393,68,21.04.2019 21:30,82,6,Zaporozhie
560,544,27,266,273,21,294,0,294,2,267,25,21.04.2019 21:55,82,6,Zaporozhie
976,971,31,331,621,24,645,0,645,13,535,97,21.04.2019 21:51,82,6,Zaporozhie
1376,1357,45,414,920,42,962,0,962,15,832,115,21.04.2019 21:00,82,6,Zaporozhie
320,306,8,130,182,8,190,0,190,7,174,9,22.04.2019 00:30,82,6,Zaporozhie
896,877,28,290,580,26,606,0,606,11,535,60,21.04.2019 21:40,82,6,Zaporozhie
112,18,0,94,18,0,18,0,18,1,12,5,22.04.2019 00:08,82,6,Zaporozhie
1232,341,0,895,337,0,337,0,337,12,309,16,21.04.2019 21:15,82,6,Zaporozhie
1824,1793,40,663,1128,33,1161,0,1161,26,1005,130,21.04.2019 22:28,82,6,Zaporozhie
1664,1636,23,568,1080,16,1096,0,1096,26,961,109,22.04.2019 02:30,82,6,Zaporozhie
1136,1120,29,406,706,24,730,0,730,19,647,64,22.04.2019 00:30,82,6,Zaporozhie
1056,1040,69,447,547,62,609,0,609,11,535,63,21.04.2019 21:45,82,6,Zaporozhie
400,384,37,163,204,33,237,0,237,2,222,13,22.04.2019 00:15,82,6,Zaporozhie
416,397,38,154,237,25,262,0,262,3,241,18,21.04.2019 22:35,82,6,Zaporozhie
432,425,7,182,244,6,250,0,250,2,217,31,22.04.2019 00:20,82,6,Zaporozhie
528,518,142,173,233,122,355,0,355,8,320,27,22.04.2019 00:17,82,6,Zaporozhie
496,491,88,168,250,78,328,0,328,2,276,50,21.04.2019 22:45,82,6,Zaporozhie
800,792,34,338,436,26,462,0,462,3,406,53,21.04.2019 22:07,82,6,Zaporozhie
400,383,34,141,230,29,259,0,259,3,231,25,22.04.2019 00:15,82,6,Zaporozhie
464,456,36,200,233,31,264,0,264,3,220,41,22.04.2019 00:40,82,6,Zaporozhie
592,583,38,189,365,38,403,0,403,3,359,41,22.04.2019 05:00,82,6,Zaporozhie
608,605,69,237,314,57,371,0,371,4,333,34,22.04.2019 00:10,82,6,Zaporozhie
640,629,37,266,345,29,374,0,374,3,345,26,22.04.2019 00:59,82,6,Zaporozhie
128,18,0,112,16,0,16,0,16,0,12,4,22.04.2019 00:02,82,6,Zaporozhie
416,399,19,185,214,17,231,0,231,4,195,32,21.04.2019 22:40,82,6,Zaporozhie
256,250,18,97,141,18,159,0,159,4,141,14,22.04.2019 01:15,82,6,Zaporozhie
384,374,40,158,187,39,226,0,226,9,200,17,21.04.2019 22:00,82,6,Zaporozhie
480,478,34,175,273,32,305,0,305,2,270,33,22.04.2019 00:30,82,6,Zaporozhie
672,645,26,373,281,18,299,0,299,1,260,38,22.04.2019 00:05,82,6,Zaporozhie
1632,1593,21,668,944,20,964,0,964,12,851,101,22.04.2019 00:40,82,6,Zaporozhie
2112,2091,18,795,1300,17,1317,0,1317,29,1121,167,22.04.2019 00:10,82,6,Zaporozhie
1408,1389,13,539,860,9,869,0,869,21,769,79,22.04.2019 00:15,82,6,Zaporozhie
1760,1736,23,693,1048,19,1067,0,1067,13,954,100,22.04.2019 00:10,82,6,Zaporozhie
2192,2145,27,865,1304,23,1327,0,1327,27,1165,135,22.04.2019 00:15,82,6,Zaporozhie
1072,1051,16,404,655,13,668,0,668,18,576,74,22.04.2019 00:12,82,6,Zaporozhie
848,850,7,360,483,5,488,0,488,6,449,33,22.04.2019 00:30,82,6,Zaporozhie
1648,1620,18,609,1026,13,1039,0,1039,21,933,85,22.04.2019 00:35,82,6,Zaporozhie
1664,1629,14,684,971,9,980,0,980,12,865,103,22.04.2019 00:05,82,6,Zaporozhie
1488,1458,18,589,882,17,899,0,899,22,809,68,22.04.2019 01:30,82,6,Zaporozhie
448,437,34,213,208,27,235,0,235,1,226,8,22.04.2019 00:05,82,6,Zaporozhie
640,627,8,312,321,7,328,0,328,7,301,20,21.04.2019 21:34,82,6,Zaporozhie
688,672,52,285,358,45,403,0,403,2,370,31,21.04.2019 21:37,82,6,Zaporozhie
768,750,81,276,419,73,492,0,492,7,440,45,22.04.2019 00:00,82,6,Zaporozhie
544,527,50,217,280,47,327,0,327,2,287,38,22.04.2019 00:45,82,6,Zaporozhie
736,716,59,317,364,55,419,0,419,8,370,41,21.04.2019 23:30,82,6,Zaporozhie
288,278,24,119,145,24,169,0,169,0,154,15,22.04.2019 00:05,82,6,Zaporozhie
928,915,21,343,564,21,585,0,585,2,520,63,22.04.2019 00:10,82,6,Zaporozhie
960,938,15,291,656,13,669,0,669,6,600,63,21.04.2019 20:50,82,6,Zaporozhie
144,132,11,53,84,7,91,0,91,0,85,6,22.04.2019 00:05,82,6,Zaporozhie
400,387,29,174,199,27,226,0,226,4,202,20,21.04.2019 21:50,82,6,Zaporozhie
688,668,48,286,360,42,402,0,402,6,361,35,22.04.2019 00:40,82,6,Zaporozhie
1088,1075,18,419,654,15,669,0,669,9,608,52,21.04.2019 21:20,82,6,Zaporozhie
1200,1182,21,352,827,21,848,0,848,15,777,56,22.04.2019 00:10,82,6,Zaporozhie
192,183,10,62,121,9,130,0,130,2,114,14,22.04.2019 00:01,82,6,Zaporozhie
720,698,82,221,426,73,499,0,499,7,449,43,22.04.2019 00:10,82,6,Zaporozhie
912,889,18,504,391,17,408,0,408,3,362,43,22.04.2019 00:20,82,6,Zaporozhie
384,369,10,215,162,7,169,0,169,7,147,15,22.04.2019 00:05,82,6,Zaporozhie
560,541,9,260,295,5,300,0,300,4,269,27,21.04.2019 22:00,82,6,Zaporozhie
1840,1819,28,834,983,23,1006,0,1006,9,906,91,22.04.2019 03:17,82,6,Zaporozhie
928,908,42,455,435,38,473,0,473,7,446,20,22.04.2019 00:10,82,6,Zaporozhie
496,481,24,234,240,22,262,0,262,2,244,16,22.04.2019 01:55,82,6,Zaporozhie
256,248,19,107,131,18,149,0,149,1,137,11,22.04.2019 00:05,82,6,Zaporozhie
224,35,7,192,26,6,32,0,32,0,25,7,22.04.2019 00:10,82,6,Zaporozhie
1056,1041,22,401,635,20,655,0,655,7,516,132,21.04.2019 21:35,82,6,Zaporozhie
352,339,42,127,189,36,225,0,225,3,201,21,21.04.2019 22:30,82,6,Zaporozhie
160,109,0,51,109,0,109,0,109,3,100,6,21.04.2019 20:30,82,6,Zaporozhie
448,385,0,63,385,0,385,0,385,50,289,46,22.04.2019 00:15,83,7,Ivano-Frankovsk
1920,1903,9,686,1228,6,1234,0,1234,39,498,697,22.04.2019 00:30,83,7,Ivano-Frankovsk
1920,1908,13,787,1124,9,1133,0,1133,48,527,558,22.04.2019 00:05,83,7,Ivano-Frankovsk
2032,2006,6,786,1241,5,1246,0,1245,52,551,642,21.04.2019 23:45,83,7,Ivano-Frankovsk
1744,1727,3,566,1176,2,1178,0,1177,37,546,594,22.04.2019 00:05,83,7,Ivano-Frankovsk
2144,2115,14,835,1300,9,1309,0,1309,46,537,726,22.04.2019 00:30,83,7,Ivano-Frankovsk
2048,2024,10,829,1212,7,1219,0,1219,41,550,628,22.04.2019 00:10,83,7,Ivano-Frankovsk
1760,1739,7,683,1072,5,1077,0,1077,34,462,581,22.04.2019 00:05,83,7,Ivano-Frankovsk
1744,1729,6,600,1140,4,1144,0,1144,60,463,621,22.04.2019 00:12,83,7,Ivano-Frankovsk
2144,2123,10,871,1265,8,1273,0,1273,35,615,623,22.04.2019 00:15,83,7,Ivano-Frankovsk
2096,2077,13,871,1215,10,1225,0,1225,52,560,613,22.04.2019 00:02,83,7,Ivano-Frankovsk
1152,1142,14,434,710,8,718,0,718,22,317,379,22.04.2019 00:10,83,7,Ivano-Frankovsk
2336,2313,17,988,1333,15,1348,0,1348,48,613,687,22.04.2019 00:07,83,7,Ivano-Frankovsk
2208,2188,14,830,1367,11,1378,0,1378,53,662,663,22.04.2019 03:45,83,7,Ivano-Frankovsk
2048,2036,12,778,1262,8,1270,0,1270,36,564,670,22.04.2019 00:15,83,7,Ivano-Frankovsk
1440,1415,15,600,829,11,840,0,840,41,375,424,22.04.2019 00:30,83,7,Ivano-Frankovsk
1584,1569,13,591,984,9,993,0,993,44,467,482,22.04.2019 00:25,83,7,Ivano-Frankovsk
1520,1489,2,621,897,2,899,0,899,29,501,369,22.04.2019 00:12,83,7,Ivano-Frankovsk
2032,1992,12,828,1193,11,1204,0,1204,46,574,584,22.04.2019 00:14,83,7,Ivano-Frankovsk
1376,1379,17,501,860,15,875,0,875,49,374,452,22.04.2019 00:05,83,7,Ivano-Frankovsk
2032,2013,11,710,1312,10,1322,0,1322,36,606,680,22.04.2019 00:03,83,7,Ivano-Frankovsk
2016,1991,25,800,1193,23,1216,0,1216,57,562,597,22.04.2019 00:10,83,7,Ivano-Frankovsk
736,737,8,282,447,7,454,0,454,13,213,228,22.04.2019 00:20,83,7,Ivano-Frankovsk
1936,1909,14,778,1148,10,1158,0,1158,37,492,629,22.04.2019 00:15,83,7,Ivano-Frankovsk
1584,1571,9,568,1010,6,1016,0,1016,21,467,528,22.04.2019 00:20,83,7,Ivano-Frankovsk
2384,2348,6,964,1416,4,1420,0,1420,48,644,728,22.04.2019 00:15,83,7,Ivano-Frankovsk
2448,2429,15,963,1472,13,1485,0,1485,65,649,771,22.04.2019 01:39,83,7,Ivano-Frankovsk
1808,1787,12,700,1098,10,1108,0,1108,37,482,589,22.04.2019 00:02,83,7,Ivano-Frankovsk
1696,1659,6,660,1031,5,1036,0,1036,38,445,553,22.04.2019 00:10,83,7,Ivano-Frankovsk
1136,1117,1,427,708,1,709,0,709,20,317,372,22.04.2019 02:40,83,7,Ivano-Frankovsk
2352,2310,10,982,1362,8,1370,0,1370,47,612,711,22.04.2019 00:10,83,7,Ivano-Frankovsk
2704,2673,4,1005,1698,1,1699,0,1699,53,743,903,21.04.2019 23:45,83,7,Ivano-Frankovsk
2288,2258,4,846,1439,3,1442,0,1442,53,647,742,22.04.2019 00:25,83,7,Ivano-Frankovsk
1136,1115,4,506,626,4,630,0,630,26,287,317,22.04.2019 00:15,83,7,Ivano-Frankovsk
2160,2148,8,843,1311,6,1317,0,1317,52,641,624,22.04.2019 00:18,83,7,Ivano-Frankovsk
2176,2146,9,829,1342,5,1347,0,1347,36,631,680,22.04.2019 00:09,83,7,Ivano-Frankovsk
2144,2122,12,886,1247,11,1258,0,1258,45,636,577,22.04.2019 00:10,83,7,Ivano-Frankovsk
2608,2587,8,1092,1510,6,1516,0,1516,48,751,717,22.04.2019 04:00,83,7,Ivano-Frankovsk
1520,1502,8,633,879,8,887,0,887,35,420,432,22.04.2019 00:29,83,7,Ivano-Frankovsk
2304,2279,12,877,1416,11,1427,0,1427,56,624,747,22.04.2019 00:05,83,7,Ivano-Frankovsk
2400,2380,7,986,1408,6,1414,0,1414,45,652,717,21.04.2019 23:41,83,7,Ivano-Frankovsk
2336,2300,9,910,1419,7,1426,0,1426,39,600,787,22.04.2019 00:05,83,7,Ivano-Frankovsk
2192,2182,10,843,1342,7,1349,0,1349,47,644,658,21.04.2019 23:20,83,7,Ivano-Frankovsk
1600,1567,10,633,960,7,967,0,967,40,434,493,22.04.2019 00:15,83,7,Ivano-Frankovsk
2192,2170,12,820,1364,8,1372,0,1372,40,617,715,22.04.2019 00:25,83,7,Ivano-Frankovsk
2432,2405,8,853,1572,7,1579,0,1579,64,685,830,21.04.2019 23:40,83,7,Ivano-Frankovsk
2144,2117,17,806,1326,12,1338,0,1337,45,607,685,22.04.2019 03:35,83,7,Ivano-Frankovsk
2416,2364,8,932,1476,8,1484,0,1483,42,652,789,22.04.2019 00:08,83,7,Ivano-Frankovsk
2144,2115,16,855,1274,15,1289,0,1289,45,591,653,22.04.2019 00:45,83,7,Ivano-Frankovsk
2384,2388,12,943,1433,8,1441,0,1441,66,606,769,22.04.2019 00:04,83,7,Ivano-Frankovsk
2080,2049,9,765,1308,7,1315,0,1315,44,579,692,22.04.2019 00:05,83,7,Ivano-Frankovsk
784,771,13,286,489,9,498,0,498,9,167,322,22.04.2019 00:20,83,7,Ivano-Frankovsk
2480,2460,30,916,1541,23,1564,0,1564,51,680,833,21.04.2019 23:52,83,7,Ivano-Frankovsk
1920,1900,18,631,1273,16,1289,0,1289,50,565,674,22.04.2019 00:05,83,7,Ivano-Frankovsk
1680,1681,16,572,1096,12,1108,0,1108,35,495,578,22.04.2019 00:01,83,7,Ivano-Frankovsk
2368,2350,21,857,1495,16,1511,0,1511,37,694,780,22.04.2019 00:09,83,7,Ivano-Frankovsk
1504,1519,13,536,960,8,968,0,968,40,454,474,22.04.2019 00:01,83,7,Ivano-Frankovsk
1408,1460,7,418,986,4,990,0,990,37,429,524,22.04.2019 00:02,83,7,Ivano-Frankovsk
2128,2113,21,742,1369,17,1386,0,1386,46,588,752,22.04.2019 01:51,83,7,Ivano-Frankovsk
1824,1796,5,699,1122,3,1125,0,1125,52,473,600,21.04.2019 23:34,83,7,Ivano-Frankovsk
1488,1476,10,586,894,8,902,0,902,39,367,496,22.04.2019 00:20,83,7,Ivano-Frankovsk
2400,2383,9,910,1484,6,1490,0,1489,56,762,671,22.04.2019 00:08,83,7,Ivano-Frankovsk
1856,1862,26,690,1145,21,1166,0,1166,51,504,611,22.04.2019 00:05,83,7,Ivano-Frankovsk
1280,1247,15,533,733,14,747,0,747,23,356,368,22.04.2019 00:20,83,7,Ivano-Frankovsk
2336,2257,12,958,1368,10,1378,0,1378,43,689,646,22.04.2019 00:00,83,7,Ivano-Frankovsk
1888,1862,9,814,1069,5,1074,0,1074,41,471,562,22.04.2019 00:08,83,7,Ivano-Frankovsk
1904,2076,9,573,1326,5,1331,0,1331,58,709,564,22.04.2019 00:05,83,7,Ivano-Frankovsk
2000,1971,12,858,1133,9,1142,0,1142,30,516,596,22.04.2019 00:20,83,7,Ivano-Frankovsk
2176,2147,16,921,1242,13,1255,0,1255,55,572,628,22.04.2019 00:35,83,7,Ivano-Frankovsk
1184,1168,13,484,689,11,700,0,700,25,321,354,22.04.2019 00:05,83,7,Ivano-Frankovsk
2176,2143,20,843,1317,16,1333,0,1333,54,569,710,22.04.2019 00:10,83,7,Ivano-Frankovsk
960,944,8,374,581,5,586,0,586,20,278,288,22.04.2019 00:02,83,7,Ivano-Frankovsk
1712,1712,14,670,1028,14,1042,0,1042,32,476,534,22.04.2019 00:05,83,7,Ivano-Frankovsk
2272,2228,18,959,1300,13,1313,0,1313,41,616,656,22.04.2019 00:30,83,7,Ivano-Frankovsk
2096,2085,17,770,1312,14,1326,0,1325,51,642,632,22.04.2019 04:20,83,7,Ivano-Frankovsk
2096,2094,24,784,1296,16,1312,0,1312,44,656,612,22.04.2019 00:08,83,7,Ivano-Frankovsk
1904,1876,4,678,1224,2,1226,0,1226,34,569,623,21.04.2019 23:15,83,7,Ivano-Frankovsk
1760,1698,3,720,1037,3,1040,0,1040,31,545,464,22.04.2019 00:10,83,7,Ivano-Frankovsk
2064,2020,15,916,1136,12,1148,0,1148,26,612,510,22.04.2019 00:11,83,7,Ivano-Frankovsk
2160,2114,7,892,1261,7,1268,0,1268,41,671,556,22.04.2019 00:35,83,7,Ivano-Frankovsk
1824,1804,3,920,901,3,904,0,904,23,467,414,22.04.2019 00:06,83,7,Ivano-Frankovsk
2288,2259,8,1009,1271,8,1279,0,1279,45,580,654,22.04.2019 00:10,83,7,Ivano-Frankovsk
2304,2243,10,1121,1174,9,1183,0,1183,40,660,483,22.04.2019 00:10,83,7,Ivano-Frankovsk
2320,2295,9,1126,1185,9,1194,0,1194,32,594,568,22.04.2019 00:07,83,7,Ivano-Frankovsk
176,160,53,30,100,46,146,0,146,3,59,84,22.04.2019 00:10,83,7,Ivano-Frankovsk
784,150,83,665,63,56,119,0,119,6,60,53,22.04.2019 00:25,83,7,Ivano-Frankovsk
192,29,7,167,18,7,25,0,25,0,15,10,22.04.2019 00:05,83,7,Ivano-Frankovsk
320,41,15,282,26,12,38,0,38,0,21,17,21.04.2019 20:15,83,7,Ivano-Frankovsk
432,49,0,389,43,0,43,0,43,3,23,17,21.04.2019 23:10,83,7,Ivano-Frankovsk
256,63,39,195,24,37,61,0,61,0,37,24,21.04.2019 23:46,83,7,Ivano-Frankovsk
384,106,23,288,73,23,96,0,96,5,55,36,21.04.2019 23:00,83,7,Ivano-Frankovsk
256,40,30,229,5,22,27,0,27,2,13,12,22.04.2019 00:27,83,7,Ivano-Frankovsk
240,63,5,192,43,5,48,0,48,0,27,21,22.04.2019 00:15,83,7,Ivano-Frankovsk
224,107,8,161,55,8,63,0,63,2,44,17,22.04.2019 00:05,83,7,Ivano-Frankovsk
496,291,82,291,147,58,205,0,205,13,93,99,22.04.2019 00:05,83,7,Ivano-Frankovsk
224,45,13,182,31,11,42,0,42,4,13,25,22.04.2019 00:17,83,7,Ivano-Frankovsk
96,1,0,95,1,0,1,0,1,0,0,1,22.04.2019 00:15,83,7,Ivano-Frankovsk
288,21,0,267,21,0,21,0,21,2,6,13,21.04.2019 23:00,83,7,Ivano-Frankovsk
128,22,13,115,9,4,13,0,13,0,6,7,22.04.2019 00:05,83,7,Ivano-Frankovsk
1072,1042,11,419,643,10,653,0,653,15,308,330,22.04.2019 00:09,83,7,Ivano-Frankovsk
1824,1811,4,657,1163,4,1167,0,1167,45,508,614,22.04.2019 00:25,83,7,Ivano-Frankovsk
1216,1204,2,425,791,0,791,0,791,22,368,401,22.04.2019 00:30,83,7,Ivano-Frankovsk
1904,1877,34,779,1096,29,1125,0,1125,49,589,487,21.04.2019 21:45,84,7,Ivano-Frankovsk
1152,1142,19,532,602,18,620,0,620,27,335,258,22.04.2019 01:10,84,7,Ivano-Frankovsk
1664,1657,19,650,995,19,1014,0,1014,50,560,404,22.04.2019 00:15,84,7,Ivano-Frankovsk
1920,1891,10,752,1158,10,1168,0,1168,35,669,464,22.04.2019 00:17,84,7,Ivano-Frankovsk
1776,1752,6,711,1060,5,1065,0,1065,32,619,414,22.04.2019 00:25,84,7,Ivano-Frankovsk
1712,1689,3,740,969,3,972,0,972,36,569,367,21.04.2019 22:40,84,7,Ivano-Frankovsk
1504,1475,6,650,848,6,854,0,854,38,526,290,22.04.2019 00:45,84,7,Ivano-Frankovsk
1424,1394,7,644,773,7,780,0,780,26,478,276,21.04.2019 23:15,84,7,Ivano-Frankovsk
672,658,5,292,376,4,380,0,380,15,192,173,21.04.2019 23:15,84,7,Ivano-Frankovsk
688,678,3,299,386,3,389,0,389,17,222,150,22.04.2019 00:05,84,7,Ivano-Frankovsk
272,274,7,77,188,7,195,0,195,2,92,101,21.04.2019 20:55,84,7,Ivano-Frankovsk
1616,1635,70,659,894,63,957,0,957,26,506,425,22.04.2019 00:30,84,7,Ivano-Frankovsk
480,462,27,168,285,27,312,0,312,9,150,153,21.04.2019 23:58,84,7,Ivano-Frankovsk
192,191,6,55,131,6,137,0,137,7,55,75,21.04.2019 20:53,84,7,Ivano-Frankovsk
128,129,7,23,98,7,105,0,105,1,49,55,21.04.2019 20:20,84,7,Ivano-Frankovsk
112,111,7,13,93,6,99,0,99,5,53,41,21.04.2019 20:30,84,7,Ivano-Frankovsk
160,146,5,69,86,5,91,0,91,6,45,40,21.04.2019 20:50,84,7,Ivano-Frankovsk
1056,1032,41,352,664,40,704,0,704,24,375,305,21.04.2019 22:25,84,7,Ivano-Frankovsk
288,286,36,102,151,35,186,0,186,0,83,103,22.04.2019 00:05,84,7,Ivano-Frankovsk
176,183,5,50,121,5,126,0,126,3,29,94,22.04.2019 00:40,84,7,Ivano-Frankovsk
256,249,13,96,147,13,160,0,160,2,98,60,22.04.2019 00:02,84,7,Ivano-Frankovsk
384,372,25,163,197,24,221,0,221,6,124,91,22.04.2019 01:05,84,7,Ivano-Frankovsk
256,241,13,61,185,10,195,0,195,9,124,62,21.04.2019 21:20,84,7,Ivano-Frankovsk
224,207,15,89,120,15,135,0,135,1,102,32,22.04.2019 00:10,84,7,Ivano-Frankovsk
1392,1380,49,442,903,47,950,0,949,27,536,386,22.04.2019 07:50,84,7,Ivano-Frankovsk
304,304,13,117,175,12,187,0,187,3,103,81,21.04.2019 22:00,84,7,Ivano-Frankovsk
272,268,25,40,207,25,232,0,232,2,83,147,21.04.2019 21:30,84,7,Ivano-Frankovsk
48,42,1,10,37,1,38,0,38,2,12,24,21.04.2019 20:33,84,7,Ivano-Frankovsk
544,531,29,221,295,28,323,0,323,5,174,144,22.04.2019 00:10,84,7,Ivano-Frankovsk
480,467,24,78,378,24,402,0,402,2,220,180,22.04.2019 00:15,84,7,Ivano-Frankovsk
1472,1463,79,532,872,68,940,0,940,18,454,468,22.04.2019 06:30,84,7,Ivano-Frankovsk
464,452,38,138,292,34,326,0,326,8,137,181,22.04.2019 00:15,84,7,Ivano-Frankovsk
960,947,18,346,597,17,614,0,614,23,339,252,22.04.2019 00:10,84,7,Ivano-Frankovsk
1776,1768,42,652,1084,40,1124,0,1124,34,530,560,21.04.2019 21:15,84,7,Ivano-Frankovsk
112,110,5,32,75,5,80,0,80,1,35,44,21.04.2019 20:45,84,7,Ivano-Frankovsk
816,793,50,279,490,47,537,0,537,13,307,217,22.04.2019 00:15,84,7,Ivano-Frankovsk
352,338,37,148,173,31,204,0,204,1,83,120,21.04.2019 21:06,84,7,Ivano-Frankovsk
96,87,4,60,35,1,36,0,36,0,16,20,22.04.2019 00:15,84,7,Ivano-Frankovsk
352,339,21,103,228,21,249,0,249,5,148,96,22.04.2019 03:05,84,7,Ivano-Frankovsk
272,266,18,49,205,18,223,0,223,7,117,99,21.04.2019 23:30,84,7,Ivano-Frankovsk
336,324,37,121,179,36,215,0,215,5,131,79,21.04.2019 21:00,84,7,Ivano-Frankovsk
352,350,26,47,279,26,305,0,305,7,182,116,22.04.2019 00:15,84,7,Ivano-Frankovsk
224,202,14,37,174,13,187,0,187,3,105,79,22.04.2019 01:10,84,7,Ivano-Frankovsk
384,376,28,141,216,27,243,0,243,3,115,125,21.04.2019 23:05,84,7,Ivano-Frankovsk
640,630,30,278,332,30,362,0,362,3,160,199,22.04.2019 00:10,84,7,Ivano-Frankovsk
384,382,20,97,267,20,287,0,287,6,176,105,21.04.2019 22:30,84,7,Ivano-Frankovsk
320,312,22,110,188,22,210,0,210,7,90,113,21.04.2019 22:35,84,7,Ivano-Frankovsk
464,454,11,35,418,11,429,0,429,64,72,293,22.04.2019 05:30,84,7,Ivano-Frankovsk
400,395,27,79,296,25,321,0,321,0,171,150,22.04.2019 01:00,84,7,Ivano-Frankovsk
640,634,34,140,466,34,500,0,500,13,370,117,21.04.2019 21:44,84,7,Ivano-Frankovsk
144,146,11,21,113,10,123,0,123,5,52,66,21.04.2019 23:45,84,7,Ivano-Frankovsk
400,387,46,101,258,41,299,0,299,7,137,155,21.04.2019 22:00,84,7,Ivano-Frankovsk
240,237,15,50,177,13,190,0,190,0,100,90,22.04.2019 00:10,84,7,Ivano-Frankovsk
320,316,0,148,172,0,172,0,172,6,122,44,21.04.2019 22:40,84,7,Ivano-Frankovsk
336,329,13,127,196,13,209,0,209,7,138,64,21.04.2019 22:00,84,7,Ivano-Frankovsk
80,67,8,27,45,8,53,0,53,1,26,26,21.04.2019 21:55,84,7,Ivano-Frankovsk
96,95,9,17,70,9,79,0,79,2,27,50,21.04.2019 21:30,84,7,Ivano-Frankovsk
64,54,7,18,39,7,46,0,46,1,21,24,21.04.2019 23:30,84,7,Ivano-Frankovsk
240,235,19,54,167,19,186,0,186,3,99,84,22.04.2019 04:30,84,7,Ivano-Frankovsk
352,341,19,134,199,19,218,0,218,10,131,77,21.04.2019 23:15,84,7,Ivano-Frankovsk
144,136,14,49,81,14,95,0,95,2,53,40,21.04.2019 21:30,84,7,Ivano-Frankovsk
288,282,16,52,220,16,236,0,236,1,92,143,21.04.2019 21:00,84,7,Ivano-Frankovsk
384,371,30,69,285,30,315,0,315,2,143,170,21.04.2019 21:30,84,7,Ivano-Frankovsk
480,472,37,119,324,37,361,0,361,8,75,278,21.04.2019 21:05,84,7,Ivano-Frankovsk
1008,992,49,331,628,49,677,0,677,13,294,370,21.04.2019 23:45,84,7,Ivano-Frankovsk
336,326,19,87,232,17,249,0,249,7,108,134,22.04.2019 00:20,84,7,Ivano-Frankovsk
176,32,8,148,20,8,28,0,28,1,15,12,22.04.2019 00:10,84,7,Ivano-Frankovsk
160,18,5,142,13,5,18,0,18,0,12,6,22.04.2019 00:10,84,7,Ivano-Frankovsk
1472,1453,10,660,803,9,812,0,812,31,410,371,22.04.2019 00:15,84,7,Ivano-Frankovsk
928,917,7,442,479,7,486,0,486,21,223,242,22.04.2019 00:13,84,7,Ivano-Frankovsk
1792,1765,6,783,1003,6,1009,0,1009,32,489,487,22.04.2019 02:10,84,7,Ivano-Frankovsk
1760,1732,3,819,939,2,941,0,941,38,498,405,22.04.2019 00:22,84,7,Ivano-Frankovsk
736,716,2,285,449,2,451,0,451,4,268,179,21.04.2019 21:10,84,7,Ivano-Frankovsk
976,973,20,333,623,20,643,0,643,32,312,299,21.04.2019 22:00,84,7,Ivano-Frankovsk
2208,2176,60,839,1310,59,1369,0,1369,40,602,727,22.04.2019 00:04,84,7,Ivano-Frankovsk
1056,1042,13,300,743,13,756,0,756,25,389,342,21.04.2019 21:40,84,7,Ivano-Frankovsk
1808,1777,43,564,1201,43,1244,0,1244,14,478,752,22.04.2019 00:25,84,7,Ivano-Frankovsk
1184,1176,34,323,828,33,861,0,861,13,442,406,22.04.2019 00:15,84,7,Ivano-Frankovsk
928,908,34,316,579,33,612,0,612,16,319,277,22.04.2019 00:10,84,7,Ivano-Frankovsk
160,147,11,54,96,10,106,0,106,2,24,80,22.04.2019 00:10,84,7,Ivano-Frankovsk
448,443,45,143,260,45,305,0,305,3,106,196,21.04.2019 21:50,84,7,Ivano-Frankovsk
1472,1460,22,582,869,21,890,0,890,23,388,479,22.04.2019 00:05,84,7,Ivano-Frankovsk
1584,1569,43,639,902,43,945,0,945,16,462,467,22.04.2019 00:02,84,7,Ivano-Frankovsk
1488,1472,37,638,816,34,850,0,850,21,451,378,22.04.2019 00:30,84,7,Ivano-Frankovsk
1072,1062,21,148,903,21,924,0,924,17,365,542,22.04.2019 00:10,84,7,Ivano-Frankovsk
1200,1178,5,498,697,5,702,0,702,19,292,391,22.04.2019 00:12,84,7,Ivano-Frankovsk
512,502,27,136,349,27,376,0,376,8,172,196,22.04.2019 00:10,84,7,Ivano-Frankovsk
400,392,27,152,222,26,248,0,248,6,82,160,22.04.2019 00:10,84,7,Ivano-Frankovsk
1712,1694,41,732,939,41,980,0,980,33,551,396,22.04.2019 00:15,84,7,Ivano-Frankovsk
832,802,44,303,487,42,529,0,529,20,270,239,21.04.2019 22:00,84,7,Ivano-Frankovsk
128,116,6,53,70,5,75,0,75,1,34,40,22.04.2019 00:15,84,7,Ivano-Frankovsk
752,736,38,321,394,37,431,0,431,23,193,215,22.04.2019 00:15,84,7,Ivano-Frankovsk
464,453,10,193,261,10,271,0,271,4,140,127,22.04.2019 00:20,84,7,Ivano-Frankovsk
768,761,36,165,567,36,603,0,603,18,198,387,22.04.2019 00:20,84,7,Ivano-Frankovsk
736,730,25,250,461,25,486,0,486,12,310,164,22.04.2019 00:05,84,7,Ivano-Frankovsk
240,233,12,73,155,12,167,0,167,4,85,78,22.04.2019 00:20,84,7,Ivano-Frankovsk
1872,1849,55,771,1046,55,1101,0,1101,40,583,478,21.04.2019 21:00,84,7,Ivano-Frankovsk
1408,1396,40,496,872,40,912,0,912,25,383,504,22.04.2019 00:15,84,7,Ivano-Frankovsk
2016,1987,55,630,1331,55,1386,0,1386,105,449,832,21.04.2019 23:00,84,7,Ivano-Frankovsk
1456,1431,86,615,760,81,841,0,841,17,351,473,21.04.2019 22:15,84,7,Ivano-Frankovsk
112,108,0,34,78,0,78,0,78,0,30,48,22.04.2019 00:03,84,7,Ivano-Frankovsk
1056,1047,47,396,613,47,660,0,660,10,361,289,22.04.2019 00:05,84,7,Ivano-Frankovsk
2448,2417,92,834,1527,87,1614,0,1614,48,852,714,21.04.2019 23:55,84,7,Ivano-Frankovsk
224,219,8,58,158,8,166,0,166,4,75,87,22.04.2019 00:01,84,7,Ivano-Frankovsk
608,597,55,246,307,55,362,0,362,8,151,203,21.04.2019 21:30,84,7,Ivano-Frankovsk
992,971,12,186,794,12,806,0,806,14,339,453,21.04.2019 21:22,84,7,Ivano-Frankovsk
960,941,33,352,575,33,608,0,608,11,207,390,22.04.2019 00:20,84,7,Ivano-Frankovsk
1632,1608,33,714,885,33,918,0,918,20,464,434,22.04.2019 00:11,84,7,Ivano-Frankovsk
816,797,24,347,448,21,469,0,469,16,232,221,22.04.2019 01:45,84,7,Ivano-Frankovsk
864,863,4,319,543,2,545,0,545,20,312,213,22.04.2019 00:10,84,7,Ivano-Frankovsk
2288,2238,35,1026,1229,33,1262,0,1262,39,702,521,22.04.2019 00:10,84,7,Ivano-Frankovsk
624,618,21,202,406,16,422,0,422,8,242,172,22.04.2019 00:33,84,7,Ivano-Frankovsk
656,648,40,176,440,40,480,0,480,5,174,301,21.04.2019 21:15,84,7,Ivano-Frankovsk
896,884,40,246,610,40,650,0,650,12,242,396,22.04.2019 00:10,84,7,Ivano-Frankovsk
2144,2110,52,570,1523,51,1574,0,1574,39,494,1041,21.04.2019 23:20,84,7,Ivano-Frankovsk
640,624,45,262,335,43,378,0,378,21,176,181,22.04.2019 01:15,84,7,Ivano-Frankovsk
704,699,10,290,404,10,414,0,414,8,196,210,22.04.2019 00:50,84,7,Ivano-Frankovsk
1392,1376,30,521,844,27,871,0,871,18,405,448,22.04.2019 04:33,84,7,Ivano-Frankovsk
1760,1760,51,711,999,50,1049,0,1049,30,522,497,22.04.2019 00:25,84,7,Ivano-Frankovsk
2288,2273,56,977,1255,56,1311,0,1311,17,564,730,22.04.2019 00:10,84,7,Ivano-Frankovsk
1456,1468,24,486,946,24,970,0,970,28,499,443,22.04.2019 00:05,84,7,Ivano-Frankovsk
1104,1085,51,304,749,51,800,0,800,20,319,461,22.04.2019 00:05,84,7,Ivano-Frankovsk
1472,1457,45,476,953,43,996,0,996,22,342,632,22.04.2019 00:05,84,7,Ivano-Frankovsk
80,26,3,58,19,3,22,0,22,2,12,8,21.04.2019 20:20,84,7,Ivano-Frankovsk
192,24,2,170,20,2,22,0,22,0,9,13,22.04.2019 00:15,84,7,Ivano-Frankovsk
1504,1483,10,704,790,10,800,0,800,33,472,295,22.04.2019 00:25,84,7,Ivano-Frankovsk
1648,1629,5,819,824,5,829,0,829,23,505,301,21.04.2019 23:15,84,7,Ivano-Frankovsk
1616,1598,8,721,889,6,895,0,895,26,541,328,21.04.2019 23:50,84,7,Ivano-Frankovsk
1248,1230,73,649,539,60,599,0,599,19,350,230,22.04.2019 00:22,84,7,Ivano-Frankovsk
368,364,21,119,228,21,249,0,249,5,110,134,21.04.2019 23:05,84,7,Ivano-Frankovsk
784,757,40,303,443,38,481,0,481,12,293,176,22.04.2019 00:15,84,7,Ivano-Frankovsk
688,665,49,214,425,49,474,0,474,12,256,206,22.04.2019 00:05,84,7,Ivano-Frankovsk
672,669,104,292,278,102,380,0,380,3,203,174,22.04.2019 00:20,84,7,Ivano-Frankovsk
224,207,34,86,104,34,138,0,138,9,78,51,22.04.2019 04:10,84,7,Ivano-Frankovsk
592,576,44,241,309,42,351,0,351,8,204,139,22.04.2019 00:55,84,7,Ivano-Frankovsk
432,418,10,169,253,10,263,0,263,19,134,110,22.04.2019 00:30,84,7,Ivano-Frankovsk
944,936,30,462,452,30,482,0,482,16,331,135,22.04.2019 00:45,84,7,Ivano-Frankovsk
720,713,30,317,374,29,403,0,403,6,212,185,21.04.2019 23:30,84,7,Ivano-Frankovsk
848,838,33,421,396,31,427,0,427,8,237,182,22.04.2019 00:10,84,7,Ivano-Frankovsk
1216,1202,142,328,746,142,888,0,888,12,363,513,22.04.2019 00:30,84,7,Ivano-Frankovsk
1296,1273,71,667,563,66,629,0,629,15,264,350,22.04.2019 00:33,84,7,Ivano-Frankovsk
400,384,51,145,206,49,255,0,255,1,144,110,22.04.2019 00:20,84,7,Ivano-Frankovsk
784,764,26,414,346,24,370,0,370,13,186,171,22.04.2019 01:05,84,7,Ivano-Frankovsk
1008,1009,74,432,506,70,576,0,576,10,366,200,21.04.2019 22:00,84,7,Ivano-Frankovsk
192,178,10,73,109,10,119,0,119,1,85,33,21.04.2019 22:30,84,7,Ivano-Frankovsk
608,597,30,195,383,30,413,0,413,7,166,240,22.04.2019 00:15,84,7,Ivano-Frankovsk
672,664,52,241,381,50,431,0,431,6,264,161,22.04.2019 00:05,84,7,Ivano-Frankovsk
1040,1024,27,241,772,27,799,0,799,10,474,315,22.04.2019 00:15,84,7,Ivano-Frankovsk
1024,1010,105,480,443,101,544,0,544,14,331,199,22.04.2019 00:05,84,7,Ivano-Frankovsk
752,739,50,373,332,47,379,0,379,13,202,164,22.04.2019 00:30,84,7,Ivano-Frankovsk
1616,1606,66,694,874,48,922,0,922,23,628,271,22.04.2019 00:15,84,7,Ivano-Frankovsk
384,378,39,130,215,39,254,0,254,10,105,139,22.04.2019 00:45,84,7,Ivano-Frankovsk
688,670,55,292,344,52,396,0,396,12,217,167,22.04.2019 00:15,84,7,Ivano-Frankovsk
464,471,35,160,269,35,304,0,304,10,141,153,21.04.2019 21:20,84,7,Ivano-Frankovsk
192,180,12,49,131,12,143,0,143,3,51,89,22.04.2019 00:02,84,7,Ivano-Frankovsk
192,188,17,100,75,17,92,0,92,0,48,44,22.04.2019 00:20,84,7,Ivano-Frankovsk
624,604,43,244,337,43,380,0,380,8,188,184,22.04.2019 00:40,84,7,Ivano-Frankovsk
880,859,47,330,509,41,550,0,550,9,346,195,22.04.2019 00:35,84,7,Ivano-Frankovsk
464,443,12,213,242,9,251,0,251,6,198,47,22.04.2019 00:10,84,7,Ivano-Frankovsk
192,188,12,56,124,12,136,0,136,7,87,42,22.04.2019 00:55,84,7,Ivano-Frankovsk
368,362,27,136,209,23,232,0,232,6,142,84,22.04.2019 00:10,84,7,Ivano-Frankovsk
528,515,59,153,321,54,375,0,375,10,141,224,21.04.2019 23:55,84,7,Ivano-Frankovsk
80,76,8,27,45,8,53,0,53,1,24,28,22.04.2019 00:35,84,7,Ivano-Frankovsk
192,180,22,73,97,22,119,0,119,3,82,34,22.04.2019 00:15,84,7,Ivano-Frankovsk
592,576,79,213,305,74,379,0,379,8,185,186,21.04.2019 21:40,84,7,Ivano-Frankovsk
384,371,12,158,214,12,226,0,226,11,127,88,22.04.2019 00:15,84,7,Ivano-Frankovsk
528,511,28,213,288,27,315,0,315,17,116,182,22.04.2019 00:05,84,7,Ivano-Frankovsk
720,704,28,405,287,28,315,0,315,5,198,112,21.04.2019 22:31,84,7,Ivano-Frankovsk
560,555,53,243,265,52,317,0,317,4,129,184,22.04.2019 00:15,84,7,Ivano-Frankovsk
256,262,22,114,120,22,142,0,142,4,89,49,22.04.2019 00:05,84,7,Ivano-Frankovsk
512,498,46,218,250,44,294,0,294,5,182,107,21.04.2019 22:50,84,7,Ivano-Frankovsk
272,254,14,100,160,12,172,0,172,8,84,80,22.04.2019 00:12,84,7,Ivano-Frankovsk
1024,1003,53,455,516,53,569,0,569,12,293,264,22.04.2019 00:15,84,7,Ivano-Frankovsk
224,91,36,139,54,31,85,0,85,4,47,34,22.04.2019 00:15,84,7,Ivano-Frankovsk
2192,2172,6,865,1323,4,1327,0,1327,30,609,688,21.04.2019 21:15,84,7,Ivano-Frankovsk
2321,2281,5,894,1422,5,1427,0,1427,34,634,759,22.04.2019 00:53,84,7,Ivano-Frankovsk
2304,2272,28,900,1382,22,1404,0,1404,44,571,789,22.04.2019 00:05,84,7,Ivano-Frankovsk
928,915,7,429,492,7,499,0,499,14,233,252,22.04.2019 00:20,84,7,Ivano-Frankovsk
2400,2352,10,971,1421,8,1429,0,1429,37,504,888,21.04.2019 21:31,84,7,Ivano-Frankovsk
1536,1521,28,630,878,28,906,0,906,38,357,511,22.04.2019 00:40,84,7,Ivano-Frankovsk
1872,1856,5,705,1164,3,1167,0,1167,37,524,606,22.04.2019 00:23,84,7,Ivano-Frankovsk
592,574,3,243,347,2,349,0,349,11,115,223,21.04.2019 22:29,84,7,Ivano-Frankovsk
448,441,9,141,300,7,307,0,307,7,141,159,22.04.2019 01:30,84,7,Ivano-Frankovsk
560,545,21,171,368,21,389,0,389,5,186,198,22.04.2019 00:35,85,7,Ivano-Frankovsk
336,329,19,107,210,19,229,0,229,2,106,121,22.04.2019 00:10,85,7,Ivano-Frankovsk
880,858,31,259,592,29,621,0,621,27,230,364,22.04.2019 00:45,85,7,Ivano-Frankovsk
560,555,19,145,398,17,415,0,415,9,218,188,22.04.2019 00:30,85,7,Ivano-Frankovsk
1408,1377,18,529,865,14,879,0,879,40,443,396,21.04.2019 23:59,85,7,Ivano-Frankovsk
1248,1227,47,430,773,45,818,0,818,15,243,560,22.04.2019 00:50,85,7,Ivano-Frankovsk
1200,1191,44,284,873,43,916,0,916,24,523,369,22.04.2019 00:20,85,7,Ivano-Frankovsk
336,322,8,133,195,8,203,0,203,5,157,41,22.04.2019 00:15,85,7,Ivano-Frankovsk
1936,1915,40,821,1078,37,1115,0,1115,18,558,539,22.04.2019 00:12,85,7,Ivano-Frankovsk
1920,1893,71,806,1049,65,1114,0,1114,46,637,431,22.04.2019 00:35,85,7,Ivano-Frankovsk
944,929,44,337,565,42,607,0,607,11,320,276,22.04.2019 00:35,85,7,Ivano-Frankovsk
160,149,15,31,114,15,129,0,129,6,43,80,22.04.2019 00:05,85,7,Ivano-Frankovsk
1904,1864,89,801,1016,87,1103,0,1103,21,700,382,22.04.2019 01:30,85,7,Ivano-Frankovsk
592,576,48,240,312,40,352,0,352,5,208,139,22.04.2019 00:30,85,7,Ivano-Frankovsk
352,335,19,171,164,17,181,0,181,8,135,38,22.04.2019 00:45,85,7,Ivano-Frankovsk
336,325,30,125,183,28,211,0,211,3,135,73,22.04.2019 00:28,85,7,Ivano-Frankovsk
1952,1926,74,944,938,70,1008,0,1008,7,621,380,22.04.2019 00:10,85,7,Ivano-Frankovsk
2128,2102,53,977,1099,52,1151,0,1151,26,657,468,22.04.2019 00:50,85,7,Ivano-Frankovsk
1152,1140,48,393,713,46,759,0,759,16,456,287,22.04.2019 00:15,85,7,Ivano-Frankovsk
992,973,46,453,495,44,539,0,539,16,315,208,22.04.2019 00:30,85,7,Ivano-Frankovsk
1312,1290,85,599,630,83,713,0,713,19,457,237,22.04.2019 00:15,85,7,Ivano-Frankovsk
336,330,29,103,204,29,233,0,233,4,131,98,22.04.2019 00:10,85,7,Ivano-Frankovsk
1440,1410,40,290,1113,37,1150,0,1150,20,683,447,22.04.2019 00:55,85,7,Ivano-Frankovsk
656,634,53,152,451,53,504,0,504,13,233,258,22.04.2019 00:20,85,7,Ivano-Frankovsk
1072,1062,37,505,530,37,567,0,567,10,334,223,22.04.2019 00:20,85,7,Ivano-Frankovsk
224,215,7,54,163,7,170,0,170,3,114,53,22.04.2019 01:00,85,7,Ivano-Frankovsk
944,933,50,222,672,50,722,0,722,9,269,444,22.04.2019 00:03,85,7,Ivano-Frankovsk
1504,1483,40,661,804,39,843,0,843,21,482,340,22.04.2019 01:38,85,7,Ivano-Frankovsk
1616,1589,78,625,913,78,991,0,991,32,528,431,22.04.2019 00:10,85,7,Ivano-Frankovsk
336,324,19,88,229,19,248,0,248,2,201,45,22.04.2019 00:20,85,7,Ivano-Frankovsk
112,103,10,42,60,10,70,0,70,2,30,38,22.04.2019 00:12,85,7,Ivano-Frankovsk
288,277,27,80,183,25,208,0,208,6,121,81,22.04.2019 00:15,85,7,Ivano-Frankovsk
752,733,20,249,484,19,503,0,503,7,212,284,22.04.2019 01:25,85,7,Ivano-Frankovsk
912,893,36,344,533,35,568,0,568,19,368,181,22.04.2019 00:25,85,7,Ivano-Frankovsk
400,394,16,120,266,14,280,0,280,3,178,99,22.04.2019 00:20,85,7,Ivano-Frankovsk
1472,1462,44,553,875,44,919,0,919,30,603,286,22.04.2019 01:50,85,7,Ivano-Frankovsk
1376,1361,48,613,716,47,763,0,763,25,460,278,22.04.2019 01:54,85,7,Ivano-Frankovsk
768,756,67,308,396,64,460,0,460,20,276,164,22.04.2019 00:20,85,7,Ivano-Frankovsk
368,359,18,84,266,18,284,0,284,4,168,112,22.04.2019 01:32,85,7,Ivano-Frankovsk
160,150,13,57,90,13,103,0,103,3,65,35,22.04.2019 00:10,85,7,Ivano-Frankovsk
448,439,32,164,254,30,284,0,284,6,177,101,22.04.2019 00:10,85,7,Ivano-Frankovsk
2192,2149,78,768,1354,70,1424,0,1424,34,803,587,22.04.2019 00:10,85,7,Ivano-Frankovsk
752,737,53,206,493,53,546,0,546,14,317,215,22.04.2019 00:15,85,7,Ivano-Frankovsk
1664,1649,32,658,974,32,1006,0,1006,31,447,528,22.04.2019 00:30,85,7,Ivano-Frankovsk
688,672,26,278,386,24,410,0,410,12,190,208,22.04.2019 00:35,85,7,Ivano-Frankovsk
528,512,22,206,300,22,322,0,322,6,212,104,22.04.2019 00:03,85,7,Ivano-Frankovsk
608,591,43,178,387,43,430,0,430,4,272,154,22.04.2019 00:10,85,7,Ivano-Frankovsk
288,274,21,86,181,21,202,0,202,2,144,56,22.04.2019 00:06,85,7,Ivano-Frankovsk
528,517,20,188,320,20,340,0,340,8,129,203,22.04.2019 00:30,85,7,Ivano-Frankovsk
768,755,24,294,450,24,474,0,474,10,282,182,22.04.2019 00:55,85,7,Ivano-Frankovsk
368,358,24,168,177,23,200,0,200,3,104,93,22.04.2019 00:12,85,7,Ivano-Frankovsk
160,146,11,72,77,11,88,0,88,1,50,37,22.04.2019 00:25,85,7,Ivano-Frankovsk
224,215,19,104,101,19,120,0,120,3,59,58,22.04.2019 00:30,85,7,Ivano-Frankovsk
1248,1226,56,319,873,56,929,0,929,16,553,360,22.04.2019 00:05,85,7,Ivano-Frankovsk
992,971,63,434,495,63,558,0,558,14,260,284,22.04.2019 01:01,85,7,Ivano-Frankovsk
1312,1286,39,528,745,39,784,0,784,13,442,329,22.04.2019 00:17,85,7,Ivano-Frankovsk
384,375,10,116,258,10,268,0,268,9,143,116,22.04.2019 00:15,85,7,Ivano-Frankovsk
928,917,65,405,461,62,523,0,523,12,329,182,22.04.2019 00:10,85,7,Ivano-Frankovsk
544,538,28,196,320,28,348,0,348,7,197,144,21.04.2019 21:09,85,7,Ivano-Frankovsk
1392,1382,49,583,764,45,809,0,809,26,444,339,22.04.2019 00:13,85,7,Ivano-Frankovsk
96,21,1,77,18,1,19,0,19,0,10,9,22.04.2019 00:10,85,7,Ivano-Frankovsk
432,419,13,167,252,13,265,0,265,8,153,104,22.04.2019 02:00,85,7,Ivano-Frankovsk
2208,2174,18,949,1245,14,1259,0,1259,42,682,535,22.04.2019 00:35,85,7,Ivano-Frankovsk
2352,2327,13,967,1372,13,1385,0,1385,39,728,618,22.04.2019 01:55,85,7,Ivano-Frankovsk
1264,1239,34,480,753,31,784,0,784,20,480,284,22.04.2019 00:20,85,7,Ivano-Frankovsk
1200,1181,55,535,611,54,665,0,665,27,386,252,22.04.2019 00:06,85,7,Ivano-Frankovsk
144,128,13,37,94,13,107,0,107,2,47,58,22.04.2019 00:40,85,7,Ivano-Frankovsk
768,759,40,166,562,40,602,0,602,15,393,194,22.04.2019 00:20,85,7,Ivano-Frankovsk
528,513,46,164,319,45,364,0,364,9,154,201,22.04.2019 00:40,85,7,Ivano-Frankovsk
128,114,16,56,56,16,72,0,72,2,31,39,22.04.2019 00:15,85,7,Ivano-Frankovsk
544,527,13,198,333,13,346,0,346,9,216,121,22.04.2019 00:21,85,7,Ivano-Frankovsk
720,705,15,256,449,15,464,0,464,12,288,164,22.04.2019 00:15,85,7,Ivano-Frankovsk
1040,1015,86,393,561,86,647,0,647,18,411,218,22.04.2019 00:15,85,7,Ivano-Frankovsk
80,73,6,28,46,6,52,0,52,2,35,15,22.04.2019 00:15,85,7,Ivano-Frankovsk
192,190,21,67,105,20,125,0,125,6,68,51,22.04.2019 00:30,85,7,Ivano-Frankovsk
144,142,10,48,86,10,96,0,96,1,69,26,22.04.2019 00:10,85,7,Ivano-Frankovsk
208,207,15,71,122,15,137,0,137,2,96,39,22.04.2019 00:10,85,7,Ivano-Frankovsk
128,123,9,46,73,9,82,0,82,1,26,55,22.04.2019 00:10,85,7,Ivano-Frankovsk
144,131,10,47,88,9,97,0,97,0,31,66,22.04.2019 02:18,85,7,Ivano-Frankovsk
80,67,12,27,41,12,53,0,53,0,22,31,22.04.2019 00:08,85,7,Ivano-Frankovsk
288,283,38,99,156,33,189,0,189,9,96,84,22.04.2019 00:38,85,7,Ivano-Frankovsk
96,94,1,11,84,1,85,0,85,1,53,31,22.04.2019 00:20,85,7,Ivano-Frankovsk
560,557,8,82,470,8,478,0,478,16,164,298,22.04.2019 00:10,85,7,Ivano-Frankovsk
128,125,2,40,86,2,88,0,88,2,22,64,22.04.2019 00:20,85,7,Ivano-Frankovsk
304,292,19,67,219,18,237,0,237,5,143,89,22.04.2019 01:39,85,7,Ivano-Frankovsk
496,488,26,173,298,25,323,0,323,12,168,143,22.04.2019 03:00,85,7,Ivano-Frankovsk
304,299,39,111,158,35,193,0,193,3,86,104,22.04.2019 00:18,85,7,Ivano-Frankovsk
192,178,12,46,134,12,146,0,146,8,50,88,22.04.2019 04:40,85,7,Ivano-Frankovsk
288,276,18,57,216,15,231,0,231,2,88,141,22.04.2019 00:20,85,7,Ivano-Frankovsk
160,155,12,44,104,12,116,0,116,3,52,61,22.04.2019 00:12,85,7,Ivano-Frankovsk
192,174,12,72,108,12,120,0,120,5,45,70,22.04.2019 00:30,85,7,Ivano-Frankovsk
496,484,42,79,375,42,417,0,417,18,190,209,22.04.2019 00:15,85,7,Ivano-Frankovsk
496,485,41,168,287,41,328,0,328,4,176,148,22.04.2019 00:43,85,7,Ivano-Frankovsk
608,600,68,97,444,67,511,0,511,13,226,272,22.04.2019 00:05,85,7,Ivano-Frankovsk
432,424,29,92,314,26,340,0,340,6,167,167,22.04.2019 01:30,85,7,Ivano-Frankovsk
272,257,23,88,164,20,184,0,184,4,95,85,22.04.2019 00:05,85,7,Ivano-Frankovsk
480,463,23,120,337,23,360,0,360,9,159,192,22.04.2019 00:40,85,7,Ivano-Frankovsk
416,406,25,82,309,25,334,0,334,3,97,234,22.04.2019 00:10,85,7,Ivano-Frankovsk
608,417,41,191,378,39,417,0,417,12,213,192,22.04.2019 00:12,85,7,Ivano-Frankovsk
160,152,14,59,87,14,101,0,101,1,67,33,22.04.2019 00:30,85,7,Ivano-Frankovsk
368,359,28,62,278,28,306,0,306,11,138,157,22.04.2019 00:45,85,7,Ivano-Frankovsk
1024,1035,56,360,610,54,664,0,664,19,417,228,22.04.2019 01:40,85,7,Ivano-Frankovsk
64,58,4,17,43,4,47,0,47,0,24,23,22.04.2019 00:05,85,7,Ivano-Frankovsk
208,202,13,53,142,13,155,0,155,1,73,81,22.04.2019 00:05,85,7,Ivano-Frankovsk
160,160,14,29,118,13,131,0,131,4,49,78,22.04.2019 00:20,85,7,Ivano-Frankovsk
832,827,39,207,586,39,625,0,625,17,437,171,22.04.2019 00:10,85,7,Ivano-Frankovsk
304,287,2,99,203,2,205,0,205,10,111,84,22.04.2019 00:15,85,7,Ivano-Frankovsk
432,415,41,150,241,41,282,0,282,6,211,65,22.04.2019 00:05,85,7,Ivano-Frankovsk
320,310,19,98,204,18,222,0,222,6,132,84,22.04.2019 00:15,85,7,Ivano-Frankovsk
272,268,9,79,184,9,193,0,193,7,129,57,22.04.2019 00:15,85,7,Ivano-Frankovsk
144,138,6,32,106,6,112,0,112,0,60,52,22.04.2019 01:15,85,7,Ivano-Frankovsk
416,405,23,155,241,20,261,0,261,9,117,135,22.04.2019 00:30,85,7,Ivano-Frankovsk
336,327,25,76,235,25,260,0,260,7,136,117,22.04.2019 00:44,85,7,Ivano-Frankovsk
368,368,27,100,243,25,268,0,268,5,146,117,22.04.2019 00:25,85,7,Ivano-Frankovsk
336,322,24,113,203,20,223,0,223,5,120,98,22.04.2019 00:06,85,7,Ivano-Frankovsk
288,279,34,66,188,34,222,0,222,5,122,95,22.04.2019 00:05,85,7,Ivano-Frankovsk
560,542,47,124,389,47,436,0,436,20,217,199,22.04.2019 00:10,85,7,Ivano-Frankovsk
704,708,37,204,465,35,500,0,500,20,281,199,22.04.2019 00:10,85,7,Ivano-Frankovsk
672,670,26,140,506,26,532,0,532,3,303,226,22.04.2019 01:40,85,7,Ivano-Frankovsk
528,535,68,188,275,65,340,0,340,4,177,159,22.04.2019 00:40,85,7,Ivano-Frankovsk
240,229,25,92,123,25,148,0,148,5,99,44,22.04.2019 00:15,85,7,Ivano-Frankovsk
432,416,55,178,204,50,254,0,254,1,134,119,22.04.2019 00:02,85,7,Ivano-Frankovsk
320,302,28,82,210,28,238,0,238,5,168,65,22.04.2019 00:20,85,7,Ivano-Frankovsk
64,55,8,19,37,8,45,0,45,1,22,22,22.04.2019 01:05,85,7,Ivano-Frankovsk
224,214,18,76,130,18,148,0,148,3,82,63,22.04.2019 00:40,85,7,Ivano-Frankovsk
464,451,31,92,341,31,372,0,372,11,129,232,22.04.2019 02:40,85,7,Ivano-Frankovsk
160,150,14,22,124,14,138,0,138,2,50,86,22.04.2019 00:30,85,7,Ivano-Frankovsk
240,226,20,98,122,20,142,0,142,4,82,56,22.04.2019 01:55,85,7,Ivano-Frankovsk
480,464,39,170,271,39,310,0,310,2,183,125,22.04.2019 00:30,85,7,Ivano-Frankovsk
400,382,30,145,225,30,255,0,255,17,122,116,22.04.2019 00:05,85,7,Ivano-Frankovsk
752,751,55,254,445,53,498,0,498,13,255,230,22.04.2019 01:10,85,7,Ivano-Frankovsk
496,471,17,166,313,17,330,0,330,4,192,134,22.04.2019 00:30,85,7,Ivano-Frankovsk
176,160,15,68,93,15,108,0,108,2,67,39,22.04.2019 00:32,85,7,Ivano-Frankovsk
592,586,25,134,433,25,458,0,458,21,271,166,22.04.2019 01:00,85,7,Ivano-Frankovsk
672,658,10,202,462,8,470,0,470,9,286,175,22.04.2019 02:46,85,7,Ivano-Frankovsk
320,303,36,140,146,34,180,0,180,5,91,84,22.04.2019 00:25,85,7,Ivano-Frankovsk
224,47,23,181,20,23,43,0,43,1,21,21,22.04.2019 00:37,85,7,Ivano-Frankovsk
48,8,0,41,7,0,7,0,7,0,3,4,22.04.2019 00:22,85,7,Ivano-Frankovsk
208,137,11,71,126,11,137,0,137,15,63,59,22.04.2019 00:30,85,7,Ivano-Frankovsk
1232,1221,12,444,776,12,788,0,788,25,367,396,22.04.2019 00:03,85,7,Ivano-Frankovsk
1856,1825,8,811,1042,3,1045,0,1045,32,554,459,22.04.2019 00:45,85,7,Ivano-Frankovsk
2240,2207,17,789,1436,15,1451,0,1451,57,705,689,22.04.2019 00:07,85,7,Ivano-Frankovsk
1600,1574,11,611,978,11,989,0,989,30,508,451,22.04.2019 00:25,85,7,Ivano-Frankovsk
2256,2217,12,873,1371,12,1383,0,1383,28,717,638,22.04.2019 01:20,85,7,Ivano-Frankovsk
1984,1943,21,811,1154,19,1173,0,1173,39,553,581,22.04.2019 00:31,85,7,Ivano-Frankovsk
1504,1464,13,654,840,10,850,0,850,39,417,394,22.04.2019 00:15,85,7,Ivano-Frankovsk
2304,2274,21,948,1339,17,1356,0,1356,54,678,624,22.04.2019 00:05,85,7,Ivano-Frankovsk
2112,2076,11,886,1219,7,1226,0,1226,41,655,530,22.04.2019 00:15,85,7,Ivano-Frankovsk
2256,2222,9,993,1255,8,1263,0,1263,45,693,525,22.04.2019 01:45,85,7,Ivano-Frankovsk
1984,1960,5,801,1180,3,1183,0,1183,31,619,533,22.04.2019 00:40,85,7,Ivano-Frankovsk
2208,2174,11,929,1270,9,1279,0,1279,48,650,581,22.04.2019 00:05,85,7,Ivano-Frankovsk
2288,2249,13,944,1336,8,1344,0,1344,41,648,655,22.04.2019 00:15,85,7,Ivano-Frankovsk
2256,2194,9,901,1347,8,1355,0,1355,55,644,656,22.04.2019 00:30,85,7,Ivano-Frankovsk
2368,2335,11,1030,1330,8,1338,0,1338,49,652,637,22.04.2019 00:02,85,7,Ivano-Frankovsk
2224,2182,9,984,1232,8,1240,0,1240,50,575,615,22.04.2019 00:35,85,7,Ivano-Frankovsk
2240,2205,8,1002,1232,6,1238,0,1238,49,651,538,22.04.2019 00:45,85,7,Ivano-Frankovsk
2384,2344,9,1137,1240,7,1247,0,1247,49,674,524,22.04.2019 00:03,85,7,Ivano-Frankovsk
2416,2376,6,1074,1337,5,1342,0,1342,59,753,530,22.04.2019 01:00,85,7,Ivano-Frankovsk
2355,2324,11,1101,1246,8,1254,0,1254,48,707,499,22.04.2019 00:10,85,7,Ivano-Frankovsk
2256,2203,3,1096,1157,3,1160,0,1160,42,630,488,21.04.2019 22:25,85,7,Ivano-Frankovsk
1920,1885,7,903,1012,5,1017,0,1017,40,586,391,21.04.2019 21:42,85,7,Ivano-Frankovsk
2352,2322,14,1096,1246,10,1256,0,1256,46,777,433,22.04.2019 00:05,85,7,Ivano-Frankovsk
1552,1529,10,702,844,6,850,0,850,23,492,335,22.04.2019 00:10,85,7,Ivano-Frankovsk
2064,2037,8,993,1064,7,1071,0,1071,24,577,470,22.04.2019 00:10,85,7,Ivano-Frankovsk
160,33,6,130,25,5,30,0,30,0,17,13,22.04.2019 00:05,85,7,Ivano-Frankovsk
528,63,48,468,15,45,60,0,60,1,30,29,21.04.2019 20:50,85,7,Ivano-Frankovsk
656,636,41,288,328,40,368,0,368,9,183,176,22.04.2019 00:10,86,7,Ivano-Frankovsk
1104,1073,48,433,627,44,671,0,671,14,389,268,22.04.2019 00:41,86,7,Ivano-Frankovsk
800,793,43,320,438,42,480,0,480,14,294,172,22.04.2019 00:40,86,7,Ivano-Frankovsk
880,858,43,378,459,43,502,0,502,22,337,143,21.04.2019 21:30,86,7,Ivano-Frankovsk
1200,1179,102,418,687,95,782,0,782,24,371,387,22.04.2019 00:05,86,7,Ivano-Frankovsk
1488,1471,40,668,781,39,820,0,820,20,627,173,22.04.2019 00:01,86,7,Ivano-Frankovsk
1328,1311,57,628,649,51,700,0,700,12,430,258,22.04.2019 00:40,86,7,Ivano-Frankovsk
704,686,41,333,342,29,371,0,371,7,239,125,22.04.2019 01:05,86,7,Ivano-Frankovsk
1200,1185,47,407,749,44,793,0,793,20,540,233,22.04.2019 00:30,86,7,Ivano-Frankovsk
1328,1303,63,478,792,58,850,0,850,19,622,209,22.04.2019 00:15,86,7,Ivano-Frankovsk
1536,1527,58,560,919,57,976,0,976,19,685,272,22.04.2019 00:45,86,7,Ivano-Frankovsk
1424,1390,67,673,689,62,751,0,751,11,464,276,22.04.2019 00:30,86,7,Ivano-Frankovsk
1136,1109,60,553,528,55,583,0,583,10,362,211,22.04.2019 00:52,86,7,Ivano-Frankovsk
1344,1336,95,506,743,95,838,0,838,23,495,320,22.04.2019 00:10,86,7,Ivano-Frankovsk
1648,1623,15,691,944,13,957,0,957,39,431,487,21.04.2019 21:00,86,7,Ivano-Frankovsk
2272,2234,36,990,1252,30,1282,0,1282,49,612,621,22.04.2019 00:05,86,7,Ivano-Frankovsk
1536,1505,14,672,857,7,864,0,864,26,453,385,22.04.2019 00:30,86,7,Ivano-Frankovsk
2080,2036,12,851,1221,8,1229,0,1229,33,578,618,22.04.2019 00:23,86,7,Ivano-Frankovsk
1760,1714,3,883,874,3,877,0,877,32,467,378,22.04.2019 01:22,86,7,Ivano-Frankovsk
1392,1358,11,580,803,9,812,0,812,26,381,405,22.04.2019 00:21,86,7,Ivano-Frankovsk
2106,2047,7,889,1211,6,1217,0,1217,36,609,572,22.04.2019 00:15,86,7,Ivano-Frankovsk
1392,1370,17,633,744,15,759,0,759,29,406,324,22.04.2019 00:22,86,7,Ivano-Frankovsk
1328,1313,17,554,762,12,774,0,774,34,401,339,22.04.2019 00:30,86,7,Ivano-Frankovsk
608,609,11,177,420,11,431,0,431,7,237,187,22.04.2019 00:15,86,7,Ivano-Frankovsk
1664,1641,48,699,920,45,965,0,965,28,523,414,22.04.2019 05:45,86,7,Ivano-Frankovsk
1680,1650,21,659,1003,18,1021,0,1021,26,579,416,22.04.2019 00:10,86,7,Ivano-Frankovsk
640,621,17,237,390,13,403,0,403,13,216,174,22.04.2019 00:05,86,7,Ivano-Frankovsk
576,551,16,297,264,15,279,0,279,6,188,85,22.04.2019 00:35,86,7,Ivano-Frankovsk
992,975,37,424,534,34,568,0,568,10,321,237,22.04.2019 02:00,86,7,Ivano-Frankovsk
704,691,32,212,461,31,492,0,492,5,298,189,22.04.2019 01:00,86,7,Ivano-Frankovsk
2400,2357,31,1253,1120,27,1147,0,1147,28,602,517,22.04.2019 00:15,86,7,Ivano-Frankovsk
1024,1005,17,392,615,17,632,0,632,10,377,245,22.04.2019 00:15,86,7,Ivano-Frankovsk
1504,1481,54,496,957,51,1008,0,1008,34,586,388,22.04.2019 00:30,86,7,Ivano-Frankovsk
1472,1451,14,537,921,14,935,0,935,27,458,450,21.04.2019 22:00,86,7,Ivano-Frankovsk
1744,1706,25,672,1049,23,1072,0,1072,48,513,511,22.04.2019 01:10,86,7,Ivano-Frankovsk
864,855,60,254,556,54,610,0,610,6,371,233,22.04.2019 00:15,86,7,Ivano-Frankovsk
1104,1086,12,476,616,12,628,0,628,23,308,297,22.04.2019 00:45,86,7,Ivano-Frankovsk
1408,1394,8,573,827,8,835,0,835,28,407,400,22.04.2019 00:15,86,7,Ivano-Frankovsk
800,796,10,366,426,8,434,0,434,11,241,182,22.04.2019 00:10,86,7,Ivano-Frankovsk
496,489,6,210,280,6,286,0,286,18,143,125,22.04.2019 00:02,86,7,Ivano-Frankovsk
800,788,42,320,441,39,480,0,480,11,265,204,22.04.2019 00:15,86,7,Ivano-Frankovsk
240,229,6,56,178,6,184,0,184,3,70,111,22.04.2019 00:08,86,7,Ivano-Frankovsk
464,456,22,173,269,22,291,0,291,4,168,119,22.04.2019 00:40,86,7,Ivano-Frankovsk
1104,1081,12,468,625,11,636,0,636,31,380,225,22.04.2019 01:20,86,7,Ivano-Frankovsk
976,960,13,385,580,11,591,0,591,18,320,253,22.04.2019 00:20,86,7,Ivano-Frankovsk
432,424,21,184,229,19,248,0,248,11,123,114,22.04.2019 00:15,86,7,Ivano-Frankovsk
976,960,74,242,660,74,734,0,734,21,325,388,22.04.2019 00:05,86,7,Ivano-Frankovsk
896,872,39,275,582,39,621,0,621,4,347,270,22.04.2019 03:50,86,7,Ivano-Frankovsk
480,456,30,190,261,29,290,0,290,5,143,142,22.04.2019 00:10,86,7,Ivano-Frankovsk
752,742,19,444,292,16,308,0,308,3,202,103,22.04.2019 00:05,86,7,Ivano-Frankovsk
624,613,13,161,452,11,463,0,463,6,168,289,22.04.2019 00:35,86,7,Ivano-Frankovsk
192,185,9,42,141,9,150,0,150,7,76,67,22.04.2019 00:10,86,7,Ivano-Frankovsk
192,188,6,42,144,6,150,0,150,0,33,117,22.04.2019 00:35,86,7,Ivano-Frankovsk
848,824,26,350,472,26,498,0,498,13,260,225,22.04.2019 00:05,86,7,Ivano-Frankovsk
832,819,31,263,539,30,569,0,569,21,345,203,22.04.2019 00:30,86,7,Ivano-Frankovsk
224,223,10,79,135,10,145,0,145,4,68,73,22.04.2019 00:20,86,7,Ivano-Frankovsk
496,483,9,70,417,9,426,0,426,5,235,186,22.04.2019 02:20,86,7,Ivano-Frankovsk
736,720,17,208,511,17,528,0,528,7,173,348,22.04.2019 00:08,86,7,Ivano-Frankovsk
2256,2216,63,1009,1188,59,1247,0,1247,33,693,521,22.04.2019 00:10,86,7,Ivano-Frankovsk
272,258,9,75,189,8,197,0,197,3,117,77,22.04.2019 00:15,86,7,Ivano-Frankovsk
800,780,33,269,498,33,531,0,531,14,349,168,22.04.2019 00:20,86,7,Ivano-Frankovsk
544,523,54,273,220,51,271,0,271,5,135,131,21.04.2019 21:00,86,7,Ivano-Frankovsk
1056,1039,17,340,700,16,716,0,716,10,419,287,22.04.2019 00:02,86,7,Ivano-Frankovsk
1536,1519,66,590,885,61,946,0,946,39,531,376,22.04.2019 00:47,86,7,Ivano-Frankovsk
256,236,4,65,189,2,191,0,191,2,152,37,22.04.2019 00:15,86,7,Ivano-Frankovsk
816,796,28,374,414,28,442,0,442,13,258,171,22.04.2019 00:15,86,7,Ivano-Frankovsk
272,36,25,242,11,19,30,0,30,0,20,10,22.04.2019 00:03,86,7,Ivano-Frankovsk
1616,1609,43,691,890,35,925,0,924,46,497,381,22.04.2019 01:00,86,7,Ivano-Frankovsk
1600,1592,40,602,958,40,998,0,998,32,560,406,22.04.2019 00:30,86,7,Ivano-Frankovsk
2240,2222,34,786,1422,32,1454,0,1454,31,651,772,22.04.2019 00:15,86,7,Ivano-Frankovsk
1984,1968,61,778,1146,60,1206,0,1206,46,539,621,22.04.2019 00:20,86,7,Ivano-Frankovsk
2320,2299,11,649,1660,11,1671,0,1671,41,1127,503,22.04.2019 02:00,86,7,Ivano-Frankovsk
2528,2502,12,1181,1335,12,1347,0,1347,35,929,383,22.04.2019 00:45,86,7,Ivano-Frankovsk
1488,1470,10,541,937,10,947,0,947,30,569,348,22.04.2019 00:45,86,7,Ivano-Frankovsk
1424,1405,2,634,788,2,790,0,790,19,529,242,22.04.2019 00:50,86,7,Ivano-Frankovsk
816,800,2,208,606,2,608,0,608,11,426,171,22.04.2019 00:05,86,7,Ivano-Frankovsk
928,915,67,282,579,67,646,0,646,16,273,357,22.04.2019 00:02,86,7,Ivano-Frankovsk
832,821,25,296,511,25,536,0,536,17,251,268,22.04.2019 00:05,86,7,Ivano-Frankovsk
800,782,70,252,481,67,548,0,548,13,251,284,22.04.2019 00:17,86,7,Ivano-Frankovsk
352,348,9,117,227,8,235,0,235,4,136,95,22.04.2019 00:09,86,7,Ivano-Frankovsk
1424,1392,53,654,719,51,770,0,770,28,493,249,22.04.2019 02:10,86,7,Ivano-Frankovsk
528,522,10,181,337,10,347,0,347,18,205,124,22.04.2019 00:05,86,7,Ivano-Frankovsk
224,215,5,71,148,5,153,0,153,7,99,47,22.04.2019 00:16,86,7,Ivano-Frankovsk
1392,1374,82,402,914,76,990,0,990,31,612,347,22.04.2019 00:10,86,7,Ivano-Frankovsk
912,905,43,240,631,41,672,0,672,12,365,295,22.04.2019 01:45,86,7,Ivano-Frankovsk
112,104,10,42,60,10,70,0,70,0,47,23,22.04.2019 00:10,86,7,Ivano-Frankovsk
304,290,28,73,204,27,231,0,231,5,142,84,22.04.2019 00:35,86,7,Ivano-Frankovsk
1088,1063,76,350,662,76,738,0,738,28,330,380,22.04.2019 00:15,86,7,Ivano-Frankovsk
848,833,74,215,562,71,633,0,633,22,348,263,22.04.2019 02:05,86,7,Ivano-Frankovsk
704,686,25,323,363,18,381,0,381,12,234,135,22.04.2019 00:10,86,7,Ivano-Frankovsk
928,918,35,386,509,33,542,0,542,10,279,253,22.04.2019 00:05,86,7,Ivano-Frankovsk
1840,1817,68,688,1085,67,1152,0,1152,33,553,566,22.04.2019 00:15,86,7,Ivano-Frankovsk
1216,1207,64,373,779,64,843,0,843,9,523,311,22.04.2019 01:55,86,7,Ivano-Frankovsk
1440,1429,60,356,1024,60,1084,0,1084,32,770,282,22.04.2019 00:14,86,7,Ivano-Frankovsk
656,637,36,269,351,36,387,0,387,8,271,108,22.04.2019 00:05,86,7,Ivano-Frankovsk
1328,1309,25,666,637,25,662,0,662,14,469,179,22.04.2019 00:15,86,7,Ivano-Frankovsk
1392,1369,51,669,673,50,723,0,723,11,508,204,22.04.2019 00:10,86,7,Ivano-Frankovsk
320,307,12,116,192,12,204,0,204,2,133,69,22.04.2019 02:35,86,7,Ivano-Frankovsk
1056,1035,46,434,576,46,622,0,622,13,441,168,22.04.2019 00:27,86,7,Ivano-Frankovsk
1152,1140,61,590,505,57,562,0,562,13,350,199,22.04.2019 00:05,86,7,Ivano-Frankovsk
992,982,38,429,525,38,563,0,563,7,367,189,22.04.2019 00:15,86,7,Ivano-Frankovsk
496,478,14,214,268,14,282,0,282,5,158,119,22.04.2019 00:30,86,7,Ivano-Frankovsk
640,633,52,198,392,50,442,0,442,14,245,183,22.04.2019 00:02,86,7,Ivano-Frankovsk
1888,1861,44,763,1081,44,1125,0,1125,27,724,374,22.04.2019 06:00,86,7,Ivano-Frankovsk
1920,1906,58,807,1063,50,1113,0,1113,31,743,339,22.04.2019 00:10,86,7,Ivano-Frankovsk
1008,999,22,318,668,22,690,0,690,14,423,253,22.04.2019 00:30,86,7,Ivano-Frankovsk
1488,1465,57,606,834,48,882,0,882,25,589,268,22.04.2019 00:10,86,7,Ivano-Frankovsk
336,322,25,116,196,24,220,0,220,10,142,68,22.04.2019 00:15,86,7,Ivano-Frankovsk
176,165,14,57,105,14,119,0,119,2,67,50,22.04.2019 00:20,86,7,Ivano-Frankovsk
960,939,17,422,521,17,538,0,538,27,279,232,22.04.2019 00:05,86,7,Ivano-Frankovsk
528,521,33,177,318,33,351,0,351,6,183,162,22.04.2019 00:10,86,7,Ivano-Frankovsk
448,442,37,115,298,35,333,0,333,5,155,173,22.04.2019 00:05,86,7,Ivano-Frankovsk
1504,1491,62,677,766,61,827,0,827,16,490,321,22.04.2019 00:50,86,7,Ivano-Frankovsk
1712,1676,27,776,913,23,936,0,936,24,515,397,22.04.2019 00:30,86,7,Ivano-Frankovsk
1632,1613,23,722,887,23,910,0,910,34,507,369,22.04.2019 00:40,86,7,Ivano-Frankovsk
1744,1717,20,737,990,17,1007,0,1007,28,511,468,22.04.2019 00:30,86,7,Ivano-Frankovsk
1136,1121,36,447,654,35,689,0,689,24,427,238,22.04.2019 01:35,86,7,Ivano-Frankovsk
672,654,37,302,333,37,370,0,370,10,162,198,22.04.2019 00:15,86,7,Ivano-Frankovsk
368,364,30,90,248,30,278,0,278,12,124,142,22.04.2019 00:05,86,7,Ivano-Frankovsk
128,127,10,25,93,10,103,0,103,4,50,49,22.04.2019 01:05,86,7,Ivano-Frankovsk
624,613,48,241,338,45,383,0,383,17,149,217,22.04.2019 01:15,86,7,Ivano-Frankovsk
320,308,19,80,221,19,240,0,240,2,51,187,22.04.2019 00:15,86,7,Ivano-Frankovsk
1456,1432,25,585,849,22,871,0,871,27,422,422,22.04.2019 00:30,86,7,Ivano-Frankovsk
1072,1048,15,500,557,15,572,0,572,18,236,318,22.04.2019 00:40,86,7,Ivano-Frankovsk
128,116,2,57,69,2,71,0,71,0,26,45,22.04.2019 00:35,86,7,Ivano-Frankovsk
832,827,41,321,474,37,511,0,511,12,274,225,22.04.2019 00:40,86,7,Ivano-Frankovsk
976,964,30,179,767,30,797,0,797,20,366,411,21.04.2019 21:30,86,7,Ivano-Frankovsk
1232,1213,29,587,616,29,645,0,645,9,370,266,22.04.2019 01:10,86,7,Ivano-Frankovsk
128,127,7,37,84,7,91,0,91,1,52,38,22.04.2019 00:15,86,7,Ivano-Frankovsk
1904,1892,24,840,1043,21,1064,0,1064,35,564,465,22.04.2019 00:10,87,7,Ivano-Frankovsk
1680,1671,29,641,1014,25,1039,0,1039,51,584,404,22.04.2019 00:10,87,7,Ivano-Frankovsk
1984,1983,6,884,1095,5,1100,0,1100,45,611,444,22.04.2019 01:30,87,7,Ivano-Frankovsk
1008,985,33,391,585,32,617,0,617,28,384,205,21.04.2019 20:45,87,7,Ivano-Frankovsk
848,827,22,365,462,21,483,0,483,19,287,177,21.04.2019 20:25,87,7,Ivano-Frankovsk
1184,1159,30,514,641,29,670,0,670,13,424,233,21.04.2019 21:20,87,7,Ivano-Frankovsk
1984,1956,61,1087,841,56,897,0,897,22,653,222,21.04.2019 22:35,87,7,Ivano-Frankovsk
976,965,27,392,557,27,584,0,584,19,402,163,21.04.2019 23:00,87,7,Ivano-Frankovsk
608,596,21,265,322,21,343,0,343,13,220,110,22.04.2019 00:10,87,7,Ivano-Frankovsk
576,557,23,270,283,23,306,0,306,5,190,111,22.04.2019 00:10,87,7,Ivano-Frankovsk
960,950,75,451,438,71,509,0,509,16,310,183,21.04.2019 23:45,87,7,Ivano-Frankovsk
1968,1925,92,908,974,86,1060,0,1060,36,502,522,22.04.2019 00:45,87,7,Ivano-Frankovsk
1552,1530,72,682,804,66,870,0,870,25,609,236,22.04.2019 00:15,87,7,Ivano-Frankovsk
688,674,22,286,381,21,402,0,402,12,177,213,22.04.2019 00:10,87,7,Ivano-Frankovsk
1904,1870,61,633,1217,54,1271,0,1271,54,671,546,22.04.2019 00:20,87,7,Ivano-Frankovsk
1216,1198,43,606,567,43,610,0,610,12,245,353,21.04.2019 21:00,87,7,Ivano-Frankovsk
1472,1446,92,789,591,92,683,0,683,12,305,366,22.04.2019 00:20,87,7,Ivano-Frankovsk
464,461,31,177,256,31,287,0,287,6,187,94,21.04.2019 22:00,87,7,Ivano-Frankovsk
496,489,30,171,297,28,325,0,325,7,170,148,22.04.2019 00:04,87,7,Ivano-Frankovsk
288,279,14,108,167,13,180,0,180,2,101,77,22.04.2019 00:15,87,7,Ivano-Frankovsk
384,383,27,137,224,23,247,0,247,6,130,111,22.04.2019 00:07,87,7,Ivano-Frankovsk
1952,1933,91,749,1117,86,1203,0,1203,37,732,434,22.04.2019 00:15,87,7,Ivano-Frankovsk
1712,1695,53,764,896,52,948,0,948,32,588,328,22.04.2019 00:20,87,7,Ivano-Frankovsk
992,971,57,451,486,55,541,0,541,18,327,196,21.04.2019 22:45,87,7,Ivano-Frankovsk
736,718,5,277,455,4,459,0,459,11,283,165,22.04.2019 00:25,87,7,Ivano-Frankovsk
1536,1510,65,564,911,61,972,0,972,21,644,307,22.04.2019 00:14,87,7,Ivano-Frankovsk
992,968,41,409,543,40,583,0,583,16,420,147,21.04.2019 23:55,87,7,Ivano-Frankovsk
2080,2059,42,825,1216,39,1255,0,1255,42,794,419,22.04.2019 00:55,87,7,Ivano-Frankovsk
1888,1859,67,735,1091,62,1153,0,1153,40,706,407,22.04.2019 00:05,87,7,Ivano-Frankovsk
432,427,10,125,297,10,307,0,307,4,238,65,22.04.2019 00:10,87,7,Ivano-Frankovsk
176,177,13,39,126,11,137,0,137,3,53,81,22.04.2019 00:30,87,7,Ivano-Frankovsk
944,928,58,392,498,54,552,0,552,17,282,253,22.04.2019 00:40,87,7,Ivano-Frankovsk
240,229,22,70,148,22,170,0,170,2,116,52,22.04.2019 00:20,87,7,Ivano-Frankovsk
1328,1317,62,445,823,60,883,0,883,21,605,257,22.04.2019 01:10,87,7,Ivano-Frankovsk
2080,2046,43,871,1166,43,1209,0,1209,35,853,321,22.04.2019 00:25,87,7,Ivano-Frankovsk
960,941,70,394,498,68,566,0,566,16,367,183,22.04.2019 01:05,87,7,Ivano-Frankovsk
384,378,31,153,200,31,231,0,231,3,153,75,21.04.2019 21:15,87,7,Ivano-Frankovsk
96,34,0,62,34,0,34,0,34,1,14,19,22.04.2019 00:20,87,7,Ivano-Frankovsk
1648,1632,13,692,945,11,956,0,956,40,506,410,22.04.2019 00:05,87,7,Ivano-Frankovsk
2112,2082,13,861,1240,11,1251,0,1251,45,610,596,22.04.2019 00:05,87,7,Ivano-Frankovsk
1648,1638,16,660,973,15,988,0,988,41,526,421,22.04.2019 00:10,87,7,Ivano-Frankovsk
2368,2341,39,944,1393,31,1424,0,1424,58,755,611,22.04.2019 00:15,87,7,Ivano-Frankovsk
1440,1409,6,636,800,4,804,0,804,34,381,389,22.04.2019 00:10,87,7,Ivano-Frankovsk
1728,1700,16,758,959,11,970,0,970,33,552,385,22.04.2019 00:25,87,7,Ivano-Frankovsk
1296,1270,8,618,670,8,678,0,678,23,340,315,22.04.2019 01:20,87,7,Ivano-Frankovsk
1072,1061,11,430,631,11,642,0,642,24,308,310,22.04.2019 01:10,87,7,Ivano-Frankovsk
1824,1800,10,864,952,8,960,0,960,36,579,345,22.04.2019 00:20,87,7,Ivano-Frankovsk
2096,2066,79,1024,997,75,1072,0,1072,13,760,299,22.04.2019 00:40,87,7,Ivano-Frankovsk
592,582,24,269,299,24,323,0,323,8,228,87,22.04.2019 00:55,87,7,Ivano-Frankovsk
208,198,7,88,113,7,120,0,120,5,50,65,22.04.2019 00:30,87,7,Ivano-Frankovsk
2304,2272,133,1278,994,32,1026,0,1026,32,651,343,22.04.2019 00:15,87,7,Ivano-Frankovsk
1360,1336,14,725,623,12,635,0,635,24,405,206,22.04.2019 00:30,87,7,Ivano-Frankovsk
1440,1418,11,822,607,11,618,0,618,17,435,166,22.04.2019 00:20,87,7,Ivano-Frankovsk
544,523,2,146,397,1,398,0,398,11,234,153,22.04.2019 02:00,87,7,Ivano-Frankovsk
1168,1068,2,595,573,0,573,0,573,16,378,179,22.04.2019 00:40,87,7,Ivano-Frankovsk
1712,1697,33,996,683,33,716,0,716,18,468,230,22.04.2019 00:03,87,7,Ivano-Frankovsk
1968,1956,32,1098,838,32,870,0,870,40,535,295,22.04.2019 00:03,87,7,Ivano-Frankovsk
1664,1647,65,918,682,64,746,0,746,29,461,256,21.04.2019 21:15,87,7,Ivano-Frankovsk
976,960,26,368,582,26,608,0,608,12,313,283,22.04.2019 00:30,87,7,Ivano-Frankovsk
1664,1645,13,819,832,13,845,0,845,35,494,316,22.04.2019 00:04,87,7,Ivano-Frankovsk
1872,1848,4,895,973,4,977,0,977,36,538,403,22.04.2019 00:40,87,7,Ivano-Frankovsk
1248,1216,38,631,580,37,617,0,617,17,391,209,22.04.2019 00:14,87,7,Ivano-Frankovsk
1168,1140,45,501,623,44,667,0,667,11,379,277,22.04.2019 00:10,87,7,Ivano-Frankovsk
1024,1004,62,229,734,61,795,0,795,8,366,421,22.04.2019 02:35,87,7,Ivano-Frankovsk
1024,1008,89,436,500,88,588,0,588,20,299,269,22.04.2019 00:35,87,7,Ivano-Frankovsk
1856,1835,40,373,1443,40,1483,0,1483,23,600,860,22.04.2019 01:30,87,7,Ivano-Frankovsk
1120,1101,18,593,510,17,527,0,527,13,273,241,22.04.2019 00:30,87,7,Ivano-Frankovsk
1744,1719,10,872,862,10,872,0,872,41,535,296,22.04.2019 00:20,87,7,Ivano-Frankovsk
1568,1543,24,753,791,24,815,0,815,26,450,339,22.04.2019 00:50,87,7,Ivano-Frankovsk
1440,1421,45,633,762,45,807,0,807,11,451,345,22.04.2019 00:45,87,7,Ivano-Frankovsk
1840,1818,62,922,859,59,918,0,918,25,573,320,22.04.2019 00:30,87,7,Ivano-Frankovsk
656,642,35,299,322,35,357,0,357,0,251,106,22.04.2019 00:20,87,7,Ivano-Frankovsk
816,812,24,289,503,24,527,0,527,40,242,245,22.04.2019 00:03,87,7,Ivano-Frankovsk
1392,1369,11,449,932,11,943,0,943,26,543,374,22.04.2019 00:25,87,7,Ivano-Frankovsk
1200,1180,11,436,754,10,764,0,764,30,513,221,22.04.2019 00:15,87,7,Ivano-Frankovsk
1312,1299,28,679,605,28,633,0,633,16,396,221,22.04.2019 01:12,87,7,Ivano-Frankovsk
1264,1242,43,537,686,41,727,0,727,19,453,255,22.04.2019 00:06,87,7,Ivano-Frankovsk
2112,2081,34,741,1341,30,1371,0,1371,31,857,483,22.04.2019 01:30,87,7,Ivano-Frankovsk
1872,1847,7,735,1130,7,1137,0,1137,34,741,362,22.04.2019 00:30,87,7,Ivano-Frankovsk
1248,1224,41,445,762,41,803,0,803,17,483,303,22.04.2019 02:50,87,7,Ivano-Frankovsk
224,214,13,62,149,13,162,0,162,3,104,55,21.04.2019 23:20,87,7,Ivano-Frankovsk
1216,1202,26,553,637,26,663,0,663,15,504,144,22.04.2019 00:15,87,7,Ivano-Frankovsk
544,534,20,186,338,20,358,0,358,4,290,64,22.04.2019 02:30,87,7,Ivano-Frankovsk
2480,2444,29,1402,1051,27,1078,0,1078,20,782,276,22.04.2019 01:45,87,7,Ivano-Frankovsk
432,418,21,190,221,21,242,0,242,5,159,78,22.04.2019 00:15,87,7,Ivano-Frankovsk
1792,1763,74,661,1058,73,1131,0,1131,89,517,525,21.04.2019 23:00,87,7,Ivano-Frankovsk
2080,2068,16,962,1105,13,1118,0,1118,32,722,364,22.04.2019 00:30,87,7,Ivano-Frankovsk
1990,1978,14,765,1211,14,1225,0,1225,36,863,326,22.04.2019 00:45,87,7,Ivano-Frankovsk
800,783,6,351,443,6,449,0,449,13,363,73,22.04.2019 00:30,87,7,Ivano-Frankovsk
1312,1299,14,501,797,14,811,0,811,28,489,294,22.04.2019 00:30,87,7,Ivano-Frankovsk
1248,1229,9,458,781,9,790,0,790,32,431,327,22.04.2019 00:30,87,7,Ivano-Frankovsk
32,30,0,8,24,0,24,0,24,0,15,9,22.04.2019 00:15,87,7,Ivano-Frankovsk
656,651,51,320,286,50,336,0,336,5,183,148,22.04.2019 00:10,87,7,Ivano-Frankovsk
192,187,7,84,101,7,108,0,108,1,76,31,22.04.2019 00:10,87,7,Ivano-Frankovsk
112,102,6,42,64,6,70,0,70,0,29,41,22.04.2019 00:05,87,7,Ivano-Frankovsk
1696,1665,37,782,878,36,914,0,914,34,532,348,22.04.2019 00:20,87,7,Ivano-Frankovsk
2336,2298,102,1052,1182,102,1284,0,1284,39,698,547,22.04.2019 01:00,87,7,Ivano-Frankovsk
1152,1139,54,317,781,54,835,0,835,23,340,472,22.04.2019 00:20,87,7,Ivano-Frankovsk
768,758,37,267,465,36,501,0,501,15,171,315,22.04.2019 00:03,87,7,Ivano-Frankovsk
1360,1343,21,614,725,21,746,0,746,11,423,312,22.04.2019 00:40,87,7,Ivano-Frankovsk
2128,2096,56,950,1122,56,1178,0,1178,24,517,637,22.04.2019 01:05,87,7,Ivano-Frankovsk
352,23,0,335,17,0,17,0,17,0,9,8,22.04.2019 00:10,87,7,Ivano-Frankovsk
1536,1504,21,649,869,18,887,0,887,17,469,401,22.04.2019 00:31,87,7,Ivano-Frankovsk
1584,1591,32,633,924,27,951,0,951,35,500,416,22.04.2019 00:05,87,7,Ivano-Frankovsk
976,961,6,463,507,6,513,0,513,9,334,170,22.04.2019 00:05,87,7,Ivano-Frankovsk
2016,1988,18,1013,987,16,1003,0,1003,15,790,198,22.04.2019 00:50,87,7,Ivano-Frankovsk
1904,1889,33,858,1013,33,1046,0,1046,20,766,260,22.04.2019 00:30,87,7,Ivano-Frankovsk
1168,1169,25,428,717,23,740,0,740,21,492,227,22.04.2019 00:10,87,7,Ivano-Frankovsk
1520,1494,17,755,751,14,765,0,765,26,472,267,22.04.2019 00:05,87,7,Ivano-Frankovsk
1616,1668,18,733,865,18,883,0,883,21,594,268,22.04.2019 00:15,87,7,Ivano-Frankovsk
672,696,4,262,406,4,410,0,410,7,309,94,22.04.2019 00:10,87,7,Ivano-Frankovsk
1648,1629,23,753,875,20,895,0,895,12,638,245,22.04.2019 00:05,87,7,Ivano-Frankovsk
352,335,11,197,144,11,155,0,155,0,113,42,21.04.2019 23:20,87,7,Ivano-Frankovsk
1936,1875,40,952,947,37,984,0,984,28,559,397,22.04.2019 02:15,88,7,Ivano-Frankovsk
1536,1515,19,709,815,12,827,0,827,28,496,303,22.04.2019 01:30,88,7,Ivano-Frankovsk
1104,1101,40,471,598,35,633,0,633,22,394,217,22.04.2019 01:15,88,7,Ivano-Frankovsk
1040,1009,22,490,534,16,550,0,550,6,389,155,22.04.2019 02:00,88,7,Ivano-Frankovsk
1360,1333,36,531,793,36,829,0,829,22,536,271,22.04.2019 01:50,88,7,Ivano-Frankovsk
1200,1173,75,330,797,73,870,0,870,18,504,348,22.04.2019 00:15,88,7,Ivano-Frankovsk
176,161,10,61,106,9,115,0,115,2,49,64,22.04.2019 00:22,88,7,Ivano-Frankovsk
608,602,46,216,347,45,392,0,392,19,174,199,21.04.2019 21:10,88,7,Ivano-Frankovsk
688,677,60,284,349,55,404,0,404,9,227,168,22.04.2019 00:30,88,7,Ivano-Frankovsk
224,207,14,86,125,13,138,0,138,1,77,60,21.04.2019 21:30,88,7,Ivano-Frankovsk
368,368,15,83,270,15,285,0,285,9,55,221,22.04.2019 00:05,88,7,Ivano-Frankovsk
896,888,78,179,639,78,717,0,717,18,280,419,22.04.2019 00:10,88,7,Ivano-Frankovsk
784,767,42,174,568,42,610,0,610,11,334,265,22.04.2019 00:15,88,7,Ivano-Frankovsk
208,201,11,56,141,11,152,0,152,2,79,71,22.04.2019 00:15,88,7,Ivano-Frankovsk
880,855,25,377,481,22,503,0,503,19,330,154,22.04.2019 00:30,88,7,Ivano-Frankovsk
288,283,16,128,144,16,160,0,160,7,90,63,22.04.2019 00:25,88,7,Ivano-Frankovsk
608,592,29,275,306,27,333,0,333,19,212,102,22.04.2019 01:25,88,7,Ivano-Frankovsk
480,476,15,154,311,15,326,0,326,5,235,86,22.04.2019 01:50,88,7,Ivano-Frankovsk
240,237,18,67,158,15,173,0,173,2,61,110,22.04.2019 01:00,88,7,Ivano-Frankovsk
480,464,31,65,384,31,415,0,415,4,168,243,22.04.2019 00:25,88,7,Ivano-Frankovsk
816,803,42,210,567,39,606,0,606,23,395,188,22.04.2019 00:30,88,7,Ivano-Frankovsk
1776,1763,48,676,1053,47,1100,0,1100,19,636,445,22.04.2019 01:15,88,7,Ivano-Frankovsk
656,646,50,218,388,50,438,0,438,7,297,134,22.04.2019 00:05,88,7,Ivano-Frankovsk
608,586,42,166,400,42,442,0,442,11,271,160,22.04.2019 00:05,88,7,Ivano-Frankovsk
48,47,10,15,24,9,33,0,33,0,13,20,22.04.2019 00:05,88,7,Ivano-Frankovsk
64,62,16,25,23,16,39,0,39,1,28,10,22.04.2019 00:20,88,7,Ivano-Frankovsk
512,515,38,187,289,36,325,0,325,4,201,120,22.04.2019 00:10,88,7,Ivano-Frankovsk
352,344,24,128,201,23,224,0,224,5,137,82,22.04.2019 00:20,88,7,Ivano-Frankovsk
864,852,32,375,457,32,489,0,489,14,332,143,22.04.2019 00:05,88,7,Ivano-Frankovsk
368,354,10,118,240,10,250,0,250,8,185,57,22.04.2019 00:05,88,7,Ivano-Frankovsk
112,99,0,42,70,0,70,0,70,1,38,31,22.04.2019 00:15,88,7,Ivano-Frankovsk
416,404,25,126,265,25,290,0,290,8,167,115,21.04.2019 22:01,88,7,Ivano-Frankovsk
320,317,22,119,182,19,201,0,201,5,107,89,22.04.2019 00:15,88,7,Ivano-Frankovsk
960,942,50,164,746,50,796,0,796,14,413,369,22.04.2019 00:35,88,7,Ivano-Frankovsk
528,521,39,219,273,36,309,0,309,6,223,80,21.04.2019 23:50,88,7,Ivano-Frankovsk
512,498,34,172,306,34,340,0,340,6,202,132,22.04.2019 00:30,88,7,Ivano-Frankovsk
752,749,35,272,445,35,480,0,480,12,327,141,22.04.2019 00:20,88,7,Ivano-Frankovsk
256,242,14,98,145,13,158,0,158,1,111,46,22.04.2019 00:10,88,7,Ivano-Frankovsk
800,786,44,358,402,40,442,0,442,13,242,187,22.04.2019 00:40,88,7,Ivano-Frankovsk
384,363,14,161,209,14,223,0,223,6,138,79,22.04.2019 04:10,88,7,Ivano-Frankovsk
528,525,28,203,299,26,325,0,325,13,191,121,22.04.2019 01:00,88,7,Ivano-Frankovsk
80,73,7,30,43,7,50,0,50,0,30,20,22.04.2019 00:14,88,7,Ivano-Frankovsk
912,887,52,354,506,52,558,0,558,12,390,156,22.04.2019 00:15,88,7,Ivano-Frankovsk
1648,1620,89,799,767,82,849,0,849,23,524,302,22.04.2019 00:05,88,7,Ivano-Frankovsk
560,547,27,245,288,27,315,0,315,14,168,133,22.04.2019 00:25,88,7,Ivano-Frankovsk
704,696,28,313,366,25,391,0,391,18,225,148,22.04.2019 00:02,88,7,Ivano-Frankovsk
1120,1100,48,442,631,47,678,0,678,10,469,199,21.04.2019 21:35,88,7,Ivano-Frankovsk
144,138,4,54,86,4,90,0,90,0,66,24,21.04.2019 23:45,88,7,Ivano-Frankovsk
1456,1427,63,622,773,61,834,0,834,15,469,350,22.04.2019 01:50,88,7,Ivano-Frankovsk
1392,1361,54,534,805,53,858,0,858,14,306,538,22.04.2019 01:00,88,7,Ivano-Frankovsk
1008,1018,117,378,521,109,630,0,630,11,269,350,22.04.2019 00:25,88,7,Ivano-Frankovsk
1472,1454,82,486,906,80,986,0,986,20,566,400,22.04.2019 00:04,88,7,Ivano-Frankovsk
912,892,59,269,584,59,643,0,643,12,388,243,22.04.2019 00:20,88,7,Ivano-Frankovsk
1872,1838,102,712,1072,88,1160,0,1160,29,558,573,22.04.2019 00:35,88,7,Ivano-Frankovsk
1312,1306,24,652,638,22,660,0,660,7,410,243,22.04.2019 01:30,88,7,Ivano-Frankovsk
1248,1233,26,613,612,23,635,0,635,5,398,232,22.04.2019 01:05,88,7,Ivano-Frankovsk
304,76,43,243,29,32,61,0,61,1,37,23,21.04.2019 21:30,88,7,Ivano-Frankovsk
976,953,56,486,436,54,490,0,490,7,332,151,21.04.2019 22:35,88,7,Ivano-Frankovsk
624,612,66,220,338,66,404,0,404,2,174,228,22.04.2019 00:45,88,7,Ivano-Frankovsk
1776,1763,99,799,883,94,977,0,977,33,600,344,22.04.2019 01:00,88,7,Ivano-Frankovsk
304,293,14,87,203,14,217,0,217,9,133,75,21.04.2019 20:48,88,7,Ivano-Frankovsk
1264,1240,57,597,617,50,667,0,667,21,335,311,22.04.2019 00:15,88,7,Ivano-Frankovsk
1024,1011,62,379,583,62,645,0,645,15,407,223,22.04.2019 02:35,88,7,Ivano-Frankovsk
1792,1777,128,720,953,119,1072,0,1072,34,624,414,22.04.2019 00:20,88,7,Ivano-Frankovsk
688,668,36,292,364,32,396,0,396,9,255,132,22.04.2019 01:05,88,7,Ivano-Frankovsk
816,805,57,374,388,54,442,0,442,15,268,159,22.04.2019 00:20,88,7,Ivano-Frankovsk
768,745,65,340,369,59,428,0,428,11,227,190,22.04.2019 01:00,88,7,Ivano-Frankovsk
320,305,18,117,188,15,203,0,203,5,105,93,21.04.2019 23:30,88,7,Ivano-Frankovsk
1152,1128,51,561,540,51,591,0,591,17,408,166,21.04.2019 23:20,88,7,Ivano-Frankovsk
1168,1146,44,411,717,40,757,0,757,23,379,355,22.04.2019 01:15,88,7,Ivano-Frankovsk
608,588,17,149,442,17,459,0,459,9,275,175,22.04.2019 00:30,88,7,Ivano-Frankovsk
704,683,15,369,320,15,335,0,335,8,190,137,22.04.2019 00:25,88,7,Ivano-Frankovsk
2144,2116,74,1009,1065,70,1135,0,1135,30,653,452,22.04.2019 00:10,88,7,Ivano-Frankovsk
768,751,54,332,388,48,436,0,436,22,283,131,22.04.2019 00:05,88,7,Ivano-Frankovsk
448,432,41,229,182,37,219,0,219,4,114,101,21.04.2019 22:08,88,7,Ivano-Frankovsk
1248,1222,98,506,646,96,742,0,742,16,406,320,22.04.2019 00:05,88,7,Ivano-Frankovsk
816,799,53,365,398,53,451,0,451,17,237,197,22.04.2019 00:10,88,7,Ivano-Frankovsk
1184,1177,47,529,610,45,655,0,655,30,340,285,22.04.2019 00:15,88,7,Ivano-Frankovsk
1616,1584,113,746,765,105,870,0,870,51,506,313,22.04.2019 03:30,88,7,Ivano-Frankovsk
288,270,24,118,146,24,170,0,170,4,111,55,22.04.2019 00:15,88,7,Ivano-Frankovsk
1952,1908,118,1034,814,104,918,0,918,27,581,310,22.04.2019 00:15,88,7,Ivano-Frankovsk
1088,1066,65,530,501,57,558,0,558,9,333,216,22.04.2019 01:10,88,7,Ivano-Frankovsk
1280,1243,50,583,653,44,697,0,697,23,420,254,22.04.2019 00:30,88,7,Ivano-Frankovsk
112,97,7,58,47,7,54,0,54,0,35,19,22.04.2019 03:36,88,7,Ivano-Frankovsk
528,515,33,228,269,31,300,0,300,5,206,89,22.04.2019 00:50,88,7,Ivano-Frankovsk
240,226,21,61,162,17,179,0,179,8,84,87,22.04.2019 00:10,88,7,Ivano-Frankovsk
2064,2040,94,908,1062,94,1156,0,1156,29,744,383,22.04.2019 00:28,88,7,Ivano-Frankovsk
1856,1823,53,895,912,49,961,0,961,30,603,328,22.04.2019 00:05,88,7,Ivano-Frankovsk
1344,1330,40,752,552,40,592,0,592,23,404,165,22.04.2019 00:12,88,7,Ivano-Frankovsk
1488,1472,99,628,770,90,860,0,860,13,519,328,22.04.2019 00:15,88,7,Ivano-Frankovsk
768,751,48,386,338,44,382,0,382,15,242,125,22.04.2019 07:00,88,7,Ivano-Frankovsk
960,939,41,408,512,40,552,0,552,18,240,294,22.04.2019 00:20,88,7,Ivano-Frankovsk
1744,1727,49,757,945,42,987,0,987,23,434,530,22.04.2019 00:20,88,7,Ivano-Frankovsk
1616,1596,62,703,853,60,913,0,913,16,458,439,22.04.2019 00:35,88,7,Ivano-Frankovsk
144,139,12,51,81,12,93,0,93,0,52,41,22.04.2019 00:40,88,7,Ivano-Frankovsk
848,818,37,366,447,35,482,0,482,21,246,215,21.04.2019 22:15,88,7,Ivano-Frankovsk
544,530,24,189,335,20,355,0,355,11,146,198,21.04.2019 21:25,88,7,Ivano-Frankovsk
800,789,55,361,391,48,439,0,439,14,274,151,22.04.2019 00:16,88,7,Ivano-Frankovsk
720,693,43,301,377,42,419,0,419,15,255,149,22.04.2019 00:10,88,7,Ivano-Frankovsk
688,668,47,322,326,40,366,0,366,6,175,185,22.04.2019 00:10,88,7,Ivano-Frankovsk
496,487,26,214,259,23,282,0,282,14,184,84,22.04.2019 00:20,88,7,Ivano-Frankovsk
224,210,18,103,105,16,121,0,121,2,97,22,22.04.2019 00:15,88,7,Ivano-Frankovsk
448,434,24,175,249,24,273,0,273,4,163,106,22.04.2019 00:05,88,7,Ivano-Frankovsk
400,392,21,197,182,21,203,0,203,4,122,77,22.04.2019 00:05,88,7,Ivano-Frankovsk
384,371,10,171,206,7,213,0,213,11,119,83,21.04.2019 22:45,88,7,Ivano-Frankovsk
1024,1008,62,555,412,57,469,0,469,12,319,138,22.04.2019 00:53,88,7,Ivano-Frankovsk
1184,1170,57,625,509,50,559,0,559,13,373,173,22.04.2019 00:25,88,7,Ivano-Frankovsk
976,968,63,361,560,55,615,0,615,29,347,239,22.04.2019 01:00,88,7,Ivano-Frankovsk
1120,1107,43,575,505,40,545,0,545,12,358,175,22.04.2019 00:15,88,7,Ivano-Frankovsk
1056,1029,54,537,467,52,519,0,519,8,336,175,22.04.2019 00:20,88,7,Ivano-Frankovsk
1376,1355,32,781,563,32,595,0,595,15,335,245,22.04.2019 00:25,88,7,Ivano-Frankovsk
1200,1181,38,700,462,38,500,0,500,7,269,224,22.04.2019 00:20,88,7,Ivano-Frankovsk
1136,1120,48,568,523,45,568,0,568,12,344,212,22.04.2019 00:27,88,7,Ivano-Frankovsk
2032,2010,64,996,979,57,1036,0,1036,26,472,538,22.04.2019 00:55,88,7,Ivano-Frankovsk
2224,2193,86,1079,1066,79,1145,0,1145,52,569,524,22.04.2019 00:20,88,7,Ivano-Frankovsk
976,962,63,537,377,62,439,0,439,8,273,158,22.04.2019 00:05,88,7,Ivano-Frankovsk
832,816,42,430,364,38,402,0,402,10,193,199,22.04.2019 00:15,88,7,Ivano-Frankovsk
1920,1885,84,961,883,76,959,0,959,27,583,349,22.04.2019 00:15,88,7,Ivano-Frankovsk
784,766,43,387,359,38,397,0,397,12,235,150,22.04.2019 00:10,88,7,Ivano-Frankovsk
1264,1232,47,609,609,46,655,0,655,11,498,146,22.04.2019 00:20,88,7,Ivano-Frankovsk
2016,1983,51,1120,849,47,896,0,896,23,628,245,22.04.2019 00:05,88,7,Ivano-Frankovsk
576,565,38,219,322,35,357,0,357,10,200,147,22.04.2019 00:15,88,7,Ivano-Frankovsk
288,275,14,94,181,13,194,0,194,7,109,78,22.04.2019 00:02,88,7,Ivano-Frankovsk
80,79,8,19,54,7,61,0,61,0,44,17,21.04.2019 23:55,88,7,Ivano-Frankovsk
816,800,29,298,489,29,518,0,518,17,237,264,22.04.2019 00:18,88,7,Ivano-Frankovsk
816,797,26,354,437,25,462,0,462,10,280,172,22.04.2019 00:33,88,7,Ivano-Frankovsk
64,21,2,43,19,2,21,0,21,0,13,8,22.04.2019 00:20,88,7,Ivano-Frankovsk
64,20,3,45,16,3,19,0,19,1,7,11,21.04.2019 20:50,88,7,Ivano-Frankovsk
640,317,0,324,316,0,316,0,316,17,260,39,22.04.2019 00:10,88,7,Ivano-Frankovsk
1680,1642,15,752,914,14,928,0,928,36,456,436,22.04.2019 00:05,88,7,Ivano-Frankovsk
1424,1398,21,662,744,18,762,0,762,28,360,374,22.04.2019 00:14,88,7,Ivano-Frankovsk
1920,1888,29,897,998,25,1023,0,1023,45,525,453,22.04.2019 00:30,88,7,Ivano-Frankovsk
1952,1928,80,818,1069,65,1134,0,1134,48,539,547,22.04.2019 00:12,88,7,Ivano-Frankovsk
1664,1628,31,756,892,16,908,0,908,29,464,415,22.04.2019 00:30,88,7,Ivano-Frankovsk
1952,1915,33,889,1039,24,1063,0,1063,38,533,492,22.04.2019 00:10,88,7,Ivano-Frankovsk
2048,2002,27,962,1066,20,1086,0,1086,30,579,477,22.04.2019 00:20,88,7,Ivano-Frankovsk
2080,2035,21,971,1096,13,1109,0,1109,48,537,524,22.04.2019 00:45,88,7,Ivano-Frankovsk
2000,1900,19,1011,974,15,989,0,989,20,559,410,22.04.2019 00:08,88,7,Ivano-Frankovsk
1728,1704,18,870,849,9,858,0,858,22,458,378,22.04.2019 00:10,88,7,Ivano-Frankovsk
1648,1622,34,714,906,28,934,0,934,33,439,462,22.04.2019 00:10,88,7,Ivano-Frankovsk
1856,1817,18,912,929,15,944,0,944,31,527,386,22.04.2019 00:26,88,7,Ivano-Frankovsk
1744,1728,25,794,929,21,950,0,950,30,419,501,22.04.2019 00:20,88,7,Ivano-Frankovsk
1760,1738,16,823,926,11,937,0,937,35,505,397,21.04.2019 23:10,88,7,Ivano-Frankovsk
1568,1541,32,716,826,26,852,0,852,28,442,382,22.04.2019 00:12,88,7,Ivano-Frankovsk
1456,1420,25,694,742,20,762,0,762,29,397,336,22.04.2019 00:15,88,7,Ivano-Frankovsk
1792,1770,32,771,994,27,1021,0,1021,31,520,470,22.04.2019 00:05,88,7,Ivano-Frankovsk
1936,1886,6,865,1065,6,1071,0,1071,36,585,450,22.04.2019 01:45,88,7,Ivano-Frankovsk
1856,1859,12,830,1017,9,1026,0,1026,32,521,473,22.04.2019 00:20,88,7,Ivano-Frankovsk
1920,1892,23,791,1109,20,1129,0,1129,33,547,549,22.04.2019 01:10,88,7,Ivano-Frankovsk
1680,1652,23,778,888,14,902,0,902,27,486,389,22.04.2019 01:15,88,7,Ivano-Frankovsk
1872,1847,26,789,1060,23,1083,0,1083,48,488,547,22.04.2019 00:20,88,7,Ivano-Frankovsk
1840,1814,21,854,968,18,986,0,986,44,437,505,22.04.2019 00:02,88,7,Ivano-Frankovsk
1472,1435,40,636,805,31,836,0,836,31,358,447,22.04.2019 01:30,88,7,Ivano-Frankovsk
1696,1657,37,754,906,36,942,0,942,18,412,512,22.04.2019 00:30,88,7,Ivano-Frankovsk
48,31,0,24,24,0,24,0,24,2,12,10,22.04.2019 00:10,88,7,Ivano-Frankovsk
48,17,5,32,12,4,16,0,16,0,9,7,22.04.2019 00:20,88,7,Ivano-Frankovsk
112,13,0,101,11,0,11,0,11,0,3,8,22.04.2019 00:05,88,7,Ivano-Frankovsk
80,12,0,68,12,0,12,0,12,0,4,8,21.04.2019 21:49,88,7,Ivano-Frankovsk
96,23,3,73,20,3,23,0,23,0,11,12,22.04.2019 00:10,88,7,Ivano-Frankovsk
464,76,45,395,29,40,69,0,69,2,35,32,22.04.2019 00:10,88,7,Ivano-Frankovsk
64,17,0,48,16,0,16,0,16,0,8,8,22.04.2019 00:05,88,7,Ivano-Frankovsk
512,518,22,179,314,19,333,0,333,7,213,113,22.04.2019 00:30,89,7,Ivano-Frankovsk
992,967,42,430,524,38,562,0,562,8,403,151,21.04.2019 21:10,89,7,Ivano-Frankovsk
128,127,10,26,92,10,102,0,102,1,84,17,22.04.2019 01:25,89,7,Ivano-Frankovsk
256,243,31,95,132,29,161,0,161,3,102,56,22.04.2019 00:30,89,7,Ivano-Frankovsk
192,214,12,22,159,11,170,0,170,3,96,71,22.04.2019 00:45,89,7,Ivano-Frankovsk
224,210,7,109,108,7,115,0,115,5,77,33,22.04.2019 01:00,89,7,Ivano-Frankovsk
592,575,37,304,260,28,288,0,288,7,193,88,22.04.2019 00:40,89,7,Ivano-Frankovsk
400,385,14,162,228,10,238,0,238,4,180,54,22.04.2019 01:30,89,7,Ivano-Frankovsk
608,604,30,233,347,28,375,0,375,9,274,92,21.04.2019 22:42,89,7,Ivano-Frankovsk
208,199,28,62,122,24,146,0,146,3,50,93,22.04.2019 00:40,89,7,Ivano-Frankovsk
672,649,30,384,268,20,288,0,288,11,174,103,22.04.2019 00:05,89,7,Ivano-Frankovsk
112,107,7,31,74,7,81,0,81,3,49,29,21.04.2019 21:45,89,7,Ivano-Frankovsk
304,302,21,117,169,18,187,0,187,3,114,70,22.04.2019 00:05,89,7,Ivano-Frankovsk
144,28,9,120,19,5,24,0,24,0,17,7,22.04.2019 01:20,89,7,Ivano-Frankovsk
2288,2259,48,1045,1196,47,1243,0,1243,39,671,533,22.04.2019 00:45,89,7,Ivano-Frankovsk
2016,2006,36,920,1069,27,1096,0,1096,36,620,440,22.04.2019 00:15,89,7,Ivano-Frankovsk
2288,2264,32,982,1281,25,1306,0,1306,49,644,613,22.04.2019 00:23,89,7,Ivano-Frankovsk
1328,1316,73,576,682,70,752,0,752,16,487,249,22.04.2019 00:15,89,7,Ivano-Frankovsk
624,603,35,350,243,31,274,0,274,9,155,110,22.04.2019 01:45,89,7,Ivano-Frankovsk
624,611,28,266,330,28,358,0,358,17,197,144,22.04.2019 01:00,89,7,Ivano-Frankovsk
864,841,18,406,440,18,458,0,458,23,220,215,22.04.2019 00:15,89,7,Ivano-Frankovsk
976,954,10,611,355,10,365,0,365,5,246,114,22.04.2019 00:30,89,7,Ivano-Frankovsk
1328,1309,43,656,630,42,672,0,672,6,514,152,22.04.2019 05:07,89,7,Ivano-Frankovsk
1488,1473,17,766,706,16,722,0,722,13,506,203,22.04.2019 01:10,89,7,Ivano-Frankovsk
1216,1200,32,521,663,32,695,0,695,7,543,145,22.04.2019 00:04,89,7,Ivano-Frankovsk
1216,1181,105,443,668,105,773,0,773,96,206,471,22.04.2019 01:10,89,7,Ivano-Frankovsk
1120,1107,93,522,509,89,598,0,598,13,442,143,22.04.2019 00:30,89,7,Ivano-Frankovsk
416,408,7,181,229,6,235,0,235,6,149,80,22.04.2019 00:55,89,7,Ivano-Frankovsk
2048,2009,40,1111,900,37,937,0,937,21,753,163,22.04.2019 01:05,89,7,Ivano-Frankovsk
1984,1954,30,1232,723,29,752,0,752,14,434,304,22.04.2019 00:14,89,7,Ivano-Frankovsk
496,480,22,217,257,22,279,0,279,5,115,159,22.04.2019 00:10,89,7,Ivano-Frankovsk
496,480,28,320,148,28,176,0,176,5,112,59,22.04.2019 01:15,89,7,Ivano-Frankovsk
928,911,25,574,331,23,354,0,354,5,227,122,22.04.2019 00:32,89,7,Ivano-Frankovsk
464,447,24,185,255,24,279,0,279,7,107,165,22.04.2019 01:00,89,7,Ivano-Frankovsk
352,337,22,208,123,21,144,0,144,3,77,64,22.04.2019 00:15,89,7,Ivano-Frankovsk
960,944,66,263,631,66,697,0,697,10,440,247,22.04.2019 00:40,89,7,Ivano-Frankovsk
400,388,22,110,268,22,290,0,290,5,182,103,22.04.2019 02:25,89,7,Ivano-Frankovsk
672,668,47,293,333,46,379,0,379,6,265,108,22.04.2019 00:10,89,7,Ivano-Frankovsk
1728,1706,18,930,783,15,798,0,798,19,516,263,22.04.2019 01:20,89,7,Ivano-Frankovsk
1520,1490,45,673,802,45,847,0,847,32,602,213,22.04.2019 00:06,89,7,Ivano-Frankovsk
1040,1030,31,461,550,29,579,0,579,8,431,140,22.04.2019 01:30,89,7,Ivano-Frankovsk
1728,1705,28,756,946,26,972,0,972,26,667,279,22.04.2019 00:33,89,7,Ivano-Frankovsk
1376,1355,46,585,745,46,791,0,791,21,521,249,22.04.2019 00:45,89,7,Ivano-Frankovsk
608,592,47,274,288,46,334,0,334,12,218,104,22.04.2019 00:23,89,7,Ivano-Frankovsk
1648,1624,9,646,993,9,1002,0,1002,21,736,245,22.04.2019 00:20,89,7,Ivano-Frankovsk
640,625,66,365,214,61,275,0,275,5,177,93,22.04.2019 00:45,89,7,Ivano-Frankovsk
1248,1220,60,560,628,60,688,0,688,23,473,192,22.04.2019 01:20,89,7,Ivano-Frankovsk
1120,1097,42,460,620,40,660,0,660,18,311,331,22.04.2019 00:15,89,7,Ivano-Frankovsk
1328,1310,20,653,655,20,675,0,675,22,445,208,22.04.2019 01:00,89,7,Ivano-Frankovsk
1488,1468,42,746,701,41,742,0,742,23,521,198,22.04.2019 01:20,89,7,Ivano-Frankovsk
800,786,7,399,395,6,401,0,401,11,283,107,22.04.2019 00:25,89,7,Ivano-Frankovsk
1072,1064,51,582,440,50,490,0,490,7,302,181,22.04.2019 00:45,89,7,Ivano-Frankovsk
1104,1093,70,611,425,68,493,0,493,6,339,148,22.04.2019 02:45,89,7,Ivano-Frankovsk
848,834,56,365,433,50,483,0,483,11,319,153,22.04.2019 01:00,89,7,Ivano-Frankovsk
1200,1182,5,582,613,5,618,0,618,5,363,250,22.04.2019 00:45,89,7,Ivano-Frankovsk
1536,1510,57,697,782,57,839,0,839,23,446,370,22.04.2019 01:25,89,7,Ivano-Frankovsk
880,865,15,456,409,15,424,0,424,4,309,111,22.04.2019 01:10,89,7,Ivano-Frankovsk
768,764,22,391,355,22,377,0,377,1,284,92,22.04.2019 00:50,89,7,Ivano-Frankovsk
144,77,59,72,18,54,72,0,72,1,40,31,22.04.2019 00:10,89,7,Ivano-Frankovsk
1904,1873,8,906,990,8,998,0,998,28,577,393,22.04.2019 00:20,89,7,Ivano-Frankovsk
1920,1899,98,898,930,92,1022,0,1022,60,703,259,22.04.2019 00:15,89,7,Ivano-Frankovsk
1504,1481,32,630,844,30,874,0,874,24,535,315,22.04.2019 00:15,89,7,Ivano-Frankovsk
1008,990,10,415,584,9,593,0,593,30,363,200,22.04.2019 00:22,89,7,Ivano-Frankovsk
1568,1525,9,735,825,8,833,0,833,19,658,156,22.04.2019 00:10,89,7,Ivano-Frankovsk
1456,1431,34,678,744,34,778,0,778,30,535,213,22.04.2019 00:10,89,7,Ivano-Frankovsk
1456,1435,47,606,804,46,850,0,850,29,519,302,22.04.2019 00:10,89,7,Ivano-Frankovsk
928,918,54,409,467,52,519,0,519,19,345,155,22.04.2019 00:15,89,7,Ivano-Frankovsk
528,518,37,210,283,35,318,0,318,12,210,96,22.04.2019 00:10,89,7,Ivano-Frankovsk
544,529,35,217,292,35,327,0,327,23,179,125,22.04.2019 00:20,89,7,Ivano-Frankovsk
1120,1116,51,418,652,50,702,0,702,53,330,319,22.04.2019 00:10,89,7,Ivano-Frankovsk
176,166,12,56,108,12,120,0,120,4,88,28,22.04.2019 00:15,89,7,Ivano-Frankovsk
432,415,12,211,211,10,221,0,221,8,166,47,22.04.2019 00:20,89,7,Ivano-Frankovsk
912,894,43,358,511,43,554,0,554,16,395,143,22.04.2019 00:47,89,7,Ivano-Frankovsk
768,769,40,360,368,40,408,0,408,15,220,173,22.04.2019 00:50,89,7,Ivano-Frankovsk
1696,1679,79,795,822,79,901,0,901,33,590,278,22.04.2019 00:05,89,7,Ivano-Frankovsk
80,67,4,25,51,4,55,0,55,0,33,22,22.04.2019 00:55,89,7,Ivano-Frankovsk
1344,1332,55,662,629,53,682,0,682,28,472,182,22.04.2019 00:20,89,7,Ivano-Frankovsk
1376,1361,72,540,766,70,836,0,836,23,447,366,22.04.2019 00:10,89,7,Ivano-Frankovsk
848,827,30,344,476,28,504,0,504,11,338,155,22.04.2019 00:05,89,7,Ivano-Frankovsk
160,156,5,49,106,5,111,0,111,6,77,28,22.04.2019 00:10,89,7,Ivano-Frankovsk
1408,1374,61,555,792,61,853,0,853,25,504,324,22.04.2019 00:35,89,7,Ivano-Frankovsk
928,900,74,441,414,73,487,0,487,6,373,108,22.04.2019 00:30,89,7,Ivano-Frankovsk
816,791,52,374,391,51,442,0,442,16,354,72,22.04.2019 03:00,89,7,Ivano-Frankovsk
1104,1083,59,512,537,55,592,0,592,14,466,112,22.04.2019 00:11,89,7,Ivano-Frankovsk
432,412,28,144,260,28,288,0,288,5,185,98,22.04.2019 00:10,89,7,Ivano-Frankovsk
1008,998,69,307,632,69,701,0,701,15,525,161,22.04.2019 00:10,89,7,Ivano-Frankovsk
736,717,46,189,501,46,547,0,547,24,393,130,22.04.2019 00:25,89,7,Ivano-Frankovsk
864,852,29,379,457,28,485,0,485,17,309,159,22.04.2019 00:05,89,7,Ivano-Frankovsk
448,438,4,154,290,4,294,0,294,18,189,87,22.04.2019 00:19,89,7,Ivano-Frankovsk
512,500,21,200,291,21,312,0,312,10,222,80,22.04.2019 00:03,89,7,Ivano-Frankovsk
1920,1903,31,719,1170,31,1201,0,1201,20,745,436,22.04.2019 00:10,89,7,Ivano-Frankovsk
1152,1124,53,401,698,53,751,0,751,12,478,261,22.04.2019 01:30,89,7,Ivano-Frankovsk
864,848,22,364,481,19,500,0,500,14,300,186,22.04.2019 00:31,89,7,Ivano-Frankovsk
1056,1035,59,434,563,59,622,0,622,16,380,226,22.04.2019 01:25,89,7,Ivano-Frankovsk
1008,977,49,403,558,47,605,0,605,14,421,170,22.04.2019 00:10,89,7,Ivano-Frankovsk
832,821,42,329,462,41,503,0,503,19,261,223,22.04.2019 00:17,89,7,Ivano-Frankovsk
1120,1105,28,578,516,26,542,0,542,21,303,218,22.04.2019 00:15,89,7,Ivano-Frankovsk
736,731,42,386,310,40,350,0,350,5,275,70,22.04.2019 00:15,89,7,Ivano-Frankovsk
672,665,37,278,360,34,394,0,394,10,293,91,22.04.2019 00:15,89,7,Ivano-Frankovsk
976,953,42,531,405,40,445,0,445,14,320,111,22.04.2019 00:11,89,7,Ivano-Frankovsk
288,274,6,137,145,6,151,0,151,4,101,46,22.04.2019 00:09,89,7,Ivano-Frankovsk
416,400,14,152,250,14,264,0,264,6,140,118,22.04.2019 00:10,89,7,Ivano-Frankovsk
960,938,51,414,495,51,546,0,546,22,371,153,22.04.2019 00:45,89,7,Ivano-Frankovsk
608,588,29,219,360,29,389,0,389,8,243,138,22.04.2019 00:10,89,7,Ivano-Frankovsk
656,641,26,198,433,25,458,0,458,21,281,156,22.04.2019 00:30,89,7,Ivano-Frankovsk
896,886,17,421,458,17,475,0,475,16,307,152,22.04.2019 00:15,89,7,Ivano-Frankovsk
304,302,11,112,181,11,192,0,192,7,126,59,22.04.2019 00:20,89,7,Ivano-Frankovsk
544,539,26,249,271,24,295,0,295,9,201,85,22.04.2019 00:50,89,7,Ivano-Frankovsk
272,257,14,125,133,14,147,0,147,4,95,48,22.04.2019 00:48,89,7,Ivano-Frankovsk
64,34,12,41,15,8,23,0,23,0,7,16,22.04.2019 00:05,89,7,Ivano-Frankovsk
48,19,3,29,16,3,19,0,19,1,7,11,22.04.2019 00:07,89,7,Ivano-Frankovsk
1760,1720,10,660,1094,6,1100,0,1100,25,866,209,22.04.2019 00:25,90,8,Kiev
2272,2231,24,810,1443,19,1462,0,1462,59,1082,321,22.04.2019 00:06,90,8,Kiev
2208,2193,20,867,1330,11,1341,0,1341,42,989,310,22.04.2019 01:45,90,8,Kiev
2416,2392,27,810,1585,21,1606,0,1606,52,1146,408,22.04.2019 00:20,90,8,Kiev
288,285,0,110,178,0,178,0,178,4,131,43,22.04.2019 00:30,90,8,Kiev
2208,2165,26,786,1401,21,1422,0,1422,61,986,375,22.04.2019 00:05,90,8,Kiev
1376,1364,23,394,962,20,982,0,982,31,656,295,22.04.2019 00:05,90,8,Kiev
1760,1745,14,563,1186,11,1197,0,1197,23,846,327,22.04.2019 00:20,90,8,Kiev
2336,2292,23,840,1481,15,1496,0,1496,42,1075,379,22.04.2019 00:12,90,8,Kiev
1680,1680,26,537,1122,21,1143,0,1143,35,815,293,22.04.2019 00:20,90,8,Kiev
2288,2267,12,796,1482,10,1492,0,1492,34,1055,403,22.04.2019 00:15,90,8,Kiev
1872,1867,17,604,1255,13,1268,0,1268,44,895,329,22.04.2019 00:15,90,8,Kiev
2176,2153,24,682,1474,20,1494,0,1494,51,1035,408,22.04.2019 00:10,90,8,Kiev
336,339,4,118,215,3,218,0,218,8,151,59,22.04.2019 00:28,90,8,Kiev
1424,1413,11,537,878,9,887,0,887,25,644,218,22.04.2019 01:15,90,8,Kiev
2112,2087,15,748,1355,9,1364,0,1364,36,981,347,22.04.2019 00:07,90,8,Kiev
1264,1258,15,385,870,9,879,0,879,18,589,272,22.04.2019 00:11,90,8,Kiev
2112,2107,16,645,1455,12,1467,0,1467,52,1052,363,22.04.2019 00:32,90,8,Kiev
368,360,0,123,245,0,245,0,245,8,166,71,22.04.2019 00:27,90,8,Kiev
1680,1663,18,585,1078,17,1095,0,1095,28,808,259,22.04.2019 00:55,90,8,Kiev
2272,2242,31,852,1393,27,1420,0,1420,37,1077,306,22.04.2019 03:20,90,8,Kiev
1456,1445,6,484,967,5,972,0,972,34,689,249,22.04.2019 00:30,90,8,Kiev
1088,1075,8,410,671,7,678,0,678,28,444,206,22.04.2019 00:15,90,8,Kiev
2352,2339,15,917,1426,9,1435,0,1435,25,1072,338,22.04.2019 00:15,90,8,Kiev
1408,1390,9,513,887,8,895,0,895,36,629,230,22.04.2019 00:05,90,8,Kiev
1472,1455,16,518,943,11,954,0,954,24,710,220,22.04.2019 00:30,90,8,Kiev
2000,1967,14,705,1286,9,1295,0,1295,35,955,305,22.04.2019 00:45,90,8,Kiev
2239,2220,19,786,1441,12,1453,0,1453,40,1051,362,22.04.2019 00:09,90,8,Kiev
592,565,9,193,392,7,399,0,399,11,259,129,22.04.2019 00:10,90,8,Kiev
2256,2223,17,852,1388,16,1404,0,1404,36,1053,315,22.04.2019 00:20,90,8,Kiev
1664,1628,2,771,891,2,893,0,893,29,714,150,21.04.2019 22:20,90,8,Kiev
1984,1951,2,787,1195,2,1197,0,1197,28,902,267,22.04.2019 00:05,90,8,Kiev
1872,1829,5,682,1185,5,1190,0,1190,27,888,275,22.04.2019 00:05,90,8,Kiev
2240,2217,14,780,1450,10,1460,0,1460,41,1098,321,22.04.2019 00:40,90,8,Kiev
2288,2256,21,805,1470,13,1483,0,1483,44,1061,378,22.04.2019 00:05,90,8,Kiev
416,413,0,151,265,0,265,0,265,9,194,62,22.04.2019 00:05,90,8,Kiev
1856,1849,7,733,1117,6,1123,0,1123,42,868,213,22.04.2019 00:50,90,8,Kiev
880,872,9,285,588,7,595,0,595,22,452,121,22.04.2019 00:05,90,8,Kiev
2272,2252,6,716,1550,6,1556,0,1556,42,1107,407,21.04.2019 21:50,90,8,Kiev
2288,2273,13,732,1545,11,1556,0,1556,46,1074,436,22.04.2019 00:26,90,8,Kiev
352,348,1,103,248,1,249,0,249,4,173,72,22.04.2019 00:35,90,8,Kiev
2192,2162,12,728,1453,11,1464,0,1464,27,1081,356,22.04.2019 00:02,90,8,Kiev
2368,2333,12,720,1638,10,1648,0,1648,51,1085,512,22.04.2019 00:05,90,8,Kiev
480,466,0,164,316,0,316,0,316,6,228,82,22.04.2019 00:10,90,8,Kiev
2352,2311,13,844,1499,9,1508,0,1508,40,1084,384,22.04.2019 01:00,90,8,Kiev
2256,2216,7,767,1482,7,1489,0,1489,41,1116,332,22.04.2019 00:20,90,8,Kiev
432,411,1,178,253,1,254,0,254,6,204,44,22.04.2019 00:05,90,8,Kiev
2288,2191,9,817,1465,6,1471,0,1471,39,1077,355,22.04.2019 00:20,90,8,Kiev
1952,1925,7,698,1249,5,1254,0,1254,35,909,310,22.04.2019 00:10,90,8,Kiev
784,763,1,273,511,0,511,0,511,15,379,117,22.04.2019 00:20,90,8,Kiev
2304,2278,2,843,1459,2,1461,0,1461,38,1120,303,22.04.2019 00:15,90,8,Kiev
1264,1291,5,445,814,5,819,0,819,28,594,197,22.04.2019 00:20,90,8,Kiev
2352,2342,15,847,1495,10,1505,0,1505,22,1151,332,21.04.2019 23:00,90,8,Kiev
1504,1488,11,632,864,8,872,0,872,17,630,225,22.04.2019 00:10,90,8,Kiev
2272,2245,36,772,1472,28,1500,0,1500,30,1122,348,22.04.2019 00:30,90,8,Kiev
1552,1526,7,539,1008,5,1013,0,1013,36,757,220,22.04.2019 00:10,90,8,Kiev
2336,2292,23,894,1419,23,1442,0,1442,32,1052,358,22.04.2019 00:30,90,8,Kiev
416,404,0,218,198,0,198,0,198,5,176,17,22.04.2019 00:10,90,8,Kiev
2432,2412,4,813,1616,3,1619,0,1619,42,1148,429,22.04.2019 00:15,90,8,Kiev
2240,2202,9,753,1483,4,1487,0,1487,35,1088,364,22.04.2019 00:05,90,8,Kiev
2112,2081,23,775,1316,21,1337,0,1337,29,1012,296,22.04.2019 00:50,90,8,Kiev
1920,1911,8,924,990,6,996,0,996,25,767,204,22.04.2019 00:05,90,8,Kiev
1824,1796,17,639,1171,14,1185,0,1185,30,892,263,22.04.2019 00:10,90,8,Kiev
2192,2160,13,772,1410,10,1420,0,1420,35,1026,359,22.04.2019 00:03,90,8,Kiev
2352,2330,9,741,1603,8,1611,0,1611,42,1103,466,22.04.2019 00:10,90,8,Kiev
2192,2151,17,721,1457,14,1471,0,1471,36,1049,386,22.04.2019 00:20,90,8,Kiev
400,386,1,136,263,1,264,0,264,10,211,43,22.04.2019 00:10,90,8,Kiev
96,35,0,62,34,0,34,0,34,0,29,5,22.04.2019 00:02,90,8,Kiev
480,26,17,457,9,14,23,0,23,0,17,6,22.04.2019 00:05,90,8,Kiev
224,13,0,211,13,0,13,0,13,0,10,3,22.04.2019 00:10,90,8,Kiev
80,24,7,60,15,5,20,0,20,0,15,5,21.04.2019 21:10,90,8,Kiev
352,69,13,284,56,12,68,0,68,3,47,18,22.04.2019 00:02,90,8,Kiev
208,28,1,180,27,1,28,0,28,2,19,7,21.04.2019 20:20,90,8,Kiev
464,381,0,87,377,0,377,0,377,15,344,18,22.04.2019 00:15,90,8,Kiev
928,916,5,342,581,5,586,0,586,13,455,118,22.04.2019 00:10,90,8,Kiev
608,612,21,181,406,21,427,0,427,8,287,132,21.04.2019 22:05,91,8,Kiev
1376,1374,14,536,826,14,840,0,840,16,592,232,21.04.2019 22:04,91,8,Kiev
784,776,12,301,472,11,483,0,483,10,343,130,22.04.2019 04:40,91,8,Kiev
176,160,0,55,121,0,121,0,121,1,76,44,21.04.2019 20:30,91,8,Kiev
1616,1620,11,612,994,10,1004,0,1004,14,701,289,21.04.2019 22:20,91,8,Kiev
896,893,1,329,567,0,567,0,567,7,386,174,21.04.2019 21:30,91,8,Kiev
2256,2275,4,791,1461,4,1465,0,1465,38,882,545,22.04.2019 00:05,91,8,Kiev
1392,1392,1,505,886,1,887,0,887,20,612,255,21.04.2019 21:15,91,8,Kiev
1392,1386,18,470,907,15,922,0,922,17,647,258,21.04.2019 22:10,91,8,Kiev
720,711,8,288,426,6,432,0,432,13,309,110,21.04.2019 21:15,91,8,Kiev
448,433,9,131,308,9,317,0,317,9,205,103,21.04.2019 22:00,91,8,Kiev
1152,1145,0,418,734,0,734,0,734,13,514,207,22.04.2019 00:15,91,8,Kiev
752,745,5,240,508,4,512,0,512,15,324,173,21.04.2019 21:00,91,8,Kiev
1344,1331,13,513,822,9,831,0,831,16,543,272,22.04.2019 00:02,91,8,Kiev
1168,1153,24,431,715,22,737,0,737,13,469,255,21.04.2019 21:00,91,8,Kiev
352,347,3,134,215,3,218,0,218,0,151,67,21.04.2019 22:30,91,8,Kiev
560,561,8,177,375,8,383,0,383,13,229,141,21.04.2019 22:00,91,8,Kiev
1760,1766,3,618,1139,3,1142,0,1142,22,674,446,21.04.2019 21:30,91,8,Kiev
1680,1698,1,590,1089,1,1090,0,1090,32,679,379,22.04.2019 02:20,91,8,Kiev
752,763,3,226,523,3,526,0,526,6,329,191,21.04.2019 23:59,91,8,Kiev
1184,1191,5,382,797,5,802,0,802,20,524,258,22.04.2019 00:03,91,8,Kiev
640,639,0,224,416,0,416,0,416,6,308,102,21.04.2019 20:57,91,8,Kiev
2320,2300,1,880,1439,1,1440,0,1440,39,952,449,22.04.2019 01:35,91,8,Kiev
1840,1851,0,702,1138,0,1138,0,1138,29,751,358,22.04.2019 00:49,91,8,Kiev
1792,1802,5,536,1251,5,1256,0,1256,39,767,450,21.04.2019 21:10,91,8,Kiev
2288,2328,2,674,1612,2,1614,0,1614,51,970,593,22.04.2019 00:10,91,8,Kiev
1040,1017,4,370,667,3,670,0,670,17,406,247,21.04.2019 21:15,91,8,Kiev
1824,1817,14,770,1048,6,1054,0,1054,29,675,350,21.04.2019 21:10,91,8,Kiev
464,459,1,160,303,1,304,0,304,5,198,101,21.04.2019 23:05,91,8,Kiev
208,209,4,68,137,3,140,0,140,3,91,46,21.04.2019 21:30,91,8,Kiev
2368,2344,7,801,1561,6,1567,0,1567,41,935,591,22.04.2019 00:13,91,8,Kiev
1056,1040,37,424,596,36,632,0,632,6,469,157,22.04.2019 00:10,91,8,Kiev
144,134,11,63,70,11,81,0,81,1,52,28,21.04.2019 22:20,91,8,Kiev
656,670,24,234,399,23,422,0,422,14,274,134,21.04.2019 22:20,91,8,Kiev
2416,2405,33,916,1470,30,1500,0,1500,22,1098,380,21.04.2019 21:50,91,8,Kiev
2320,2339,2,837,1482,1,1483,0,1483,36,1067,380,21.04.2019 22:17,91,8,Kiev
1680,1637,6,752,922,6,928,0,928,23,677,228,21.04.2019 21:40,91,8,Kiev
1920,1935,5,708,1209,3,1212,0,1212,29,845,338,21.04.2019 22:10,91,8,Kiev
784,768,49,314,425,45,470,0,470,16,324,130,21.04.2019 20:40,91,8,Kiev
2432,2397,11,1166,1261,5,1266,0,1266,30,980,256,22.04.2019 07:15,91,8,Kiev
448,455,2,192,254,2,256,0,256,3,180,73,21.04.2019 21:20,91,8,Kiev
544,538,29,204,312,28,340,0,340,6,245,89,21.04.2019 22:45,91,8,Kiev
320,314,7,110,204,6,210,0,210,0,129,81,21.04.2019 23:00,91,8,Kiev
608,594,6,314,289,5,294,0,294,7,246,41,21.04.2019 21:11,91,8,Kiev
688,696,46,249,398,41,439,0,439,8,338,93,21.04.2019 21:15,91,8,Kiev
704,708,68,301,335,68,403,0,403,10,279,114,21.04.2019 21:20,91,8,Kiev
96,85,6,35,55,6,61,0,61,2,47,12,22.04.2019 00:10,91,8,Kiev
640,640,35,239,366,35,401,0,401,4,295,102,21.04.2019 21:30,91,8,Kiev
176,170,15,71,90,15,105,0,105,2,72,31,21.04.2019 20:40,91,8,Kiev
816,879,36,238,546,32,578,0,578,7,368,203,22.04.2019 01:40,91,8,Kiev
352,344,23,119,214,19,233,0,233,5,156,72,21.04.2019 21:20,91,8,Kiev
432,418,20,158,254,20,274,0,274,12,187,75,21.04.2019 23:40,91,8,Kiev
912,919,12,394,506,12,518,0,518,9,349,160,22.04.2019 00:35,91,8,Kiev
192,187,14,73,105,14,119,0,119,1,78,40,21.04.2019 21:12,91,8,Kiev
656,652,25,297,335,24,359,0,359,8,199,152,21.04.2019 21:57,91,8,Kiev
96,90,6,39,51,6,57,0,57,0,26,31,21.04.2019 22:05,91,8,Kiev
816,802,7,387,424,5,429,0,429,7,315,107,21.04.2019 21:30,91,8,Kiev
400,397,4,132,264,4,268,0,268,7,203,58,21.04.2019 20:45,91,8,Kiev
240,244,0,80,160,0,160,0,160,1,127,32,21.04.2019 20:50,91,8,Kiev
320,311,24,118,178,24,202,0,202,3,175,24,22.04.2019 00:30,91,8,Kiev
672,655,7,224,441,7,448,0,448,12,314,122,21.04.2019 20:37,91,8,Kiev
576,561,25,244,307,25,332,0,332,4,233,95,21.04.2019 20:37,91,8,Kiev
256,245,10,85,162,9,171,0,171,5,117,49,21.04.2019 21:20,91,8,Kiev
816,815,18,388,410,18,428,0,428,11,287,130,21.04.2019 20:45,91,8,Kiev
640,653,47,211,382,47,429,0,429,3,322,104,21.04.2019 20:50,91,8,Kiev
352,347,1,151,200,1,201,0,201,7,144,50,21.04.2019 21:30,91,8,Kiev
528,531,1,188,339,1,340,0,340,3,270,67,21.04.2019 22:30,91,8,Kiev
768,761,22,332,416,20,436,0,436,12,322,102,21.04.2019 21:20,91,8,Kiev
288,279,14,100,174,14,188,0,188,5,147,36,21.04.2019 22:00,91,8,Kiev
736,740,37,269,430,37,467,0,467,8,333,126,21.04.2019 20:45,91,8,Kiev
496,504,40,146,310,40,350,0,350,9,246,95,21.04.2019 20:50,91,8,Kiev
352,349,31,121,202,28,231,0,231,5,138,88,21.04.2019 22:00,91,8,Kiev
512,509,36,179,301,32,333,0,333,4,209,120,21.04.2019 21:05,91,8,Kiev
448,436,27,199,223,26,249,0,249,1,190,58,22.04.2019 00:30,91,8,Kiev
528,535,45,147,338,43,381,0,381,9,302,70,21.04.2019 20:50,91,8,Kiev
464,456,39,182,243,39,282,0,282,3,195,84,21.04.2019 21:00,91,8,Kiev
352,344,8,105,239,8,247,0,247,5,162,80,21.04.2019 20:40,91,8,Kiev
416,428,23,160,235,21,256,0,256,2,171,83,21.04.2019 20:55,91,8,Kiev
160,154,11,61,88,11,99,0,99,1,59,39,21.04.2019 20:43,91,8,Kiev
544,534,32,236,281,27,308,0,308,5,203,100,21.04.2019 23:45,91,8,Kiev
480,501,26,133,321,26,347,0,347,5,225,117,21.04.2019 20:55,91,8,Kiev
192,70,30,140,39,13,52,0,52,0,44,8,21.04.2019 20:30,91,8,Kiev
416,406,28,181,209,26,235,0,235,2,159,74,22.04.2019 04:10,91,8,Kiev
384,397,33,97,254,33,287,0,287,2,198,87,21.04.2019 21:00,91,8,Kiev
1696,1665,120,701,886,109,995,0,995,23,683,289,21.04.2019 21:57,91,8,Kiev
528,521,55,172,301,55,356,0,356,0,225,131,21.04.2019 20:39,91,8,Kiev
240,237,20,52,168,20,188,0,188,0,129,59,21.04.2019 20:45,91,8,Kiev
272,274,31,73,168,31,199,0,199,1,132,66,21.04.2019 23:40,91,8,Kiev
784,772,69,230,485,69,554,0,554,15,400,139,21.04.2019 22:00,91,8,Kiev
176,168,19,43,114,19,133,0,133,1,101,31,21.04.2019 21:10,91,8,Kiev
256,254,20,109,127,20,147,0,147,2,82,63,21.04.2019 21:00,91,8,Kiev
272,271,25,85,163,24,187,0,187,1,148,38,22.04.2019 00:15,91,8,Kiev
400,368,22,169,209,22,231,0,231,6,182,43,21.04.2019 20:30,91,8,Kiev
1104,1083,76,429,599,76,675,0,675,12,513,150,21.04.2019 21:32,91,8,Kiev
320,314,37,105,179,36,215,0,215,3,164,48,21.04.2019 21:08,91,8,Kiev
368,365,34,134,200,34,234,0,234,6,136,92,22.04.2019 03:08,91,8,Kiev
560,543,30,211,322,27,349,0,349,7,243,99,21.04.2019 20:55,91,8,Kiev
576,561,16,241,319,16,335,0,335,4,231,100,21.04.2019 21:40,91,8,Kiev
864,863,70,404,395,65,460,0,460,15,359,86,22.04.2019 05:07,91,8,Kiev
448,448,42,148,260,40,300,0,300,2,226,72,21.04.2019 21:00,91,8,Kiev
368,364,15,153,201,14,215,0,215,3,173,39,22.04.2019 00:00,91,8,Kiev
192,188,10,33,149,10,159,0,159,0,108,51,21.04.2019 22:45,91,8,Kiev
176,174,14,29,133,14,147,0,147,2,98,47,21.04.2019 23:50,91,8,Kiev
448,441,50,135,270,43,313,0,313,5,235,73,21.04.2019 21:48,91,8,Kiev
2128,2107,46,985,1099,44,1143,0,1143,35,854,254,21.04.2019 22:00,91,8,Kiev
880,866,35,405,441,34,475,0,475,6,373,96,21.04.2019 20:50,91,8,Kiev
432,408,24,201,209,22,231,0,231,3,168,60,21.04.2019 23:53,91,8,Kiev
656,664,61,281,316,59,375,0,375,4,262,109,21.04.2019 21:40,91,8,Kiev
624,603,57,314,260,50,310,0,310,4,239,67,21.04.2019 20:30,91,8,Kiev
576,564,47,219,314,43,357,0,357,4,265,88,21.04.2019 21:10,91,8,Kiev
128,128,17,42,72,14,86,0,86,1,65,20,21.04.2019 20:40,91,8,Kiev
272,258,31,92,150,30,180,0,180,3,103,74,21.04.2019 20:47,91,8,Kiev
784,788,50,359,382,43,425,0,425,9,309,107,22.04.2019 00:25,91,8,Kiev
1136,1127,23,520,597,19,616,0,616,12,475,129,21.04.2019 22:10,91,8,Kiev
560,557,15,239,308,13,321,0,321,5,253,63,21.04.2019 22:00,91,8,Kiev
480,474,21,188,275,17,292,0,292,6,233,53,21.04.2019 22:23,91,8,Kiev
480,471,43,215,227,38,265,0,265,4,216,45,21.04.2019 21:14,91,8,Kiev
496,481,39,107,350,39,389,0,389,8,128,253,21.04.2019 21:06,91,8,Kiev
672,657,66,271,345,56,401,0,401,8,301,92,21.04.2019 21:05,91,8,Kiev
240,232,30,107,105,28,133,0,133,2,108,23,21.04.2019 21:30,91,8,Kiev
560,558,50,204,306,50,356,0,356,8,270,78,21.04.2019 23:00,91,8,Kiev
512,529,41,163,311,38,349,0,349,2,253,94,22.04.2019 00:10,91,8,Kiev
608,584,41,319,251,38,289,0,289,7,202,80,22.04.2019 00:05,91,8,Kiev
880,857,24,429,431,20,451,0,451,6,334,111,22.04.2019 00:20,91,8,Kiev
912,902,46,360,510,42,552,0,552,5,416,131,21.04.2019 21:50,91,8,Kiev
272,251,17,96,159,17,176,0,176,1,150,25,21.04.2019 23:45,91,8,Kiev
432,423,33,146,258,28,286,0,286,3,157,126,22.04.2019 00:15,91,8,Kiev
1520,1507,56,718,764,38,802,0,802,21,580,201,22.04.2019 01:00,91,8,Kiev
1056,1030,24,463,570,23,593,0,593,8,439,146,21.04.2019 23:37,91,8,Kiev
784,780,30,373,382,29,411,0,411,12,282,117,22.04.2019 02:00,91,8,Kiev
192,188,6,56,131,5,136,0,136,2,104,30,21.04.2019 21:00,91,8,Kiev
384,375,29,184,177,23,200,0,200,6,144,50,22.04.2019 00:36,91,8,Kiev
1504,1495,35,579,900,25,925,0,925,35,631,259,21.04.2019 22:22,91,8,Kiev
1504,1491,24,615,869,20,889,0,889,25,618,246,21.04.2019 21:00,91,8,Kiev
1312,1296,12,564,736,12,748,0,748,28,528,192,21.04.2019 21:20,91,8,Kiev
1696,1668,18,666,1014,16,1030,0,1030,29,717,284,21.04.2019 22:10,91,8,Kiev
544,529,18,269,262,13,275,0,275,4,185,86,22.04.2019 00:05,91,8,Kiev
976,969,32,423,522,31,553,0,553,10,410,133,21.04.2019 21:37,91,8,Kiev
512,498,14,232,267,13,280,0,280,7,224,49,21.04.2019 21:30,91,8,Kiev
80,67,0,35,45,0,45,0,45,0,24,21,21.04.2019 21:00,91,8,Kiev
1600,1587,8,610,983,7,990,0,990,25,744,221,22.04.2019 00:20,91,8,Kiev
1904,1892,4,708,1194,2,1196,0,1196,29,891,276,22.04.2019 00:25,91,8,Kiev
1632,1612,11,609,1014,9,1023,0,1023,34,737,252,22.04.2019 04:00,91,8,Kiev
1760,1737,4,698,1059,3,1062,0,1062,25,858,179,22.04.2019 00:04,91,8,Kiev
1584,1547,13,640,931,13,944,0,944,21,691,232,22.04.2019 00:30,91,8,Kiev
1936,1914,16,797,1123,16,1139,0,1139,32,875,232,22.04.2019 00:50,91,8,Kiev
1680,1667,15,729,937,14,951,0,951,17,740,194,22.04.2019 00:10,91,8,Kiev
2032,1996,12,906,1115,11,1126,0,1126,21,873,232,22.04.2019 04:35,91,8,Kiev
1504,1494,11,632,865,7,872,0,872,22,643,207,22.04.2019 00:40,91,8,Kiev
1472,1446,11,608,855,9,864,0,864,11,636,217,22.04.2019 00:25,91,8,Kiev
1600,1583,6,737,858,5,863,0,863,34,607,222,22.04.2019 00:01,91,8,Kiev
1920,1902,11,817,1097,6,1103,0,1103,38,781,284,22.04.2019 00:15,91,8,Kiev
1712,1706,10,671,1034,7,1041,0,1041,25,761,255,22.04.2019 00:05,91,8,Kiev
1760,1750,11,557,1193,10,1203,0,1203,29,775,399,22.04.2019 01:55,91,8,Kiev
1920,1894,8,758,1159,3,1162,0,1162,34,796,332,22.04.2019 02:55,91,8,Kiev
1872,1843,14,676,1184,12,1196,0,1196,36,838,322,22.04.2019 00:12,91,8,Kiev
2048,2028,8,771,1269,8,1277,0,1277,41,869,367,22.04.2019 00:05,91,8,Kiev
1680,1667,12,590,1081,9,1090,0,1090,31,721,338,22.04.2019 00:05,91,8,Kiev
1856,1848,14,736,1111,9,1120,0,1120,41,757,322,22.04.2019 00:07,91,8,Kiev
1952,1927,4,663,1287,2,1289,0,1289,28,909,352,22.04.2019 00:15,91,8,Kiev
1568,1557,7,596,967,5,972,0,972,21,710,241,22.04.2019 00:20,91,8,Kiev
1712,1683,5,587,1123,2,1125,0,1125,26,774,325,22.04.2019 00:01,91,8,Kiev
1632,1590,9,690,935,7,942,0,942,22,679,241,22.04.2019 00:10,91,8,Kiev
352,107,59,248,58,46,104,0,104,4,80,20,21.04.2019 21:00,91,8,Kiev
1840,1818,0,689,1151,0,1151,0,1151,27,705,419,22.04.2019 03:40,91,8,Kiev
1008,997,14,482,513,13,526,0,526,11,399,116,22.04.2019 00:15,92,8,Kiev
1776,1738,11,716,1052,8,1060,0,1060,27,824,209,22.04.2019 00:15,92,8,Kiev
656,651,6,315,337,4,341,0,341,9,267,65,21.04.2019 21:00,92,8,Kiev
1168,1134,4,532,633,3,636,0,636,19,464,153,21.04.2019 23:45,92,8,Kiev
1600,1586,13,719,868,13,881,0,881,18,627,236,22.04.2019 01:15,92,8,Kiev
1840,1811,12,802,1032,6,1038,0,1038,31,780,227,22.04.2019 00:47,92,8,Kiev
1920,1892,6,763,1153,4,1157,0,1157,26,845,286,22.04.2019 01:05,92,8,Kiev
1152,1143,29,345,778,29,807,0,807,21,617,169,22.04.2019 00:20,92,8,Kiev
368,363,38,110,222,36,258,0,258,7,175,76,21.04.2019 20:40,92,8,Kiev
480,470,40,163,278,39,317,0,317,5,272,40,21.04.2019 21:30,92,8,Kiev
208,198,34,51,123,34,157,0,157,4,97,56,21.04.2019 21:01,92,8,Kiev
720,702,68,253,400,67,467,0,467,7,335,125,22.04.2019 00:18,92,8,Kiev
368,360,33,96,239,33,272,0,272,6,188,78,21.04.2019 21:00,92,8,Kiev
784,763,60,190,534,60,594,0,594,11,472,111,21.04.2019 22:10,92,8,Kiev
256,254,23,73,160,23,183,0,183,5,139,39,21.04.2019 21:50,92,8,Kiev
672,665,70,212,393,67,460,0,460,10,332,118,22.04.2019 00:15,92,8,Kiev
256,255,38,75,143,38,181,0,181,0,98,83,21.04.2019 21:01,92,8,Kiev
144,142,20,37,87,20,107,0,107,0,73,34,21.04.2019 21:50,92,8,Kiev
352,346,59,91,202,59,261,0,261,6,177,78,22.04.2019 00:15,92,8,Kiev
400,398,55,104,241,55,296,0,296,8,184,104,21.04.2019 21:15,92,8,Kiev
400,399,26,140,234,26,260,0,260,12,190,58,21.04.2019 23:50,92,8,Kiev
992,977,36,395,561,36,597,0,597,17,460,120,22.04.2019 00:10,92,8,Kiev
560,544,11,223,327,10,337,0,337,4,264,69,21.04.2019 21:40,92,8,Kiev
992,969,99,328,569,95,664,0,664,10,529,125,22.04.2019 01:00,92,8,Kiev
448,441,41,166,241,41,282,0,282,5,225,52,21.04.2019 21:50,92,8,Kiev
1344,1333,39,633,672,39,711,0,711,24,519,168,21.04.2019 22:30,92,8,Kiev
976,962,14,463,500,13,513,0,513,21,371,121,22.04.2019 00:05,92,8,Kiev
224,217,12,85,127,12,139,0,139,4,98,37,21.04.2019 21:20,92,8,Kiev
400,389,31,90,280,30,310,0,310,3,218,89,21.04.2019 20:30,92,8,Kiev
688,691,51,250,391,47,438,0,438,4,337,97,22.04.2019 00:05,92,8,Kiev
544,540,25,194,327,23,350,0,350,6,248,96,22.04.2019 02:39,92,8,Kiev
944,933,56,313,575,56,631,0,631,8,428,195,22.04.2019 00:12,92,8,Kiev
880,872,45,323,512,45,557,0,557,10,379,168,22.04.2019 00:20,92,8,Kiev
432,433,66,128,239,65,304,0,304,6,227,71,21.04.2019 21:00,92,8,Kiev
336,320,43,105,188,43,231,0,231,7,155,69,21.04.2019 20:25,92,8,Kiev
592,583,59,178,355,59,414,0,414,5,253,156,21.04.2019 21:00,92,8,Kiev
496,485,31,185,282,29,311,0,311,4,220,87,21.04.2019 22:05,92,8,Kiev
176,180,12,58,106,12,118,0,118,2,86,30,22.04.2019 00:30,92,8,Kiev
336,325,30,41,265,30,295,0,295,4,159,132,21.04.2019 21:00,92,8,Kiev
496,491,25,190,283,23,306,0,306,7,225,74,21.04.2019 21:10,92,8,Kiev
816,793,30,264,523,29,552,0,552,14,448,90,22.04.2019 00:15,92,8,Kiev
592,583,34,199,359,34,393,0,393,7,284,102,22.04.2019 00:03,92,8,Kiev
912,897,62,298,555,59,614,0,614,15,404,195,22.04.2019 05:25,92,8,Kiev
1920,1876,92,619,1211,90,1301,0,1299,33,1043,223,21.04.2019 23:10,92,8,Kiev
400,403,39,118,243,39,282,0,282,5,180,97,21.04.2019 20:40,92,8,Kiev
144,150,29,33,83,28,111,0,111,0,92,19,21.04.2019 20:40,92,8,Kiev
256,250,26,60,170,26,196,0,196,5,157,34,21.04.2019 20:45,92,8,Kiev
1856,1824,31,736,1091,29,1120,0,1120,25,773,322,21.04.2019 21:25,92,8,Kiev
1376,1367,9,556,813,7,820,0,820,17,615,188,22.04.2019 01:05,92,8,Kiev
352,342,33,93,227,32,259,0,259,2,178,79,22.04.2019 06:55,92,8,Kiev
576,574,65,219,292,65,357,0,357,12,252,93,21.04.2019 22:20,92,8,Kiev
384,378,22,152,210,22,232,0,232,4,164,64,21.04.2019 21:10,92,8,Kiev
912,897,90,344,481,87,568,0,568,13,437,118,21.04.2019 21:00,92,8,Kiev
224,79,16,158,52,14,66,0,66,0,49,17,21.04.2019 22:50,92,8,Kiev
608,594,44,241,335,32,367,0,367,7,281,79,21.04.2019 21:50,92,8,Kiev
176,176,19,48,111,17,128,0,128,4,92,32,21.04.2019 21:00,92,8,Kiev
1792,1742,30,695,1069,28,1097,0,1097,20,785,292,22.04.2019 00:50,92,8,Kiev
1408,1390,16,555,838,15,853,0,853,20,628,205,22.04.2019 00:55,92,8,Kiev
352,343,41,130,183,39,222,0,222,4,180,38,21.04.2019 22:03,92,8,Kiev
80,80,3,38,39,3,42,0,42,0,31,11,22.04.2019 00:15,92,8,Kiev
752,747,36,308,417,27,444,0,444,9,330,105,22.04.2019 00:25,92,8,Kiev
640,621,34,292,316,32,348,0,348,8,266,74,21.04.2019 23:00,92,8,Kiev
432,422,67,155,219,58,277,0,277,7,212,58,21.04.2019 21:46,92,8,Kiev
304,293,38,95,179,30,209,0,209,13,121,75,22.04.2019 01:30,92,8,Kiev
416,417,23,160,233,23,256,0,256,5,160,91,21.04.2019 22:25,92,8,Kiev
128,127,14,35,80,13,93,0,93,1,60,32,21.04.2019 23:55,92,8,Kiev
544,539,38,242,264,38,302,0,302,2,242,58,21.04.2019 22:10,92,8,Kiev
752,745,40,284,431,37,468,0,468,3,377,88,21.04.2019 22:00,92,8,Kiev
304,294,42,113,154,37,191,0,191,2,172,17,21.04.2019 23:00,92,8,Kiev
400,390,36,118,249,33,282,0,282,0,238,44,21.04.2019 21:35,92,8,Kiev
288,286,12,91,188,9,197,0,197,2,161,34,22.04.2019 06:10,92,8,Kiev
528,518,47,136,349,43,392,0,392,7,292,93,22.04.2019 00:45,92,8,Kiev
176,170,9,53,114,9,123,0,123,4,98,21,21.04.2019 22:05,92,8,Kiev
176,171,13,59,105,12,117,0,117,1,88,28,21.04.2019 22:01,92,8,Kiev
80,76,7,23,50,7,57,0,57,1,50,6,22.04.2019 00:10,92,8,Kiev
384,382,42,124,225,35,260,0,260,5,166,89,21.04.2019 20:45,92,8,Kiev
496,504,53,167,281,48,329,0,329,8,225,96,21.04.2019 21:00,92,8,Kiev
352,346,41,89,224,39,263,0,263,3,158,102,21.04.2019 21:05,92,8,Kiev
160,150,14,38,111,11,122,0,122,1,99,22,21.04.2019 21:20,92,8,Kiev
400,387,27,135,241,24,265,0,265,2,213,50,21.04.2019 22:40,92,8,Kiev
144,130,16,48,81,15,96,0,96,5,59,32,22.04.2019 01:20,92,8,Kiev
128,24,12,105,11,12,23,0,23,1,14,8,21.04.2019 21:10,92,8,Kiev
1424,1384,10,692,723,9,732,0,732,22,578,132,22.04.2019 00:05,92,8,Kiev
1840,1811,6,722,1115,3,1118,0,1118,42,805,271,22.04.2019 02:01,92,8,Kiev
1440,1409,4,601,835,4,839,0,839,21,606,212,22.04.2019 00:14,92,8,Kiev
1072,1044,3,456,613,3,616,0,616,10,500,106,22.04.2019 00:20,92,8,Kiev
256,249,0,123,133,0,133,0,133,1,99,33,22.04.2019 00:02,92,8,Kiev
496,505,54,192,257,47,304,0,304,10,241,53,22.04.2019 02:40,92,8,Kiev
720,719,75,227,420,73,493,0,493,12,329,152,22.04.2019 01:05,92,8,Kiev
224,217,25,49,150,25,175,0,175,5,130,40,22.04.2019 02:50,92,8,Kiev
400,392,29,175,199,26,225,0,225,4,163,58,22.04.2019 00:05,92,8,Kiev
272,265,19,112,146,14,160,0,160,2,92,66,22.04.2019 00:15,92,8,Kiev
240,236,19,83,140,17,157,0,157,4,102,51,21.04.2019 21:20,92,8,Kiev
272,271,34,101,141,30,171,0,171,0,123,48,21.04.2019 21:20,92,8,Kiev
128,113,7,58,63,7,70,0,70,2,55,13,21.04.2019 22:20,92,8,Kiev
400,391,23,166,214,20,234,0,234,5,170,59,21.04.2019 21:00,92,8,Kiev
720,724,63,300,362,58,420,0,420,5,314,101,22.04.2019 00:55,92,8,Kiev
592,580,40,283,269,40,309,0,309,5,243,61,21.04.2019 22:10,92,8,Kiev
256,252,23,54,179,23,202,0,202,1,150,51,21.04.2019 21:31,92,8,Kiev
112,111,5,17,90,5,95,0,95,0,73,22,21.04.2019 21:45,92,8,Kiev
256,252,18,63,175,18,193,0,193,1,143,49,22.04.2019 00:15,92,8,Kiev
176,169,6,74,96,6,102,0,102,1,72,29,21.04.2019 21:00,92,8,Kiev
160,24,19,138,5,17,22,0,22,0,16,6,22.04.2019 00:05,92,8,Kiev
368,363,28,174,166,28,194,0,194,3,145,46,21.04.2019 20:52,92,8,Kiev
816,806,70,296,452,68,520,0,520,7,390,123,22.04.2019 00:20,92,8,Kiev
512,506,50,176,286,50,336,0,336,2,267,67,21.04.2019 21:05,92,8,Kiev
416,417,29,142,248,26,274,0,274,2,198,74,21.04.2019 20:45,92,8,Kiev
560,550,28,198,336,26,362,0,362,12,245,105,21.04.2019 21:25,92,8,Kiev
736,717,47,285,407,44,451,0,451,10,352,89,21.04.2019 21:10,92,8,Kiev
640,627,64,198,380,62,442,0,442,8,335,99,21.04.2019 21:05,92,8,Kiev
256,255,34,91,134,31,165,0,165,7,112,46,21.04.2019 21:00,92,8,Kiev
848,829,60,345,447,56,503,0,503,8,377,118,21.04.2019 21:30,92,8,Kiev
832,832,68,320,452,60,512,0,512,16,374,122,21.04.2019 21:15,92,8,Kiev
208,207,41,47,123,38,161,0,161,3,136,22,21.04.2019 21:06,92,8,Kiev
656,653,61,237,367,52,419,0,419,8,291,120,21.04.2019 21:17,92,8,Kiev
544,550,23,194,329,21,350,0,350,14,254,82,22.04.2019 00:15,92,8,Kiev
272,269,34,95,148,29,177,0,177,9,115,53,21.04.2019 21:20,92,8,Kiev
352,343,37,115,202,35,237,0,237,1,181,55,21.04.2019 21:30,92,8,Kiev
1264,1237,23,570,673,21,694,0,694,19,523,152,21.04.2019 21:30,92,8,Kiev
1168,1150,41,536,595,37,632,0,632,10,475,147,21.04.2019 21:50,92,8,Kiev
384,372,41,166,181,37,218,0,218,6,153,59,21.04.2019 21:30,92,8,Kiev
304,297,23,96,188,20,208,0,208,8,133,67,22.04.2019 00:10,92,8,Kiev
2096,2048,35,925,1144,27,1171,0,1171,29,861,281,22.04.2019 00:45,92,8,Kiev
2016,1991,35,865,1118,33,1151,0,1151,32,852,267,21.04.2019 23:57,92,8,Kiev
2080,2048,23,951,1109,20,1129,0,1129,31,868,230,21.04.2019 21:34,92,8,Kiev
464,452,66,143,256,65,321,0,321,8,230,83,21.04.2019 20:58,92,8,Kiev
400,402,40,149,213,38,251,0,251,8,141,102,21.04.2019 21:20,92,8,Kiev
352,342,19,159,174,19,193,0,193,8,126,59,21.04.2019 23:35,92,8,Kiev
80,71,9,16,55,9,64,0,64,0,27,37,21.04.2019 22:40,92,8,Kiev
496,500,33,170,297,29,326,0,326,5,214,107,21.04.2019 21:13,92,8,Kiev
400,398,50,133,217,50,267,0,267,6,183,78,21.04.2019 22:30,92,8,Kiev
512,504,43,186,292,34,326,0,326,6,256,64,22.04.2019 00:15,92,8,Kiev
1856,1808,19,736,1101,19,1120,0,1120,27,842,251,22.04.2019 01:05,92,8,Kiev
1872,1841,10,718,1144,10,1154,0,1154,28,871,255,22.04.2019 00:25,92,8,Kiev
1920,1878,12,830,1079,11,1090,0,1090,21,786,283,22.04.2019 00:05,92,8,Kiev
992,976,87,404,509,79,588,0,588,10,395,183,21.04.2019 21:50,92,8,Kiev
336,334,21,140,178,18,196,0,196,0,139,57,21.04.2019 21:17,92,8,Kiev
448,439,30,128,290,30,320,0,320,3,224,93,21.04.2019 20:43,92,8,Kiev
320,306,20,118,183,19,202,0,202,2,135,65,22.04.2019 00:55,92,8,Kiev
144,146,9,40,95,9,104,0,104,4,68,32,22.04.2019 00:05,92,8,Kiev
384,374,33,159,197,28,225,0,225,10,183,32,22.04.2019 00:10,92,8,Kiev
560,546,31,271,259,30,289,0,289,3,237,49,22.04.2019 00:20,92,8,Kiev
400,386,32,133,239,28,267,0,267,4,222,41,21.04.2019 21:22,92,8,Kiev
1664,1661,43,646,977,41,1018,0,1018,22,798,198,22.04.2019 00:26,92,8,Kiev
512,497,18,216,278,18,296,0,296,6,209,81,21.04.2019 21:00,92,8,Kiev
224,207,12,72,141,11,152,0,152,4,88,60,21.04.2019 21:05,92,8,Kiev
464,454,20,207,238,19,257,0,257,7,197,53,21.04.2019 23:50,92,8,Kiev
944,926,40,346,569,29,598,0,598,14,467,117,21.04.2019 21:40,92,8,Kiev
288,273,25,87,176,25,201,0,201,3,137,61,21.04.2019 21:40,92,8,Kiev
576,579,57,180,344,52,396,0,396,2,319,75,21.04.2019 23:00,92,8,Kiev
496,478,28,203,269,24,293,0,293,0,225,68,22.04.2019 00:30,92,8,Kiev
480,472,31,170,285,25,310,0,310,5,239,66,22.04.2019 03:15,92,8,Kiev
496,479,56,186,254,56,310,0,310,3,247,60,21.04.2019 20:34,92,8,Kiev
528,533,45,193,292,43,335,0,335,17,226,92,21.04.2019 21:00,92,8,Kiev
608,612,53,217,342,49,391,0,391,4,284,103,21.04.2019 21:15,92,8,Kiev
384,377,34,117,236,31,267,0,267,7,190,70,21.04.2019 21:00,92,8,Kiev
272,261,36,86,152,34,186,0,186,5,148,33,21.04.2019 21:00,92,8,Kiev
288,275,24,83,181,24,205,0,205,9,150,46,22.04.2019 00:20,92,8,Kiev
128,127,10,43,77,8,85,0,85,5,60,20,21.04.2019 21:30,92,8,Kiev
896,884,11,470,416,10,426,0,426,10,281,135,21.04.2019 22:18,92,8,Kiev
480,467,96,149,236,95,331,0,331,4,211,116,21.04.2019 21:35,92,8,Kiev
144,134,11,60,75,9,84,0,84,1,57,26,21.04.2019 22:00,92,8,Kiev
144,34,11,111,23,10,33,0,33,0,26,7,22.04.2019 00:20,92,8,Kiev
368,367,22,162,187,19,206,0,206,2,143,61,21.04.2019 21:20,92,8,Kiev
512,511,43,165,308,39,347,0,347,6,264,77,21.04.2019 20:30,92,8,Kiev
400,400,46,142,215,43,258,0,258,5,206,47,22.04.2019 00:25,92,8,Kiev
128,126,22,34,75,19,94,0,94,0,63,31,21.04.2019 21:31,92,8,Kiev
496,487,63,173,266,57,323,0,323,7,183,133,22.04.2019 00:30,92,8,Kiev
592,582,79,207,324,61,385,0,385,5,263,117,22.04.2019 00:30,92,8,Kiev
272,266,16,90,166,16,182,0,182,1,135,46,21.04.2019 23:00,92,8,Kiev
832,822,51,299,485,48,533,0,533,15,384,134,21.04.2019 23:55,92,8,Kiev
288,279,11,128,149,11,160,0,160,5,82,73,21.04.2019 21:45,92,8,Kiev
976,946,28,482,471,23,494,0,494,10,385,99,22.04.2019 00:10,92,8,Kiev
1440,1412,46,731,666,43,709,0,709,11,542,156,21.04.2019 21:00,92,8,Kiev
480,476,46,156,280,44,324,0,324,3,262,59,22.04.2019 00:10,92,8,Kiev
288,271,20,94,174,20,194,0,194,3,120,71,22.04.2019 00:10,92,8,Kiev
176,169,16,71,94,11,105,0,105,1,89,15,22.04.2019 05:26,92,8,Kiev
240,232,14,83,143,14,157,0,157,3,104,50,21.04.2019 21:08,92,8,Kiev
560,540,50,240,274,46,320,0,320,6,241,73,21.04.2019 21:15,92,8,Kiev
176,176,13,59,104,13,117,0,117,5,66,46,21.04.2019 20:28,92,8,Kiev
592,576,47,223,323,46,369,0,369,10,256,103,22.04.2019 00:09,92,8,Kiev
800,793,50,344,409,47,456,0,456,12,305,139,21.04.2019 23:50,92,8,Kiev
384,375,24,151,212,21,233,0,233,6,171,56,22.04.2019 05:15,92,8,Kiev
544,543,30,228,289,27,316,0,316,6,268,42,22.04.2019 00:13,92,8,Kiev
560,551,37,220,306,34,340,0,340,7,260,73,22.04.2019 00:40,92,8,Kiev
576,556,74,176,328,72,400,0,400,8,225,167,22.04.2019 00:07,92,8,Kiev
416,402,63,149,208,59,267,0,267,5,204,58,22.04.2019 00:45,92,8,Kiev
496,480,39,203,255,38,293,0,293,6,203,84,21.04.2019 21:15,92,8,Kiev
192,194,15,63,114,15,129,0,129,1,96,32,21.04.2019 20:50,92,8,Kiev
2416,2380,29,1099,1292,25,1317,0,1317,26,1032,259,22.04.2019 03:05,92,8,Kiev
192,89,47,107,40,45,85,0,85,1,62,22,22.04.2019 00:05,92,8,Kiev
1200,1181,18,447,738,15,753,0,753,16,571,166,21.04.2019 23:30,92,8,Kiev
336,325,13,82,242,12,254,0,254,6,189,59,22.04.2019 00:30,93,8,Kiev
752,734,31,224,501,27,528,0,528,9,405,114,22.04.2019 00:38,93,8,Kiev
160,157,9,41,110,9,119,0,119,3,78,38,22.04.2019 00:30,93,8,Kiev
432,430,45,118,270,44,314,0,314,5,235,74,22.04.2019 00:10,93,8,Kiev
224,205,28,66,133,25,158,0,158,0,112,46,21.04.2019 23:10,93,8,Kiev
464,454,46,151,270,43,313,0,313,4,249,60,21.04.2019 23:50,93,8,Kiev
544,537,37,222,290,32,322,0,322,2,245,75,22.04.2019 00:30,93,8,Kiev
528,518,20,208,300,20,320,0,320,3,265,52,22.04.2019 00:15,93,8,Kiev
528,511,28,219,288,21,309,0,309,7,197,105,22.04.2019 01:00,93,8,Kiev
416,416,51,129,240,47,287,0,287,6,182,99,22.04.2019 00:30,93,8,Kiev
464,466,65,45,357,62,419,0,419,0,209,210,22.04.2019 00:30,93,8,Kiev
160,150,4,79,78,3,81,0,81,1,51,29,22.04.2019 01:20,93,8,Kiev
464,448,44,170,252,42,294,0,294,9,210,75,22.04.2019 00:45,93,8,Kiev
208,208,36,63,114,31,145,0,145,1,91,53,21.04.2019 21:00,93,8,Kiev
304,299,24,100,180,24,204,0,204,1,162,41,22.04.2019 00:15,93,8,Kiev
1104,1087,81,473,566,65,631,0,631,9,511,111,22.04.2019 00:15,93,8,Kiev
288,273,30,70,193,25,218,0,218,5,156,57,21.04.2019 23:00,93,8,Kiev
112,101,7,25,81,6,87,0,87,0,72,15,22.04.2019 01:20,93,8,Kiev
400,389,9,116,278,6,284,0,284,4,210,70,22.04.2019 00:25,93,8,Kiev
80,71,4,23,53,4,57,0,57,0,35,22,22.04.2019 00:45,93,8,Kiev
160,38,16,122,22,16,38,0,38,1,27,10,22.04.2019 00:25,93,8,Kiev
320,321,15,115,190,15,205,0,205,3,155,47,22.04.2019 04:05,93,8,Kiev
160,148,16,45,99,16,115,0,115,1,79,35,22.04.2019 03:20,93,8,Kiev
192,178,27,61,107,24,131,0,131,2,95,34,21.04.2019 21:30,93,8,Kiev
160,154,24,43,93,24,117,0,117,1,86,30,22.04.2019 00:15,93,8,Kiev
560,563,31,180,353,27,380,0,380,5,279,96,22.04.2019 01:25,93,8,Kiev
288,295,35,37,221,30,251,0,251,25,92,134,22.04.2019 00:05,93,8,Kiev
464,471,55,147,268,49,317,0,317,7,234,76,21.04.2019 21:10,93,8,Kiev
336,337,27,139,175,22,197,0,197,4,142,51,22.04.2019 05:42,93,8,Kiev
336,339,31,88,217,31,248,0,248,5,194,49,22.04.2019 00:35,93,8,Kiev
80,74,9,20,55,5,60,0,60,1,33,26,22.04.2019 02:15,93,8,Kiev
416,409,47,114,255,47,302,0,302,3,212,87,22.04.2019 00:10,93,8,Kiev
208,211,23,42,143,23,166,1,166,1,115,50,21.04.2019 21:00,93,8,Kiev
128,119,17,32,80,16,96,0,96,0,64,32,21.04.2019 21:35,93,8,Kiev
384,385,36,103,247,34,281,0,281,8,188,85,22.04.2019 00:43,93,8,Kiev
832,833,89,238,514,80,594,0,594,11,461,122,22.04.2019 00:25,93,8,Kiev
240,249,23,81,138,21,159,0,159,1,95,63,22.04.2019 00:50,93,8,Kiev
112,111,17,15,80,17,97,0,97,1,66,30,22.04.2019 01:30,93,8,Kiev
1328,1323,110,427,797,104,901,0,901,10,632,259,21.04.2019 22:50,93,8,Kiev
368,360,42,110,218,40,258,0,258,1,186,71,22.04.2019 00:30,93,8,Kiev
368,366,36,93,239,36,275,0,275,0,219,56,21.04.2019 20:32,93,8,Kiev
448,449,51,132,270,46,316,0,316,6,202,108,22.04.2019 00:20,93,8,Kiev
384,398,57,102,228,54,282,0,282,5,186,91,22.04.2019 00:30,93,8,Kiev
448,464,43,74,335,39,374,0,374,5,154,215,21.04.2019 22:35,93,8,Kiev
96,92,14,11,71,14,85,0,85,1,43,41,21.04.2019 21:10,93,8,Kiev
176,177,10,45,122,9,131,0,131,1,93,37,22.04.2019 00:20,93,8,Kiev
672,656,1,268,403,1,404,0,404,10,320,74,22.04.2019 00:07,93,8,Kiev
2272,2259,15,818,1445,9,1454,0,1454,24,1125,305,22.04.2019 00:10,93,8,Kiev
1024,1022,12,372,646,6,652,0,652,15,496,141,22.04.2019 00:10,93,8,Kiev
832,813,6,307,519,6,525,0,525,16,432,77,22.04.2019 00:15,93,8,Kiev
2032,1998,29,819,1191,22,1213,0,1213,21,996,196,22.04.2019 00:10,93,8,Kiev
80,71,1,39,40,1,41,0,41,1,27,13,22.04.2019 00:02,93,8,Kiev
400,403,38,148,217,35,252,0,252,6,179,67,22.04.2019 04:27,93,8,Kiev
80,71,5,41,35,4,39,0,39,0,28,11,22.04.2019 00:10,93,8,Kiev
336,341,27,82,227,27,254,0,254,2,187,65,21.04.2019 22:30,93,8,Kiev
176,176,17,60,101,15,116,0,116,2,93,21,22.04.2019 00:05,93,8,Kiev
160,153,19,56,85,19,104,0,104,2,74,28,22.04.2019 00:10,93,8,Kiev
576,572,40,227,315,34,349,0,349,14,222,113,22.04.2019 00:30,93,8,Kiev
128,129,15,44,71,13,84,0,84,1,64,19,22.04.2019 00:00,93,8,Kiev
544,540,21,207,319,18,337,0,337,1,285,51,22.04.2019 02:50,93,8,Kiev
592,579,57,227,313,52,365,0,365,6,307,52,22.04.2019 00:20,93,8,Kiev
400,375,54,131,222,47,269,0,269,3,193,73,22.04.2019 00:05,93,8,Kiev
192,178,12,76,106,10,116,0,116,3,80,33,22.04.2019 00:10,93,8,Kiev
1072,1060,28,392,655,25,680,0,680,13,537,130,22.04.2019 00:40,93,8,Kiev
224,221,16,61,147,16,163,0,163,2,127,34,22.04.2019 01:45,93,8,Kiev
624,604,22,250,353,21,374,0,374,4,301,69,21.04.2019 22:00,93,8,Kiev
208,198,12,67,129,12,141,0,141,0,103,38,22.04.2019 00:05,93,8,Kiev
2240,2211,11,899,1334,7,1341,0,1341,36,1046,259,22.04.2019 01:20,93,8,Kiev
432,418,50,145,239,48,287,0,287,8,194,85,22.04.2019 00:32,93,8,Kiev
560,550,37,201,324,35,359,0,359,5,277,77,22.04.2019 00:25,93,8,Kiev
1568,1551,89,609,879,80,959,0,959,13,761,185,22.04.2019 00:48,93,8,Kiev
208,202,19,93,100,15,115,0,115,2,83,30,22.04.2019 00:15,93,8,Kiev
208,192,5,64,139,5,144,0,144,1,101,42,22.04.2019 00:07,93,8,Kiev
304,293,10,119,177,8,185,0,185,5,108,72,22.04.2019 00:15,93,8,Kiev
528,522,35,161,332,35,367,0,367,8,284,75,22.04.2019 00:30,93,8,Kiev
288,286,20,101,167,20,187,0,187,2,125,60,22.04.2019 00:15,93,8,Kiev
1232,1232,65,462,705,65,770,0,770,14,587,169,22.04.2019 00:30,93,8,Kiev
1280,1249,23,551,710,19,729,0,729,19,559,151,22.04.2019 00:10,93,8,Kiev
880,885,13,435,432,13,445,0,445,6,318,121,21.04.2019 23:00,93,8,Kiev
320,309,2,145,175,0,175,0,175,8,126,41,22.04.2019 00:11,93,8,Kiev
480,477,7,195,279,6,285,0,285,3,205,77,21.04.2019 21:30,93,8,Kiev
176,22,0,155,21,0,21,0,21,0,13,8,22.04.2019 00:30,93,8,Kiev
400,400,2,104,294,2,296,0,296,3,206,87,22.04.2019 01:45,93,8,Kiev
64,52,7,25,32,7,39,0,39,1,30,8,22.04.2019 01:00,93,8,Kiev
848,853,46,341,467,40,507,0,507,7,382,118,21.04.2019 21:19,94,8,Kiev
288,297,5,64,220,4,224,0,224,5,157,62,21.04.2019 21:30,94,8,Kiev
592,582,43,187,362,43,405,0,405,11,317,77,21.04.2019 20:30,94,8,Kiev
352,335,29,47,276,29,305,0,305,1,76,228,21.04.2019 20:26,94,8,Kiev
320,314,40,113,169,38,207,0,207,4,143,60,21.04.2019 20:35,94,8,Kiev
352,339,22,134,198,20,218,0,218,5,150,63,21.04.2019 21:05,94,8,Kiev
2352,2377,6,650,1697,5,1702,0,1702,38,973,691,22.04.2019 00:10,94,8,Kiev
1776,1784,6,585,1186,5,1191,0,1191,38,732,421,22.04.2019 01:15,94,8,Kiev
1024,1019,12,360,652,12,664,0,664,7,450,207,21.04.2019 20:50,94,8,Kiev
720,721,0,275,445,0,445,0,445,10,328,107,21.04.2019 20:55,94,8,Kiev
656,656,0,203,453,0,453,0,453,9,318,126,21.04.2019 21:23,94,8,Kiev
1680,1695,6,553,1121,6,1127,0,1127,17,757,353,22.04.2019 01:01,94,8,Kiev
1632,1660,6,499,1128,5,1133,0,1133,20,754,359,22.04.2019 00:05,94,8,Kiev
976,986,60,300,623,53,676,0,676,8,510,158,21.04.2019 21:00,94,8,Kiev
336,339,1,125,210,1,211,0,211,5,137,69,21.04.2019 20:34,94,8,Kiev
176,170,1,33,142,1,143,0,143,2,112,29,21.04.2019 20:40,94,8,Kiev
768,757,16,308,446,14,460,0,460,3,336,121,21.04.2019 20:41,94,8,Kiev
192,184,1,36,155,1,156,0,156,1,98,57,21.04.2019 20:35,94,8,Kiev
192,196,10,27,156,9,165,0,165,2,113,50,22.04.2019 02:25,94,8,Kiev
720,717,39,144,537,39,576,0,576,50,256,270,21.04.2019 22:30,94,8,Kiev
576,564,22,158,398,20,418,0,418,5,286,127,21.04.2019 20:34,94,8,Kiev
336,323,20,123,198,15,213,0,213,2,130,81,21.04.2019 21:40,94,8,Kiev
464,466,25,162,277,25,302,0,302,10,220,72,21.04.2019 23:00,94,8,Kiev
880,868,47,191,642,47,689,0,689,10,556,123,21.04.2019 20:58,94,8,Kiev
304,314,21,81,202,21,223,0,223,0,166,57,21.04.2019 20:41,94,8,Kiev
448,429,21,134,293,21,314,0,314,8,193,113,21.04.2019 20:35,94,8,Kiev
1360,1346,19,522,821,17,838,0,838,14,677,147,21.04.2019 21:25,94,8,Kiev
352,347,22,75,255,22,277,0,277,5,167,105,21.04.2019 20:20,94,8,Kiev
464,460,34,190,243,31,274,0,274,6,196,72,21.04.2019 20:37,94,8,Kiev
160,145,19,42,99,19,118,0,118,0,80,38,21.04.2019 20:28,94,8,Kiev
1344,1326,85,378,883,83,966,0,966,15,622,329,22.04.2019 00:20,94,8,Kiev
192,195,37,53,102,37,139,0,139,0,99,40,21.04.2019 20:50,94,8,Kiev
528,523,66,95,369,64,433,0,433,3,246,184,21.04.2019 20:40,94,8,Kiev
992,530,376,466,153,373,526,0,526,23,388,115,22.04.2019 02:05,94,8,Kiev
432,147,132,290,13,129,142,0,142,3,100,39,21.04.2019 21:00,94,8,Kiev
240,245,16,62,163,15,178,0,178,3,104,71,21.04.2019 21:00,94,8,Kiev
624,608,14,237,375,12,387,0,387,5,235,147,21.04.2019 21:13,94,8,Kiev
1328,1327,72,468,789,71,860,0,860,19,593,248,21.04.2019 23:30,94,8,Kiev
1456,1433,12,501,943,12,955,0,955,16,702,237,21.04.2019 21:36,94,8,Kiev
592,581,10,252,331,9,340,0,340,8,248,84,22.04.2019 01:40,94,8,Kiev
368,365,18,127,223,18,241,0,241,4,171,66,21.04.2019 21:00,94,8,Kiev
464,455,14,173,278,13,291,0,291,6,228,57,21.04.2019 21:31,94,8,Kiev
320,322,38,103,179,38,217,0,217,6,144,67,21.04.2019 20:45,94,8,Kiev
352,347,11,129,212,11,223,0,223,6,157,60,22.04.2019 01:10,94,8,Kiev
64,54,0,22,42,0,42,0,42,0,18,24,21.04.2019 20:14,94,8,Kiev
416,410,18,167,231,18,249,0,249,7,175,67,21.04.2019 21:07,94,8,Kiev
512,510,5,171,336,5,341,0,341,9,247,85,22.04.2019 00:28,94,8,Kiev
1232,1205,19,556,657,19,676,0,676,12,463,201,21.04.2019 20:50,94,8,Kiev
448,435,38,132,278,38,316,0,316,7,227,82,21.04.2019 20:55,94,8,Kiev
112,103,12,32,68,12,80,0,80,0,62,18,21.04.2019 20:22,94,8,Kiev
512,505,9,184,319,9,328,0,328,7,231,90,21.04.2019 21:30,94,8,Kiev
272,254,24,108,140,24,164,0,164,6,95,63,21.04.2019 20:20,94,8,Kiev
400,393,22,126,252,22,274,0,274,7,202,65,21.04.2019 20:50,94,8,Kiev
928,961,19,299,612,17,629,0,629,17,443,169,21.04.2019 21:30,94,8,Kiev
448,438,33,159,256,33,289,0,289,4,194,91,21.04.2019 21:10,94,8,Kiev
112,113,9,31,72,9,81,0,81,0,57,24,21.04.2019 20:20,94,8,Kiev
720,734,20,256,444,20,464,0,464,11,336,117,21.04.2019 21:45,94,8,Kiev
288,276,5,109,174,5,179,0,179,3,119,57,22.04.2019 01:00,94,8,Kiev
2272,2261,17,935,1323,14,1337,0,1337,27,946,364,22.04.2019 04:28,94,8,Kiev
592,588,36,193,369,30,399,0,399,8,271,120,21.04.2019 20:58,94,8,Kiev
224,209,7,73,144,7,151,0,151,7,96,48,21.04.2019 21:15,94,8,Kiev
1456,1475,10,440,1010,6,1016,0,1016,28,724,264,21.04.2019 22:30,94,8,Kiev
2080,2099,16,711,1360,9,1369,0,1369,30,931,408,21.04.2019 22:00,94,8,Kiev
1552,1553,7,482,1066,4,1070,0,1070,35,715,320,21.04.2019 21:30,94,8,Kiev
2288,2306,7,722,1560,6,1566,0,1566,41,1098,427,22.04.2019 00:05,94,8,Kiev
144,7,1,138,5,1,6,0,6,0,5,1,22.04.2019 00:08,94,8,Kiev
1984,1977,11,604,1372,8,1380,0,1380,32,966,382,22.04.2019 00:15,94,8,Kiev
2176,2204,19,784,1379,13,1392,0,1392,28,963,401,21.04.2019 21:33,94,8,Kiev
1472,1467,13,523,940,9,949,0,949,14,685,250,21.04.2019 20:55,94,8,Kiev
1680,1664,9,592,1083,5,1088,0,1088,24,755,309,21.04.2019 20:50,94,8,Kiev
2112,2136,8,827,1280,5,1285,0,1285,32,870,383,21.04.2019 22:00,94,8,Kiev
1392,1374,8,516,870,6,876,0,876,15,674,187,22.04.2019 00:15,94,8,Kiev
1088,1094,5,300,784,4,788,0,788,17,529,242,22.04.2019 02:45,94,8,Kiev
2288,2289,6,674,1608,6,1614,0,1614,38,1086,490,22.04.2019 00:02,94,8,Kiev
2128,2119,10,625,1494,9,1503,0,1503,34,1005,464,21.04.2019 21:36,94,8,Kiev
2128,2151,4,586,1539,3,1542,0,1542,42,1080,420,21.04.2019 22:10,94,8,Kiev
2304,2305,5,676,1624,4,1628,0,1628,48,1054,526,22.04.2019 00:05,94,8,Kiev
2208,2215,6,708,1495,5,1500,0,1500,34,1020,446,21.04.2019 22:00,94,8,Kiev
1952,1957,3,637,1314,1,1315,0,1315,35,882,398,21.04.2019 21:05,94,8,Kiev
1824,1844,9,464,1355,5,1360,0,1360,33,898,429,22.04.2019 00:01,94,8,Kiev
2448,2476,12,837,1602,9,1611,0,1611,40,1099,472,21.04.2019 22:50,94,8,Kiev
2368,2391,7,872,1494,2,1496,0,1496,25,986,485,21.04.2019 21:45,94,8,Kiev
2448,2440,5,897,1547,4,1551,0,1551,40,1076,435,21.04.2019 22:50,94,8,Kiev
2272,2255,10,795,1469,8,1477,0,1477,40,1060,377,21.04.2019 22:30,94,8,Kiev
96,91,0,35,61,0,61,0,61,1,46,14,21.04.2019 22:00,94,8,Kiev
400,410,3,100,298,2,300,0,300,2,211,87,21.04.2019 20:55,94,8,Kiev
2160,2170,3,943,1214,3,1217,0,1217,21,852,344,21.04.2019 21:40,95,8,Kiev
1568,1577,1,577,990,1,991,0,991,23,646,322,21.04.2019 22:00,95,8,Kiev
480,465,0,157,323,0,323,0,323,7,199,117,21.04.2019 21:33,95,8,Kiev
1280,1267,0,550,730,0,730,0,730,21,506,203,21.04.2019 22:00,95,8,Kiev
1184,1174,3,362,819,3,822,0,822,27,506,289,21.04.2019 21:40,95,8,Kiev
2144,2133,6,710,1428,6,1434,0,1434,33,881,520,21.04.2019 21:39,95,8,Kiev
2096,2085,2,745,1349,2,1351,0,1351,44,825,482,21.04.2019 21:50,95,8,Kiev
1984,2005,0,651,1333,0,1333,0,1333,38,777,518,21.04.2019 22:35,95,8,Kiev
2128,2110,6,774,1349,5,1354,0,1354,37,844,473,21.04.2019 22:45,95,8,Kiev
1968,1968,5,686,1277,5,1282,0,1282,42,786,454,22.04.2019 00:02,95,8,Kiev
1824,1803,1,720,1103,1,1104,0,1104,26,708,370,21.04.2019 20:00,95,8,Kiev
2224,2198,12,855,1358,11,1369,0,1369,53,865,451,21.04.2019 21:33,95,8,Kiev
2096,2090,0,916,1180,0,1180,0,1180,47,818,315,21.04.2019 22:50,95,8,Kiev
2032,2050,0,688,1344,0,1344,0,1344,51,836,457,22.04.2019 00:10,95,8,Kiev
2080,2080,3,709,1369,2,1371,0,1371,40,864,467,22.04.2019 00:05,95,8,Kiev
1936,1931,2,587,1347,2,1349,0,1349,42,820,487,21.04.2019 22:00,95,8,Kiev
1968,1957,2,688,1278,2,1280,0,1280,33,784,463,21.04.2019 21:42,95,8,Kiev
1856,1855,0,761,1095,0,1095,0,1095,28,713,354,21.04.2019 22:15,95,8,Kiev
2400,2382,3,872,1525,3,1528,0,1528,41,951,536,21.04.2019 21:45,95,8,Kiev
2096,2068,0,912,1184,0,1184,0,1184,22,802,360,22.04.2019 00:20,95,8,Kiev
2464,2504,0,791,1673,0,1673,0,1673,40,1052,581,21.04.2019 22:40,95,8,Kiev
2560,2591,0,966,1594,0,1594,0,1594,28,1023,543,21.04.2019 22:01,95,8,Kiev
2336,2346,4,814,1519,3,1522,0,1522,21,1013,488,22.04.2019 00:05,95,8,Kiev
832,815,28,355,449,28,477,0,477,4,339,134,21.04.2019 21:30,95,8,Kiev
384,384,0,149,235,0,235,0,235,4,165,66,22.04.2019 00:01,95,8,Kiev
592,585,5,248,339,5,344,0,344,4,252,88,21.04.2019 21:30,95,8,Kiev
2048,2042,12,657,1379,12,1391,0,1391,26,943,422,21.04.2019 21:55,95,8,Kiev
1232,1228,0,426,806,0,806,0,806,13,492,301,21.04.2019 20:43,95,8,Kiev
2080,2137,2,666,1413,1,1414,0,1414,20,974,420,21.04.2019 22:00,95,8,Kiev
2352,2401,2,798,1552,2,1554,0,1554,30,1013,511,21.04.2019 21:30,95,8,Kiev
928,915,34,343,554,31,585,0,585,11,430,144,22.04.2019 00:25,95,8,Kiev
2448,2418,7,1108,1333,7,1340,0,1340,18,952,370,21.04.2019 22:20,95,8,Kiev
2336,2367,6,829,1504,3,1507,0,1507,33,933,541,21.04.2019 22:39,95,8,Kiev
2448,2486,0,873,1575,0,1575,0,1575,34,1038,503,21.04.2019 23:45,95,8,Kiev
2224,2405,4,509,1711,4,1715,0,1715,35,1054,626,21.04.2019 20:30,95,8,Kiev
2016,2171,1,489,1527,0,1527,0,1527,35,789,703,22.04.2019 00:10,95,8,Kiev
2224,2273,2,806,1416,2,1418,0,1418,24,907,487,21.04.2019 21:55,95,8,Kiev
1440,1457,0,582,858,0,858,0,858,12,611,235,21.04.2019 20:50,95,8,Kiev
528,518,0,251,277,0,277,0,277,1,209,67,21.04.2019 21:10,95,8,Kiev
464,12,9,456,1,7,8,0,8,0,5,3,21.04.2019 20:35,95,8,Kiev
128,7,0,122,6,0,6,0,6,1,5,0,22.04.2019 00:15,95,8,Kiev
1840,1960,8,535,1299,6,1305,0,1305,42,853,410,22.04.2019 00:30,95,8,Kiev
2480,2605,5,797,1680,3,1683,0,1683,46,1046,591,22.04.2019 01:17,95,8,Kiev
2336,2413,4,749,1584,3,1587,0,1587,41,1080,466,22.04.2019 00:15,95,8,Kiev
2432,2511,13,715,1709,8,1717,0,1717,44,1112,561,21.04.2019 22:00,95,8,Kiev
2096,2121,7,694,1397,5,1402,0,1402,53,825,524,22.04.2019 00:08,95,8,Kiev
2416,2568,6,769,1643,4,1647,0,1647,30,1065,552,21.04.2019 22:01,95,8,Kiev
2432,2535,9,757,1669,6,1675,0,1675,46,1125,504,21.04.2019 22:05,95,8,Kiev
2368,2485,12,665,1695,8,1703,0,1703,48,1104,551,22.04.2019 05:00,95,8,Kiev
2400,2545,7,654,1740,6,1746,0,1746,51,1096,599,21.04.2019 22:00,95,8,Kiev
2432,2527,5,773,1655,4,1659,0,1659,44,1068,547,21.04.2019 23:00,95,8,Kiev
2400,2665,7,698,1697,5,1702,0,1702,33,1105,564,22.04.2019 00:30,95,8,Kiev
2304,2513,5,610,1690,4,1694,0,1694,33,1101,560,21.04.2019 23:24,95,8,Kiev
2384,2635,20,605,1763,16,1779,0,1779,36,1101,642,22.04.2019 06:35,95,8,Kiev
880,899,0,319,561,0,561,0,561,10,364,187,21.04.2019 21:48,95,8,Kiev
2288,2357,11,713,1565,10,1575,0,1575,36,979,560,21.04.2019 23:55,95,8,Kiev
1616,1635,3,616,997,3,1000,0,1000,26,680,294,21.04.2019 23:00,95,8,Kiev
2112,2152,5,741,1367,4,1371,0,1371,40,906,425,21.04.2019 22:20,95,8,Kiev
2048,2035,2,837,1209,2,1211,0,1211,38,847,326,21.04.2019 23:35,95,8,Kiev
2272,2323,4,807,1462,3,1465,0,1465,32,933,500,21.04.2019 22:00,95,8,Kiev
2272,2284,7,819,1448,5,1453,0,1453,23,1046,384,22.04.2019 06:33,95,8,Kiev
976,970,2,406,569,1,570,0,570,13,391,166,22.04.2019 00:15,95,8,Kiev
2304,2286,1,879,1424,1,1425,0,1425,28,847,550,22.04.2019 00:15,95,8,Kiev
1984,1976,5,668,1311,5,1316,0,1316,25,796,495,21.04.2019 21:50,95,8,Kiev
1712,1705,1,592,1119,1,1120,0,1120,27,660,433,21.04.2019 21:53,95,8,Kiev
2112,2163,2,608,1503,1,1504,0,1504,38,920,546,21.04.2019 22:30,95,8,Kiev
2096,2089,3,716,1377,3,1380,0,1380,60,890,430,21.04.2019 21:19,95,8,Kiev
2512,2521,2,753,1759,0,1759,0,1759,42,1049,668,21.04.2019 22:16,95,8,Kiev
336,103,0,233,103,0,103,0,103,6,75,22,21.04.2019 20:14,95,8,Kiev
688,682,89,7,592,89,681,0,681,31,602,48,22.04.2019 00:10,95,8,Kiev
144,118,0,29,115,0,115,0,115,4,104,7,22.04.2019 00:05,95,8,Kiev
1264,1240,1,476,787,1,788,0,788,22,491,275,22.04.2019 00:10,95,8,Kiev
1984,2072,1,633,1350,1,1351,0,1351,16,790,545,21.04.2019 22:00,95,8,Kiev
2304,2333,16,616,1678,10,1688,0,1688,50,1137,501,22.04.2019 00:01,95,8,Kiev
2560,2647,2,814,1744,2,1746,0,1746,23,1008,715,21.04.2019 21:02,95,8,Kiev
1072,1078,1,348,723,1,724,0,724,13,450,261,21.04.2019 23:05,95,8,Kiev
1856,1930,0,559,1297,0,1297,0,1297,12,775,510,21.04.2019 22:30,95,8,Kiev
1360,1390,0,444,916,0,916,0,916,11,522,383,21.04.2019 21:28,95,8,Kiev
2192,2343,1,576,1615,1,1616,0,1616,20,936,660,21.04.2019 21:33,95,8,Kiev
1888,2140,4,450,1436,2,1438,0,1438,24,881,533,22.04.2019 00:05,95,8,Kiev
2096,2331,0,472,1624,0,1624,0,1624,35,965,624,22.04.2019 00:33,95,8,Kiev
48,6,0,42,6,0,6,0,6,0,5,1,22.04.2019 06:15,96,8,Kiev
1072,1079,9,480,588,4,592,0,592,13,467,112,21.04.2019 22:10,96,8,Kiev
1024,1015,5,449,573,2,575,0,575,15,455,105,22.04.2019 00:30,96,8,Kiev
256,242,5,127,128,1,129,0,129,1,108,20,22.04.2019 01:15,96,8,Kiev
2224,2201,7,852,1370,2,1372,0,1372,37,1013,322,21.04.2019 23:10,96,8,Kiev
2112,2093,25,844,1246,22,1268,0,1268,24,948,296,21.04.2019 23:00,96,8,Kiev
2192,2178,10,802,1384,6,1390,0,1390,30,1048,312,22.04.2019 00:38,96,8,Kiev
2176,2144,3,840,1333,3,1336,0,1336,33,964,339,22.04.2019 00:30,96,8,Kiev
1680,1668,2,601,1077,2,1079,0,1079,28,791,260,22.04.2019 02:05,96,8,Kiev
1664,1652,6,684,977,3,980,0,980,12,714,254,22.04.2019 00:40,96,8,Kiev
2272,2275,16,884,1378,10,1388,0,1388,31,952,405,22.04.2019 00:30,96,8,Kiev
1936,1940,24,586,1329,21,1350,0,1350,37,875,438,22.04.2019 02:50,96,8,Kiev
1920,1916,13,667,1242,11,1253,0,1253,23,877,353,22.04.2019 00:25,96,8,Kiev
1664,1650,6,721,938,5,943,0,943,20,658,265,22.04.2019 00:30,96,8,Kiev
1952,1937,17,869,1067,16,1083,0,1083,23,819,241,22.04.2019 01:45,96,8,Kiev
96,86,0,34,62,0,62,0,62,0,44,18,21.04.2019 20:20,96,8,Kiev
864,861,22,290,557,17,574,0,574,10,452,112,21.04.2019 21:15,96,8,Kiev
1456,1433,20,616,820,20,840,0,840,21,662,157,22.04.2019 00:10,96,8,Kiev
144,128,13,43,88,13,101,0,101,0,82,19,21.04.2019 20:45,96,8,Kiev
128,128,11,35,82,11,93,0,93,0,59,34,21.04.2019 21:52,96,8,Kiev
1552,1555,8,732,812,8,820,0,820,16,656,148,22.04.2019 00:10,96,8,Kiev
624,602,21,256,349,19,368,0,368,5,266,97,22.04.2019 04:30,96,8,Kiev
160,159,3,47,111,2,113,0,113,2,80,31,21.04.2019 23:30,96,8,Kiev
800,790,55,264,487,49,536,0,536,5,407,124,21.04.2019 22:00,96,8,Kiev
400,385,6,185,214,1,215,0,215,4,170,41,22.04.2019 00:10,96,8,Kiev
192,183,17,88,87,17,104,0,104,0,62,42,21.04.2019 21:00,96,8,Kiev
80,66,2,35,43,2,45,0,45,0,36,9,22.04.2019 00:32,96,8,Kiev
816,810,17,242,557,17,574,0,574,19,403,152,22.04.2019 01:00,96,8,Kiev
304,295,9,110,185,9,194,0,194,1,105,88,22.04.2019 00:40,96,8,Kiev
944,940,44,321,580,43,623,0,623,15,427,181,22.04.2019 01:30,96,8,Kiev
576,570,7,249,322,5,327,0,327,6,242,79,22.04.2019 00:20,96,8,Kiev
896,883,37,323,536,37,573,0,573,10,431,132,22.04.2019 00:10,96,8,Kiev
2128,2118,39,774,1316,38,1354,0,1354,27,1001,326,21.04.2019 22:25,96,8,Kiev
496,489,36,213,249,34,283,0,283,3,210,70,21.04.2019 23:02,96,8,Kiev
128,117,27,50,51,27,78,0,78,0,47,31,21.04.2019 20:55,96,8,Kiev
192,182,4,60,128,4,132,0,132,1,101,30,22.04.2019 04:30,96,8,Kiev
272,268,6,112,154,6,160,0,160,7,120,33,21.04.2019 20:50,96,8,Kiev
656,647,36,303,317,36,353,0,353,12,252,89,22.04.2019 00:26,96,8,Kiev
1072,1061,80,229,769,74,843,0,843,6,694,143,22.04.2019 01:30,96,8,Kiev
400,394,35,87,278,35,313,0,313,5,237,71,21.04.2019 22:50,96,8,Kiev
688,677,8,178,502,8,510,0,510,9,406,95,21.04.2019 21:15,96,8,Kiev
1088,1086,25,412,651,25,676,0,676,17,543,116,21.04.2019 21:41,96,8,Kiev
576,621,40,181,356,39,395,0,395,8,262,125,22.04.2019 00:15,96,8,Kiev
240,28,16,214,12,14,26,0,26,0,17,9,21.04.2019 20:20,96,8,Kiev
2400,2546,7,672,1724,4,1728,0,1728,47,1060,621,22.04.2019 03:03,96,8,Kiev
2304,2446,8,589,1708,7,1715,0,1715,35,1039,641,22.04.2019 00:10,96,8,Kiev
2256,2427,7,488,1761,7,1768,0,1768,44,1087,637,22.04.2019 00:40,96,8,Kiev
2304,2533,11,480,1816,8,1824,0,1824,39,1163,622,22.04.2019 00:30,96,8,Kiev
2336,2364,11,759,1569,8,1577,0,1577,48,997,532,22.04.2019 00:40,96,8,Kiev
2368,2598,7,486,1875,7,1882,0,1882,32,1151,699,22.04.2019 03:28,96,8,Kiev
2400,2464,14,720,1669,11,1680,0,1680,33,1103,544,22.04.2019 00:23,96,8,Kiev
2272,2309,6,625,1643,4,1647,0,1647,42,981,624,22.04.2019 01:15,96,8,Kiev
2208,2251,11,665,1534,9,1543,0,1543,47,934,562,21.04.2019 21:25,96,8,Kiev
1904,1893,9,524,1379,1,1380,0,1380,39,923,418,21.04.2019 21:30,96,8,Kiev
2272,2260,14,887,1372,13,1385,0,1385,36,972,377,22.04.2019 00:05,96,8,Kiev
2160,2131,14,895,1254,11,1265,0,1265,35,924,306,22.04.2019 00:30,96,8,Kiev
512,502,9,197,307,8,315,0,315,4,220,91,22.04.2019 00:00,96,8,Kiev
224,211,2,81,141,2,143,0,143,3,121,19,22.04.2019 00:10,96,8,Kiev
160,153,10,62,88,10,98,0,98,2,69,27,21.04.2019 20:25,96,8,Kiev
128,123,2,53,73,2,75,0,75,2,45,28,21.04.2019 20:30,96,8,Kiev
192,180,33,43,116,33,149,0,149,3,113,33,22.04.2019 00:15,96,8,Kiev
192,182,17,38,137,17,154,0,154,0,119,35,22.04.2019 00:08,96,8,Kiev
592,578,29,206,358,28,386,0,386,6,291,89,22.04.2019 00:20,96,8,Kiev
624,616,17,263,345,16,361,0,361,6,243,112,22.04.2019 00:47,96,8,Kiev
1344,1334,10,525,813,6,819,0,819,19,617,183,22.04.2019 00:11,96,8,Kiev
352,335,3,154,195,3,198,0,198,3,159,36,22.04.2019 00:05,96,8,Kiev
704,691,33,278,394,32,426,0,426,12,339,75,21.04.2019 21:40,96,8,Kiev
1680,1645,10,681,992,7,999,0,999,38,699,262,21.04.2019 21:30,96,8,Kiev
1232,1214,20,495,719,18,737,0,737,14,535,188,22.04.2019 00:15,96,8,Kiev
640,644,42,218,380,42,422,0,422,13,313,96,22.04.2019 00:25,96,8,Kiev
1968,1952,21,851,1100,17,1117,0,1117,8,813,296,22.04.2019 00:14,96,8,Kiev
1184,1164,12,524,648,12,660,0,660,2,509,149,22.04.2019 00:05,96,8,Kiev
64,63,5,19,41,4,45,0,45,0,36,9,21.04.2019 20:30,96,8,Kiev
1328,1326,20,553,761,14,775,0,775,13,592,170,21.04.2019 21:30,96,8,Kiev
1008,1023,27,346,638,24,662,0,662,7,474,181,21.04.2019 22:06,96,8,Kiev
1040,1035,14,368,661,11,672,0,672,11,498,163,22.04.2019 00:30,96,8,Kiev
304,299,15,106,183,15,198,0,198,2,141,55,22.04.2019 04:08,96,8,Kiev
336,340,17,160,163,13,176,0,176,4,132,40,21.04.2019 21:45,96,8,Kiev
2096,2098,29,670,1398,28,1426,0,1426,36,986,404,22.04.2019 00:35,96,8,Kiev
144,146,12,22,110,12,122,0,122,1,66,55,22.04.2019 00:15,96,8,Kiev
1008,1013,19,395,600,13,613,0,613,11,441,161,21.04.2019 22:40,96,8,Kiev
2240,2274,4,711,1525,4,1529,0,1529,42,1013,474,22.04.2019 00:45,96,8,Kiev
2016,2035,8,686,1323,7,1330,0,1330,31,930,369,22.04.2019 00:07,96,8,Kiev
1728,1798,3,491,1235,2,1237,0,1237,31,872,334,21.04.2019 22:11,96,8,Kiev
1264,1253,6,454,805,5,810,0,810,26,559,225,22.04.2019 00:00,96,8,Kiev
592,611,2,143,447,2,449,0,449,9,317,123,21.04.2019 21:50,96,8,Kiev
480,479,28,131,322,27,349,0,349,10,261,78,21.04.2019 20:45,96,8,Kiev
416,412,24,132,260,24,284,0,284,2,192,90,22.04.2019 00:03,96,8,Kiev
384,384,33,136,219,29,248,0,248,2,195,51,21.04.2019 21:00,96,8,Kiev
992,993,3,397,592,3,595,0,595,11,452,132,22.04.2019 00:00,96,8,Kiev
432,430,1,184,247,1,248,0,248,9,185,54,22.04.2019 00:05,96,8,Kiev
1648,1658,11,554,1088,6,1094,0,1094,25,801,268,22.04.2019 00:20,96,8,Kiev
160,157,21,36,105,19,124,0,124,1,95,28,22.04.2019 00:05,96,8,Kiev
272,266,47,87,138,47,185,0,185,3,122,60,21.04.2019 23:30,96,8,Kiev
256,265,16,50,193,13,206,0,206,0,161,45,21.04.2019 20:40,96,8,Kiev
192,194,9,55,129,8,137,0,137,4,107,26,22.04.2019 00:25,96,8,Kiev
1072,1054,5,313,755,4,759,0,759,12,562,185,22.04.2019 00:35,96,8,Kiev
304,303,25,111,171,22,193,0,193,6,134,53,22.04.2019 00:02,96,8,Kiev
128,43,9,85,34,9,43,0,43,0,26,17,21.04.2019 21:10,96,8,Kiev
176,54,0,130,46,0,46,0,46,4,31,11,22.04.2019 00:15,96,8,Kiev
2272,2234,24,874,1379,19,1398,0,1398,29,954,415,22.04.2019 00:30,96,8,Kiev
2208,2158,38,866,1307,35,1342,0,1342,32,930,380,21.04.2019 21:30,96,8,Kiev
2144,2116,26,841,1280,23,1303,0,1303,25,923,355,22.04.2019 00:30,96,8,Kiev
1952,1917,10,739,1206,7,1213,0,1213,16,776,421,22.04.2019 00:15,96,8,Kiev
1008,990,52,482,479,47,526,0,526,8,368,150,22.04.2019 00:40,96,8,Kiev
864,843,40,376,454,34,488,0,488,18,345,125,21.04.2019 21:00,96,8,Kiev
320,317,34,89,200,31,231,0,231,7,172,52,22.04.2019 00:10,96,8,Kiev
1024,1016,166,221,653,150,803,0,803,14,495,294,21.04.2019 21:24,96,8,Kiev
704,700,40,272,395,37,432,0,432,3,313,116,21.04.2019 20:40,96,8,Kiev
560,555,16,230,319,11,330,0,330,4,253,73,22.04.2019 00:10,96,8,Kiev
576,562,28,256,301,19,320,0,320,5,236,79,22.04.2019 00:20,96,8,Kiev
464,446,50,178,245,41,286,0,286,3,197,86,22.04.2019 00:50,96,8,Kiev
496,498,53,201,252,43,295,0,295,3,214,78,21.04.2019 21:14,96,8,Kiev
448,449,33,178,242,28,270,0,270,15,196,59,21.04.2019 21:03,96,8,Kiev
384,383,16,122,246,16,262,0,262,2,202,58,22.04.2019 00:20,96,8,Kiev
832,822,38,386,420,26,446,0,446,4,365,77,22.04.2019 00:15,96,8,Kiev
352,360,37,126,196,30,226,0,226,7,169,50,21.04.2019 21:30,96,8,Kiev
304,292,34,143,135,26,161,0,161,4,114,43,22.04.2019 00:20,96,8,Kiev
304,306,34,107,165,32,197,0,197,2,154,41,21.04.2019 21:24,96,8,Kiev
320,305,21,143,157,20,177,0,177,3,141,33,22.04.2019 01:15,96,8,Kiev
368,360,16,89,267,12,279,0,279,3,239,37,22.04.2019 00:35,96,8,Kiev
352,356,26,139,194,19,213,0,213,5,145,63,21.04.2019 21:20,96,8,Kiev
288,279,20,110,162,16,178,0,178,5,112,61,22.04.2019 00:05,96,8,Kiev
304,287,18,126,164,14,178,0,178,0,141,37,22.04.2019 00:08,96,8,Kiev
272,259,12,135,126,11,137,0,137,3,81,53,22.04.2019 00:30,96,8,Kiev
368,352,16,180,175,13,188,0,188,2,136,50,22.04.2019 00:20,96,8,Kiev
240,233,7,109,124,7,131,0,131,4,87,40,22.04.2019 00:15,96,8,Kiev
240,237,18,90,134,16,150,0,150,0,81,69,22.04.2019 00:07,96,8,Kiev
256,253,9,88,159,9,168,0,168,4,104,60,22.04.2019 00:05,96,8,Kiev
256,243,23,97,136,23,159,0,159,2,110,47,22.04.2019 01:30,96,8,Kiev
208,205,20,98,91,19,110,0,110,5,80,25,22.04.2019 00:55,96,8,Kiev
80,69,10,33,40,7,47,0,47,1,30,16,21.04.2019 22:10,96,8,Kiev
224,208,40,73,115,36,151,0,151,0,87,64,22.04.2019 00:35,96,8,Kiev
192,181,28,91,80,21,101,0,101,0,67,34,21.04.2019 21:36,96,8,Kiev
144,143,14,48,84,12,96,0,96,2,60,34,22.04.2019 01:10,96,8,Kiev
224,221,24,81,123,20,143,0,143,1,114,28,22.04.2019 00:10,96,8,Kiev
128,132,36,34,64,30,94,0,94,0,45,49,21.04.2019 22:30,96,8,Kiev
208,190,18,98,96,14,110,0,110,3,69,38,21.04.2019 21:30,96,8,Kiev
144,141,14,52,82,10,92,0,92,1,65,26,21.04.2019 20:50,96,8,Kiev
128,125,30,38,62,28,90,0,90,7,42,41,22.04.2019 00:10,96,8,Kiev
128,119,3,52,73,3,76,0,76,0,58,18,21.04.2019 20:30,96,8,Kiev
128,114,13,45,71,12,83,0,83,1,43,39,21.04.2019 21:30,96,8,Kiev
128,117,14,52,62,14,76,0,76,2,48,26,21.04.2019 23:00,96,8,Kiev
160,151,8,93,61,6,67,0,67,0,48,19,22.04.2019 00:10,96,8,Kiev
160,161,13,56,92,12,104,0,104,2,83,19,22.04.2019 00:15,96,8,Kiev
112,108,10,45,57,10,67,0,67,1,48,18,21.04.2019 21:15,96,8,Kiev
96,89,7,39,50,7,57,0,57,1,40,16,21.04.2019 21:50,96,8,Kiev
80,77,6,24,50,6,56,0,56,1,34,21,21.04.2019 23:00,96,8,Kiev
144,146,20,27,97,20,117,0,117,2,58,57,22.04.2019 00:40,96,8,Kiev
144,141,22,48,75,21,96,0,96,0,61,35,21.04.2019 22:05,96,8,Kiev
96,94,13,27,57,12,69,0,69,0,50,19,22.04.2019 00:20,96,8,Kiev
80,78,10,24,51,5,56,0,56,0,41,15,22.04.2019 00:10,96,8,Kiev
80,73,8,34,39,7,46,0,46,0,31,15,22.04.2019 00:30,96,8,Kiev
80,81,1,23,56,1,57,0,57,1,26,30,21.04.2019 22:37,96,8,Kiev
64,60,14,34,19,11,30,0,30,0,25,5,21.04.2019 21:30,96,8,Kiev
64,53,1,35,29,0,29,0,29,0,21,8,21.04.2019 20:40,96,8,Kiev
64,52,5,30,29,5,34,0,34,1,25,8,21.04.2019 20:15,96,8,Kiev
128,35,9,94,25,9,34,0,34,1,19,14,21.04.2019 21:30,96,8,Kiev
624,609,30,276,325,23,348,0,348,6,238,104,22.04.2019 00:05,96,8,Kiev
304,292,25,138,145,21,166,0,166,1,145,20,21.04.2019 21:50,96,8,Kiev
352,350,19,171,163,18,181,0,181,0,134,47,22.04.2019 01:05,96,8,Kiev
336,335,39,97,203,36,239,0,239,5,153,81,22.04.2019 00:55,96,8,Kiev
208,209,22,63,124,21,145,0,145,4,105,36,22.04.2019 00:15,96,8,Kiev
384,386,42,144,198,42,240,0,240,3,186,51,22.04.2019 00:15,96,8,Kiev
432,420,33,188,215,29,244,0,244,9,168,67,22.04.2019 00:10,96,8,Kiev
304,291,16,94,197,13,210,0,210,3,149,58,21.04.2019 21:30,96,8,Kiev
288,290,8,71,210,7,217,0,217,2,172,43,22.04.2019 03:25,96,8,Kiev
144,141,10,45,89,10,99,0,99,3,74,22,22.04.2019 00:30,96,8,Kiev
320,301,27,143,153,24,177,0,177,7,121,49,22.04.2019 06:10,96,8,Kiev
704,682,62,311,335,58,393,0,393,4,290,99,22.04.2019 00:15,96,8,Kiev
144,133,17,54,74,16,90,0,90,2,58,30,22.04.2019 00:10,96,8,Kiev
112,104,13,47,54,11,65,0,65,1,44,20,22.04.2019 00:10,96,8,Kiev
48,15,2,36,12,0,12,0,12,0,6,6,22.04.2019 00:05,96,8,Kiev
784,832,6,214,565,5,570,0,570,20,340,210,22.04.2019 00:35,96,8,Kiev
2320,2361,10,702,1611,7,1618,0,1618,26,1027,565,22.04.2019 00:10,96,8,Kiev
2096,2118,22,714,1364,18,1382,0,1382,37,894,451,22.04.2019 00:40,96,8,Kiev
1488,1516,14,451,1028,9,1037,0,1037,29,646,362,21.04.2019 22:15,96,8,Kiev
2096,2207,8,546,1546,4,1550,0,1550,31,1003,516,22.04.2019 00:30,96,8,Kiev
2224,2319,6,665,1555,4,1559,0,1559,50,1024,485,22.04.2019 00:11,96,8,Kiev
1376,1444,1,425,950,1,951,0,951,18,610,323,21.04.2019 22:18,96,8,Kiev
2096,2169,20,620,1463,13,1476,0,1476,41,946,489,21.04.2019 21:30,96,8,Kiev
2384,2382,12,768,1609,7,1616,0,1616,33,1077,506,22.04.2019 01:50,96,8,Kiev
2208,2187,11,818,1379,11,1390,0,1390,42,926,422,22.04.2019 00:15,96,8,Kiev
2176,2214,9,734,1435,7,1442,0,1442,41,930,471,22.04.2019 00:30,96,8,Kiev
2416,2468,6,702,1709,5,1714,0,1714,48,1092,574,22.04.2019 01:00,96,8,Kiev
2288,2244,14,871,1407,10,1417,0,1417,42,1106,269,22.04.2019 01:40,96,8,Kiev
2336,2298,9,933,1397,6,1403,0,1403,38,1149,216,22.04.2019 01:45,96,8,Kiev
2288,2258,9,843,1441,4,1445,0,1445,44,1095,306,22.04.2019 01:30,96,8,Kiev
2208,2147,10,892,1308,8,1316,0,1316,27,1072,217,21.04.2019 21:30,96,8,Kiev
2256,2214,5,890,1363,3,1366,0,1366,24,1107,235,22.04.2019 00:45,96,8,Kiev
2448,2376,11,964,1476,8,1484,0,1484,30,1202,252,22.04.2019 00:50,96,8,Kiev
2288,2239,7,928,1356,4,1360,0,1360,25,1115,220,22.04.2019 01:00,96,8,Kiev
2128,2078,9,869,1256,3,1259,0,1259,34,1027,198,22.04.2019 01:00,96,8,Kiev
144,22,3,123,18,3,21,0,21,0,20,1,22.04.2019 01:55,96,8,Kiev
2208,2284,3,784,1423,1,1424,0,1424,35,851,538,22.04.2019 00:15,96,8,Kiev
1056,1040,0,350,706,0,706,0,706,27,499,180,21.04.2019 21:20,96,8,Kiev
1360,1363,22,430,908,22,930,0,930,21,612,297,22.04.2019 00:05,96,8,Kiev
1984,2118,2,528,1454,2,1456,0,1456,26,959,471,22.04.2019 03:03,96,8,Kiev
2032,2140,3,553,1477,2,1479,0,1479,33,895,551,22.04.2019 00:10,96,8,Kiev
1520,965,1,786,734,0,734,0,734,20,535,179,22.04.2019 00:10,96,8,Kiev
896,907,1,273,622,1,623,0,623,18,404,201,21.04.2019 23:34,96,8,Kiev
1936,1920,36,740,1170,26,1196,0,1196,30,840,326,22.04.2019 00:08,97,8,Kiev
1904,1905,17,718,1170,16,1186,0,1186,26,829,331,22.04.2019 01:00,97,8,Kiev
1072,1074,8,386,680,6,686,0,686,14,469,203,22.04.2019 00:10,97,8,Kiev
2016,1983,10,831,1179,6,1185,0,1185,36,937,212,22.04.2019 00:40,97,8,Kiev
608,602,16,224,373,11,384,0,384,13,257,114,22.04.2019 00:15,97,8,Kiev
672,662,24,252,396,24,420,0,420,3,321,96,22.04.2019 00:05,97,8,Kiev
864,847,24,431,415,18,433,0,433,12,333,88,22.04.2019 00:10,97,8,Kiev
1216,1191,18,561,643,12,655,0,655,11,475,169,22.04.2019 00:30,97,8,Kiev
336,325,26,131,179,26,205,0,205,1,152,52,22.04.2019 00:05,97,8,Kiev
688,677,60,251,384,53,437,0,437,13,298,126,22.04.2019 00:20,97,8,Kiev
384,378,23,136,231,17,248,0,248,10,196,42,22.04.2019 00:10,97,8,Kiev
1216,1213,18,452,746,18,764,0,764,8,567,189,22.04.2019 00:30,97,8,Kiev
768,758,52,370,359,39,398,0,398,5,294,99,22.04.2019 00:15,97,8,Kiev
1072,1045,57,498,521,53,574,0,574,20,429,125,22.04.2019 00:38,97,8,Kiev
912,908,50,388,487,37,524,0,524,15,390,119,22.04.2019 00:05,97,8,Kiev
528,513,39,190,299,39,338,0,338,6,227,105,22.04.2019 00:01,97,8,Kiev
240,221,21,100,119,21,140,0,140,1,92,47,21.04.2019 21:00,97,8,Kiev
1888,1875,57,756,1082,50,1132,0,1132,39,805,288,22.04.2019 00:30,97,8,Kiev
976,962,56,397,527,52,579,0,579,11,459,109,22.04.2019 00:15,97,8,Kiev
432,432,9,195,229,8,237,0,237,3,168,66,22.04.2019 00:25,97,8,Kiev
320,317,24,128,170,22,192,0,192,0,120,72,22.04.2019 00:05,97,8,Kiev
960,999,140,345,493,122,615,0,615,11,383,221,22.04.2019 00:10,97,8,Kiev
592,579,53,223,321,48,369,0,369,4,263,102,22.04.2019 01:00,97,8,Kiev
560,548,57,225,285,50,335,0,335,4,242,89,22.04.2019 00:10,97,8,Kiev
1248,1235,51,465,737,46,783,0,783,12,646,125,22.04.2019 00:20,97,8,Kiev
464,472,43,166,260,38,298,0,298,6,227,65,22.04.2019 00:30,97,8,Kiev
160,163,14,43,108,9,117,0,117,4,87,26,22.04.2019 00:20,97,8,Kiev
896,886,12,331,553,12,565,0,565,8,421,136,22.04.2019 01:30,97,8,Kiev
720,715,44,267,413,40,453,0,453,12,334,107,22.04.2019 00:05,97,8,Kiev
976,953,41,374,564,38,602,0,602,8,483,111,22.04.2019 00:15,97,8,Kiev
320,303,23,134,163,23,186,0,186,4,149,33,22.04.2019 00:05,97,8,Kiev
928,905,30,429,471,28,499,0,499,7,394,98,22.04.2019 01:20,97,8,Kiev
128,123,8,38,82,8,90,0,90,0,81,9,22.04.2019 00:23,97,8,Kiev
112,99,3,48,63,1,64,0,64,1,52,11,22.04.2019 00:24,97,8,Kiev
608,603,45,231,334,43,377,0,377,7,279,91,22.04.2019 00:31,97,8,Kiev
1536,1522,8,652,876,8,884,0,884,19,716,149,22.04.2019 00:30,97,8,Kiev
96,90,0,22,74,0,74,0,74,2,51,21,22.04.2019 00:05,97,8,Kiev
464,450,8,191,265,8,273,0,273,5,223,45,22.04.2019 00:20,97,8,Kiev
1824,1825,5,756,1064,4,1068,0,1068,24,819,225,22.04.2019 00:35,97,8,Kiev
1680,1679,7,758,917,5,922,0,922,3,760,159,22.04.2019 00:20,97,8,Kiev
2272,2252,12,948,1318,6,1324,0,1324,26,1089,209,22.04.2019 00:10,97,8,Kiev
2304,2289,6,941,1359,4,1363,0,1363,30,1107,226,22.04.2019 01:20,97,8,Kiev
1712,1713,21,706,987,19,1006,0,1006,9,761,236,22.04.2019 00:11,97,8,Kiev
1104,1085,12,581,511,12,523,0,523,16,385,122,22.04.2019 00:05,97,8,Kiev
912,898,5,405,503,4,507,0,507,14,403,90,22.04.2019 00:04,97,8,Kiev
208,203,2,97,109,2,111,0,111,2,92,17,22.04.2019 00:10,97,8,Kiev
256,260,14,100,143,13,156,0,156,0,120,36,22.04.2019 00:13,97,8,Kiev
96,84,4,50,42,4,46,0,46,0,35,11,21.04.2019 22:05,97,8,Kiev
112,108,9,28,75,9,84,0,84,1,58,25,22.04.2019 00:10,97,8,Kiev
560,555,26,237,297,26,323,0,323,6,253,64,22.04.2019 00:31,97,8,Kiev
1936,1940,20,663,1253,20,1273,0,1273,27,885,361,22.04.2019 00:07,97,8,Kiev
1936,1985,16,645,1280,11,1291,0,1291,36,965,290,22.04.2019 00:50,97,8,Kiev
1616,1651,3,508,1105,3,1108,0,1108,22,854,232,22.04.2019 00:40,97,8,Kiev
1008,1006,28,336,648,24,672,0,672,14,508,150,22.04.2019 00:05,97,8,Kiev
144,141,3,58,83,3,86,0,86,2,62,22,22.04.2019 00:15,97,8,Kiev
1264,1264,7,470,787,7,794,0,794,14,598,182,22.04.2019 00:15,97,8,Kiev
1664,1658,6,692,967,5,972,0,972,16,732,224,22.04.2019 00:45,97,8,Kiev
208,202,14,91,103,14,117,0,117,1,96,20,22.04.2019 00:03,97,8,Kiev
1168,1185,15,420,733,15,748,0,748,8,531,209,22.04.2019 00:05,97,8,Kiev
768,749,15,285,469,14,483,0,483,11,344,128,22.04.2019 00:07,97,8,Kiev
352,342,36,92,226,34,260,0,260,5,180,75,22.04.2019 01:10,97,8,Kiev
128,119,6,46,76,6,82,0,82,0,58,24,22.04.2019 00:02,97,8,Kiev
704,689,39,296,371,37,408,0,408,3,305,100,22.04.2019 00:30,97,8,Kiev
144,133,19,66,59,19,78,0,78,0,62,16,22.04.2019 00:10,97,8,Kiev
1632,1620,73,663,902,67,969,0,969,16,766,187,22.04.2019 00:10,97,8,Kiev
1968,1954,8,657,1303,8,1311,0,1311,19,889,403,22.04.2019 00:27,97,8,Kiev
1488,1479,8,535,946,7,953,0,953,29,692,232,22.04.2019 00:06,97,8,Kiev
416,418,15,103,299,14,313,0,313,5,191,117,22.04.2019 00:17,97,8,Kiev
1040,1039,36,376,635,29,664,0,664,12,465,187,22.04.2019 00:25,97,8,Kiev
1680,1649,10,654,1016,10,1026,0,1026,28,806,192,22.04.2019 01:06,97,8,Kiev
1312,1293,50,626,638,48,686,0,686,9,517,160,22.04.2019 00:46,97,8,Kiev
816,802,44,353,419,44,463,0,463,18,335,110,22.04.2019 00:30,97,8,Kiev
992,984,6,478,511,3,514,0,514,6,401,107,22.04.2019 00:17,97,8,Kiev
1232,1187,2,477,753,2,755,0,755,6,527,222,22.04.2019 00:31,97,8,Kiev
1376,1360,4,557,815,4,819,0,819,10,642,167,22.04.2019 00:47,97,8,Kiev
1232,1226,5,476,751,5,756,0,756,12,591,153,22.04.2019 00:10,97,8,Kiev
1376,1383,8,536,836,4,840,0,840,33,623,184,22.04.2019 00:15,97,8,Kiev
528,520,8,185,337,6,343,0,343,6,272,65,22.04.2019 00:15,97,8,Kiev
1696,1747,12,547,1137,12,1149,0,1149,26,704,419,22.04.2019 00:15,97,8,Kiev
2096,2111,10,678,1408,10,1418,0,1418,49,929,440,22.04.2019 00:10,97,8,Kiev
2064,2071,2,698,1365,1,1366,0,1366,30,920,416,22.04.2019 00:02,97,8,Kiev
2336,2425,4,564,1770,2,1772,0,1772,37,1144,591,22.04.2019 00:10,97,8,Kiev
2000,2050,4,582,1414,4,1418,0,1418,28,930,460,22.04.2019 00:15,97,8,Kiev
1904,1921,6,587,1313,4,1317,0,1317,38,879,400,22.04.2019 00:05,97,8,Kiev
1568,1612,1,397,1171,0,1171,0,1171,17,736,418,22.04.2019 00:45,97,8,Kiev
2224,2233,8,775,1444,5,1449,0,1449,32,979,438,22.04.2019 00:15,97,8,Kiev
1760,1778,9,550,1205,5,1210,0,1210,36,814,360,22.04.2019 00:45,97,8,Kiev
1760,1779,7,529,1226,5,1231,0,1231,25,816,390,22.04.2019 00:10,97,8,Kiev
1840,1846,8,610,1225,5,1230,0,1230,34,823,373,22.04.2019 00:07,97,8,Kiev
2080,2082,6,652,1423,5,1428,0,1428,55,920,453,22.04.2019 00:07,97,8,Kiev
1920,1970,4,609,1309,2,1311,0,1311,30,935,346,22.04.2019 00:05,97,8,Kiev
1936,2066,4,496,1437,3,1440,0,1440,23,907,510,22.04.2019 00:12,97,8,Kiev
1856,1850,11,635,1210,11,1221,0,1221,38,770,413,22.04.2019 00:05,97,8,Kiev
1904,1934,8,612,1286,6,1292,0,1292,21,865,406,22.04.2019 00:10,97,8,Kiev
2032,2069,2,601,1431,0,1431,0,1431,23,1006,402,22.04.2019 00:30,97,8,Kiev
2272,2324,6,606,1665,1,1666,0,1666,38,1110,518,22.04.2019 00:07,97,8,Kiev
1904,1922,6,544,1357,3,1360,0,1360,36,892,432,22.04.2019 00:10,97,8,Kiev
2112,2169,5,618,1491,3,1494,0,1494,30,997,467,22.04.2019 06:15,97,8,Kiev
2064,2102,2,587,1476,1,1477,0,1477,32,986,459,22.04.2019 00:25,97,8,Kiev
2096,2109,10,672,1417,7,1424,0,1424,33,975,416,22.04.2019 00:01,97,8,Kiev
2096,2099,3,695,1398,3,1401,0,1401,35,988,378,22.04.2019 00:47,97,8,Kiev
2080,2071,25,655,1405,20,1425,0,1425,32,993,400,22.04.2019 00:10,97,8,Kiev
2480,2528,10,811,1660,9,1669,0,1669,44,1130,495,22.04.2019 05:37,97,8,Kiev
1760,1778,7,606,1149,5,1154,0,1154,24,784,346,22.04.2019 05:15,97,8,Kiev
2064,2079,4,730,1331,3,1334,0,1333,38,890,405,22.04.2019 00:10,97,8,Kiev
2048,2053,3,754,1292,2,1294,0,1294,35,919,340,22.04.2019 00:04,97,8,Kiev
1904,1921,11,614,1283,7,1290,0,1290,38,846,406,22.04.2019 05:10,97,8,Kiev
2208,2213,15,777,1420,11,1431,0,1431,36,952,443,22.04.2019 00:07,97,8,Kiev
768,146,59,625,90,53,143,0,143,3,101,39,22.04.2019 00:05,97,8,Kiev
1744,1753,5,510,1230,4,1234,0,1234,35,855,344,22.04.2019 00:10,97,8,Kiev
1920,1936,19,626,1278,16,1294,0,1294,30,904,360,21.04.2019 21:50,98,8,Kiev
656,655,14,243,402,11,413,0,413,5,291,117,21.04.2019 20:29,98,8,Kiev
1712,1824,8,369,1335,8,1343,0,1343,29,792,522,22.04.2019 00:15,98,8,Kiev
1312,1315,12,457,844,11,855,0,855,12,586,257,21.04.2019 21:20,98,8,Kiev
1248,1232,10,449,793,6,799,0,799,21,533,245,21.04.2019 21:18,98,8,Kiev
672,692,8,172,492,8,500,0,500,10,334,156,21.04.2019 21:34,98,8,Kiev
1600,1593,77,536,998,66,1064,0,1064,33,768,263,21.04.2019 22:10,98,8,Kiev
1808,1818,59,706,1053,49,1102,0,1102,26,827,249,21.04.2019 21:45,98,8,Kiev
2272,2317,64,650,1569,53,1622,0,1622,39,986,597,21.04.2019 22:40,98,8,Kiev
384,385,31,121,233,30,263,0,263,5,159,99,21.04.2019 22:05,98,8,Kiev
1935,1943,17,753,1169,13,1182,0,1182,18,874,290,21.04.2019 21:40,98,8,Kiev
1424,1419,40,549,844,31,875,0,875,19,653,203,21.04.2019 21:05,98,8,Kiev
1376,1364,33,515,838,23,861,0,861,15,623,223,21.04.2019 21:05,98,8,Kiev
1264,1257,51,452,772,40,812,0,812,9,636,167,21.04.2019 21:30,98,8,Kiev
272,273,10,86,176,10,186,0,186,3,132,51,21.04.2019 20:40,98,8,Kiev
912,896,19,327,566,19,585,0,585,13,420,152,22.04.2019 00:20,98,8,Kiev
160,148,13,61,86,13,99,0,99,2,65,32,21.04.2019 20:30,98,8,Kiev
144,134,14,34,96,14,110,0,110,1,70,39,21.04.2019 20:14,98,8,Kiev
1584,1565,30,621,940,23,963,0,963,9,623,331,22.04.2019 00:10,98,8,Kiev
96,86,4,24,68,4,72,0,72,0,34,38,21.04.2019 20:20,98,8,Kiev
1312,1325,18,488,810,14,824,0,824,11,582,231,21.04.2019 22:00,98,8,Kiev
160,164,5,60,97,3,100,0,100,6,48,46,21.04.2019 23:00,98,8,Kiev
62,48,4,27,31,4,35,0,35,0,21,14,21.04.2019 20:24,98,8,Kiev
880,892,28,304,548,28,576,0,576,16,363,197,22.04.2019 03:25,98,8,Kiev
1200,1172,30,507,667,26,693,0,693,10,535,148,21.04.2019 21:00,98,8,Kiev
256,247,9,110,137,9,146,0,146,0,115,31,21.04.2019 20:45,98,8,Kiev
1760,1742,40,719,1007,34,1041,0,1041,24,759,258,22.04.2019 02:35,98,8,Kiev
1744,1735,15,778,957,9,966,0,966,35,667,264,22.04.2019 00:24,98,8,Kiev
144,141,1,59,84,1,85,0,85,0,71,14,21.04.2019 21:08,98,8,Kiev
224,219,25,66,133,25,158,0,158,5,108,45,22.04.2019 00:12,98,8,Kiev
608,589,49,271,293,44,337,0,337,9,249,79,21.04.2019 20:35,98,8,Kiev
208,201,25,77,106,25,131,0,131,1,99,31,22.04.2019 00:15,98,8,Kiev
192,183,13,60,119,13,132,0,132,3,93,36,21.04.2019 20:30,98,8,Kiev
640,638,63,230,349,61,410,0,410,8,271,131,21.04.2019 21:00,98,8,Kiev
304,294,31,108,170,26,196,0,196,1,156,39,21.04.2019 21:30,98,8,Kiev
320,318,24,118,178,24,202,0,202,6,158,38,21.04.2019 22:45,98,8,Kiev
384,367,39,130,215,39,254,0,254,6,176,72,22.04.2019 00:00,98,8,Kiev
352,349,26,147,182,23,205,0,205,4,134,67,22.04.2019 00:19,98,8,Kiev
304,289,43,110,151,43,194,0,194,4,120,70,22.04.2019 00:10,98,8,Kiev
256,245,22,107,127,22,149,0,149,1,109,39,21.04.2019 23:50,98,8,Kiev
464,458,17,205,242,17,259,0,259,0,190,69,21.04.2019 21:10,98,8,Kiev
576,576,47,225,304,47,351,0,351,6,270,75,21.04.2019 20:50,98,8,Kiev
496,487,59,197,241,58,299,0,299,2,230,67,22.04.2019 00:10,98,8,Kiev
752,742,70,285,399,68,467,0,467,6,374,87,22.04.2019 00:20,98,8,Kiev
336,345,39,28,271,37,308,0,308,5,177,126,22.04.2019 00:05,98,8,Kiev
496,496,6,218,272,6,278,0,278,4,187,87,21.04.2019 20:22,98,8,Kiev
496,483,49,150,304,42,346,0,346,7,232,107,21.04.2019 21:30,98,8,Kiev
160,150,19,47,94,19,113,0,113,0,70,43,21.04.2019 22:00,98,8,Kiev
880,871,46,289,555,36,591,0,591,13,463,115,22.04.2019 00:30,98,8,Kiev
336,331,63,103,176,57,233,0,233,10,129,94,21.04.2019 20:25,98,8,Kiev
544,544,55,163,326,55,381,0,381,6,202,173,22.04.2019 00:05,98,8,Kiev
832,816,45,370,418,44,462,0,462,6,342,114,21.04.2019 20:55,98,8,Kiev
288,283,26,94,168,26,194,0,194,3,140,51,21.04.2019 20:40,98,8,Kiev
352,339,40,81,231,40,271,0,271,0,205,66,22.04.2019 00:15,98,8,Kiev
160,155,24,43,93,24,117,0,117,2,69,46,22.04.2019 00:30,98,8,Kiev
144,134,11,61,74,9,83,0,83,1,76,6,22.04.2019 00:43,98,8,Kiev
464,445,47,162,263,39,302,0,302,11,193,98,22.04.2019 00:45,98,8,Kiev
1216,1199,9,587,620,9,629,0,629,11,452,166,22.04.2019 00:04,98,8,Kiev
320,306,46,122,157,41,198,0,198,3,127,68,21.04.2019 20:30,98,8,Kiev
672,660,25,273,374,25,399,0,399,4,297,98,22.04.2019 00:15,98,8,Kiev
192,184,18,36,139,17,156,0,156,1,116,39,22.04.2019 00:05,98,8,Kiev
992,1000,71,384,543,65,608,0,608,10,464,134,21.04.2019 21:30,98,8,Kiev
2080,2063,64,677,1344,59,1403,0,1403,39,1071,293,22.04.2019 01:30,98,8,Kiev
304,299,27,101,178,25,203,0,203,5,149,49,22.04.2019 00:10,98,8,Kiev
624,414,8,236,380,8,388,0,388,16,281,91,22.04.2019 00:15,98,8,Kiev
1472,1453,35,580,865,27,892,0,892,14,651,227,22.04.2019 01:15,98,8,Kiev
1264,1256,28,522,719,23,742,0,742,20,531,191,22.04.2019 00:15,98,8,Kiev
1296,1279,37,514,754,28,782,0,782,21,603,158,22.04.2019 00:55,98,8,Kiev
1392,1365,42,608,756,28,784,0,784,12,574,198,21.04.2019 22:00,98,8,Kiev
1024,996,32,432,565,27,592,0,592,14,430,148,22.04.2019 07:00,98,8,Kiev
1280,1264,27,483,780,17,797,0,797,17,612,168,22.04.2019 04:10,98,8,Kiev
1264,1247,43,583,646,35,681,0,681,16,514,151,21.04.2019 21:45,98,8,Kiev
576,563,28,232,324,20,344,0,344,6,270,68,22.04.2019 00:15,98,8,Kiev
1760,1747,46,767,960,33,993,0,993,19,781,193,22.04.2019 07:00,98,8,Kiev
1008,992,50,414,556,38,594,0,594,12,448,134,21.04.2019 21:28,98,8,Kiev
384,380,46,95,245,44,289,0,289,2,182,105,21.04.2019 20:54,98,8,Kiev
496,487,49,197,257,42,299,0,299,3,205,91,22.04.2019 00:30,98,8,Kiev
320,307,39,120,166,34,200,0,200,3,136,61,22.04.2019 00:10,98,8,Kiev
320,318,60,56,205,59,264,0,264,14,128,122,22.04.2019 00:15,98,8,Kiev
640,655,89,202,349,89,438,0,438,5,340,93,21.04.2019 22:30,98,8,Kiev
448,449,66,134,252,62,314,0,314,8,189,117,21.04.2019 20:55,98,8,Kiev
672,654,65,144,468,60,528,0,528,18,265,245,21.04.2019 22:00,98,8,Kiev
672,664,93,178,407,87,494,0,494,11,312,171,22.04.2019 00:10,98,8,Kiev
384,390,37,99,252,33,285,0,285,3,158,124,21.04.2019 20:30,98,8,Kiev
768,773,83,309,386,73,459,0,459,8,283,168,22.04.2019 00:05,98,8,Kiev
160,158,29,28,107,25,132,0,132,4,48,80,21.04.2019 21:00,98,8,Kiev
2160,2215,19,682,1466,12,1478,0,1478,42,1021,415,22.04.2019 00:05,98,8,Kiev
1936,1980,10,621,1309,6,1315,0,1315,49,863,403,22.04.2019 00:05,98,8,Kiev
1664,1673,11,552,1105,7,1112,0,1112,36,707,369,22.04.2019 00:55,98,8,Kiev
2112,2132,17,685,1412,15,1427,0,1427,38,918,471,22.04.2019 00:10,98,8,Kiev
2064,2078,11,614,1447,3,1450,0,1450,41,987,422,22.04.2019 00:04,98,8,Kiev
1824,1832,12,616,1198,10,1208,0,1208,24,845,339,21.04.2019 22:00,98,8,Kiev
416,69,69,362,0,54,54,0,54,0,42,12,21.04.2019 20:50,98,8,Kiev
720,577,5,144,571,5,576,0,576,56,466,54,22.04.2019 01:55,99,9,Kirov
1792,1756,3,760,1030,2,1032,0,1032,20,814,198,22.04.2019 00:30,99,9,Kirov
2000,1968,7,900,1094,6,1100,0,1100,25,905,170,22.04.2019 07:40,99,9,Kirov
2064,2029,13,775,1276,13,1289,0,1289,27,1002,260,22.04.2019 00:20,99,9,Kirov
1296,1265,5,468,824,4,828,0,828,27,607,194,22.04.2019 00:45,99,9,Kirov
1168,1132,0,757,411,0,411,0,411,13,322,76,22.04.2019 01:30,99,9,Kirov
1408,1384,6,519,886,3,889,0,889,26,683,180,22.04.2019 00:10,99,9,Kirov
1664,1625,5,627,1033,4,1037,0,1037,20,807,210,22.04.2019 02:45,99,9,Kirov
1360,1319,5,542,816,2,818,0,818,9,639,170,22.04.2019 07:30,99,9,Kirov
1296,1259,4,494,798,4,802,0,802,13,644,145,22.04.2019 00:40,99,9,Kirov
2416,2367,12,933,1474,9,1483,0,1483,38,1145,300,22.04.2019 05:40,99,9,Kirov
2432,2370,16,1024,1399,9,1408,0,1408,33,1091,284,22.04.2019 01:25,99,9,Kirov
2416,2372,12,959,1450,7,1457,0,1457,44,1122,291,21.04.2019 21:30,99,9,Kirov
2064,2008,12,867,1188,9,1197,0,1197,31,919,247,22.04.2019 00:15,99,9,Kirov
1312,1312,3,435,874,3,877,0,877,16,625,236,22.04.2019 00:30,99,9,Kirov
1488,1472,5,646,840,2,842,0,842,16,655,171,22.04.2019 00:03,99,9,Kirov
2048,2005,7,711,1334,3,1337,0,1337,43,1029,265,22.04.2019 00:19,99,9,Kirov
2272,2246,3,739,1531,2,1533,0,1533,33,1136,364,22.04.2019 00:10,99,9,Kirov
1216,1196,13,481,724,11,735,0,735,14,533,188,22.04.2019 00:30,99,9,Kirov
1440,1405,9,675,760,5,765,0,765,14,599,152,22.04.2019 00:35,99,9,Kirov
1744,1718,13,722,1014,8,1022,0,1022,29,769,224,22.04.2019 00:50,99,9,Kirov
1808,1771,11,689,1110,9,1119,0,1119,18,823,278,22.04.2019 00:40,99,9,Kirov
880,861,23,337,530,13,543,0,543,12,423,108,22.04.2019 04:50,99,9,Kirov
1840,1814,9,685,1152,3,1155,0,1155,20,898,237,22.04.2019 02:42,99,9,Kirov
1264,1248,6,461,800,3,803,0,803,18,626,159,22.04.2019 03:37,99,9,Kirov
2096,2065,16,724,1358,14,1372,0,1372,36,1072,264,22.04.2019 00:45,99,9,Kirov
1632,1590,8,655,970,7,977,0,977,23,785,169,22.04.2019 00:10,99,9,Kirov
2256,2202,9,905,1343,8,1351,0,1351,32,1054,265,22.04.2019 04:45,99,9,Kirov
2160,2106,6,876,1279,5,1284,0,1284,22,963,299,22.04.2019 02:15,99,9,Kirov
752,728,2,285,465,2,467,0,467,9,370,88,22.04.2019 00:05,99,9,Kirov
1536,1512,8,578,953,5,958,0,958,18,740,200,22.04.2019 03:10,99,9,Kirov
1808,1767,5,668,1136,4,1140,0,1140,25,887,228,22.04.2019 03:25,99,9,Kirov
2032,1994,39,807,1196,29,1225,0,1225,22,933,270,22.04.2019 00:50,99,9,Kirov
2128,2100,8,846,1274,8,1282,0,1282,40,939,303,22.04.2019 07:34,99,9,Kirov
2272,2222,4,863,1407,2,1409,0,1409,34,1061,314,22.04.2019 00:50,99,9,Kirov
1408,1384,7,457,947,4,951,0,951,24,751,176,22.04.2019 00:10,99,9,Kirov
1232,1201,5,449,778,5,783,0,783,13,576,194,21.04.2019 23:50,99,9,Kirov
1728,1712,13,616,1101,11,1112,0,1112,27,819,266,22.04.2019 00:40,99,9,Kirov
1616,1600,10,568,1040,8,1048,0,1048,25,772,251,22.04.2019 06:30,99,9,Kirov
1904,1857,12,678,1219,6,1225,0,1225,37,934,255,22.04.2019 00:10,99,9,Kirov
1792,1750,4,632,1156,4,1160,0,1160,31,871,258,22.04.2019 00:18,99,9,Kirov
1712,1672,6,688,1021,3,1024,0,1024,22,802,200,22.04.2019 06:18,99,9,Kirov
1616,1585,8,519,1092,5,1097,0,1097,27,803,267,22.04.2019 00:10,99,9,Kirov
1760,1728,4,547,1210,3,1213,0,1213,31,873,309,22.04.2019 00:10,99,9,Kirov
2192,2146,18,785,1392,15,1407,0,1407,28,1074,305,21.04.2019 22:45,99,9,Kirov
2032,2002,8,773,1255,4,1259,0,1259,23,951,285,22.04.2019 00:05,99,9,Kirov
1616,1585,6,549,1062,5,1067,0,1067,24,789,254,22.04.2019 02:20,99,9,Kirov
1824,1783,6,707,1111,6,1117,0,1117,21,864,232,22.04.2019 00:07,99,9,Kirov
2112,2078,7,746,1362,4,1366,0,1366,33,1053,280,22.04.2019 00:20,99,9,Kirov
2336,2319,6,852,1478,6,1484,0,1484,36,1134,314,22.04.2019 00:16,99,9,Kirov
2208,2164,8,725,1479,4,1483,0,1483,26,1142,315,22.04.2019 01:55,99,9,Kirov
2144,2092,8,763,1379,2,1381,0,1381,24,1023,334,22.04.2019 00:10,99,9,Kirov
2336,2284,9,894,1436,6,1442,0,1442,24,1115,303,21.04.2019 22:50,99,9,Kirov
1952,1907,4,719,1230,3,1233,0,1233,23,932,278,22.04.2019 00:37,99,9,Kirov
2336,2275,5,916,1416,4,1420,0,1420,35,1060,325,21.04.2019 22:15,99,9,Kirov
1600,1552,0,970,630,0,630,0,630,8,532,90,22.04.2019 00:05,99,9,Kirov
2272,2227,5,1026,1243,3,1246,0,1246,26,990,230,22.04.2019 07:20,99,9,Kirov
1472,1447,6,598,871,3,874,0,874,10,703,161,22.04.2019 04:42,99,9,Kirov
2288,2240,16,870,1404,14,1418,0,1418,39,1099,280,22.04.2019 00:55,99,9,Kirov
224,182,12,53,160,11,171,0,171,4,120,47,21.04.2019 23:37,99,9,Kirov
320,105,90,224,15,81,96,0,96,0,85,11,21.04.2019 23:00,99,9,Kirov
176,40,3,139,35,2,37,0,37,0,33,4,22.04.2019 00:05,99,9,Kirov
272,63,9,216,49,7,56,0,56,1,44,11,22.04.2019 00:05,99,9,Kirov
144,87,23,61,60,23,83,0,83,1,68,14,21.04.2019 22:20,99,9,Kirov
816,296,203,559,87,170,257,0,257,9,213,35,21.04.2019 22:45,99,9,Kirov
144,34,0,115,29,0,29,0,29,1,26,2,22.04.2019 00:09,99,9,Kirov
128,43,0,88,40,0,40,0,40,1,28,11,22.04.2019 06:07,99,9,Kirov
256,29,3,227,26,3,29,0,29,1,18,10,22.04.2019 00:15,99,9,Kirov
2240,2200,18,889,1336,15,1351,0,1350,32,1054,264,22.04.2019 05:30,99,9,Kirov
2048,2017,7,862,1179,7,1186,0,1186,25,979,182,22.04.2019 00:45,99,9,Kirov
1552,1540,10,610,934,8,942,0,942,21,744,177,22.04.2019 01:23,99,9,Kirov
976,956,3,387,587,2,589,0,589,10,472,107,22.04.2019 00:20,99,9,Kirov
2304,2252,11,842,1454,8,1462,0,1462,30,1122,309,22.04.2019 00:40,99,9,Kirov
1680,1650,4,697,979,4,983,0,983,16,747,220,22.04.2019 00:45,99,9,Kirov
2128,2105,8,784,1341,3,1344,0,1344,27,1023,294,22.04.2019 01:15,99,9,Kirov
992,985,7,438,549,5,554,0,554,14,451,89,22.04.2019 06:05,99,9,Kirov
2416,2395,15,971,1435,10,1445,0,1445,30,1207,208,22.04.2019 06:10,99,9,Kirov
1872,1857,21,805,1050,17,1067,0,1067,13,835,219,22.04.2019 06:55,99,9,Kirov
2336,2324,12,1026,1299,11,1310,0,1310,29,1052,229,22.04.2019 00:10,99,9,Kirov
2256,2211,3,915,1339,2,1341,0,1341,30,1077,234,22.04.2019 02:00,99,9,Kirov
1184,1162,25,443,720,21,741,0,741,15,583,143,22.04.2019 00:30,99,9,Kirov
1728,1689,9,700,1022,6,1028,0,1028,16,791,221,22.04.2019 05:34,99,9,Kirov
1712,1694,8,749,955,8,963,0,963,26,738,199,22.04.2019 00:25,99,9,Kirov
1296,1276,12,516,770,10,780,0,780,21,570,189,22.04.2019 00:09,99,9,Kirov
1184,1160,4,441,741,2,743,0,743,23,569,151,22.04.2019 00:20,99,9,Kirov
2320,2286,13,898,1411,11,1422,0,1421,25,1169,227,22.04.2019 00:55,99,9,Kirov
928,924,9,326,595,7,602,0,602,20,431,151,21.04.2019 21:40,99,9,Kirov
1408,1454,15,487,910,11,921,0,921,36,628,257,21.04.2019 21:55,99,9,Kirov
1280,1256,2,561,717,2,719,0,719,15,563,141,22.04.2019 00:25,99,9,Kirov
1424,1412,10,511,907,6,913,0,913,28,646,239,22.04.2019 04:00,99,9,Kirov
1296,1280,6,487,806,3,809,0,809,22,583,204,22.04.2019 00:30,99,9,Kirov
768,748,2,313,455,0,455,0,455,8,355,92,21.04.2019 23:00,99,9,Kirov
1744,1627,8,826,912,6,918,0,918,24,603,291,22.04.2019 00:23,99,9,Kirov
1440,1416,3,627,811,2,813,0,813,27,623,163,22.04.2019 00:10,99,9,Kirov
864,850,8,344,513,7,520,0,520,17,371,132,22.04.2019 00:05,99,9,Kirov
688,666,0,309,379,0,379,0,379,4,276,99,22.04.2019 00:30,99,9,Kirov
1456,1427,13,550,895,11,906,0,906,30,656,220,22.04.2019 00:05,99,9,Kirov
2176,2146,5,817,1355,4,1359,0,1359,40,1071,248,22.04.2019 00:30,99,9,Kirov
1856,1823,7,684,1168,4,1172,0,1172,37,826,309,21.04.2019 21:50,99,9,Kirov
1904,1882,13,816,1079,9,1088,0,1088,21,885,182,22.04.2019 00:10,99,9,Kirov
1504,1477,7,564,935,5,940,0,940,30,652,258,22.04.2019 00:10,99,9,Kirov
1728,1711,5,766,958,4,962,0,962,31,712,219,22.04.2019 00:05,99,9,Kirov
2064,2031,11,750,1307,7,1314,0,1314,31,951,332,22.04.2019 00:20,99,9,Kirov
1232,1216,5,524,704,4,708,0,708,8,572,128,22.04.2019 00:10,99,9,Kirov
208,200,125,11,74,123,197,0,197,5,78,114,22.04.2019 00:10,99,9,Kirov
80,14,7,66,7,7,14,0,14,0,9,5,22.04.2019 00:15,99,9,Kirov
288,48,18,242,30,16,46,0,46,0,32,14,21.04.2019 21:00,99,9,Kirov
416,21,0,402,14,0,14,0,14,0,12,2,21.04.2019 21:04,99,9,Kirov
288,177,47,125,118,45,163,0,163,1,141,21,22.04.2019 00:10,99,9,Kirov
976,492,0,484,492,0,492,0,492,29,434,29,22.04.2019 01:26,99,9,Kirov
1824,1801,31,824,972,28,1000,0,1000,28,818,154,22.04.2019 00:05,100,9,Kirov
1792,1772,45,741,1013,38,1051,0,1051,26,833,192,22.04.2019 01:05,100,9,Kirov
1792,1755,14,666,1114,12,1126,0,1126,16,918,192,22.04.2019 00:10,100,9,Kirov
1952,1935,23,832,1098,22,1120,0,1120,24,932,164,22.04.2019 01:10,100,9,Kirov
1328,1300,12,659,657,12,669,0,669,30,563,76,22.04.2019 00:35,100,9,Kirov
240,231,6,101,134,5,139,0,139,2,121,16,21.04.2019 21:00,100,9,Kirov
256,249,14,118,127,11,138,0,138,3,113,22,21.04.2019 22:15,100,9,Kirov
384,378,24,132,229,23,252,0,252,6,220,26,22.04.2019 01:10,100,9,Kirov
256,248,23,99,134,23,157,0,157,4,87,66,21.04.2019 20:56,100,9,Kirov
48,36,1,27,20,1,21,0,21,0,15,6,21.04.2019 20:40,100,9,Kirov
320,314,19,142,159,19,178,0,178,1,148,29,21.04.2019 21:15,100,9,Kirov
336,317,9,115,212,9,221,0,221,2,161,58,22.04.2019 00:04,100,9,Kirov
688,682,37,309,345,34,379,0,379,6,268,105,21.04.2019 22:10,100,9,Kirov
96,95,4,34,59,3,62,0,62,0,44,18,22.04.2019 00:31,100,9,Kirov
192,177,4,72,117,3,120,0,120,2,103,15,21.04.2019 20:30,100,9,Kirov
496,476,40,189,267,40,307,0,307,1,210,96,21.04.2019 20:45,100,9,Kirov
384,364,31,139,214,31,245,0,245,4,188,53,22.04.2019 00:10,100,9,Kirov
336,323,16,110,212,14,226,0,226,7,190,29,21.04.2019 20:55,100,9,Kirov
128,121,5,50,73,5,78,0,78,0,71,7,21.04.2019 20:55,100,9,Kirov
432,412,17,183,234,15,249,0,249,5,165,79,22.04.2019 00:15,100,9,Kirov
128,127,9,35,88,5,93,0,93,5,50,38,22.04.2019 00:10,100,9,Kirov
208,195,4,109,98,1,99,0,99,2,66,31,21.04.2019 22:30,100,9,Kirov
400,395,16,156,230,14,244,0,244,3,216,25,22.04.2019 00:20,100,9,Kirov
96,90,1,32,63,1,64,0,64,2,51,11,22.04.2019 00:10,100,9,Kirov
576,554,37,247,294,35,329,0,329,0,279,50,21.04.2019 21:11,100,9,Kirov
208,194,7,79,124,5,129,0,129,2,81,46,21.04.2019 20:35,100,9,Kirov
16,15,3,8,6,2,8,0,8,0,5,3,21.04.2019 21:40,100,9,Kirov
432,417,21,136,278,18,296,0,296,3,258,35,22.04.2019 00:10,100,9,Kirov
256,252,13,110,137,9,146,0,146,3,111,32,21.04.2019 20:20,100,9,Kirov
320,312,28,103,191,26,217,0,217,2,171,44,22.04.2019 00:17,100,9,Kirov
448,444,28,166,257,25,282,0,282,4,209,69,22.04.2019 00:05,100,9,Kirov
80,78,2,36,42,2,44,0,44,2,33,9,21.04.2019 21:05,100,9,Kirov
160,153,13,57,90,13,103,0,103,3,65,35,21.04.2019 22:30,100,9,Kirov
320,303,13,135,172,13,185,0,185,5,135,45,22.04.2019 00:45,100,9,Kirov
416,409,15,159,242,15,257,0,257,3,209,45,21.04.2019 20:30,100,9,Kirov
384,379,17,129,238,17,255,0,255,5,231,19,22.04.2019 00:10,100,9,Kirov
384,383,21,101,266,17,283,0,283,3,197,83,21.04.2019 20:45,100,9,Kirov
560,545,40,222,298,40,338,0,338,4,276,58,22.04.2019 00:10,100,9,Kirov
208,196,4,78,126,4,130,0,130,2,95,33,21.04.2019 23:10,100,9,Kirov
64,53,2,36,28,0,28,0,28,0,21,7,22.04.2019 00:20,100,9,Kirov
240,231,6,124,111,5,116,0,116,1,95,20,21.04.2019 20:40,100,9,Kirov
224,218,15,78,134,12,146,0,146,2,121,23,21.04.2019 23:15,100,9,Kirov
1120,1092,12,526,587,7,594,0,594,12,479,103,21.04.2019 22:05,100,9,Kirov
1488,1447,14,622,853,13,866,0,866,9,669,188,22.04.2019 00:30,100,9,Kirov
544,538,7,236,302,6,308,0,308,5,260,43,21.04.2019 20:30,100,9,Kirov
896,886,10,389,497,10,507,0,507,11,420,76,22.04.2019 01:10,100,9,Kirov
336,325,9,157,170,9,179,0,179,1,136,42,21.04.2019 21:00,100,9,Kirov
192,194,10,74,108,10,118,0,118,4,76,38,21.04.2019 21:00,100,9,Kirov
352,341,16,145,193,14,207,0,207,4,156,47,21.04.2019 20:44,100,9,Kirov
256,237,29,99,131,26,157,0,157,1,127,29,21.04.2019 21:18,100,9,Kirov
320,303,10,149,162,9,171,0,171,1,136,34,21.04.2019 22:00,100,9,Kirov
560,538,46,187,327,46,373,0,373,2,311,60,21.04.2019 21:00,100,9,Kirov
720,710,36,286,400,34,434,0,434,7,360,67,22.04.2019 00:15,100,9,Kirov
416,407,41,158,220,38,258,0,258,7,186,65,21.04.2019 20:31,100,9,Kirov
368,356,31,142,195,31,226,0,226,1,209,16,22.04.2019 00:12,100,9,Kirov
160,159,4,59,97,4,101,0,101,2,86,13,22.04.2019 02:18,100,9,Kirov
256,243,13,104,139,13,152,0,152,3,130,19,22.04.2019 00:15,100,9,Kirov
272,259,7,119,149,4,153,0,153,1,133,19,21.04.2019 23:55,100,9,Kirov
96,96,5,24,67,5,72,0,72,0,61,11,21.04.2019 21:20,100,9,Kirov
240,219,15,91,134,15,149,0,149,3,118,28,21.04.2019 23:40,100,9,Kirov
368,360,11,135,222,11,233,0,233,2,195,36,21.04.2019 23:58,100,9,Kirov
272,270,11,92,171,9,180,0,180,5,149,26,21.04.2019 23:10,100,9,Kirov
512,496,21,256,235,21,256,0,256,12,158,86,22.04.2019 01:25,100,9,Kirov
224,218,13,113,100,11,111,0,111,2,92,17,22.04.2019 00:11,100,9,Kirov
1680,1661,6,766,913,1,914,0,914,12,754,148,21.04.2019 21:40,100,9,Kirov
1520,1505,9,769,743,8,751,0,751,12,653,86,22.04.2019 02:00,100,9,Kirov
1680,1656,6,722,955,3,958,0,958,24,797,137,22.04.2019 00:30,100,9,Kirov
1632,1608,4,727,901,4,905,0,905,14,763,128,22.04.2019 00:15,100,9,Kirov
1120,1098,3,509,608,3,611,0,611,12,513,86,22.04.2019 02:00,100,9,Kirov
2032,2009,37,788,1212,32,1244,0,1244,26,964,254,21.04.2019 21:40,100,9,Kirov
1792,1761,26,743,1027,22,1049,0,1049,23,857,169,22.04.2019 01:05,100,9,Kirov
1200,1176,24,534,647,19,666,0,666,4,574,88,21.04.2019 20:50,100,9,Kirov
368,355,36,114,222,32,254,0,254,3,192,59,22.04.2019 00:30,100,9,Kirov
432,410,46,193,195,44,239,0,239,0,191,48,22.04.2019 02:10,100,9,Kirov
448,445,42,163,248,37,285,0,285,2,212,71,21.04.2019 22:50,100,9,Kirov
336,332,28,142,170,24,194,0,194,1,157,36,21.04.2019 20:20,100,9,Kirov
128,114,18,57,53,18,71,0,71,2,52,17,21.04.2019 21:40,100,9,Kirov
160,155,11,66,85,9,94,0,94,0,73,21,21.04.2019 21:00,100,9,Kirov
272,265,16,75,181,16,197,0,197,1,163,33,21.04.2019 21:15,100,9,Kirov
976,955,64,425,489,62,551,0,551,8,442,101,22.04.2019 01:10,100,9,Kirov
592,580,23,270,301,21,322,0,322,5,237,80,21.04.2019 21:14,100,9,Kirov
688,663,20,439,232,17,249,0,249,0,198,51,22.04.2019 03:20,100,9,Kirov
272,264,31,114,130,28,158,0,158,1,112,45,22.04.2019 03:05,100,9,Kirov
208,199,15,88,106,14,120,0,120,4,84,32,22.04.2019 00:15,100,9,Kirov
352,343,13,125,217,10,227,0,227,4,192,31,22.04.2019 00:25,100,9,Kirov
400,384,31,169,205,26,231,0,231,5,193,33,22.04.2019 00:30,100,9,Kirov
480,463,11,202,267,11,278,0,278,3,221,54,22.04.2019 00:05,100,9,Kirov
128,114,0,56,72,0,72,0,72,0,58,14,21.04.2019 23:50,100,9,Kirov
192,189,6,48,140,4,144,0,144,0,122,22,22.04.2019 01:02,100,9,Kirov
96,94,2,35,59,2,61,0,61,0,51,10,21.04.2019 20:45,100,9,Kirov
208,203,9,94,106,8,114,0,114,3,75,36,22.04.2019 01:40,100,9,Kirov
304,298,28,119,158,27,185,0,185,2,133,50,22.04.2019 00:25,100,9,Kirov
1120,1051,35,502,590,28,618,0,618,11,499,108,21.04.2019 23:38,100,9,Kirov
1152,1116,46,460,652,40,692,0,692,13,582,97,22.04.2019 00:50,100,9,Kirov
720,704,50,325,347,48,395,0,395,8,344,43,21.04.2019 21:22,100,9,Kirov
1872,1852,20,742,1110,20,1130,0,1130,24,932,174,21.04.2019 23:50,100,9,Kirov
768,772,43,332,394,42,436,0,436,6,358,72,22.04.2019 00:30,100,9,Kirov
832,824,13,302,517,13,530,0,530,10,424,96,22.04.2019 00:36,100,9,Kirov
1088,1058,25,373,690,25,715,0,715,11,565,139,22.04.2019 00:15,100,9,Kirov
128,123,10,38,80,10,90,0,90,4,63,23,22.04.2019 00:10,100,9,Kirov
688,680,21,337,330,21,351,0,351,6,298,47,22.04.2019 00:20,100,9,Kirov
304,298,24,145,138,21,159,0,159,3,129,27,21.04.2019 21:30,100,9,Kirov
720,713,11,241,468,11,479,0,479,13,343,123,21.04.2019 21:30,100,9,Kirov
400,399,23,168,214,18,232,0,232,5,170,57,21.04.2019 22:00,100,9,Kirov
288,285,26,111,151,26,177,0,177,2,153,22,21.04.2019 20:40,100,9,Kirov
912,898,70,419,428,65,493,0,493,9,414,70,21.04.2019 21:10,100,9,Kirov
416,409,7,190,222,4,226,0,226,2,180,44,21.04.2019 21:30,100,9,Kirov
336,314,10,131,195,10,205,0,205,0,165,40,21.04.2019 23:50,100,9,Kirov
224,204,2,102,120,2,122,0,122,5,97,20,21.04.2019 22:30,100,9,Kirov
640,630,51,234,357,49,406,0,406,8,358,40,22.04.2019 00:10,100,9,Kirov
672,659,47,271,359,42,401,0,401,3,356,42,22.04.2019 01:00,100,9,Kirov
240,233,31,115,98,27,125,0,125,3,80,42,21.04.2019 22:00,100,9,Kirov
512,497,31,239,250,23,273,0,273,7,198,68,21.04.2019 21:35,100,9,Kirov
208,203,15,76,117,15,132,0,132,2,109,21,21.04.2019 21:00,100,9,Kirov
320,306,13,103,204,13,217,0,217,2,180,35,22.04.2019 00:45,100,9,Kirov
272,267,18,53,201,18,219,0,219,3,192,24,21.04.2019 23:59,100,9,Kirov
272,268,15,90,168,14,182,0,182,2,154,26,21.04.2019 23:00,100,9,Kirov
352,346,16,101,236,15,251,0,251,9,199,43,22.04.2019 01:00,100,9,Kirov
464,448,32,135,298,31,329,0,329,7,277,45,21.04.2019 22:30,100,9,Kirov
96,80,4,58,35,3,38,0,38,4,26,8,22.04.2019 01:00,100,9,Kirov
224,221,12,89,123,12,135,0,135,2,96,37,22.04.2019 00:25,100,9,Kirov
224,215,11,109,105,10,115,0,115,1,96,18,21.04.2019 22:10,100,9,Kirov
688,677,51,306,337,45,382,0,382,4,299,79,22.04.2019 00:30,100,9,Kirov
704,683,32,276,399,29,428,0,428,7,348,73,22.04.2019 00:20,100,9,Kirov
320,307,18,144,161,15,176,0,176,5,144,27,22.04.2019 00:05,100,9,Kirov
400,389,19,157,224,19,243,0,243,2,205,36,22.04.2019 01:05,100,9,Kirov
112,98,10,54,48,10,58,0,58,4,46,8,21.04.2019 22:00,100,9,Kirov
144,132,0,77,67,0,67,0,67,0,54,13,21.04.2019 21:42,100,9,Kirov
832,807,69,346,420,66,486,0,486,5,412,69,22.04.2019 00:27,100,9,Kirov
2016,1985,61,844,1117,55,1172,0,1172,25,955,192,22.04.2019 00:10,100,9,Kirov
800,786,47,289,467,44,511,0,511,6,455,50,22.04.2019 01:45,100,9,Kirov
1616,1579,36,612,971,33,1004,0,1004,29,817,158,21.04.2019 23:00,100,9,Kirov
2288,2264,26,862,1405,21,1426,0,1426,21,1087,318,22.04.2019 02:05,100,9,Kirov
784,777,25,290,472,22,494,0,494,1,416,77,22.04.2019 00:30,100,9,Kirov
288,283,15,118,161,9,170,0,170,3,140,27,22.04.2019 00:05,100,9,Kirov
496,475,32,170,295,31,326,0,326,4,279,43,21.04.2019 21:00,100,9,Kirov
560,541,53,197,316,47,363,0,363,4,287,72,21.04.2019 22:30,100,9,Kirov
544,520,52,181,311,52,363,0,363,1,320,42,21.04.2019 20:30,100,9,Kirov
368,158,26,267,83,18,101,0,101,1,86,14,21.04.2019 22:30,100,9,Kirov
2336,2297,30,838,1476,22,1498,0,1498,26,1255,217,22.04.2019 00:20,100,9,Kirov
1520,1492,19,633,868,19,887,0,887,15,760,112,22.04.2019 01:30,100,9,Kirov
416,409,5,194,218,4,222,0,222,6,194,22,21.04.2019 23:50,100,9,Kirov
304,296,8,114,182,8,190,0,190,2,123,65,22.04.2019 00:20,100,9,Kirov
224,215,7,94,125,5,130,0,130,4,80,46,21.04.2019 21:00,100,9,Kirov
352,335,9,142,202,8,210,0,210,1,180,29,21.04.2019 22:00,100,9,Kirov
128,125,4,42,83,3,86,0,86,2,65,19,21.04.2019 21:20,100,9,Kirov
304,292,11,106,188,10,198,0,198,10,146,42,21.04.2019 21:05,100,9,Kirov
464,450,40,174,254,36,290,0,290,3,211,76,21.04.2019 23:30,100,9,Kirov
288,284,16,146,126,16,142,0,142,0,110,32,22.04.2019 00:10,100,9,Kirov
528,512,32,217,280,31,311,0,311,1,268,42,22.04.2019 00:14,100,9,Kirov
720,704,19,259,443,18,461,0,461,8,372,81,21.04.2019 21:10,100,9,Kirov
288,277,3,149,137,2,139,0,139,0,121,18,22.04.2019 00:05,100,9,Kirov
432,416,29,198,210,24,234,0,234,8,181,45,21.04.2019 22:30,100,9,Kirov
464,444,38,186,248,30,278,0,278,7,225,46,21.04.2019 22:10,100,9,Kirov
208,203,18,82,108,18,126,0,126,0,91,35,22.04.2019 00:30,100,9,Kirov
80,74,0,36,44,0,44,0,44,0,26,18,21.04.2019 20:30,100,9,Kirov
528,517,6,211,313,4,317,0,317,3,243,71,21.04.2019 21:00,100,9,Kirov
400,392,9,175,218,7,225,0,225,3,165,57,21.04.2019 21:30,100,9,Kirov
336,322,20,129,193,14,207,0,207,5,163,39,22.04.2019 00:30,100,9,Kirov
656,644,37,280,340,36,376,0,376,3,301,72,22.04.2019 00:10,100,9,Kirov
512,497,4,244,264,4,268,0,268,1,213,54,22.04.2019 00:05,100,9,Kirov
288,276,9,125,156,7,163,0,163,1,140,22,21.04.2019 21:30,100,9,Kirov
1072,1041,22,501,560,11,571,0,571,15,480,76,22.04.2019 00:05,100,9,Kirov
1216,1200,24,532,669,15,684,0,684,29,563,92,22.04.2019 00:10,100,9,Kirov
976,955,15,415,546,15,561,0,561,19,461,81,22.04.2019 01:10,100,9,Kirov
1712,1724,34,720,971,21,992,0,992,24,815,153,22.04.2019 01:34,100,9,Kirov
1584,1546,38,658,898,28,926,0,926,19,786,121,22.04.2019 00:15,100,9,Kirov
1200,1186,21,520,663,17,680,0,680,8,582,90,22.04.2019 00:25,100,9,Kirov
1344,1312,29,576,743,25,768,0,768,10,658,100,22.04.2019 00:35,100,9,Kirov
848,827,28,396,432,20,452,0,452,9,377,66,22.04.2019 02:06,100,9,Kirov
2144,2122,37,1087,1036,21,1057,0,1057,19,899,139,22.04.2019 00:17,100,9,Kirov
1504,1473,25,657,825,22,847,0,847,15,706,126,21.04.2019 21:12,100,9,Kirov
704,689,16,365,325,14,339,0,339,5,285,49,21.04.2019 23:55,100,9,Kirov
432,430,30,178,225,29,254,0,254,9,198,47,21.04.2019 20:51,100,9,Kirov
736,717,78,300,366,70,436,0,436,6,352,78,21.04.2019 22:30,100,9,Kirov
816,807,93,387,347,82,429,0,429,5,352,72,21.04.2019 22:30,100,9,Kirov
288,277,45,85,158,45,203,0,203,2,145,56,21.04.2019 23:01,100,9,Kirov
352,346,16,143,196,13,209,0,209,4,174,31,22.04.2019 00:45,100,9,Kirov
464,447,26,182,257,25,282,0,282,6,225,51,22.04.2019 00:15,100,9,Kirov
512,490,22,268,224,20,244,0,244,3,192,49,21.04.2019 20:45,100,9,Kirov
800,786,69,345,392,63,455,0,455,17,374,64,22.04.2019 01:15,100,9,Kirov
368,361,37,203,133,32,165,0,165,1,113,51,22.04.2019 00:45,100,9,Kirov
848,826,62,392,402,54,456,0,456,5,388,63,22.04.2019 00:05,100,9,Kirov
256,252,23,87,149,20,169,0,169,3,136,30,22.04.2019 01:20,100,9,Kirov
384,374,42,148,199,37,236,0,236,4,182,50,21.04.2019 20:47,100,9,Kirov
256,249,36,101,121,34,155,0,155,5,121,29,21.04.2019 23:30,100,9,Kirov
464,451,52,206,217,41,258,0,258,1,203,54,21.04.2019 21:10,100,9,Kirov
464,454,33,217,219,28,247,0,247,2,184,61,22.04.2019 02:10,100,9,Kirov
400,383,55,153,193,54,247,0,247,3,211,33,22.04.2019 03:00,100,9,Kirov
400,391,14,174,212,14,226,0,226,4,202,20,22.04.2019 00:05,100,9,Kirov
272,259,62,112,105,55,160,0,160,19,116,25,22.04.2019 00:03,100,9,Kirov
480,460,41,169,275,36,311,0,311,4,268,39,22.04.2019 00:35,100,9,Kirov
272,256,26,123,127,22,149,0,149,7,109,33,21.04.2019 22:50,100,9,Kirov
144,141,9,49,89,6,95,0,95,4,65,26,22.04.2019 00:15,100,9,Kirov
832,810,67,352,419,61,480,0,480,7,409,64,22.04.2019 00:55,100,9,Kirov
656,656,43,267,348,41,389,0,389,5,320,64,21.04.2019 21:56,100,9,Kirov
1312,1296,21,582,710,20,730,0,730,8,622,100,22.04.2019 01:10,100,9,Kirov
752,731,31,276,450,26,476,0,476,3,431,42,22.04.2019 00:33,100,9,Kirov
576,572,11,246,319,11,330,0,330,2,286,42,22.04.2019 00:45,100,9,Kirov
416,399,38,201,178,37,215,0,215,9,160,46,21.04.2019 21:45,100,9,Kirov
128,126,11,67,55,6,61,0,61,3,35,23,21.04.2019 21:55,100,9,Kirov
256,252,14,115,128,13,141,0,141,2,123,16,22.04.2019 00:30,100,9,Kirov
368,352,15,178,179,11,190,0,190,4,157,29,21.04.2019 21:15,100,9,Kirov
416,401,21,154,247,15,262,0,262,4,220,38,21.04.2019 22:30,100,9,Kirov
1568,1533,2,581,986,1,987,0,987,21,761,205,22.04.2019 00:30,100,9,Kirov
2128,2100,4,827,1298,3,1301,0,1301,16,1099,186,22.04.2019 00:15,100,9,Kirov
1296,1263,8,659,633,4,637,0,637,21,502,114,22.04.2019 01:20,100,9,Kirov
1696,1653,6,628,1064,4,1068,0,1068,15,856,197,22.04.2019 00:12,100,9,Kirov
2288,2254,12,916,1364,8,1372,0,1372,39,1084,249,22.04.2019 00:35,100,9,Kirov
1680,1651,5,657,1019,4,1023,0,1023,29,776,218,22.04.2019 00:35,100,9,Kirov
1696,1658,6,694,998,4,1002,0,1002,17,792,193,22.04.2019 00:55,100,9,Kirov
1840,1815,8,693,1144,3,1147,0,1147,17,914,216,21.04.2019 22:43,100,9,Kirov
2480,2437,5,1119,1356,5,1361,0,1361,35,1110,216,22.04.2019 00:40,100,9,Kirov
2416,2374,12,1010,1398,8,1406,0,1406,23,1129,254,22.04.2019 00:22,100,9,Kirov
736,376,121,376,250,110,360,0,360,7,277,76,22.04.2019 00:15,100,9,Kirov
1408,1375,9,497,903,8,911,0,911,17,742,152,22.04.2019 00:30,100,9,Kirov
1728,1691,14,657,1059,12,1071,0,1071,19,805,247,22.04.2019 00:15,100,9,Kirov
1392,1368,5,572,815,5,820,0,820,10,719,91,21.04.2019 21:00,101,9,Kirov
1008,982,12,468,530,10,540,0,540,15,415,110,21.04.2019 22:30,101,9,Kirov
2288,2258,26,1049,1218,21,1239,0,1239,34,898,307,22.04.2019 00:45,101,9,Kirov
1600,1581,10,783,810,7,817,0,817,15,582,220,21.04.2019 22:00,101,9,Kirov
2128,2101,11,960,1159,9,1168,0,1168,32,876,260,21.04.2019 22:30,101,9,Kirov
1840,1807,22,844,979,17,996,0,996,13,743,240,22.04.2019 01:00,101,9,Kirov
1520,1481,14,757,749,14,763,0,763,10,628,125,22.04.2019 01:45,101,9,Kirov
1184,1164,50,572,562,50,612,0,612,8,473,131,22.04.2019 00:05,101,9,Kirov
304,308,22,119,164,21,185,0,185,5,130,50,21.04.2019 23:30,101,9,Kirov
640,618,48,276,316,48,364,0,364,15,238,111,21.04.2019 23:55,101,9,Kirov
240,234,16,110,117,13,130,0,130,0,99,31,22.04.2019 06:30,101,9,Kirov
688,681,35,313,340,35,375,0,375,5,270,100,21.04.2019 22:00,101,9,Kirov
240,225,10,112,118,10,128,0,128,1,96,31,22.04.2019 00:05,101,9,Kirov
448,444,42,112,299,37,336,0,336,4,223,109,22.04.2019 00:05,101,9,Kirov
464,452,45,182,242,40,282,0,282,3,214,65,22.04.2019 00:01,101,9,Kirov
1056,1037,57,412,595,49,644,0,644,13,459,172,22.04.2019 00:25,101,9,Kirov
336,324,18,150,168,18,186,0,186,9,132,45,22.04.2019 00:10,101,9,Kirov
1168,1151,11,555,602,11,613,0,613,12,488,113,22.04.2019 05:00,101,9,Kirov
320,312,22,114,184,22,206,0,206,1,134,71,22.04.2019 00:19,101,9,Kirov
1536,1537,40,682,819,35,854,0,854,21,666,167,22.04.2019 00:07,101,9,Kirov
736,721,48,285,404,47,451,0,451,1,339,111,21.04.2019 21:30,101,9,Kirov
1456,1414,5,637,814,5,819,0,819,23,610,186,22.04.2019 00:15,101,9,Kirov
1840,1836,25,727,1091,22,1113,0,1113,29,805,279,22.04.2019 00:15,101,9,Kirov
1440,1420,5,597,840,3,843,0,843,21,621,201,22.04.2019 01:10,101,9,Kirov
528,518,4,219,306,3,309,0,309,9,220,80,22.04.2019 00:10,101,9,Kirov
2176,2133,37,919,1221,36,1257,0,1257,25,1031,201,21.04.2019 22:55,101,9,Kirov
2208,2154,43,993,1187,28,1215,0,1215,31,1013,171,22.04.2019 00:55,101,9,Kirov
320,324,21,118,185,17,202,0,202,3,127,72,21.04.2019 21:00,101,9,Kirov
608,603,14,265,330,13,343,0,343,6,252,85,22.04.2019 00:10,101,9,Kirov
416,414,18,177,221,18,239,0,239,5,180,54,22.04.2019 00:15,101,9,Kirov
384,368,3,159,222,3,225,0,225,2,161,62,22.04.2019 00:35,101,9,Kirov
384,388,24,150,210,24,234,150,234,6,163,65,21.04.2019 20:30,101,9,Kirov
960,944,7,443,511,6,517,0,517,6,437,74,21.04.2019 21:26,101,9,Kirov
560,538,24,220,316,24,340,0,340,7,263,70,21.04.2019 20:50,101,9,Kirov
496,476,10,200,287,9,296,0,296,7,195,94,22.04.2019 00:45,101,9,Kirov
368,354,23,138,207,23,230,0,230,7,151,72,22.04.2019 00:05,101,9,Kirov
400,388,5,187,208,5,213,0,213,2,181,30,21.04.2019 20:20,101,9,Kirov
352,344,11,147,194,11,205,0,205,4,130,71,21.04.2019 21:22,101,9,Kirov
864,847,23,398,449,17,466,0,466,12,379,75,22.04.2019 00:15,101,9,Kirov
128,122,1,60,67,1,68,0,68,1,58,9,22.04.2019 00:05,101,9,Kirov
400,394,37,164,204,32,236,0,236,2,183,51,22.04.2019 00:10,101,9,Kirov
400,385,29,139,232,29,261,0,261,2,222,37,21.04.2019 21:02,101,9,Kirov
800,790,16,338,446,16,462,0,462,7,377,78,22.04.2019 00:30,101,9,Kirov
1456,1425,29,741,688,27,715,0,715,15,571,129,21.04.2019 23:30,101,9,Kirov
176,175,0,77,99,0,99,0,99,0,55,44,21.04.2019 21:40,101,9,Kirov
144,130,4,63,77,4,81,0,81,4,61,16,22.04.2019 00:30,101,9,Kirov
320,315,5,113,202,5,207,0,207,6,181,20,21.04.2019 20:55,101,9,Kirov
368,345,13,139,217,12,229,0,229,4,185,40,22.04.2019 00:50,101,9,Kirov
176,176,2,61,113,2,115,0,115,2,85,28,22.04.2019 00:18,101,9,Kirov
112,98,3,63,46,3,49,0,49,0,38,11,22.04.2019 00:20,101,9,Kirov
272,261,3,122,147,3,150,0,150,6,108,36,22.04.2019 00:15,101,9,Kirov
544,524,27,228,289,27,316,0,316,6,231,79,21.04.2019 20:30,101,9,Kirov
240,230,4,98,140,2,142,0,142,1,119,22,21.04.2019 22:00,101,9,Kirov
528,522,55,233,245,50,295,0,295,8,241,46,21.04.2019 21:25,101,9,Kirov
496,486,4,197,296,3,299,0,299,2,248,49,22.04.2019 00:05,101,9,Kirov
1568,1535,33,724,816,28,844,0,844,19,677,148,22.04.2019 01:10,101,9,Kirov
1664,1651,31,681,957,26,983,0,983,24,761,198,22.04.2019 04:00,101,9,Kirov
880,862,6,372,503,5,508,0,508,4,401,103,22.04.2019 00:30,101,9,Kirov
256,237,22,124,110,22,132,0,132,0,103,29,22.04.2019 08:10,101,9,Kirov
784,776,14,303,470,11,481,0,481,10,430,41,22.04.2019 04:40,101,9,Kirov
752,738,11,316,426,10,436,0,436,6,387,43,22.04.2019 05:10,101,9,Kirov
2032,1999,6,874,1152,6,1158,0,1158,37,1022,99,22.04.2019 00:46,101,9,Kirov
784,767,3,375,406,3,409,0,409,5,362,42,22.04.2019 00:35,101,9,Kirov
1024,1001,6,468,550,6,556,0,556,2,507,47,22.04.2019 00:45,101,9,Kirov
592,581,4,231,357,4,361,0,361,0,317,44,22.04.2019 00:45,101,9,Kirov
496,487,14,223,259,14,273,0,273,3,241,29,22.04.2019 00:38,101,9,Kirov
400,394,30,153,217,30,247,0,247,5,218,24,22.04.2019 00:15,101,9,Kirov
544,523,10,229,306,9,315,0,315,6,259,50,22.04.2019 00:15,101,9,Kirov
288,280,18,125,148,15,163,0,163,3,126,34,22.04.2019 07:10,101,9,Kirov
720,709,30,344,351,25,376,0,376,7,325,44,22.04.2019 00:12,101,9,Kirov
1104,1087,62,404,638,62,700,0,700,17,585,98,22.04.2019 00:15,101,9,Kirov
176,166,29,74,76,26,102,0,102,2,86,14,22.04.2019 00:30,101,9,Kirov
368,364,7,138,225,5,230,0,230,4,202,24,21.04.2019 21:00,101,9,Kirov
496,489,12,221,270,5,275,0,275,2,235,38,21.04.2019 23:35,101,9,Kirov
1072,1046,24,507,544,21,565,0,565,9,454,102,22.04.2019 00:20,101,9,Kirov
64,55,1,21,42,1,43,0,43,0,28,15,22.04.2019 00:30,101,9,Kirov
240,231,6,75,159,6,165,0,165,1,130,34,22.04.2019 00:30,101,9,Kirov
320,310,31,131,158,31,189,0,189,0,148,41,21.04.2019 23:00,101,9,Kirov
1440,1411,12,598,831,11,842,0,842,25,602,215,22.04.2019 00:36,101,9,Kirov
2320,2291,7,1049,1268,3,1271,0,1271,23,990,258,22.04.2019 01:35,101,9,Kirov
368,355,0,180,188,0,188,0,188,2,152,34,21.04.2019 20:50,101,9,Kirov
48,48,5,20,25,3,28,0,28,0,22,6,21.04.2019 22:25,101,9,Kirov
336,325,20,129,187,20,207,0,207,2,146,59,22.04.2019 00:45,101,9,Kirov
96,84,5,44,47,5,52,0,52,4,34,14,21.04.2019 20:30,101,9,Kirov
336,336,9,151,177,8,185,0,185,1,163,21,22.04.2019 00:20,101,9,Kirov
432,417,21,177,236,19,255,0,255,0,205,50,21.04.2019 22:00,101,9,Kirov
896,884,36,426,441,29,470,0,470,9,407,54,21.04.2019 22:45,101,9,Kirov
1056,1032,21,440,596,20,616,0,616,8,497,111,22.04.2019 00:07,101,9,Kirov
560,549,36,190,334,36,370,0,370,7,282,81,21.04.2019 20:40,101,9,Kirov
80,76,9,38,37,5,42,0,42,2,23,17,21.04.2019 20:31,101,9,Kirov
208,197,11,108,89,11,100,0,100,1,78,21,21.04.2019 20:55,101,9,Kirov
352,353,39,87,232,33,265,0,265,4,211,50,21.04.2019 22:11,101,9,Kirov
768,762,63,241,466,61,527,0,527,10,399,118,22.04.2019 00:30,101,9,Kirov
1392,1380,77,599,719,74,793,0,793,12,612,169,21.04.2019 21:05,101,9,Kirov
448,441,22,176,254,18,272,0,272,5,228,39,21.04.2019 21:30,101,9,Kirov
144,134,3,41,100,3,103,0,103,3,64,36,21.04.2019 21:15,101,9,Kirov
160,158,14,49,98,13,111,0,111,3,68,40,21.04.2019 23:20,101,9,Kirov
272,255,31,109,133,30,163,0,163,2,125,36,21.04.2019 21:30,101,9,Kirov
384,376,25,140,224,20,244,0,244,4,206,34,21.04.2019 22:00,101,9,Kirov
384,385,22,170,194,20,214,0,214,13,143,58,21.04.2019 21:15,101,9,Kirov
64,62,1,33,31,0,31,0,31,2,27,2,21.04.2019 20:35,101,9,Kirov
160,148,4,62,94,4,98,0,98,0,67,31,21.04.2019 20:37,101,9,Kirov
256,248,21,42,193,21,214,0,214,2,176,36,22.04.2019 01:15,101,9,Kirov
64,63,5,18,41,5,46,0,46,1,25,20,21.04.2019 21:50,101,9,Kirov
80,75,4,32,47,1,48,0,48,0,39,9,22.04.2019 06:00,101,9,Kirov
400,384,32,144,227,29,256,0,256,10,200,46,21.04.2019 20:35,101,9,Kirov
640,623,32,295,318,27,345,0,345,3,298,44,22.04.2019 00:45,101,9,Kirov
144,142,6,65,75,4,79,0,79,1,41,37,21.04.2019 21:25,101,9,Kirov
688,670,40,284,367,37,404,0,404,3,313,88,22.04.2019 00:05,101,9,Kirov
352,341,12,154,189,9,198,0,198,4,167,27,22.04.2019 00:45,101,9,Kirov
544,526,44,193,307,44,351,0,351,9,290,52,22.04.2019 00:30,101,9,Kirov
1168,1143,55,517,604,47,651,0,651,5,537,109,21.04.2019 23:57,101,9,Kirov
352,347,22,144,191,17,208,0,208,4,157,47,22.04.2019 00:02,101,9,Kirov
832,821,71,307,456,69,525,0,525,9,366,150,22.04.2019 00:30,101,9,Kirov
976,955,46,448,483,45,528,0,528,10,421,97,22.04.2019 00:15,101,9,Kirov
80,82,6,24,52,4,56,0,56,0,49,7,22.04.2019 00:10,101,9,Kirov
544,541,45,238,265,41,306,0,306,4,229,73,22.04.2019 01:15,101,9,Kirov
144,136,21,55,70,19,89,0,89,0,74,15,22.04.2019 03:00,101,9,Kirov
1088,1061,80,428,590,70,660,0,660,16,506,138,22.04.2019 00:28,101,9,Kirov
560,552,49,253,261,46,307,0,307,5,246,56,22.04.2019 00:12,101,9,Kirov
128,122,12,51,68,9,77,0,77,3,57,17,21.04.2019 22:03,101,9,Kirov
704,687,45,336,325,43,368,0,368,6,272,90,22.04.2019 00:10,101,9,Kirov
816,796,36,349,433,34,467,0,467,15,367,85,22.04.2019 00:20,101,9,Kirov
208,202,17,87,105,16,121,0,121,1,82,38,21.04.2019 23:30,101,9,Kirov
448,435,22,230,202,16,218,0,218,8,174,36,22.04.2019 00:15,101,9,Kirov
192,181,8,84,100,8,108,0,108,2,77,29,22.04.2019 00:40,101,9,Kirov
528,522,42,149,340,39,379,0,379,12,319,48,22.04.2019 00:15,101,9,Kirov
1008,998,57,442,522,44,566,0,566,5,449,112,21.04.2019 23:30,101,9,Kirov
560,545,47,226,293,41,334,0,334,6,276,52,22.04.2019 00:30,101,9,Kirov
720,711,41,357,331,32,363,0,362,3,275,84,21.04.2019 21:50,101,9,Kirov
256,247,19,116,128,12,140,0,140,4,101,35,22.04.2019 07:15,101,9,Kirov
672,668,54,297,329,46,375,0,375,10,258,107,21.04.2019 22:00,101,9,Kirov
1904,1889,55,804,1054,46,1100,0,1100,34,833,233,22.04.2019 00:30,101,9,Kirov
1552,1527,33,692,830,30,860,0,860,22,683,155,21.04.2019 23:59,101,9,Kirov
2032,2001,80,863,1108,61,1169,0,1169,26,903,240,22.04.2019 03:15,101,9,Kirov
1312,1282,43,558,711,43,754,0,754,13,624,117,22.04.2019 00:30,101,9,Kirov
1712,1691,94,713,925,74,999,0,999,23,800,176,22.04.2019 01:10,102,9,Kirov
1824,1696,68,809,954,61,1015,0,1015,8,859,148,22.04.2019 00:45,102,9,Kirov
816,807,66,379,375,62,437,0,437,6,343,88,21.04.2019 21:30,102,9,Kirov
368,356,26,155,188,25,213,0,213,1,178,34,22.04.2019 01:15,102,9,Kirov
192,184,21,79,94,19,113,0,113,2,88,23,22.04.2019 02:00,102,9,Kirov
976,971,98,439,453,84,537,0,537,12,456,69,21.04.2019 22:52,102,9,Kirov
960,930,77,382,514,64,578,0,578,9,482,87,22.04.2019 00:13,102,9,Kirov
848,822,80,338,440,70,510,0,510,8,409,93,22.04.2019 00:05,102,9,Kirov
416,393,30,221,170,25,195,0,195,5,171,19,22.04.2019 03:24,102,9,Kirov
736,717,59,276,407,53,460,0,460,7,397,56,22.04.2019 00:20,102,9,Kirov
176,164,6,80,90,6,96,0,96,0,83,13,21.04.2019 20:45,102,9,Kirov
112,97,15,48,51,13,64,0,64,4,52,8,21.04.2019 20:45,102,9,Kirov
192,172,20,93,80,19,99,0,99,5,86,8,21.04.2019 20:36,102,9,Kirov
608,603,57,208,347,53,400,0,400,3,359,38,21.04.2019 21:35,102,9,Kirov
128,120,11,60,57,11,68,0,68,5,51,12,21.04.2019 22:00,102,9,Kirov
448,438,39,109,303,36,339,0,339,10,256,73,21.04.2019 20:24,102,9,Kirov
192,188,12,32,148,12,160,0,160,0,115,45,22.04.2019 00:35,102,9,Kirov
320,306,41,126,156,38,194,0,194,2,151,41,21.04.2019 21:00,102,9,Kirov
1184,1165,166,502,529,153,682,0,682,11,574,97,21.04.2019 21:05,102,9,Kirov
128,117,17,37,76,15,91,0,91,0,82,9,21.04.2019 20:56,102,9,Kirov
608,600,57,220,342,46,388,0,388,6,328,54,21.04.2019 21:30,102,9,Kirov
1264,1237,71,545,668,51,719,0,719,14,634,71,22.04.2019 00:20,102,9,Kirov
1072,1037,66,476,546,50,596,0,596,10,522,64,21.04.2019 22:30,102,9,Kirov
1312,1285,77,526,719,67,786,0,786,15,676,95,21.04.2019 22:35,102,9,Kirov
272,259,21,111,142,19,161,0,161,0,128,33,22.04.2019 00:10,102,9,Kirov
1056,1043,80,391,595,70,665,0,665,12,554,99,21.04.2019 23:30,102,9,Kirov
144,138,10,61,73,10,83,0,83,0,74,9,21.04.2019 20:40,102,9,Kirov
224,220,10,81,133,10,143,0,143,1,121,21,22.04.2019 00:05,102,9,Kirov
144,132,25,71,54,19,73,0,73,0,59,14,22.04.2019 00:55,102,9,Kirov
64,48,4,37,23,4,27,0,27,0,25,2,21.04.2019 23:30,102,9,Kirov
944,920,64,438,450,56,506,0,506,7,376,123,21.04.2019 21:46,102,9,Kirov
320,314,34,132,155,33,188,0,188,2,149,37,22.04.2019 00:20,102,9,Kirov
704,686,80,326,302,76,378,0,378,9,304,65,22.04.2019 00:30,102,9,Kirov
592,586,18,187,388,17,405,0,405,6,356,43,22.04.2019 00:30,102,9,Kirov
1696,1688,28,546,1125,25,1150,0,1150,19,949,182,22.04.2019 00:10,102,9,Kirov
928,910,18,342,570,16,586,0,586,8,502,76,22.04.2019 00:45,102,9,Kirov
544,516,11,259,277,8,285,0,285,11,245,29,22.04.2019 00:15,102,9,Kirov
448,436,10,142,296,10,306,0,306,6,257,43,21.04.2019 21:20,102,9,Kirov
1360,1327,14,556,795,9,804,0,804,21,714,69,22.04.2019 00:30,102,9,Kirov
224,211,14,90,123,11,134,0,134,2,94,38,21.04.2019 20:50,102,9,Kirov
384,369,15,154,218,12,230,0,230,4,195,31,22.04.2019 00:23,102,9,Kirov
128,116,6,56,66,6,72,0,72,1,54,17,21.04.2019 21:00,102,9,Kirov
688,674,67,274,347,67,414,0,414,4,339,71,22.04.2019 00:10,102,9,Kirov
432,415,22,162,253,17,270,0,270,6,226,38,22.04.2019 00:10,102,9,Kirov
592,580,20,286,287,19,306,0,306,8,262,36,21.04.2019 21:05,102,9,Kirov
576,556,16,255,305,16,321,0,321,8,264,49,22.04.2019 00:05,102,9,Kirov
528,510,43,218,272,38,310,0,310,6,261,43,21.04.2019 22:00,102,9,Kirov
448,440,30,187,236,25,261,0,261,2,225,34,22.04.2019 00:05,102,9,Kirov
144,137,15,58,75,11,86,0,86,5,55,26,22.04.2019 00:30,102,9,Kirov
384,376,1,154,229,1,230,0,230,1,206,23,22.04.2019 00:25,102,9,Kirov
416,410,9,189,218,9,227,0,227,1,176,50,21.04.2019 21:05,102,9,Kirov
336,329,17,95,224,17,241,0,241,2,184,55,21.04.2019 21:33,102,9,Kirov
128,112,13,55,61,12,73,0,73,2,46,25,21.04.2019 21:30,102,9,Kirov
1792,1755,16,834,948,10,958,0,958,24,803,131,22.04.2019 00:30,102,9,Kirov
1696,1655,23,772,903,21,924,0,924,15,746,163,22.04.2019 00:40,102,9,Kirov
2272,2239,29,952,1292,28,1320,0,1320,34,1051,235,22.04.2019 00:56,102,9,Kirov
1488,1466,25,679,790,19,809,0,809,23,616,170,21.04.2019 23:05,102,9,Kirov
880,871,15,476,393,11,404,0,404,14,327,63,22.04.2019 00:17,102,9,Kirov
80,79,7,29,44,7,51,0,51,2,33,16,22.04.2019 00:30,102,9,Kirov
512,497,16,223,276,13,289,0,289,2,249,38,22.04.2019 00:30,102,9,Kirov
544,534,124,237,232,75,307,0,307,6,250,51,22.04.2019 00:10,102,9,Kirov
336,327,19,153,166,17,183,0,183,4,135,44,21.04.2019 22:40,102,9,Kirov
864,853,27,354,488,22,510,0,510,16,411,83,21.04.2019 22:20,102,9,Kirov
352,341,15,155,186,11,197,0,197,2,161,34,22.04.2019 00:52,102,9,Kirov
256,246,13,117,128,11,139,0,139,3,105,31,22.04.2019 00:55,102,9,Kirov
240,225,6,85,149,6,155,0,155,1,129,25,21.04.2019 23:00,102,9,Kirov
128,118,0,74,54,0,54,0,54,0,40,14,21.04.2019 22:10,102,9,Kirov
176,162,6,77,93,6,99,0,99,2,83,14,21.04.2019 21:40,102,9,Kirov
416,411,42,142,234,40,274,0,274,5,182,87,22.04.2019 00:05,102,9,Kirov
192,184,20,39,133,20,153,0,153,3,108,42,22.04.2019 00:20,102,9,Kirov
288,270,13,104,171,13,184,0,184,2,137,45,22.04.2019 00:50,102,9,Kirov
144,138,5,74,66,4,70,0,70,0,53,17,21.04.2019 21:10,102,9,Kirov
640,633,21,293,328,19,347,0,347,7,255,85,21.04.2019 23:55,102,9,Kirov
128,126,7,48,73,7,80,0,80,2,57,21,22.04.2019 01:30,102,9,Kirov
496,488,64,155,277,64,341,0,341,3,265,73,22.04.2019 00:45,102,9,Kirov
160,158,12,17,132,11,143,0,143,1,95,47,21.04.2019 20:50,102,9,Kirov
864,843,53,368,443,53,496,0,496,3,429,64,22.04.2019 00:16,102,9,Kirov
752,736,21,352,382,18,400,0,400,7,348,45,22.04.2019 01:05,102,9,Kirov
512,502,15,254,246,12,258,0,258,8,229,21,22.04.2019 00:15,102,9,Kirov
608,602,20,222,369,17,386,0,386,9,299,78,22.04.2019 01:40,102,9,Kirov
624,614,36,255,338,31,369,0,369,10,288,71,21.04.2019 22:55,102,9,Kirov
400,391,51,161,188,51,239,0,239,6,164,69,22.04.2019 00:15,102,9,Kirov
64,62,0,26,38,0,38,0,38,0,28,10,21.04.2019 20:50,102,9,Kirov
416,406,54,91,274,51,325,0,325,1,262,62,22.04.2019 00:10,102,9,Kirov
304,303,21,112,174,18,192,0,192,5,159,28,22.04.2019 00:40,102,9,Kirov
96,92,12,51,34,11,45,0,45,1,37,7,21.04.2019 21:15,102,9,Kirov
272,255,24,105,146,21,167,0,167,1,126,40,21.04.2019 22:40,102,9,Kirov
880,853,13,371,504,5,509,0,509,10,424,75,22.04.2019 00:23,102,9,Kirov
528,514,32,197,305,26,331,0,331,1,275,55,22.04.2019 00:30,102,9,Kirov
224,212,21,62,141,21,162,0,162,0,140,22,21.04.2019 21:33,102,9,Kirov
80,79,17,27,36,17,53,0,53,1,35,17,22.04.2019 00:35,102,9,Kirov
208,200,12,98,99,11,110,0,110,1,92,17,22.04.2019 02:40,102,9,Kirov
640,626,43,299,300,41,341,0,341,0,295,46,21.04.2019 21:00,102,9,Kirov
288,271,110,81,105,102,207,0,207,3,135,69,22.04.2019 00:35,102,9,Kirov
912,824,3,460,450,2,452,0,452,1,377,74,22.04.2019 00:26,102,9,Kirov
96,84,0,12,84,0,84,0,84,12,57,15,21.04.2019 23:50,102,9,Kirov
784,767,62,236,486,62,548,0,548,3,475,70,21.04.2019 21:45,102,9,Kirov
448,440,16,165,267,16,283,0,283,5,245,33,21.04.2019 22:00,102,9,Kirov
464,459,38,191,238,35,273,0,273,1,233,39,21.04.2019 21:05,102,9,Kirov
704,696,20,302,383,19,402,0,402,0,330,72,22.04.2019 00:40,102,9,Kirov
96,86,10,44,42,10,52,0,52,0,47,5,22.04.2019 00:30,102,9,Kirov
1504,1493,9,689,809,6,815,0,815,16,698,101,21.04.2019 23:50,102,9,Kirov
1696,1674,38,687,971,38,1009,0,1009,18,833,158,22.04.2019 00:05,102,9,Kirov
496,487,8,232,256,8,264,0,264,4,218,42,21.04.2019 22:30,102,9,Kirov
112,104,14,42,56,14,70,0,70,0,56,14,21.04.2019 22:25,102,9,Kirov
768,762,16,335,419,14,433,0,433,6,393,34,21.04.2019 21:20,102,9,Kirov
896,889,47,316,535,45,580,0,580,9,481,90,21.04.2019 22:10,102,9,Kirov
592,585,35,271,286,35,321,0,321,1,240,80,22.04.2019 00:35,102,9,Kirov
528,508,34,217,277,34,311,0,311,7,225,79,22.04.2019 00:18,102,9,Kirov
688,676,41,258,392,38,430,0,430,10,360,60,21.04.2019 20:35,102,9,Kirov
464,455,27,167,270,27,297,0,297,4,257,36,22.04.2019 02:00,102,9,Kirov
1776,1744,17,741,1019,16,1035,0,1035,30,873,132,22.04.2019 00:15,102,9,Kirov
1520,1498,54,688,790,42,832,0,832,18,691,123,22.04.2019 00:10,102,9,Kirov
528,517,32,241,263,24,287,0,287,8,226,53,22.04.2019 00:07,102,9,Kirov
112,98,8,38,66,8,74,0,74,1,58,15,22.04.2019 00:30,102,9,Kirov
192,183,4,92,96,4,100,0,100,0,74,26,21.04.2019 20:30,102,9,Kirov
1072,1060,11,518,543,11,554,0,554,6,464,84,22.04.2019 00:15,102,9,Kirov
288,285,0,124,164,0,164,0,164,4,135,25,22.04.2019 00:10,102,9,Kirov
368,364,23,131,219,18,237,0,237,1,214,22,22.04.2019 00:02,102,9,Kirov
976,955,28,484,466,26,492,0,492,5,400,87,22.04.2019 00:20,102,9,Kirov
784,774,26,337,422,25,447,0,447,9,376,62,22.04.2019 00:10,102,9,Kirov
640,626,8,292,341,7,348,0,348,9,279,60,22.04.2019 01:06,102,9,Kirov
320,310,25,109,186,25,211,0,211,2,184,25,22.04.2019 01:00,102,9,Kirov
736,712,60,276,406,54,460,0,460,3,435,22,21.04.2019 22:40,102,9,Kirov
432,422,50,188,195,49,244,0,244,6,222,16,21.04.2019 23:21,102,9,Kirov
464,461,41,178,247,39,286,0,286,5,217,64,21.04.2019 20:44,102,9,Kirov
464,448,32,179,255,30,285,0,285,3,236,46,22.04.2019 02:40,102,9,Kirov
80,70,6,53,21,6,27,0,27,2,20,5,21.04.2019 23:40,102,9,Kirov
1584,1559,32,705,849,30,879,0,879,15,731,133,21.04.2019 21:30,102,9,Kirov
320,316,18,130,173,17,190,0,190,4,158,28,21.04.2019 22:20,102,9,Kirov
1280,1256,11,599,670,11,681,0,681,15,566,100,21.04.2019 21:30,102,9,Kirov
208,190,6,102,100,6,106,0,106,1,75,30,21.04.2019 20:39,102,9,Kirov
272,265,19,48,205,19,224,0,224,5,162,57,21.04.2019 21:45,102,9,Kirov
48,47,4,12,32,4,36,0,36,0,26,10,22.04.2019 00:03,102,9,Kirov
1248,1233,18,479,752,17,769,0,769,15,649,105,21.04.2019 22:05,102,9,Kirov
1440,1410,35,481,929,30,959,0,959,16,788,155,21.04.2019 23:47,102,9,Kirov
1248,1220,36,459,759,30,789,0,789,19,669,101,22.04.2019 00:01,102,9,Kirov
1456,1429,36,520,905,31,936,0,936,22,772,142,22.04.2019 02:50,102,9,Kirov
1136,1110,26,432,683,21,704,0,704,8,609,87,22.04.2019 01:10,102,9,Kirov
1216,1207,33,464,724,28,752,0,752,18,647,87,22.04.2019 01:00,102,9,Kirov
896,905,29,334,540,22,562,0,562,12,474,76,22.04.2019 00:08,102,9,Kirov
1024,1004,34,441,558,25,583,0,583,10,493,80,22.04.2019 00:10,102,9,Kirov
1072,1037,18,395,662,15,677,0,677,19,585,73,22.04.2019 00:15,102,9,Kirov
1088,1069,11,380,699,9,708,0,708,15,602,91,22.04.2019 00:05,102,9,Kirov
1600,1572,38,619,949,32,981,0,981,22,862,97,21.04.2019 22:30,102,9,Kirov
736,716,4,267,465,4,469,0,469,6,402,61,22.04.2019 00:40,102,9,Kirov
1104,1085,29,455,624,25,649,0,649,16,557,76,22.04.2019 00:25,102,9,Kirov
1056,1036,24,402,633,21,654,0,654,12,580,62,22.04.2019 00:43,102,9,Kirov
1103,1077,72,516,558,29,587,0,587,9,529,49,22.04.2019 00:07,102,9,Kirov
1728,1694,51,690,999,39,1038,0,1038,20,895,123,22.04.2019 01:10,102,9,Kirov
1728,1694,46,730,964,34,998,0,998,27,873,98,22.04.2019 00:15,102,9,Kirov
1264,1240,27,569,676,19,695,0,695,17,634,44,22.04.2019 00:10,102,9,Kirov
1552,1529,34,661,860,31,891,0,891,14,806,71,22.04.2019 00:05,102,9,Kirov
1168,1155,31,489,655,24,679,0,679,7,610,62,22.04.2019 00:30,102,9,Kirov
208,200,8,47,153,8,161,0,161,1,124,36,21.04.2019 21:53,102,9,Kirov
144,48,22,104,26,14,40,0,40,0,36,4,21.04.2019 23:30,102,9,Kirov
368,51,15,320,35,13,48,0,48,0,41,7,22.04.2019 00:18,102,9,Kirov
1168,1145,3,453,713,2,715,0,715,14,539,162,22.04.2019 01:30,102,9,Kirov
1408,1370,8,523,879,6,885,0,885,26,701,158,22.04.2019 00:10,102,9,Kirov
1184,1159,11,440,733,11,744,0,744,12,619,113,22.04.2019 01:25,102,9,Kirov
1440,1417,12,529,899,12,911,0,911,15,747,149,21.04.2019 22:00,102,9,Kirov
1424,1391,11,540,876,8,884,0,884,16,752,116,21.04.2019 21:20,102,9,Kirov
976,961,4,401,574,1,575,0,575,8,444,123,22.04.2019 00:45,102,9,Kirov
1552,1525,10,628,916,8,924,0,924,20,729,175,22.04.2019 00:15,102,9,Kirov
1792,1779,8,652,1135,5,1140,0,1140,30,913,197,22.04.2019 00:17,102,9,Kirov
1728,1707,7,708,1013,7,1020,0,1020,29,809,182,22.04.2019 00:05,102,9,Kirov
1808,1783,10,703,1100,5,1105,0,1105,29,883,193,22.04.2019 00:16,102,9,Kirov
1920,1908,9,758,1153,9,1162,0,1162,26,923,213,22.04.2019 00:25,102,9,Kirov
1312,1305,4,548,761,3,764,0,764,11,618,135,21.04.2019 23:40,102,9,Kirov
1536,1528,18,573,946,17,963,0,963,31,758,174,22.04.2019 00:05,102,9,Kirov
1616,1582,9,639,970,7,977,0,977,27,784,166,22.04.2019 01:10,102,9,Kirov
1408,1391,13,512,886,10,896,0,896,29,703,164,22.04.2019 00:10,102,9,Kirov
1392,1354,15,553,827,12,839,0,839,16,678,145,22.04.2019 00:30,102,9,Kirov
2112,2080,10,799,1307,6,1313,0,1313,36,1064,213,22.04.2019 00:10,102,9,Kirov
2080,2045,13,862,1207,11,1218,0,1218,30,994,194,22.04.2019 01:25,102,9,Kirov
1936,1900,24,810,1110,16,1126,0,1126,27,945,154,22.04.2019 00:10,102,9,Kirov
1360,1350,6,471,885,4,889,0,889,24,706,159,22.04.2019 00:27,102,9,Kirov
1168,1146,15,500,659,9,668,0,668,17,555,96,22.04.2019 00:25,102,9,Kirov
1632,1608,1,619,1012,1,1013,0,1013,34,846,133,22.04.2019 01:20,102,9,Kirov
1552,1536,7,588,959,5,964,0,964,17,835,112,22.04.2019 00:35,102,9,Kirov
160,152,17,16,128,16,144,0,144,5,115,24,21.04.2019 20:55,102,9,Kirov
160,31,23,130,8,22,30,0,30,0,25,5,22.04.2019 00:15,102,9,Kirov
176,52,5,124,47,5,52,0,52,1,46,5,22.04.2019 00:30,102,9,Kirov
1440,1399,8,575,858,7,865,0,865,19,720,126,21.04.2019 21:50,103,9,Kirov
1552,1514,10,578,966,8,974,0,974,16,796,162,21.04.2019 23:00,103,9,Kirov
1984,1956,19,782,1190,12,1202,0,1202,25,1023,154,22.04.2019 00:40,103,9,Kirov
1360,1339,19,542,801,17,818,0,818,9,724,85,22.04.2019 00:40,103,9,Kirov
752,740,19,309,428,15,443,0,443,7,363,73,21.04.2019 21:04,103,9,Kirov
1152,1137,16,437,705,10,715,0,715,18,593,104,22.04.2019 01:00,103,9,Kirov
528,512,6,239,285,4,289,0,289,2,247,40,21.04.2019 23:50,103,9,Kirov
560,545,9,214,340,6,346,0,346,8,301,37,22.04.2019 00:25,103,9,Kirov
976,960,18,359,601,16,617,0,617,8,523,86,22.04.2019 00:12,103,9,Kirov
1136,1118,17,554,574,8,582,0,582,3,508,71,21.04.2019 23:48,103,9,Kirov
1088,1071,22,425,643,20,663,0,663,24,555,84,21.04.2019 22:05,103,9,Kirov
1056,1028,15,468,576,12,588,0,588,7,506,75,22.04.2019 00:20,103,9,Kirov
976,953,58,290,630,56,686,0,686,17,604,65,22.04.2019 03:20,103,9,Kirov
160,156,14,56,90,14,104,0,104,2,81,21,21.04.2019 20:55,103,9,Kirov
144,147,8,42,94,8,102,0,102,4,90,8,21.04.2019 22:30,103,9,Kirov
256,256,23,96,140,20,160,0,160,3,132,25,21.04.2019 20:45,103,9,Kirov
432,417,41,187,204,41,245,0,245,0,203,42,22.04.2019 00:05,103,9,Kirov
592,589,44,233,316,43,359,0,359,8,286,65,21.04.2019 21:05,103,9,Kirov
544,530,56,150,342,52,394,0,394,5,325,64,21.04.2019 21:00,103,9,Kirov
480,476,63,183,239,58,297,0,297,1,252,44,21.04.2019 23:00,103,9,Kirov
384,378,29,135,221,28,249,0,249,2,202,45,21.04.2019 21:00,103,9,Kirov
928,913,29,410,490,28,518,0,518,8,449,61,21.04.2019 22:30,103,9,Kirov
80,72,7,48,27,5,32,0,32,0,25,7,22.04.2019 00:05,103,9,Kirov
496,485,33,196,269,31,300,0,300,3,262,35,21.04.2019 21:20,103,9,Kirov
432,418,16,172,244,16,260,0,260,0,242,18,22.04.2019 00:05,103,9,Kirov
592,573,30,244,321,27,348,0,348,7,286,55,21.04.2019 21:45,103,9,Kirov
480,476,46,185,253,42,295,0,295,0,238,57,21.04.2019 21:00,103,9,Kirov
144,147,10,68,66,10,76,0,76,0,48,28,22.04.2019 00:20,103,9,Kirov
864,856,39,370,457,37,494,0,494,6,412,76,22.04.2019 00:05,103,9,Kirov
352,336,15,162,175,15,190,0,190,1,170,19,22.04.2019 00:10,103,9,Kirov
240,233,22,76,142,22,164,0,164,0,144,20,21.04.2019 21:05,103,9,Kirov
592,572,32,276,289,27,316,0,316,3,265,48,21.04.2019 21:00,103,9,Kirov
224,220,14,56,156,12,168,0,168,0,138,30,21.04.2019 22:45,103,9,Kirov
224,207,3,107,114,3,117,0,117,0,109,8,22.04.2019 00:10,103,9,Kirov
176,158,14,63,99,14,113,0,113,1,83,29,21.04.2019 22:45,103,9,Kirov
496,486,30,182,284,30,314,0,314,1,281,32,21.04.2019 21:25,103,9,Kirov
240,223,7,105,128,7,135,0,135,1,117,17,21.04.2019 21:00,103,9,Kirov
320,301,5,143,172,5,177,0,177,0,150,27,22.04.2019 00:11,103,9,Kirov
224,209,2,89,133,2,135,0,135,2,115,18,21.04.2019 20:47,103,9,Kirov
160,157,11,67,84,9,93,0,93,0,81,12,21.04.2019 23:20,103,9,Kirov
352,344,14,163,177,12,189,0,189,1,144,44,21.04.2019 23:55,103,9,Kirov
80,68,0,45,35,0,35,0,35,2,26,7,21.04.2019 20:45,103,9,Kirov
80,72,4,37,39,4,43,0,43,1,27,15,21.04.2019 20:30,103,9,Kirov
496,488,8,248,240,8,248,0,248,3,201,44,21.04.2019 21:00,103,9,Kirov
592,570,17,282,293,17,310,0,310,4,254,52,21.04.2019 21:00,103,9,Kirov
1312,1281,34,606,673,33,706,0,706,10,570,126,21.04.2019 22:10,103,9,Kirov
1008,984,61,482,467,59,526,0,526,10,434,82,21.04.2019 22:00,103,9,Kirov
832,812,52,324,457,51,508,0,508,12,423,73,21.04.2019 20:50,103,9,Kirov
1136,1118,33,457,649,30,679,0,679,8,562,109,21.04.2019 21:22,103,9,Kirov
1168,1138,15,463,690,15,705,0,705,21,533,151,21.04.2019 20:44,103,9,Kirov
560,560,43,207,314,39,353,0,353,4,304,45,21.04.2019 20:45,103,9,Kirov
352,347,43,140,173,39,212,0,212,3,147,62,21.04.2019 20:32,103,9,Kirov
96,97,11,34,53,9,62,0,62,2,39,21,21.04.2019 21:55,103,9,Kirov
384,377,27,174,187,23,210,0,210,0,172,38,21.04.2019 20:55,103,9,Kirov
816,784,36,302,478,36,514,0,514,5,430,79,21.04.2019 21:00,103,9,Kirov
768,759,44,299,427,42,469,0,469,3,398,68,21.04.2019 21:30,103,9,Kirov
800,788,54,290,456,54,510,0,510,5,356,149,21.04.2019 21:00,103,9,Kirov
656,631,39,235,387,34,421,0,421,7,269,145,21.04.2019 20:55,103,9,Kirov
336,335,31,117,190,29,219,0,219,2,164,53,22.04.2019 00:05,103,9,Kirov
656,644,55,210,396,50,446,0,446,4,391,51,21.04.2019 21:35,103,9,Kirov
144,141,4,59,82,3,85,0,85,2,60,23,21.04.2019 21:10,103,9,Kirov
416,393,36,181,200,35,235,0,235,3,178,54,21.04.2019 22:00,103,9,Kirov
224,218,26,92,109,23,132,0,132,2,107,23,21.04.2019 21:30,103,9,Kirov
704,691,36,217,452,35,487,0,487,7,385,95,21.04.2019 22:00,103,9,Kirov
816,798,55,325,440,51,491,0,491,4,427,60,21.04.2019 21:20,103,9,Kirov
256,255,20,122,118,16,134,0,134,1,108,25,21.04.2019 22:15,103,9,Kirov
368,359,36,128,204,36,240,0,240,5,197,38,21.04.2019 22:00,103,9,Kirov
608,604,56,175,382,51,433,0,433,7,372,54,21.04.2019 23:30,103,9,Kirov
544,533,3,304,237,3,240,0,240,2,208,30,22.04.2019 00:02,103,9,Kirov
128,114,9,33,86,9,95,0,95,0,44,51,22.04.2019 00:15,103,9,Kirov
192,185,3,47,143,2,145,0,145,1,58,86,22.04.2019 00:01,103,9,Kirov
128,129,6,30,93,5,98,0,98,3,59,36,22.04.2019 00:05,103,9,Kirov
544,532,53,217,280,47,327,0,327,1,278,48,21.04.2019 21:00,103,9,Kirov
512,495,39,212,263,37,300,0,300,4,262,34,22.04.2019 00:15,103,9,Kirov
80,79,6,29,45,6,51,0,51,3,41,7,21.04.2019 21:40,103,9,Kirov
688,677,72,224,394,70,464,0,464,6,381,77,21.04.2019 21:32,103,9,Kirov
288,283,14,124,150,14,164,0,164,2,124,38,22.04.2019 02:25,103,9,Kirov
624,615,20,321,287,16,303,0,303,2,278,23,21.04.2019 20:45,103,9,Kirov
1008,981,17,475,516,17,533,0,533,13,445,75,21.04.2019 20:50,103,9,Kirov
416,403,31,169,220,27,247,0,247,0,220,27,21.04.2019 21:55,103,9,Kirov
144,134,10,56,78,10,88,0,88,3,81,4,21.04.2019 22:20,103,9,Kirov
464,448,21,199,245,20,265,0,265,10,214,41,21.04.2019 20:44,103,9,Kirov
112,104,7,58,47,7,54,0,54,0,50,4,22.04.2019 00:06,103,9,Kirov
1200,1177,113,445,645,110,755,0,755,16,629,110,21.04.2019 21:20,103,9,Kirov
144,133,12,73,59,12,71,0,71,1,62,8,21.04.2019 22:00,103,9,Kirov
512,503,32,171,313,28,341,0,341,6,276,59,21.04.2019 21:37,103,9,Kirov
192,177,12,82,99,11,110,0,110,0,55,55,21.04.2019 21:50,103,9,Kirov
192,185,7,76,109,7,116,0,116,2,84,30,21.04.2019 20:30,103,9,Kirov
480,477,32,165,287,28,315,0,315,5,282,28,21.04.2019 20:50,103,9,Kirov
1392,1372,34,536,828,28,856,0,856,13,715,128,22.04.2019 01:10,103,9,Kirov
1696,1653,11,634,1053,9,1062,0,1062,9,916,137,22.04.2019 00:05,103,9,Kirov
1632,1581,19,627,992,13,1005,0,1005,22,874,109,21.04.2019 22:00,103,9,Kirov
1184,1159,20,474,694,16,710,0,710,14,622,74,21.04.2019 22:03,103,9,Kirov
304,297,12,111,183,10,193,0,193,7,153,33,22.04.2019 01:48,103,9,Kirov
640,624,34,259,350,31,381,0,381,11,333,37,21.04.2019 20:50,103,9,Kirov
336,327,7,120,209,7,216,0,216,4,194,18,21.04.2019 21:20,103,9,Kirov
272,257,12,99,162,11,173,0,173,3,134,36,21.04.2019 22:00,103,9,Kirov
688,684,70,269,354,65,419,0,419,9,370,40,22.04.2019 00:20,103,9,Kirov
768,740,31,276,462,30,492,0,492,6,417,69,21.04.2019 21:10,103,9,Kirov
256,248,4,68,184,4,188,0,188,2,158,28,21.04.2019 21:00,103,9,Kirov
304,286,12,92,200,12,212,0,212,6,186,20,21.04.2019 20:40,103,9,Kirov
400,390,23,171,211,18,229,0,229,2,185,42,22.04.2019 00:05,103,9,Kirov
144,141,8,43,96,5,101,0,101,3,73,25,21.04.2019 22:10,103,9,Kirov
720,695,9,344,370,6,376,0,376,14,309,53,21.04.2019 22:00,103,9,Kirov
176,178,9,58,109,9,118,0,118,2,86,30,21.04.2019 20:41,103,9,Kirov
944,923,49,372,528,44,572,0,572,17,497,58,21.04.2019 20:32,103,9,Kirov
176,173,6,58,112,6,118,0,118,2,102,14,21.04.2019 21:20,103,9,Kirov
288,274,0,105,183,0,183,0,183,3,141,39,21.04.2019 22:00,103,9,Kirov
544,532,9,246,291,7,298,0,298,4,243,51,21.04.2019 20:55,103,9,Kirov
832,812,13,356,463,13,476,0,476,4,406,66,21.04.2019 22:25,103,9,Kirov
560,540,14,259,289,12,301,0,301,6,262,33,22.04.2019 00:15,103,9,Kirov
576,553,25,296,257,23,280,0,280,3,228,49,21.04.2019 20:50,103,9,Kirov
112,97,6,45,61,6,67,0,67,0,50,17,21.04.2019 22:25,103,9,Kirov
192,180,13,88,91,13,104,0,104,0,85,19,22.04.2019 00:10,103,9,Kirov
752,735,54,230,470,52,522,0,522,4,457,61,21.04.2019 22:08,103,9,Kirov
512,512,21,156,337,19,356,0,356,4,293,59,21.04.2019 22:30,103,9,Kirov
320,314,13,125,188,7,195,0,195,0,167,28,21.04.2019 21:00,103,9,Kirov
528,510,3,227,299,2,301,0,301,1,225,75,21.04.2019 21:45,103,9,Kirov
352,340,5,119,228,5,233,0,233,0,202,31,21.04.2019 21:32,103,9,Kirov
144,42,30,107,12,25,37,0,37,0,32,5,21.04.2019 20:20,103,9,Kirov
384,357,0,33,351,0,351,0,351,13,273,65,21.04.2019 20:40,103,9,Kirov
1136,1130,26,420,694,22,716,0,716,5,614,97,22.04.2019 00:15,103,9,Kirov
656,654,14,266,379,11,390,0,390,6,323,61,22.04.2019 00:20,103,9,Kirov
1008,985,24,443,547,18,565,0,565,5,494,66,22.04.2019 01:50,103,9,Kirov
400,394,29,183,190,27,217,0,217,14,133,70,22.04.2019 00:30,103,9,Kirov
272,265,15,83,179,10,189,0,189,4,168,17,22.04.2019 02:55,103,9,Kirov
256,241,4,145,108,3,111,0,111,0,84,27,22.04.2019 00:15,103,9,Kirov
352,341,5,152,196,4,200,0,200,4,132,64,22.04.2019 00:10,103,9,Kirov
736,712,36,258,443,35,478,0,478,7,372,99,22.04.2019 00:05,103,9,Kirov
176,169,11,77,90,9,99,0,99,1,85,13,22.04.2019 00:05,103,9,Kirov
112,97,7,49,56,7,63,0,63,1,54,8,21.04.2019 21:00,103,9,Kirov
1920,1900,13,685,1225,10,1235,0,1235,38,1021,176,21.04.2019 22:20,103,9,Kirov
2320,2288,25,978,1323,19,1342,0,1342,32,1116,194,22.04.2019 00:10,103,9,Kirov
1712,1674,21,742,956,14,970,0,970,21,847,102,21.04.2019 21:40,103,9,Kirov
1632,1619,25,624,985,23,1008,0,1008,29,836,143,21.04.2019 21:30,103,9,Kirov
1856,1809,21,694,1149,13,1162,0,1162,23,963,176,22.04.2019 04:21,103,9,Kirov
2000,1965,17,738,1246,16,1262,0,1262,27,1038,197,22.04.2019 00:03,103,9,Kirov
1632,1623,34,677,935,20,955,0,955,18,779,158,22.04.2019 00:20,103,9,Kirov
1536,1509,32,638,871,27,898,0,898,27,756,115,22.04.2019 00:40,103,9,Kirov
1584,1558,19,611,955,18,973,0,973,17,817,139,21.04.2019 21:50,103,9,Kirov
2320,2271,17,911,1393,16,1409,0,1409,41,1200,168,22.04.2019 01:30,103,9,Kirov
2464,2369,20,1003,1443,18,1461,0,1461,17,1275,169,21.04.2019 22:30,103,9,Kirov
1760,1756,14,675,1076,9,1085,0,1085,33,913,139,21.04.2019 23:40,103,9,Kirov
2064,2033,24,826,1222,16,1238,0,1238,23,1042,173,21.04.2019 21:55,103,9,Kirov
1920,1878,19,806,1097,17,1114,0,1114,29,948,137,21.04.2019 21:35,103,9,Kirov
1850,1805,24,696,1132,22,1154,0,1154,31,988,135,21.04.2019 21:55,103,9,Kirov
2048,2018,11,793,1248,7,1255,0,1255,36,1066,153,22.04.2019 00:10,103,9,Kirov
1904,1880,15,695,1199,10,1209,0,1209,33,994,182,22.04.2019 04:45,103,9,Kirov
2336,2307,16,977,1345,14,1359,0,1359,27,1175,157,21.04.2019 23:20,103,9,Kirov
2320,2277,16,1029,1280,11,1291,0,1291,26,1102,163,21.04.2019 23:00,103,9,Kirov
2288,2255,12,887,1389,12,1401,0,1401,32,1158,211,21.04.2019 21:55,103,9,Kirov
2240,2212,12,864,1367,9,1376,0,1376,36,1147,193,21.04.2019 23:55,103,9,Kirov
1568,1546,9,613,947,8,955,0,955,19,799,137,22.04.2019 00:20,103,9,Kirov
2336,2286,8,981,1349,6,1355,0,1355,29,1167,159,21.04.2019 21:53,103,9,Kirov
2240,2194,14,891,1337,12,1349,0,1349,29,1145,175,22.04.2019 00:10,103,9,Kirov
1424,1417,10,527,887,10,897,0,897,19,788,90,21.04.2019 22:33,103,9,Kirov
1360,1323,15,662,685,13,698,0,698,19,588,91,21.04.2019 21:30,103,9,Kirov
1488,1456,8,623,859,6,865,0,865,25,749,91,22.04.2019 03:59,103,9,Kirov
2128,2091,26,870,1235,23,1258,0,1258,29,1073,156,21.04.2019 22:30,103,9,Kirov
2096,2083,22,885,1194,17,1211,0,1211,28,1041,142,21.04.2019 21:55,103,9,Kirov
2032,1997,25,913,1098,21,1119,0,1119,25,965,129,21.04.2019 21:25,103,9,Kirov
1120,1113,25,476,619,25,644,0,643,14,526,103,22.04.2019 03:00,103,9,Kirov
1264,1243,5,582,677,5,682,0,682,20,580,82,21.04.2019 22:03,103,9,Kirov
1520,1507,11,718,792,10,802,0,802,20,697,85,21.04.2019 22:31,103,9,Kirov
1456,1437,11,665,783,8,791,0,791,11,712,68,21.04.2019 21:45,103,9,Kirov
528,517,5,255,270,3,273,0,273,10,233,30,22.04.2019 00:05,103,9,Kirov
848,843,20,347,484,17,501,0,501,6,447,48,21.04.2019 21:10,103,9,Kirov
784,784,5,299,482,3,485,0,485,11,434,40,21.04.2019 21:36,103,9,Kirov
1744,1707,47,741,959,44,1003,0,1003,18,867,118,22.04.2019 00:50,103,9,Kirov
192,181,53,19,121,52,173,0,173,7,126,40,22.04.2019 00:15,103,9,Kirov
416,55,35,367,18,31,49,0,49,0,44,5,21.04.2019 20:40,103,9,Kirov
192,55,10,139,43,10,53,0,53,2,43,8,21.04.2019 21:20,103,9,Kirov
64,36,0,29,35,0,35,0,35,2,25,8,21.04.2019 20:42,103,9,Kirov
576,553,0,60,516,0,516,0,516,16,248,252,21.04.2019 22:15,105,10,Lugansk
1968,1919,9,1124,835,9,844,0,844,26,746,72,22.04.2019 00:15,105,10,Lugansk
1808,1760,9,1005,795,8,803,0,803,17,720,66,22.04.2019 00:40,105,10,Lugansk
1808,1822,23,933,861,14,875,0,875,14,784,77,22.04.2019 00:20,105,10,Lugansk
1760,1707,24,961,779,20,799,0,799,17,734,48,22.04.2019 00:30,105,10,Lugansk
1808,1776,28,976,805,27,832,0,832,25,745,62,22.04.2019 00:50,105,10,Lugansk
128,15,0,113,15,0,15,0,15,0,13,2,22.04.2019 00:20,105,10,Lugansk
224,205,0,19,205,0,205,0,205,23,130,52,21.04.2019 21:10,106,10,Lugansk
1712,1646,0,314,1398,0,1398,0,1398,47,711,640,21.04.2019 22:20,106,10,Lugansk
848,783,0,225,623,0,623,0,623,23,276,324,21.04.2019 22:15,106,10,Lugansk
688,686,24,325,341,22,363,0,363,4,337,22,22.04.2019 02:05,106,10,Lugansk
384,372,7,144,234,6,240,0,240,5,225,10,21.04.2019 21:50,106,10,Lugansk
464,457,25,202,238,24,262,0,262,5,248,9,21.04.2019 20:20,106,10,Lugansk
608,621,33,281,302,25,327,0,327,3,266,58,21.04.2019 22:40,106,10,Lugansk
752,747,21,371,367,14,381,0,381,4,349,28,22.04.2019 00:15,106,10,Lugansk
80,73,4,29,47,4,51,0,51,0,48,3,22.04.2019 02:35,106,10,Lugansk
336,334,21,153,169,14,183,0,183,1,173,9,21.04.2019 21:30,106,10,Lugansk
1328,1304,33,690,608,30,638,0,638,13,586,39,21.04.2019 22:25,106,10,Lugansk
144,133,2,43,99,2,101,0,101,0,85,16,21.04.2019 23:00,106,10,Lugansk
128,119,2,69,58,1,59,0,59,0,56,3,22.04.2019 00:05,106,10,Lugansk
1040,1015,60,563,442,35,477,0,477,14,442,21,21.04.2019 22:50,106,10,Lugansk
288,272,15,139,134,15,149,0,149,3,136,10,21.04.2019 23:50,106,10,Lugansk
288,282,12,127,149,12,161,0,161,1,152,8,21.04.2019 23:10,106,10,Lugansk
320,305,21,161,140,19,159,0,159,2,151,6,22.04.2019 00:30,106,10,Lugansk
224,216,12,97,115,12,127,0,127,2,117,8,22.04.2019 00:05,106,10,Lugansk
224,220,0,146,78,0,78,0,78,0,72,6,22.04.2019 00:10,106,10,Lugansk
288,285,27,112,149,27,176,0,176,2,167,7,22.04.2019 00:20,106,10,Lugansk
384,369,7,253,126,5,131,0,131,4,120,7,21.04.2019 22:35,106,10,Lugansk
368,357,22,207,141,20,161,0,161,5,148,8,21.04.2019 23:15,106,10,Lugansk
1824,1822,29,687,1117,20,1137,0,1137,27,976,134,21.04.2019 21:18,106,10,Lugansk
1568,1608,45,541,998,29,1027,0,1027,35,883,109,21.04.2019 21:00,106,10,Lugansk
2161,2174,48,819,1307,35,1342,0,1342,29,1190,123,21.04.2019 22:07,106,10,Lugansk
1376,1354,27,621,734,21,755,0,755,16,683,56,21.04.2019 23:15,106,10,Lugansk
2000,2026,58,759,1193,48,1241,0,1241,24,1089,128,21.04.2019 22:00,106,10,Lugansk
2368,2374,49,987,1341,40,1381,0,1381,25,1254,102,22.04.2019 00:27,106,10,Lugansk
2320,2355,54,900,1382,38,1420,0,1420,26,1279,115,21.04.2019 21:40,106,10,Lugansk
2368,2410,41,904,1436,28,1464,0,1464,31,1324,109,21.04.2019 21:58,106,10,Lugansk
2112,2128,54,768,1303,41,1344,0,1344,32,1210,102,21.04.2019 21:30,106,10,Lugansk
1584,1570,14,662,912,10,922,0,922,20,826,76,22.04.2019 00:30,106,10,Lugansk
1888,1882,8,877,1003,8,1011,0,1011,25,914,72,22.04.2019 00:03,106,10,Lugansk
2432,2453,60,851,1543,38,1581,0,1581,46,1339,196,22.04.2019 00:10,106,10,Lugansk
1632,1688,36,544,1065,23,1088,0,1088,22,937,129,21.04.2019 22:22,106,10,Lugansk
2112,2125,45,900,1177,35,1212,0,1212,18,1104,90,22.04.2019 00:10,106,10,Lugansk
1744,1741,23,689,1041,14,1055,0,1055,20,947,88,21.04.2019 21:15,106,10,Lugansk
2256,2290,73,902,1306,48,1354,0,1354,29,1211,114,22.04.2019 00:15,106,10,Lugansk
1872,1881,67,744,1075,53,1128,0,1128,24,1008,96,22.04.2019 00:10,106,10,Lugansk
1712,1705,62,635,1034,43,1077,0,1077,19,963,95,21.04.2019 22:02,106,10,Lugansk
2096,2141,42,714,1356,26,1382,0,1382,38,1217,127,22.04.2019 00:15,106,10,Lugansk
1616,1634,39,621,968,27,995,0,995,25,883,87,21.04.2019 22:48,106,10,Lugansk
1440,1481,32,469,946,25,971,0,971,38,857,76,22.04.2019 00:05,106,10,Lugansk
2112,2157,38,769,1314,29,1343,0,1343,30,1184,129,21.04.2019 22:18,106,10,Lugansk
1360,1365,35,614,722,24,746,0,746,18,669,59,22.04.2019 00:01,106,10,Lugansk
464,453,9,183,274,7,281,0,281,8,245,28,21.04.2019 20:39,106,10,Lugansk
2192,2238,39,823,1343,26,1369,0,1369,22,1206,141,21.04.2019 22:35,106,10,Lugansk
2320,2332,59,903,1380,37,1417,0,1417,35,1249,133,22.04.2019 01:29,106,10,Lugansk
2352,2388,62,793,1517,42,1559,0,1559,34,1404,121,21.04.2019 22:25,106,10,Lugansk
2368,2360,39,912,1431,25,1456,0,1456,46,1291,119,21.04.2019 21:40,106,10,Lugansk
2208,2234,43,735,1446,27,1473,0,1473,30,1304,139,22.04.2019 02:33,106,10,Lugansk
2336,2361,46,835,1464,37,1501,0,1501,29,1339,133,21.04.2019 22:10,106,10,Lugansk
2096,2110,38,672,1395,29,1424,0,1424,36,1260,128,21.04.2019 22:14,106,10,Lugansk
2208,2226,60,744,1419,45,1464,0,1464,40,1271,153,21.04.2019 22:30,106,10,Lugansk
2096,2092,40,774,1298,24,1322,0,1322,27,1185,110,21.04.2019 21:10,106,10,Lugansk
2352,2373,22,922,1415,15,1430,0,1430,32,1285,113,21.04.2019 22:10,106,10,Lugansk
1968,1964,20,729,1228,11,1239,0,1239,23,1077,139,21.04.2019 22:30,106,10,Lugansk
2128,2102,23,814,1300,14,1314,0,1314,28,1165,121,21.04.2019 22:19,106,10,Lugansk
1728,1714,20,643,1070,15,1085,0,1085,16,955,114,22.04.2019 00:02,106,10,Lugansk
2080,2041,15,811,1256,13,1269,0,1269,14,1125,130,21.04.2019 21:05,106,10,Lugansk
2400,2371,30,867,1511,22,1533,0,1533,33,1356,144,21.04.2019 22:10,106,10,Lugansk
2400,2387,34,838,1545,17,1562,0,1562,45,1382,135,21.04.2019 22:35,106,10,Lugansk
2224,2204,22,781,1424,19,1443,0,1442,21,1273,148,22.04.2019 00:01,106,10,Lugansk
624,617,25,231,371,22,393,0,393,4,355,34,21.04.2019 21:10,106,10,Lugansk
592,581,27,260,312,20,332,0,332,5,311,16,21.04.2019 22:27,106,10,Lugansk
640,622,23,336,286,18,304,0,304,7,280,17,21.04.2019 20:40,106,10,Lugansk
1136,1115,57,467,623,46,669,0,669,5,625,39,21.04.2019 20:58,106,10,Lugansk
1808,1778,94,943,797,68,865,0,865,17,823,25,21.04.2019 22:04,106,10,Lugansk
1968,1943,121,949,914,105,1019,0,1019,24,975,20,21.04.2019 21:17,106,10,Lugansk
160,160,10,82,69,9,78,0,78,0,75,3,21.04.2019 21:00,106,10,Lugansk
528,517,21,219,291,18,309,0,309,4,286,19,21.04.2019 21:10,106,10,Lugansk
224,52,39,173,14,37,51,0,51,0,46,5,21.04.2019 20:43,106,10,Lugansk
1056,1036,0,89,967,0,967,0,967,64,399,504,21.04.2019 20:59,107,10,Lugansk
688,621,0,83,605,0,605,0,605,27,256,322,22.04.2019 00:15,107,10,Lugansk
1168,1141,16,623,538,7,545,0,545,10,490,45,21.04.2019 20:53,107,10,Lugansk
1168,1130,15,645,513,10,523,0,523,7,472,44,22.04.2019 00:30,107,10,Lugansk
1424,1406,25,688,723,13,736,0,736,22,669,45,22.04.2019 01:30,107,10,Lugansk
1232,1216,12,706,520,6,526,0,526,10,491,25,21.04.2019 20:55,107,10,Lugansk
1392,1374,17,786,598,8,606,0,606,10,556,40,22.04.2019 00:40,107,10,Lugansk
1232,1205,9,660,569,3,572,0,572,8,537,27,22.04.2019 00:18,107,10,Lugansk
2320,2262,13,1215,1095,10,1105,0,1105,23,999,83,21.04.2019 23:55,107,10,Lugansk
1760,1721,39,991,742,27,769,0,769,16,703,50,22.04.2019 00:20,107,10,Lugansk
1792,1763,17,875,905,12,917,0,917,18,810,89,22.04.2019 00:30,107,10,Lugansk
2064,2018,41,1146,895,23,918,0,918,18,834,66,21.04.2019 22:55,107,10,Lugansk
1520,1499,9,775,737,8,745,0,745,11,699,35,22.04.2019 01:15,107,10,Lugansk
128,147,22,0,106,22,128,0,128,7,59,62,22.04.2019 00:05,107,10,Lugansk
112,36,14,77,21,14,35,0,35,0,25,10,22.04.2019 01:10,107,10,Lugansk
144,16,0,130,14,0,14,0,14,0,11,3,22.04.2019 00:40,107,10,Lugansk
2096,2049,19,1029,1052,15,1067,0,1067,15,980,72,22.04.2019 00:10,107,10,Lugansk
1824,1786,23,836,973,15,988,0,988,14,906,68,22.04.2019 00:10,107,10,Lugansk
1856,1816,15,882,964,10,974,0,974,13,873,88,22.04.2019 03:50,107,10,Lugansk
2016,1979,12,943,1065,8,1073,0,1073,25,977,71,22.04.2019 00:20,107,10,Lugansk
2032,2018,8,925,1099,8,1107,0,1107,23,1015,69,22.04.2019 00:15,107,10,Lugansk
2096,2053,22,1125,956,15,971,0,971,20,890,61,22.04.2019 00:01,107,10,Lugansk
2112,2083,11,1061,1043,8,1051,0,1051,29,964,58,21.04.2019 23:00,107,10,Lugansk
2240,2184,15,1211,1018,11,1029,0,1029,32,936,61,22.04.2019 00:05,107,10,Lugansk
2032,2000,17,1022,995,15,1010,0,1010,18,922,70,22.04.2019 00:30,107,10,Lugansk
1568,1541,19,738,817,13,830,0,830,14,754,62,22.04.2019 00:35,107,10,Lugansk
1712,1674,21,768,929,15,944,0,944,21,854,69,22.04.2019 00:45,107,10,Lugansk
1696,1672,19,860,825,11,836,0,836,35,748,53,22.04.2019 00:07,107,10,Lugansk
2224,2168,45,1133,1061,30,1091,0,1091,30,999,62,22.04.2019 00:30,107,10,Lugansk
1920,1878,39,950,940,30,970,0,970,23,884,63,22.04.2019 00:13,107,10,Lugansk
1664,1630,25,886,758,20,778,0,778,19,714,45,22.04.2019 00:10,107,10,Lugansk
1584,1554,25,813,753,18,771,0,771,18,694,59,22.04.2019 00:20,107,10,Lugansk
896,877,23,469,404,23,427,0,427,9,395,23,22.04.2019 00:10,107,10,Lugansk
1008,987,17,599,396,13,409,0,409,8,386,15,22.04.2019 00:28,107,10,Lugansk
1904,1861,14,999,896,9,905,0,905,29,817,59,22.04.2019 00:30,107,10,Lugansk
2176,2132,26,1115,1047,14,1061,0,1061,27,953,81,22.04.2019 00:05,107,10,Lugansk
2080,2037,31,1058,994,28,1022,0,1022,27,925,70,22.04.2019 00:25,107,10,Lugansk
2144,2100,12,1076,1057,11,1068,0,1068,39,952,77,22.04.2019 00:10,107,10,Lugansk
2272,2229,25,1144,1109,19,1128,0,1128,29,1013,86,22.04.2019 00:30,107,10,Lugansk
1584,1581,4,622,959,3,962,0,962,30,854,78,21.04.2019 23:15,107,10,Lugansk
1600,1567,9,664,928,8,936,0,936,14,854,68,22.04.2019 00:30,107,10,Lugansk
2176,2167,21,944,1215,17,1232,0,1232,23,1091,118,22.04.2019 00:10,107,10,Lugansk
2192,2186,26,998,1178,16,1194,0,1194,32,1022,140,22.04.2019 00:10,107,10,Lugansk
2176,2165,20,898,1262,16,1278,0,1278,32,1131,115,22.04.2019 00:30,107,10,Lugansk
2048,2063,7,770,1272,6,1278,0,1278,31,1121,126,22.04.2019 00:10,107,10,Lugansk
2160,2103,16,960,1187,13,1200,0,1200,28,1061,111,22.04.2019 01:30,107,10,Lugansk
2128,2118,10,971,1154,3,1157,0,1157,34,1023,100,22.04.2019 07:00,107,10,Lugansk
2144,2097,9,1084,1052,8,1060,0,1060,29,958,73,22.04.2019 00:20,107,10,Lugansk
2128,2075,29,1030,1088,10,1098,0,1098,26,992,80,22.04.2019 00:18,107,10,Lugansk
2480,2435,9,1393,1081,6,1087,0,1087,31,999,57,22.04.2019 00:55,107,10,Lugansk
2480,2417,23,1219,1252,9,1261,0,1261,29,1139,93,21.04.2019 23:30,107,10,Lugansk
2064,2043,28,958,1087,19,1106,0,1106,29,1025,52,22.04.2019 00:10,107,10,Lugansk
1808,1776,24,978,813,17,830,0,830,25,750,55,22.04.2019 00:45,107,10,Lugansk
2000,1951,8,1106,888,6,894,0,894,25,816,53,22.04.2019 00:35,107,10,Lugansk
1808,1781,30,918,868,22,890,0,890,23,830,37,22.04.2019 00:10,107,10,Lugansk
1904,1874,23,1008,877,19,896,0,896,15,852,29,22.04.2019 00:10,107,10,Lugansk
2112,2069,30,1129,970,13,983,0,983,30,910,43,22.04.2019 00:35,107,10,Lugansk
2144,2062,42,1131,978,35,1013,0,1013,25,940,48,22.04.2019 00:20,107,10,Lugansk
1344,1327,37,740,586,18,604,0,604,14,568,22,22.04.2019 00:05,107,10,Lugansk
224,82,28,146,52,26,78,0,78,5,59,14,22.04.2019 00:07,107,10,Lugansk
144,83,2,63,79,2,81,0,81,5,69,7,22.04.2019 00:07,107,10,Lugansk
592,190,115,421,71,100,171,0,171,4,155,12,22.04.2019 00:10,107,10,Lugansk
768,710,0,195,573,0,573,0,573,31,257,285,21.04.2019 22:00,112,10,Lugansk
496,452,0,54,442,0,442,0,442,12,128,302,21.04.2019 21:00,112,10,Lugansk
1616,1572,35,1103,478,35,513,0,513,6,480,27,22.04.2019 00:12,112,10,Lugansk
752,733,7,364,384,4,388,0,388,7,359,22,21.04.2019 21:10,112,10,Lugansk
928,897,13,611,306,11,317,0,317,6,298,13,21.04.2019 22:07,112,10,Lugansk
704,675,16,378,311,15,326,0,326,4,312,10,22.04.2019 00:05,112,10,Lugansk
2160,2127,23,1167,980,13,993,0,993,22,933,38,22.04.2019 00:12,112,10,Lugansk
1280,1254,18,667,603,10,613,0,613,9,589,15,22.04.2019 01:20,112,10,Lugansk
816,795,26,428,365,23,388,0,388,6,358,24,22.04.2019 00:25,112,10,Lugansk
1024,1012,6,601,420,3,423,0,423,4,401,18,22.04.2019 00:45,112,10,Lugansk
1232,1218,13,625,599,8,607,0,607,12,572,23,21.04.2019 21:30,112,10,Lugansk
1312,1298,18,729,578,5,583,0,583,12,538,33,21.04.2019 21:45,112,10,Lugansk
1392,1388,4,660,729,3,732,0,732,6,691,35,22.04.2019 04:45,112,10,Lugansk
1568,1543,12,727,830,11,841,0,841,17,779,45,22.04.2019 00:10,112,10,Lugansk
736,715,10,355,371,10,381,0,381,9,363,9,21.04.2019 21:05,112,10,Lugansk
1696,1675,23,922,758,16,774,0,774,22,720,32,21.04.2019 22:01,112,10,Lugansk
976,960,39,536,409,31,440,0,440,7,420,13,21.04.2019 22:15,112,10,Lugansk
1248,1232,125,622,521,105,626,0,626,14,523,89,21.04.2019 22:00,112,10,Lugansk
608,539,12,362,244,2,246,0,246,6,227,13,22.04.2019 00:00,112,10,Lugansk
1968,1940,12,831,1132,5,1137,0,1137,34,1028,75,21.04.2019 21:50,112,10,Lugansk
2080,2070,11,836,1238,6,1244,0,1244,29,1138,77,21.04.2019 21:40,112,10,Lugansk
2128,2108,10,919,1200,9,1209,0,1209,32,1103,74,21.04.2019 22:50,112,10,Lugansk
2224,2214,20,834,1376,14,1390,0,1390,33,1260,97,21.04.2019 21:33,112,10,Lugansk
2128,2100,15,939,1176,13,1189,0,1189,33,1081,75,22.04.2019 00:15,112,10,Lugansk
2320,2299,20,1036,1271,13,1284,0,1284,32,1187,65,21.04.2019 23:06,112,10,Lugansk
2288,2275,16,1009,1263,16,1279,0,1279,29,1171,79,22.04.2019 01:05,112,10,Lugansk
2288,2254,24,1066,1208,14,1222,0,1222,35,1128,59,22.04.2019 00:05,112,10,Lugansk
2240,2213,27,1043,1179,18,1197,0,1197,22,1131,44,22.04.2019 00:25,112,10,Lugansk
1488,1515,16,609,867,12,879,0,879,19,786,74,22.04.2019 00:35,112,10,Lugansk
1488,1474,25,678,786,24,810,0,810,18,744,48,22.04.2019 00:15,112,10,Lugansk
1984,1967,20,834,1134,16,1150,0,1150,25,1062,63,22.04.2019 00:40,112,10,Lugansk
2144,2127,19,835,1290,19,1309,0,1309,30,1160,119,21.04.2019 22:45,112,10,Lugansk
1904,1923,21,776,1109,19,1128,0,1128,37,1015,76,22.04.2019 00:25,112,10,Lugansk
1984,1972,27,880,1084,20,1104,0,1104,27,995,82,21.04.2019 22:47,112,10,Lugansk
2352,2349,33,1038,1288,26,1314,0,1314,28,1181,105,22.04.2019 00:03,112,10,Lugansk
2288,2259,25,1036,1233,19,1252,0,1252,36,1138,78,22.04.2019 00:42,112,10,Lugansk
2192,2177,23,1024,1148,20,1168,0,1168,22,1081,65,22.04.2019 00:10,112,10,Lugansk
2192,2168,22,1054,1117,21,1138,0,1138,23,1045,70,22.04.2019 00:10,112,10,Lugansk
2176,2168,28,973,1182,21,1203,0,1203,31,1093,79,21.04.2019 22:00,112,10,Lugansk
1536,1532,9,630,900,6,906,0,906,20,806,80,22.04.2019 00:30,112,10,Lugansk
1472,1451,7,768,700,4,704,0,704,18,659,27,21.04.2019 22:32,112,10,Lugansk
352,42,21,316,19,17,36,0,36,1,34,1,21.04.2019 21:40,112,10,Lugansk
480,379,0,101,379,0,379,0,379,14,344,21,22.04.2019 00:11,113,10,Lugansk
544,544,0,18,526,0,526,0,526,12,181,333,21.04.2019 21:10,113,10,Lugansk
464,471,0,21,443,0,443,0,443,9,280,154,22.04.2019 00:45,113,10,Lugansk
2192,2185,63,888,1250,54,1304,0,1304,14,1167,123,22.04.2019 02:05,113,10,Lugansk
1360,1341,37,474,852,34,886,0,886,23,799,64,22.04.2019 01:00,113,10,Lugansk
496,486,68,176,257,63,320,0,320,4,294,22,22.04.2019 00:51,113,10,Lugansk
432,425,29,170,233,29,262,0,262,4,236,22,22.04.2019 00:10,113,10,Lugansk
160,158,11,45,104,11,115,0,115,3,103,9,22.04.2019 00:40,113,10,Lugansk
320,309,15,97,208,15,223,0,223,5,169,49,22.04.2019 01:50,113,10,Lugansk
384,381,38,125,225,34,259,0,259,5,230,24,22.04.2019 00:20,113,10,Lugansk
256,256,23,71,166,19,185,0,185,3,167,15,22.04.2019 00:22,113,10,Lugansk
304,294,28,101,180,23,203,0,203,7,178,18,22.04.2019 00:05,113,10,Lugansk
304,292,24,120,164,20,184,0,184,3,164,17,22.04.2019 00:10,113,10,Lugansk
512,491,35,211,270,31,301,0,301,2,273,26,22.04.2019 00:30,113,10,Lugansk
208,206,23,78,109,21,130,0,130,2,114,14,22.04.2019 00:05,113,10,Lugansk
720,698,50,297,378,45,423,0,423,5,382,36,22.04.2019 00:15,113,10,Lugansk
144,138,11,47,86,11,97,0,97,1,72,24,22.04.2019 00:01,113,10,Lugansk
560,540,71,228,275,57,332,0,332,7,311,14,22.04.2019 01:10,113,10,Lugansk
224,217,12,88,125,11,136,0,136,2,127,7,22.04.2019 00:15,113,10,Lugansk
512,493,58,198,256,58,314,0,314,4,288,22,22.04.2019 00:48,113,10,Lugansk
240,242,19,89,132,19,151,0,151,2,135,14,22.04.2019 00:05,113,10,Lugansk
96,90,7,46,44,6,50,0,50,2,47,1,22.04.2019 00:45,113,10,Lugansk
144,136,2,57,85,2,87,0,87,2,79,6,22.04.2019 00:11,113,10,Lugansk
1504,1492,67,667,787,50,837,0,837,14,773,50,22.04.2019 00:10,113,10,Lugansk
1376,1369,19,628,734,14,748,0,748,16,667,65,22.04.2019 00:40,113,10,Lugansk
1184,1173,25,499,667,18,685,0,685,10,619,56,22.04.2019 00:30,113,10,Lugansk
1552,1531,34,727,797,28,825,0,825,14,753,58,22.04.2019 00:50,113,10,Lugansk
1472,1439,24,640,809,23,832,0,832,9,786,37,22.04.2019 00:20,113,10,Lugansk
592,591,50,262,285,45,330,0,330,10,302,18,22.04.2019 00:40,113,10,Lugansk
720,715,118,280,326,114,440,0,440,5,397,38,22.04.2019 01:20,113,10,Lugansk
1840,1806,108,862,878,100,978,0,978,14,913,51,22.04.2019 00:55,113,10,Lugansk
1648,1610,107,742,819,87,906,0,906,10,875,21,22.04.2019 01:15,113,10,Lugansk
208,204,9,95,104,9,113,0,113,3,103,7,22.04.2019 00:05,113,10,Lugansk
336,323,17,116,206,14,220,0,220,2,200,18,22.04.2019 00:15,113,10,Lugansk
448,438,47,169,237,42,279,0,279,1,223,55,22.04.2019 00:50,113,10,Lugansk
1264,1247,66,716,496,52,548,0,548,8,524,16,22.04.2019 00:10,113,10,Lugansk
496,483,66,212,226,58,284,0,284,4,249,31,22.04.2019 00:10,113,10,Lugansk
368,353,19,175,174,19,193,0,193,4,166,23,22.04.2019 00:50,113,10,Lugansk
352,342,28,148,178,26,204,0,204,2,192,10,22.04.2019 00:05,113,10,Lugansk
1072,1055,80,454,549,69,618,0,618,13,582,23,22.04.2019 00:15,113,10,Lugansk
656,639,83,221,354,81,435,0,435,4,399,32,22.04.2019 00:53,113,10,Lugansk
320,317,37,122,173,25,198,0,198,1,180,17,22.04.2019 02:30,113,10,Lugansk
992,968,84,402,514,76,590,0,590,21,523,46,22.04.2019 00:22,113,10,Lugansk
224,25,15,200,10,14,24,0,24,0,21,3,22.04.2019 00:45,113,10,Lugansk
592,587,52,272,274,46,320,0,320,8,286,26,22.04.2019 00:10,113,10,Lugansk
768,740,37,313,422,33,455,0,455,10,421,24,22.04.2019 00:10,113,10,Lugansk
240,228,0,103,137,0,137,0,137,0,130,7,22.04.2019 00:20,113,10,Lugansk
208,206,48,13,148,47,195,0,195,14,132,49,22.04.2019 02:00,113,10,Lugansk
176,178,7,25,144,7,151,0,151,2,126,23,22.04.2019 00:05,113,10,Lugansk
1328,1308,22,501,812,15,827,0,827,15,776,36,22.04.2019 00:51,113,10,Lugansk
1056,1030,16,374,669,13,682,0,682,12,636,34,22.04.2019 00:15,113,10,Lugansk
1488,1474,34,553,908,27,935,0,935,19,857,59,22.04.2019 00:20,113,10,Lugansk
1680,1664,34,671,980,29,1009,0,1009,16,923,70,22.04.2019 00:05,113,10,Lugansk
2032,1988,53,820,1172,40,1212,0,1212,22,1126,64,22.04.2019 00:25,113,10,Lugansk
576,563,45,185,352,39,391,0,391,4,371,16,22.04.2019 00:20,113,10,Lugansk
128,123,7,25,96,7,103,0,103,0,100,3,22.04.2019 00:20,113,10,Lugansk
208,205,28,73,111,24,135,0,135,0,131,4,22.04.2019 01:15,113,10,Lugansk
288,276,41,125,128,35,163,0,163,2,148,13,22.04.2019 00:10,113,10,Lugansk
928,909,24,365,542,21,563,0,563,9,525,29,22.04.2019 00:30,113,10,Lugansk
384,379,9,127,248,9,257,0,257,3,245,9,22.04.2019 00:20,113,10,Lugansk
96,87,4,41,51,4,55,0,55,0,53,2,22.04.2019 00:10,113,10,Lugansk
400,387,37,147,217,36,253,0,253,5,220,28,22.04.2019 00:10,113,10,Lugansk
400,386,24,139,241,20,261,0,261,1,253,7,22.04.2019 00:30,113,10,Lugansk
80,77,5,32,43,5,48,0,48,1,43,4,22.04.2019 00:15,113,10,Lugansk
400,383,21,138,243,19,262,0,262,1,230,31,22.04.2019 00:30,113,10,Lugansk
304,289,19,131,159,14,173,0,173,4,161,8,22.04.2019 00:11,113,10,Lugansk
416,396,17,161,241,14,255,0,255,2,225,28,22.04.2019 00:15,113,10,Lugansk
400,389,36,176,201,23,224,0,224,3,197,24,22.04.2019 00:30,113,10,Lugansk
784,761,28,195,566,23,589,0,589,6,518,65,22.04.2019 00:40,113,10,Lugansk
815,794,31,312,472,31,503,0,503,18,440,45,22.04.2019 02:15,113,10,Lugansk
144,139,5,39,100,5,105,0,105,7,94,4,22.04.2019 00:15,113,10,Lugansk
1504,1476,92,617,806,81,887,0,887,9,811,67,21.04.2019 21:15,113,10,Lugansk
256,242,5,121,131,4,135,0,135,3,127,5,22.04.2019 00:10,113,10,Lugansk
432,413,40,142,253,37,290,0,290,6,250,34,22.04.2019 00:10,113,10,Lugansk
304,296,39,127,144,33,177,0,177,1,161,15,22.04.2019 00:05,113,10,Lugansk
528,513,47,195,290,43,333,0,333,4,306,23,22.04.2019 00:05,113,10,Lugansk
400,388,44,143,221,36,257,0,257,0,232,25,22.04.2019 00:00,113,10,Lugansk
304,292,28,109,167,28,195,0,195,0,176,19,22.04.2019 00:01,113,10,Lugansk
1040,1044,6,365,670,5,675,0,675,21,599,55,22.04.2019 00:06,113,10,Lugansk
528,518,56,206,271,51,322,0,322,3,290,29,22.04.2019 00:33,113,10,Lugansk
480,461,31,229,226,25,251,0,251,3,233,15,22.04.2019 00:10,113,10,Lugansk
752,739,42,269,443,40,483,0,483,4,457,22,22.04.2019 00:40,113,10,Lugansk
256,337,38,10,213,33,246,0,246,10,223,13,22.04.2019 04:05,113,10,Lugansk
416,409,30,202,188,26,214,0,214,0,205,9,22.04.2019 00:05,113,10,Lugansk
320,322,32,89,201,30,231,0,231,3,212,16,22.04.2019 01:15,113,10,Lugansk
304,293,20,90,197,17,214,0,214,5,194,15,21.04.2019 20:30,113,10,Lugansk
256,36,36,225,0,31,31,0,31,0,27,4,22.04.2019 00:20,113,10,Lugansk
752,737,70,311,374,67,441,0,441,7,411,23,22.04.2019 00:15,113,10,Lugansk
272,261,34,78,162,32,194,0,194,4,169,21,22.04.2019 00:03,113,10,Lugansk
320,310,39,106,182,32,214,0,214,6,196,12,22.04.2019 00:05,113,10,Lugansk
80,74,11,25,45,10,55,0,55,0,53,2,21.04.2019 22:30,113,10,Lugansk
480,460,48,219,219,42,261,0,261,6,248,7,22.04.2019 00:10,113,10,Lugansk
320,321,55,109,159,52,211,0,211,2,199,10,22.04.2019 00:30,113,10,Lugansk
432,410,48,163,224,45,269,0,269,9,238,22,22.04.2019 00:15,113,10,Lugansk
624,609,94,170,364,90,454,0,454,9,411,34,22.04.2019 00:05,113,10,Lugansk
256,248,16,81,161,14,175,0,175,1,161,13,22.04.2019 02:10,113,10,Lugansk
128,126,4,31,93,4,97,0,97,2,88,7,22.04.2019 00:37,113,10,Lugansk
256,234,22,91,146,19,165,0,165,5,155,5,22.04.2019 00:33,113,10,Lugansk
432,426,67,80,289,63,352,0,352,4,334,14,22.04.2019 02:00,113,10,Lugansk
368,359,37,158,176,34,210,0,210,4,197,9,22.04.2019 00:10,113,10,Lugansk
272,263,36,109,131,32,163,0,163,7,139,17,22.04.2019 00:30,113,10,Lugansk
176,166,6,66,104,6,110,0,110,1,106,3,22.04.2019 00:10,113,10,Lugansk
112,109,8,14,90,8,98,0,98,3,92,3,22.04.2019 01:25,113,10,Lugansk
784,779,0,17,767,0,767,0,767,20,207,540,22.04.2019 00:01,114,10,Lugansk
384,372,0,18,366,0,366,0,366,9,222,135,22.04.2019 00:25,114,10,Lugansk
720,712,0,28,692,0,692,0,692,45,389,258,21.04.2019 21:20,114,10,Lugansk
1088,1056,27,379,687,22,709,0,709,16,651,42,22.04.2019 00:50,114,10,Lugansk
1392,1444,22,479,896,17,913,0,913,21,845,47,22.04.2019 00:30,114,10,Lugansk
1408,1417,12,533,865,10,875,0,875,20,792,63,22.04.2019 00:30,114,10,Lugansk
1168,1154,12,492,665,11,676,0,676,15,623,38,22.04.2019 01:55,114,10,Lugansk
912,887,64,443,417,52,469,0,469,3,440,26,22.04.2019 00:20,114,10,Lugansk
400,399,53,124,226,50,276,0,276,7,240,29,22.04.2019 00:30,114,10,Lugansk
1040,1016,53,478,516,46,562,0,562,7,522,33,22.04.2019 06:00,114,10,Lugansk
640,619,21,265,354,21,375,0,375,8,338,29,22.04.2019 01:25,114,10,Lugansk
672,655,20,239,413,20,433,0,433,13,387,33,22.04.2019 00:10,114,10,Lugansk
192,181,4,65,123,4,127,0,127,0,113,14,22.04.2019 00:52,114,10,Lugansk
128,124,6,43,79,6,85,0,85,2,78,5,22.04.2019 00:25,114,10,Lugansk
320,308,44,121,159,40,199,0,199,4,189,6,22.04.2019 00:10,114,10,Lugansk
592,588,47,224,325,43,368,0,368,8,336,24,22.04.2019 00:15,114,10,Lugansk
432,423,25,186,224,22,246,0,246,2,223,21,22.04.2019 00:10,114,10,Lugansk
256,253,8,91,157,8,165,0,165,1,161,3,22.04.2019 00:15,114,10,Lugansk
192,183,12,65,115,12,127,0,127,0,116,11,22.04.2019 00:10,114,10,Lugansk
352,347,48,95,213,44,257,0,257,2,249,6,22.04.2019 00:20,114,10,Lugansk
672,653,39,307,329,36,365,0,365,3,340,22,22.04.2019 00:50,114,10,Lugansk
416,407,17,170,233,13,246,0,246,6,221,19,22.04.2019 01:05,114,10,Lugansk
112,104,1,40,71,1,72,0,72,0,66,6,22.04.2019 00:25,114,10,Lugansk
896,871,20,316,562,18,580,0,580,8,551,21,22.04.2019 00:30,114,10,Lugansk
432,419,19,132,282,18,300,0,300,1,276,23,22.04.2019 00:10,114,10,Lugansk
256,241,17,98,145,13,158,0,158,1,153,4,22.04.2019 00:30,114,10,Lugansk
992,968,21,406,571,15,586,0,586,5,552,29,22.04.2019 02:40,114,10,Lugansk
752,730,16,271,467,14,481,0,481,12,450,19,22.04.2019 00:10,114,10,Lugansk
384,369,40,152,194,38,232,0,232,1,205,26,22.04.2019 00:20,114,10,Lugansk
560,542,36,245,285,30,315,0,315,9,293,13,22.04.2019 00:15,114,10,Lugansk
176,171,7,46,123,7,130,0,130,2,117,11,22.04.2019 00:50,114,10,Lugansk
368,356,7,108,254,6,260,0,260,3,243,14,22.04.2019 00:30,114,10,Lugansk
160,147,15,75,72,13,85,0,85,2,75,8,22.04.2019 01:05,114,10,Lugansk
80,77,5,32,43,5,48,0,48,0,44,4,22.04.2019 00:05,114,10,Lugansk
336,319,17,141,179,16,195,0,195,4,176,15,22.04.2019 00:30,114,10,Lugansk
608,585,28,242,342,24,366,0,366,2,354,10,22.04.2019 00:05,114,10,Lugansk
304,284,0,157,147,0,147,0,147,0,137,10,22.04.2019 00:30,114,10,Lugansk
480,468,31,176,276,28,304,0,304,6,292,6,22.04.2019 01:40,114,10,Lugansk
272,260,19,87,168,17,185,0,185,2,180,3,22.04.2019 00:10,114,10,Lugansk
288,279,18,109,161,18,179,0,179,2,171,6,22.04.2019 02:10,114,10,Lugansk
624,602,8,259,360,5,365,0,365,8,342,15,21.04.2019 20:55,114,10,Lugansk
528,518,25,182,324,22,346,0,346,1,333,12,22.04.2019 02:00,114,10,Lugansk
832,809,51,465,322,45,367,0,367,10,342,15,22.04.2019 00:10,114,10,Lugansk
336,309,16,129,191,16,207,0,207,0,189,18,22.04.2019 00:20,114,10,Lugansk
256,240,14,117,128,11,139,0,139,4,130,5,22.04.2019 01:15,114,10,Lugansk
384,367,13,123,248,13,261,0,261,2,249,10,22.04.2019 00:45,114,10,Lugansk
880,859,23,418,442,20,462,0,462,10,420,32,22.04.2019 00:30,114,10,Lugansk
816,805,38,349,440,27,467,0,467,6,432,29,22.04.2019 00:30,114,10,Lugansk
240,222,19,108,115,17,132,0,132,0,126,6,22.04.2019 00:05,114,10,Lugansk
1360,1335,99,519,747,94,841,0,841,24,755,62,22.04.2019 01:45,114,10,Lugansk
928,913,52,401,480,47,527,0,527,11,506,10,22.04.2019 00:10,114,10,Lugansk
368,370,40,166,165,37,202,0,202,7,176,19,22.04.2019 01:05,114,10,Lugansk
208,197,0,125,83,0,83,0,83,5,70,8,22.04.2019 01:15,114,10,Lugansk
736,716,42,394,316,26,342,0,342,14,302,26,22.04.2019 00:40,114,10,Lugansk
1984,1938,32,1509,461,14,475,0,475,22,405,48,22.04.2019 03:15,114,10,Lugansk
672,655,4,417,251,4,255,0,255,8,233,14,22.04.2019 00:30,114,10,Lugansk
1344,1307,18,843,487,14,501,0,501,19,441,41,22.04.2019 00:50,114,10,Lugansk
256,251,4,132,120,4,124,0,124,2,96,26,22.04.2019 00:05,114,10,Lugansk
112,104,3,61,49,2,51,0,51,2,40,9,22.04.2019 00:10,114,10,Lugansk
768,757,23,445,301,22,323,0,323,7,302,14,22.04.2019 00:05,114,10,Lugansk
240,221,16,144,83,13,96,0,96,0,71,25,22.04.2019 03:45,114,10,Lugansk
288,273,4,178,106,4,110,0,110,4,93,13,22.04.2019 00:30,114,10,Lugansk
1408,1376,54,782,575,51,626,0,626,17,595,14,22.04.2019 00:20,114,10,Lugansk
528,514,8,286,234,8,242,0,242,6,229,7,22.04.2019 00:05,114,10,Lugansk
1728,1707,40,1010,687,31,718,0,718,17,670,31,22.04.2019 00:35,114,10,Lugansk
224,26,11,201,14,9,23,0,23,1,15,7,22.04.2019 00:30,114,10,Lugansk
1072,1105,4,281,787,4,791,0,791,30,223,538,22.04.2019 00:10,115,11,Lvov
2000,1982,6,735,1261,4,1265,0,1265,40,388,837,22.04.2019 00:30,115,11,Lvov
1280,1269,15,390,878,12,890,0,890,13,245,632,22.04.2019 00:45,115,11,Lvov
1376,1361,10,445,923,8,931,0,931,29,334,568,22.04.2019 00:10,115,11,Lvov
1680,1721,7,519,1154,7,1161,0,1161,27,392,742,22.04.2019 00:20,115,11,Lvov
1648,1634,8,532,1110,6,1116,0,1116,31,344,741,22.04.2019 00:50,115,11,Lvov
1616,1607,2,613,1001,2,1003,0,1003,25,256,722,22.04.2019 00:40,115,11,Lvov
1680,1668,12,588,1082,10,1092,0,1092,27,311,754,22.04.2019 01:00,115,11,Lvov
2208,2209,19,777,1418,13,1431,0,1431,32,463,936,22.04.2019 00:02,115,11,Lvov
2112,2141,16,577,1522,13,1535,0,1535,49,402,1084,22.04.2019 00:10,115,11,Lvov
1712,1753,5,526,1181,5,1186,0,1186,33,365,788,22.04.2019 00:14,115,11,Lvov
1616,1642,12,508,1100,8,1108,0,1108,31,398,679,21.04.2019 23:00,115,11,Lvov
2320,2304,10,757,1556,7,1563,0,1563,56,414,1093,21.04.2019 23:30,115,11,Lvov
1504,1507,7,526,972,6,978,0,978,20,328,630,22.04.2019 00:20,115,11,Lvov
1776,1783,6,534,1237,5,1242,0,1242,37,356,849,22.04.2019 00:45,115,11,Lvov
1568,1588,7,472,1093,3,1096,0,1096,29,353,714,22.04.2019 00:10,115,11,Lvov
1248,1264,6,494,748,6,754,0,754,22,336,396,22.04.2019 00:15,115,11,Lvov
1536,1519,7,476,1054,6,1060,0,1054,31,363,666,22.04.2019 00:20,115,11,Lvov
1584,1588,11,486,1089,9,1098,0,1098,27,323,748,22.04.2019 00:15,115,11,Lvov
1168,1153,7,399,764,5,769,0,769,30,263,476,22.04.2019 00:12,115,11,Lvov
2352,2355,7,715,1630,7,1637,0,1637,39,467,1131,22.04.2019 00:30,115,11,Lvov
2192,2185,12,680,1503,9,1512,0,1512,42,391,1079,22.04.2019 00:15,115,11,Lvov
1600,1573,4,493,1104,3,1107,0,1107,27,196,884,22.04.2019 00:15,115,11,Lvov
2128,2099,3,784,1343,1,1344,0,1344,29,377,938,22.04.2019 00:15,115,11,Lvov
1872,1857,9,601,1262,9,1271,0,1271,27,312,932,22.04.2019 00:15,115,11,Lvov
1664,1674,2,579,1084,1,1085,0,1085,25,336,724,22.04.2019 00:15,115,11,Lvov
2336,2325,15,769,1553,14,1567,0,1567,32,400,1135,22.04.2019 00:07,115,11,Lvov
1328,1308,5,433,891,4,895,0,895,11,197,687,22.04.2019 00:20,115,11,Lvov
320,28,0,293,27,0,27,1,27,1,7,19,22.04.2019 00:10,115,11,Lvov
208,43,0,173,35,0,35,0,35,1,9,25,22.04.2019 00:07,115,11,Lvov
384,157,125,250,30,104,134,0,134,1,41,92,22.04.2019 00:20,115,11,Lvov
368,38,26,331,12,25,37,0,37,2,10,25,22.04.2019 00:05,115,11,Lvov
752,158,79,613,71,68,139,0,139,6,34,99,22.04.2019 00:30,115,11,Lvov
832,203,80,638,118,76,194,0,194,3,53,138,22.04.2019 00:15,115,11,Lvov
1904,1897,9,535,1360,9,1369,0,1369,50,385,934,22.04.2019 00:20,115,11,Lvov
1952,1947,7,630,1316,6,1322,0,1322,42,354,926,22.04.2019 01:29,115,11,Lvov
1856,1859,15,637,1207,12,1219,0,1219,22,322,875,22.04.2019 00:30,115,11,Lvov
1696,1682,24,588,1089,19,1108,0,1108,18,301,789,22.04.2019 00:45,115,11,Lvov
2352,2379,22,719,1615,18,1633,0,1633,46,407,1180,22.04.2019 00:20,115,11,Lvov
1232,1226,3,609,621,2,623,0,623,14,209,400,22.04.2019 00:41,115,11,Lvov
2256,2233,34,787,1445,24,1469,0,1469,40,491,938,22.04.2019 00:07,115,11,Lvov
2176,2174,30,679,1478,19,1497,0,1497,45,521,931,22.04.2019 00:06,115,11,Lvov
2384,2373,27,878,1492,14,1506,0,1506,50,392,1064,22.04.2019 00:05,115,11,Lvov
2512,2555,5,658,1852,2,1854,0,1854,47,427,1380,22.04.2019 00:12,115,11,Lvov
2000,2006,18,612,1371,17,1388,0,1388,54,307,1027,22.04.2019 00:30,115,11,Lvov
1280,1264,5,392,885,3,888,0,888,26,256,606,22.04.2019 00:26,115,11,Lvov
2016,2011,15,564,1441,11,1452,0,1452,35,353,1064,22.04.2019 00:30,115,11,Lvov
1968,1957,8,623,1339,6,1345,0,1345,35,439,871,22.04.2019 01:10,115,11,Lvov
2000,1984,17,618,1369,13,1382,0,1382,37,357,988,22.04.2019 00:15,115,11,Lvov
1456,1458,7,420,1031,5,1036,0,1036,25,252,759,22.04.2019 00:10,115,11,Lvov
2192,2165,11,754,1430,8,1438,0,1438,31,368,1039,22.04.2019 00:20,115,11,Lvov
1696,1705,25,485,1191,20,1211,0,1211,37,359,815,22.04.2019 00:20,115,11,Lvov
1904,1894,17,481,1407,16,1423,0,1419,31,268,1120,21.04.2019 22:00,115,11,Lvov
1760,1743,16,528,1223,9,1232,0,1232,41,327,864,22.04.2019 00:52,115,11,Lvov
2176,2162,21,658,1503,15,1518,0,1518,33,416,1069,22.04.2019 00:30,115,11,Lvov
2128,2106,16,619,1494,15,1509,0,1509,31,407,1071,22.04.2019 00:50,115,11,Lvov
2352,2327,10,720,1622,10,1632,0,1631,49,388,1194,22.04.2019 00:40,115,11,Lvov
2080,2064,17,637,1428,15,1443,0,1443,36,383,1024,21.04.2019 21:42,115,11,Lvov
1936,1936,15,560,1363,13,1376,0,1376,35,393,948,22.04.2019 00:15,115,11,Lvov
2320,2297,25,716,1583,21,1604,0,1604,52,417,1135,22.04.2019 00:10,115,11,Lvov
2256,2270,15,614,1630,12,1642,0,1642,50,440,1152,22.04.2019 00:20,115,11,Lvov
2400,2404,16,721,1670,9,1679,0,1679,51,474,1154,22.04.2019 00:05,115,11,Lvov
2304,2286,27,667,1617,20,1637,0,1637,37,431,1169,22.04.2019 00:05,115,11,Lvov
2240,2220,26,707,1514,19,1533,0,1533,48,454,1031,22.04.2019 01:00,115,11,Lvov
2064,2055,15,530,1523,11,1534,0,1534,31,378,1125,22.04.2019 00:42,115,11,Lvov
2128,2137,10,610,1508,10,1518,0,1518,35,432,1051,21.04.2019 22:30,115,11,Lvov
2096,2066,17,660,1421,15,1436,0,1436,28,392,1016,22.04.2019 00:10,115,11,Lvov
2400,2381,12,726,1664,10,1674,0,1674,49,449,1176,22.04.2019 00:15,115,11,Lvov
2352,2354,24,853,1480,19,1499,0,1499,48,527,924,22.04.2019 00:07,115,11,Lvov
2368,2364,15,714,1641,13,1654,0,1654,40,447,1167,22.04.2019 00:10,115,11,Lvov
2272,2237,23,728,1531,13,1544,0,1544,42,449,1053,22.04.2019 00:30,115,11,Lvov
2112,2087,22,716,1380,16,1396,0,1396,33,370,993,22.04.2019 00:15,115,11,Lvov
1376,1372,12,406,960,10,970,0,970,27,313,630,22.04.2019 00:15,115,11,Lvov
2048,2050,13,589,1448,11,1459,0,1459,35,393,1031,22.04.2019 00:40,115,11,Lvov
2032,2016,22,543,1471,18,1489,0,1489,41,370,1078,22.04.2019 00:05,115,11,Lvov
2304,2288,16,731,1562,11,1573,0,1573,32,409,1132,22.04.2019 00:05,115,11,Lvov
2504,2464,7,732,1767,5,1772,0,1767,42,418,1307,22.04.2019 00:40,115,11,Lvov
2352,2337,17,706,1634,12,1646,0,1646,44,404,1198,22.04.2019 00:30,115,11,Lvov
1872,1855,11,551,1313,8,1321,0,1321,32,375,914,22.04.2019 00:10,115,11,Lvov
1968,1948,17,541,1412,15,1427,0,1427,34,395,998,22.04.2019 00:15,115,11,Lvov
2432,2413,25,689,1721,22,1743,0,1743,45,429,1269,22.04.2019 00:15,115,11,Lvov
2432,2442,10,601,1825,6,1831,0,1831,40,418,1372,22.04.2019 00:45,115,11,Lvov
2352,2338,16,611,1729,12,1741,0,1741,38,437,1266,22.04.2019 00:05,115,11,Lvov
2304,2285,16,633,1658,13,1671,0,1671,41,410,1220,22.04.2019 00:10,115,11,Lvov
2416,2404,12,662,1744,10,1754,0,1754,34,480,1240,22.04.2019 00:05,115,11,Lvov
2240,2232,15,738,1489,13,1502,0,1502,30,516,956,22.04.2019 00:05,115,11,Lvov
2304,2292,15,736,1556,12,1568,0,1568,33,526,1009,22.04.2019 00:30,115,11,Lvov
2512,2510,9,811,1694,7,1701,0,1701,42,529,1130,22.04.2019 00:10,115,11,Lvov
2464,2441,7,904,1555,5,1560,0,1560,41,497,1022,22.04.2019 00:15,115,11,Lvov
560,154,154,423,0,137,137,0,137,3,53,81,22.04.2019 00:15,115,11,Lvov
688,200,24,520,144,24,168,0,168,4,59,105,22.04.2019 00:20,115,11,Lvov
96,59,0,44,52,0,52,0,52,1,18,33,22.04.2019 00:15,115,11,Lvov
384,63,50,326,13,45,58,0,58,1,18,39,22.04.2019 00:20,115,11,Lvov
1664,1644,3,546,1117,1,1118,0,1118,24,290,804,22.04.2019 00:30,115,11,Lvov
2304,2295,17,736,1556,12,1568,0,1568,51,416,1101,22.04.2019 00:55,116,11,Lvov
1376,1366,9,418,950,8,958,0,958,27,178,753,22.04.2019 00:30,116,11,Lvov
2304,2309,18,658,1631,15,1646,0,1646,49,497,1100,22.04.2019 00:05,116,11,Lvov
2320,2293,7,649,1667,4,1671,0,1671,52,381,1238,21.04.2019 21:48,116,11,Lvov
1984,1964,24,691,1273,20,1293,0,1293,48,357,888,22.04.2019 00:05,116,11,Lvov
2112,2113,19,687,1412,13,1425,0,1425,31,419,975,22.04.2019 00:10,116,11,Lvov
1968,1954,25,701,1249,18,1267,0,1267,42,372,853,22.04.2019 00:02,116,11,Lvov
2144,2176,21,781,1347,16,1363,0,1363,46,439,878,22.04.2019 00:10,116,11,Lvov
2432,2432,18,768,1649,15,1664,0,1664,51,504,1109,22.04.2019 02:32,116,11,Lvov
2320,2340,21,843,1465,12,1477,0,1477,52,505,920,22.04.2019 00:20,116,11,Lvov
2336,2331,14,785,1541,10,1551,0,1551,58,507,986,22.04.2019 03:16,116,11,Lvov
2192,2160,16,633,1545,14,1559,0,1559,32,433,1094,22.04.2019 00:20,116,11,Lvov
2112,2094,21,651,1442,19,1461,0,1461,39,399,1023,22.04.2019 00:05,116,11,Lvov
2144,2106,14,663,1468,13,1481,0,1481,63,408,1010,22.04.2019 03:39,116,11,Lvov
2240,2213,12,665,1565,10,1575,0,1575,40,434,1101,22.04.2019 00:30,116,11,Lvov
1968,1962,13,627,1330,11,1341,0,1341,31,353,957,22.04.2019 00:02,116,11,Lvov
2000,1996,17,601,1386,13,1399,0,1399,52,364,983,21.04.2019 21:34,116,11,Lvov
2176,2162,24,645,1515,16,1531,0,1530,53,481,996,22.04.2019 00:07,116,11,Lvov
2256,2222,19,733,1509,14,1523,0,1522,36,406,1080,22.04.2019 00:10,116,11,Lvov
2224,2316,15,684,1530,10,1540,0,1540,50,478,1012,22.04.2019 00:20,116,11,Lvov
2304,2313,18,758,1532,14,1546,0,1546,39,455,1052,22.04.2019 03:56,116,11,Lvov
1984,2015,27,599,1365,20,1385,0,1385,36,369,980,22.04.2019 01:05,116,11,Lvov
2224,2227,25,711,1492,21,1513,0,1513,35,469,1009,22.04.2019 00:11,116,11,Lvov
2256,2232,17,750,1489,17,1506,0,1506,48,508,950,21.04.2019 23:20,116,11,Lvov
2192,2227,20,698,1479,15,1494,0,1494,42,440,1012,22.04.2019 00:05,116,11,Lvov
2288,2281,12,724,1555,9,1564,0,1564,71,494,999,22.04.2019 05:40,116,11,Lvov
2112,2104,24,723,1370,19,1389,0,1389,45,403,941,22.04.2019 00:15,116,11,Lvov
2144,2159,18,619,1514,11,1525,0,1525,47,417,1061,22.04.2019 00:05,116,11,Lvov
2256,2237,13,658,1587,11,1598,0,1598,47,428,1123,21.04.2019 23:45,116,11,Lvov
2400,2383,12,866,1524,10,1534,0,1534,35,460,1039,22.04.2019 00:22,116,11,Lvov
2112,2112,17,628,1468,16,1484,0,1484,33,359,1092,22.04.2019 03:40,116,11,Lvov
2400,2381,27,702,1674,24,1698,0,1697,55,450,1192,21.04.2019 23:45,116,11,Lvov
2272,2249,20,805,1451,16,1467,0,1467,29,377,1061,22.04.2019 00:10,116,11,Lvov
1648,1718,17,348,1287,13,1300,0,1300,33,335,932,22.04.2019 00:03,116,11,Lvov
2032,2029,14,576,1446,10,1456,0,1456,46,406,1004,22.04.2019 00:15,116,11,Lvov
2176,2143,13,750,1418,8,1426,0,1426,49,386,991,22.04.2019 02:10,116,11,Lvov
2080,2089,27,671,1388,21,1409,0,1409,41,425,943,22.04.2019 00:05,116,11,Lvov
2160,2133,17,773,1373,14,1387,0,1387,43,417,927,22.04.2019 00:22,116,11,Lvov
2256,2209,26,904,1338,14,1352,0,1352,41,366,945,22.04.2019 00:15,116,11,Lvov
2048,2042,36,599,1417,32,1449,0,1449,50,374,1025,22.04.2019 03:45,116,11,Lvov
2256,2269,29,667,1573,16,1589,0,1589,48,397,1144,22.04.2019 00:01,116,11,Lvov
2176,2192,15,658,1508,10,1518,0,1518,47,413,1058,22.04.2019 00:12,116,11,Lvov
2272,2291,19,617,1640,15,1655,0,1655,48,462,1145,22.04.2019 00:02,116,11,Lvov
1952,1987,13,538,1404,10,1414,0,1414,32,403,979,22.04.2019 00:10,116,11,Lvov
2288,2298,18,745,1529,14,1543,0,1543,30,411,1102,22.04.2019 00:15,116,11,Lvov
2240,2237,16,667,1563,10,1573,0,1573,51,412,1110,22.04.2019 00:26,116,11,Lvov
1888,1884,36,604,1256,28,1284,0,1284,40,242,1002,22.04.2019 00:30,116,11,Lvov
1792,1801,28,509,1258,25,1283,0,1283,28,287,968,22.04.2019 00:30,116,11,Lvov
2144,2134,37,633,1481,30,1511,0,1511,35,340,1136,22.04.2019 03:00,116,11,Lvov
2208,2182,5,925,1280,3,1283,0,1283,39,425,819,22.04.2019 00:04,116,11,Lvov
2416,2411,5,700,1712,4,1716,0,1716,60,355,1301,22.04.2019 04:00,116,11,Lvov
2464,2448,7,869,1592,3,1595,0,1595,43,420,1132,22.04.2019 00:01,116,11,Lvov
2448,2446,12,788,1649,11,1660,0,1660,47,431,1182,21.04.2019 22:15,116,11,Lvov
2192,2187,13,750,1433,9,1442,0,1441,45,414,982,22.04.2019 00:20,116,11,Lvov
2240,2239,19,774,1448,18,1466,0,1466,45,444,977,22.04.2019 00:05,116,11,Lvov
2432,2422,8,770,1654,8,1662,0,1662,48,396,1218,22.04.2019 00:10,116,11,Lvov
1984,1984,10,527,1449,8,1457,0,1457,43,306,1108,22.04.2019 00:10,116,11,Lvov
2416,2431,14,772,1634,10,1644,0,1644,36,533,1075,22.04.2019 00:20,116,11,Lvov
2224,2213,6,773,1446,5,1451,0,1451,50,396,1005,22.04.2019 00:01,116,11,Lvov
2192,2169,16,758,1418,16,1434,0,1434,28,399,1007,22.04.2019 00:22,116,11,Lvov
2208,2207,13,675,1521,12,1533,0,1533,36,410,1087,21.04.2019 22:30,116,11,Lvov
1920,1903,5,583,1333,4,1337,0,1337,34,322,981,22.04.2019 00:09,116,11,Lvov
2192,2170,5,654,1534,4,1538,0,1538,57,367,1114,22.04.2019 00:30,116,11,Lvov
2384,2379,13,802,1572,10,1582,0,1582,47,403,1132,21.04.2019 23:45,116,11,Lvov
2096,2070,7,650,1442,4,1446,0,1446,37,312,1097,22.04.2019 00:30,116,11,Lvov
2368,2360,18,779,1572,17,1589,0,1589,51,348,1190,22.04.2019 00:30,116,11,Lvov
2192,2169,10,704,1484,4,1488,0,1488,42,364,1082,22.04.2019 05:09,116,11,Lvov
2048,2048,17,733,1300,15,1315,0,1315,39,341,935,22.04.2019 00:15,116,11,Lvov
2352,2330,13,682,1658,12,1670,0,1670,49,323,1298,22.04.2019 01:00,116,11,Lvov
1600,1575,7,503,1092,5,1097,0,1097,28,255,814,22.04.2019 00:02,116,11,Lvov
2224,2206,12,795,1418,11,1429,0,1429,36,354,1039,22.04.2019 00:10,116,11,Lvov
2272,2245,13,660,1601,11,1612,0,1612,44,348,1220,22.04.2019 00:07,116,11,Lvov
2368,2346,18,758,1594,16,1610,0,1610,44,405,1161,22.04.2019 00:12,116,11,Lvov
2176,2171,6,724,1448,4,1452,0,1452,38,390,1024,22.04.2019 00:07,116,11,Lvov
2240,2206,9,676,1556,8,1564,0,1564,33,364,1167,22.04.2019 00:13,116,11,Lvov
1840,1806,8,559,1275,6,1281,0,1281,31,279,971,22.04.2019 00:10,116,11,Lvov
1984,2019,12,668,1306,10,1316,0,1316,41,343,932,21.04.2019 23:50,116,11,Lvov
1984,1974,19,637,1334,13,1347,0,1347,40,394,913,22.04.2019 00:15,116,11,Lvov
1936,1906,47,718,1181,37,1218,0,1218,37,289,892,22.04.2019 00:10,116,11,Lvov
1328,1312,3,432,894,2,896,0,896,21,224,651,22.04.2019 00:20,116,11,Lvov
544,534,2,165,377,2,379,0,379,14,118,247,22.04.2019 00:09,116,11,Lvov
960,822,25,138,797,25,822,0,822,93,626,103,22.04.2019 00:17,117,11,Lvov
2016,2019,25,712,1286,18,1304,0,1304,32,472,800,22.04.2019 00:05,117,11,Lvov
2080,2052,22,729,1336,15,1351,0,1351,42,422,887,22.04.2019 00:05,117,11,Lvov
1376,1490,6,356,1017,3,1020,0,1020,25,422,573,22.04.2019 00:02,117,11,Lvov
1616,1653,14,557,1051,8,1059,0,1059,38,359,662,22.04.2019 00:05,117,11,Lvov
1376,1415,5,487,884,5,889,0,889,37,285,567,22.04.2019 00:45,117,11,Lvov
1568,1623,9,544,1016,8,1024,0,1024,25,347,652,21.04.2019 21:57,117,11,Lvov
1984,1980,7,699,1279,6,1285,0,1285,29,422,834,22.04.2019 00:10,117,11,Lvov
2064,2075,6,770,1288,6,1294,0,1294,36,357,901,22.04.2019 00:20,117,11,Lvov
2208,2196,8,870,1332,6,1338,0,1338,38,444,856,22.04.2019 00:19,117,11,Lvov
2160,2169,5,820,1336,4,1340,0,1340,27,412,901,22.04.2019 00:20,117,11,Lvov
1456,1477,11,490,958,8,966,0,966,33,271,662,22.04.2019 00:15,117,11,Lvov
880,923,0,304,576,0,576,0,576,19,188,369,22.04.2019 00:02,117,11,Lvov
1440,1461,7,458,978,4,982,0,982,24,284,674,22.04.2019 00:40,117,11,Lvov
1712,1833,10,443,1261,8,1269,0,1269,38,380,851,22.04.2019 00:50,117,11,Lvov
1648,1659,7,523,1118,7,1125,0,1125,34,348,743,22.04.2019 00:08,117,11,Lvov
2032,2036,16,684,1336,12,1348,0,1348,38,499,811,22.04.2019 00:03,117,11,Lvov
1488,1487,7,494,988,6,994,0,994,33,363,598,21.04.2019 21:24,117,11,Lvov
1680,1698,16,522,1142,16,1158,0,1158,32,373,753,22.04.2019 00:05,117,11,Lvov
2000,2011,25,658,1323,19,1342,0,1342,40,451,851,22.04.2019 00:10,117,11,Lvov
2080,2074,24,655,1405,20,1425,0,1425,53,474,898,22.04.2019 00:03,117,11,Lvov
1856,1859,10,572,1275,9,1284,0,1284,43,414,827,22.04.2019 00:20,117,11,Lvov
1936,1949,16,607,1314,15,1329,0,1329,62,491,776,22.04.2019 00:50,117,11,Lvov
1296,1298,18,399,881,16,897,0,897,39,325,533,22.04.2019 01:30,117,11,Lvov
1408,1419,8,502,899,7,906,0,906,23,247,636,22.04.2019 00:25,117,11,Lvov
208,73,61,138,12,58,70,0,70,0,22,48,22.04.2019 00:07,117,11,Lvov
544,177,72,395,84,65,149,0,149,4,59,86,22.04.2019 00:15,117,11,Lvov
240,101,13,143,84,13,97,0,97,1,34,62,22.04.2019 00:05,117,11,Lvov
176,24,11,152,13,11,24,0,24,0,6,18,22.04.2019 00:40,117,11,Lvov
2112,2104,24,651,1442,19,1461,0,1461,51,460,950,22.04.2019 01:40,117,11,Lvov
1791,1783,13,636,1145,10,1155,0,1155,30,442,683,22.04.2019 00:37,117,11,Lvov
2032,2096,20,589,1429,14,1443,0,1443,38,491,914,22.04.2019 00:22,117,11,Lvov
2048,2053,21,590,1439,19,1458,0,1458,41,517,900,22.04.2019 00:03,117,11,Lvov
1808,1793,8,726,1077,5,1082,0,1082,29,414,639,22.04.2019 00:05,117,11,Lvov
1824,1828,27,522,1284,18,1302,0,1302,50,509,743,22.04.2019 00:45,117,11,Lvov
1600,1586,13,308,1279,13,1292,0,1292,46,333,913,21.04.2019 22:00,117,11,Lvov
1712,1889,10,461,1244,7,1251,0,1251,35,398,818,22.04.2019 01:20,117,11,Lvov
1904,1893,20,600,1292,12,1304,0,1304,35,459,810,22.04.2019 00:57,117,11,Lvov
2032,2054,26,722,1291,19,1310,0,1310,40,418,852,22.04.2019 00:45,117,11,Lvov
1904,1908,26,638,1247,19,1266,0,1266,37,422,807,22.04.2019 00:20,117,11,Lvov
1488,1479,7,487,996,5,1001,0,1001,33,365,603,22.04.2019 00:10,117,11,Lvov
1600,1592,12,550,1041,9,1050,0,1050,33,362,655,22.04.2019 00:05,117,11,Lvov
1728,1715,16,576,1143,9,1152,0,1152,34,337,781,22.04.2019 00:15,117,11,Lvov
2000,2003,21,671,1315,14,1329,0,1329,36,372,921,22.04.2019 00:20,117,11,Lvov
2416,2401,21,829,1574,13,1587,0,1587,51,506,1030,22.04.2019 00:20,117,11,Lvov
2176,2097,3,1023,1150,3,1153,0,1153,29,528,596,21.04.2019 23:40,117,11,Lvov
2240,2208,12,629,1606,5,1611,0,1611,60,532,1019,22.04.2019 00:30,117,11,Lvov
2112,2121,2,565,1545,2,1547,0,1547,40,519,988,22.04.2019 01:00,117,11,Lvov
2400,2359,5,962,1433,5,1438,0,1438,47,660,731,22.04.2019 00:15,117,11,Lvov
2624,2527,0,1281,1343,0,1343,0,1343,37,580,726,22.04.2019 00:05,117,11,Lvov
2176,2120,3,946,1229,1,1230,0,1230,40,534,656,22.04.2019 00:12,117,11,Lvov
2752,2710,8,848,1898,6,1904,0,1904,38,646,1220,22.04.2019 00:05,117,11,Lvov
2192,2053,11,950,1232,10,1242,0,1242,36,455,751,22.04.2019 00:35,117,11,Lvov
2432,2394,3,854,1575,3,1578,0,1578,58,566,954,21.04.2019 23:50,117,11,Lvov
1872,1865,20,558,1296,18,1314,0,1314,46,388,880,22.04.2019 00:03,117,11,Lvov
1888,1890,8,613,1270,5,1275,0,1275,39,340,896,22.04.2019 00:20,117,11,Lvov
1712,1707,17,454,1244,14,1258,0,1258,53,300,905,21.04.2019 20:54,117,11,Lvov
1824,1821,9,680,1139,5,1144,0,1144,33,322,789,22.04.2019 00:30,117,11,Lvov
2336,2366,14,619,1707,10,1717,0,1717,35,445,1237,22.04.2019 00:24,117,11,Lvov
2320,2303,21,790,1516,14,1530,0,1530,41,369,1120,22.04.2019 00:30,117,11,Lvov
1856,1826,15,637,1204,15,1219,0,1219,44,372,803,22.04.2019 00:30,117,11,Lvov
1552,1552,12,436,1108,8,1116,0,1116,38,320,758,22.04.2019 00:07,117,11,Lvov
1888,1836,20,631,1241,16,1257,0,1257,31,456,770,22.04.2019 00:06,117,11,Lvov
1792,1790,17,517,1260,15,1275,0,1275,36,392,847,22.04.2019 00:12,117,11,Lvov
1792,1818,30,571,1201,20,1221,0,1221,32,331,858,22.04.2019 00:11,117,11,Lvov
1952,1925,18,612,1322,18,1340,0,1340,32,382,926,22.04.2019 00:05,117,11,Lvov
2208,2224,16,570,1627,11,1638,0,1638,37,412,1189,22.04.2019 00:05,117,11,Lvov
1664,1650,13,555,1097,12,1109,0,1109,38,284,787,22.04.2019 00:05,117,11,Lvov
1984,1969,18,602,1372,10,1382,0,1382,42,322,1018,22.04.2019 00:01,117,11,Lvov
1728,1778,14,500,1218,10,1228,0,1228,31,389,808,22.04.2019 00:45,117,11,Lvov
2048,2018,17,646,1392,10,1402,0,1402,56,380,966,22.04.2019 00:22,117,11,Lvov
2000,1975,7,633,1361,6,1367,0,1367,44,385,938,22.04.2019 00:05,117,11,Lvov
1504,1495,17,435,1056,13,1069,0,1069,26,330,713,22.04.2019 00:05,117,11,Lvov
2096,2072,14,704,1383,9,1392,0,1392,43,398,951,22.04.2019 00:30,117,11,Lvov
1920,1924,15,562,1344,14,1358,0,1358,36,391,931,22.04.2019 00:30,117,11,Lvov
1488,1456,11,517,964,7,971,0,971,25,230,716,22.04.2019 00:59,117,11,Lvov
1920,1910,8,612,1303,5,1308,0,1308,42,316,950,22.04.2019 01:30,117,11,Lvov
1488,1470,10,495,988,5,993,0,993,42,257,694,22.04.2019 00:27,117,11,Lvov
1728,1704,8,537,1188,3,1191,0,1191,28,349,814,22.04.2019 00:05,117,11,Lvov
2016,2003,13,626,1380,10,1390,0,1390,35,339,1016,22.04.2019 01:23,117,11,Lvov
2432,2426,8,801,1626,5,1631,0,1631,46,488,1097,22.04.2019 00:30,117,11,Lvov
2400,2402,18,720,1667,13,1680,0,1680,50,466,1164,21.04.2019 23:51,117,11,Lvov
2160,2126,10,696,1457,7,1464,0,1464,54,383,1027,22.04.2019 00:30,117,11,Lvov
2320,2290,9,690,1623,7,1630,0,1630,50,452,1128,22.04.2019 00:20,117,11,Lvov
416,88,49,345,31,40,71,0,71,0,23,48,22.04.2019 00:10,117,11,Lvov
224,135,25,99,105,20,125,0,125,6,31,88,22.04.2019 00:05,117,11,Lvov
1280,669,315,710,303,267,570,0,570,31,169,370,22.04.2019 00:05,117,11,Lvov
2112,2177,4,566,1543,3,1546,0,1546,41,587,918,22.04.2019 00:48,117,11,Lvov
1472,1510,10,478,984,10,994,0,994,17,343,634,22.04.2019 00:20,117,11,Lvov
1088,1154,7,342,739,7,746,0,746,27,284,435,22.04.2019 00:20,117,11,Lvov
1456,1272,15,583,865,8,873,0,873,28,320,525,22.04.2019 00:15,117,11,Lvov
2304,2316,18,748,1542,14,1556,0,1556,35,437,1084,22.04.2019 00:30,117,11,Lvov
2256,2272,21,857,1383,16,1399,0,1399,50,427,922,22.04.2019 00:21,117,11,Lvov
1808,1797,10,627,1175,6,1181,0,1181,32,397,752,22.04.2019 00:20,117,11,Lvov
1104,1077,2,760,343,1,344,0,344,11,133,200,22.04.2019 01:05,117,11,Lvov
1504,1436,2,535,967,2,969,0,969,12,387,570,22.04.2019 00:10,117,11,Lvov
1328,1356,2,329,997,2,999,0,999,20,261,718,22.04.2019 00:15,117,11,Lvov
2400,2378,19,662,1719,19,1738,0,1738,39,373,1326,22.04.2019 00:05,118,11,Lvov
2176,2149,9,647,1520,9,1529,0,1529,44,308,1177,22.04.2019 00:02,118,11,Lvov
1968,1942,26,596,1347,25,1372,0,1372,52,253,1067,22.04.2019 00:40,118,11,Lvov
2160,2141,11,687,1463,10,1473,0,1473,49,253,1171,22.04.2019 00:14,118,11,Lvov
672,682,13,125,536,11,547,0,547,12,128,407,22.04.2019 00:05,118,11,Lvov
2512,2476,32,765,1715,32,1747,0,1747,43,357,1347,22.04.2019 00:03,118,11,Lvov
944,935,12,225,709,10,719,0,719,14,153,552,22.04.2019 01:30,118,11,Lvov
1904,1880,44,500,1360,44,1404,0,1404,37,300,1067,22.04.2019 00:20,118,11,Lvov
1584,1575,11,487,1087,10,1097,0,1097,18,230,849,22.04.2019 00:20,118,11,Lvov
1696,1685,25,531,1145,20,1165,0,1165,42,261,862,22.04.2019 00:12,118,11,Lvov
752,743,19,236,501,15,516,0,516,12,121,383,22.04.2019 00:20,118,11,Lvov
944,926,23,217,709,18,727,0,727,17,100,610,21.04.2019 23:20,118,11,Lvov
1136,1116,14,317,806,13,819,0,819,20,144,655,22.04.2019 00:32,118,11,Lvov
1744,1737,13,550,1181,13,1194,0,1194,26,259,909,22.04.2019 00:05,118,11,Lvov
2336,2324,36,630,1672,34,1706,0,1706,43,288,1375,22.04.2019 00:15,118,11,Lvov
1776,1750,12,605,1161,10,1171,0,1171,24,290,857,22.04.2019 00:25,118,11,Lvov
1840,1842,17,559,1267,14,1281,0,1281,35,292,954,22.04.2019 00:30,118,11,Lvov
1904,1919,20,708,1178,18,1196,0,1196,26,258,912,22.04.2019 00:18,118,11,Lvov
1760,1739,22,536,1203,21,1224,0,1224,26,268,930,22.04.2019 00:10,118,11,Lvov
1344,1334,10,341,993,10,1003,0,1003,14,222,767,22.04.2019 00:25,118,11,Lvov
1200,1193,32,311,858,31,889,0,889,13,201,675,22.04.2019 01:00,118,11,Lvov
752,744,34,157,561,34,595,0,595,17,160,418,22.04.2019 00:10,118,11,Lvov
384,378,19,93,272,19,291,0,291,6,70,215,22.04.2019 02:40,118,11,Lvov
1680,1648,69,458,1153,69,1222,0,1222,38,234,950,22.04.2019 00:25,118,11,Lvov
272,259,10,50,212,10,222,0,222,10,39,173,22.04.2019 00:45,118,11,Lvov
1120,1105,15,383,724,13,737,0,737,21,153,563,21.04.2019 22:00,118,11,Lvov
1600,1577,16,466,1120,14,1134,0,1134,22,246,866,22.04.2019 00:10,118,11,Lvov
1488,1474,44,391,1053,44,1097,0,1097,15,204,878,22.04.2019 00:10,118,11,Lvov
432,418,29,133,270,29,299,0,299,13,52,234,22.04.2019 00:05,118,11,Lvov
144,136,7,20,117,7,124,0,124,2,20,102,22.04.2019 00:15,118,11,Lvov
272,270,11,76,187,9,196,0,196,2,37,157,22.04.2019 00:05,118,11,Lvov
80,72,5,28,47,5,52,0,52,0,8,44,22.04.2019 00:10,118,11,Lvov
80,70,10,35,36,9,45,0,45,1,6,38,22.04.2019 00:10,118,11,Lvov
224,208,3,43,178,3,181,0,181,9,27,145,22.04.2019 00:10,118,11,Lvov
800,790,25,204,575,21,596,0,596,10,144,442,22.04.2019 00:30,118,11,Lvov
448,435,33,72,344,32,376,0,376,3,74,299,22.04.2019 00:02,118,11,Lvov
240,236,16,34,190,16,206,0,206,1,29,176,22.04.2019 00:15,118,11,Lvov
256,243,15,29,212,15,227,0,227,11,37,179,22.04.2019 00:01,118,11,Lvov
544,533,29,141,375,28,403,0,403,8,108,287,21.04.2019 20:58,118,11,Lvov
480,469,28,138,317,25,342,0,342,5,70,267,22.04.2019 00:27,118,11,Lvov
464,456,10,123,331,10,341,0,341,4,82,255,21.04.2019 22:15,118,11,Lvov
112,109,7,19,86,7,93,0,93,1,30,62,22.04.2019 00:05,118,11,Lvov
496,496,21,103,373,20,393,0,393,11,92,290,22.04.2019 00:40,118,11,Lvov
1712,1723,15,519,1181,12,1193,0,1193,21,270,902,22.04.2019 00:15,118,11,Lvov
2032,2024,34,568,1431,33,1464,0,1464,42,320,1102,22.04.2019 00:15,118,11,Lvov
1344,1296,1,438,905,1,906,0,906,43,330,533,22.04.2019 00:05,118,11,Lvov
928,923,21,153,755,20,775,0,775,19,281,475,22.04.2019 00:06,118,11,Lvov
464,457,24,175,267,22,289,0,289,3,68,218,22.04.2019 00:05,118,11,Lvov
336,323,25,84,227,25,252,0,252,6,36,210,22.04.2019 00:03,118,11,Lvov
208,193,20,38,151,19,170,0,170,7,9,154,22.04.2019 00:15,118,11,Lvov
240,228,9,67,164,9,173,0,173,4,28,141,22.04.2019 00:15,118,11,Lvov
128,123,8,24,96,8,104,0,104,3,8,93,22.04.2019 00:20,118,11,Lvov
144,134,8,23,113,8,121,0,121,1,18,102,22.04.2019 00:10,118,11,Lvov
112,106,7,17,89,6,95,0,95,2,25,68,22.04.2019 00:25,118,11,Lvov
576,577,10,88,478,10,488,0,488,29,53,406,22.04.2019 00:12,118,11,Lvov
432,416,19,55,358,19,377,0,377,11,47,319,22.04.2019 00:10,118,11,Lvov
1504,1478,31,321,1152,31,1183,0,1183,19,150,1014,22.04.2019 00:30,118,11,Lvov
1392,1383,18,273,1102,17,1119,0,1119,23,190,906,22.04.2019 00:15,118,11,Lvov
928,911,23,190,717,21,738,0,738,11,112,615,21.04.2019 21:10,118,11,Lvov
2064,2051,34,525,1505,34,1539,0,1539,159,200,1180,22.04.2019 00:15,118,11,Lvov
1920,1895,19,499,1403,18,1421,0,1421,44,273,1104,22.04.2019 00:20,118,11,Lvov
240,223,1,62,177,1,178,0,178,11,31,136,22.04.2019 00:10,118,11,Lvov
1248,1225,43,367,842,39,881,0,881,32,224,625,22.04.2019 00:15,118,11,Lvov
448,433,28,116,304,28,332,0,332,5,61,266,21.04.2019 21:45,118,11,Lvov
496,483,19,178,300,18,318,0,318,6,63,249,21.04.2019 21:56,118,11,Lvov
912,904,54,196,662,54,716,0,716,18,139,559,22.04.2019 00:05,118,11,Lvov
656,637,35,100,522,34,556,0,556,21,64,471,22.04.2019 00:02,118,11,Lvov
608,588,30,153,425,30,455,0,455,16,90,349,22.04.2019 00:05,118,11,Lvov
256,245,22,24,210,22,232,0,232,0,29,203,22.04.2019 00:03,118,11,Lvov
128,123,9,20,101,7,108,0,108,0,14,94,22.04.2019 00:10,118,11,Lvov
528,520,20,126,382,20,402,0,402,10,105,287,22.04.2019 00:07,118,11,Lvov
336,318,15,59,262,15,277,0,277,11,29,237,22.04.2019 00:15,118,11,Lvov
256,250,6,76,174,6,180,0,180,0,40,140,21.04.2019 21:05,118,11,Lvov
1968,1938,58,590,1320,58,1378,0,1378,60,271,1047,22.04.2019 00:30,118,11,Lvov
624,602,9,172,443,9,452,0,452,11,156,285,22.04.2019 00:15,118,11,Lvov
960,952,46,141,775,44,819,0,819,31,81,707,22.04.2019 00:15,118,11,Lvov
80,73,3,19,58,3,61,0,61,2,12,47,22.04.2019 00:05,118,11,Lvov
368,362,31,51,286,31,317,0,317,32,64,221,22.04.2019 00:02,118,11,Lvov
304,293,31,31,242,31,273,0,273,2,19,252,22.04.2019 00:10,118,11,Lvov
352,340,23,70,260,22,282,0,282,7,22,253,21.04.2019 23:55,118,11,Lvov
976,952,43,123,810,43,853,0,853,23,126,704,22.04.2019 00:15,118,11,Lvov
800,780,34,68,698,34,732,0,732,41,63,628,22.04.2019 00:40,118,11,Lvov
464,449,6,100,358,6,364,0,364,2,80,282,22.04.2019 02:20,118,11,Lvov
2016,1981,27,531,1459,26,1485,0,1485,35,310,1140,22.04.2019 00:21,118,11,Lvov
2336,2306,48,554,1737,45,1782,0,1782,69,321,1392,22.04.2019 00:05,118,11,Lvov
1568,1548,40,497,1033,38,1071,0,1071,16,226,829,22.04.2019 00:30,118,11,Lvov
288,275,10,76,202,10,212,0,212,2,31,179,22.04.2019 00:02,118,11,Lvov
1200,1180,33,385,787,28,815,0,815,17,165,633,22.04.2019 00:12,118,11,Lvov
2032,2011,12,659,1361,12,1373,0,1373,34,315,1024,22.04.2019 00:50,118,11,Lvov
1568,1548,8,507,1054,7,1061,0,1061,19,304,738,22.04.2019 00:35,118,11,Lvov
1248,1228,31,390,827,31,858,0,858,16,185,657,22.04.2019 01:20,118,11,Lvov
1696,1682,33,433,1230,33,1263,0,1263,23,218,1022,22.04.2019 00:55,118,11,Lvov
1120,1097,37,264,819,37,856,0,856,23,174,659,22.04.2019 00:15,118,11,Lvov
368,349,12,67,289,12,301,0,301,7,57,237,22.04.2019 00:20,118,11,Lvov
192,177,16,56,120,16,136,0,136,1,38,97,21.04.2019 23:50,118,11,Lvov
656,648,25,191,445,20,465,0,465,8,123,334,22.04.2019 00:15,118,11,Lvov
496,485,18,50,428,18,446,0,446,2,42,402,21.04.2019 22:00,118,11,Lvov
176,168,12,44,120,12,132,0,132,1,17,114,22.04.2019 01:00,118,11,Lvov
336,319,36,60,240,36,276,0,276,1,26,249,22.04.2019 01:15,118,11,Lvov
2160,2153,8,620,1535,5,1540,0,1540,40,371,1129,22.04.2019 00:20,118,11,Lvov
2128,2109,12,674,1442,12,1454,0,1454,28,329,1097,22.04.2019 04:30,118,11,Lvov
1344,1336,10,354,981,9,990,0,990,25,235,730,22.04.2019 00:20,118,11,Lvov
1680,1662,3,556,1121,3,1124,0,1123,39,244,840,22.04.2019 01:17,118,11,Lvov
2464,2453,15,698,1754,12,1766,0,1766,47,421,1298,22.04.2019 00:06,118,11,Lvov
2096,2070,6,698,1394,4,1398,0,1398,34,227,1137,22.04.2019 04:30,118,11,Lvov
2448,2422,7,805,1636,7,1643,0,1643,43,386,1214,22.04.2019 01:37,118,11,Lvov
1968,1970,14,639,1319,10,1329,0,1329,35,251,1043,22.04.2019 00:20,118,11,Lvov
2240,2248,14,763,1467,10,1477,0,1477,50,374,1053,21.04.2019 21:30,118,11,Lvov
1264,1239,0,455,809,0,809,0,809,21,326,462,22.04.2019 00:04,118,11,Lvov
2288,2274,97,767,1454,67,1521,0,1521,41,401,1079,22.04.2019 00:15,118,11,Lvov
2208,2192,1,742,1465,1,1466,0,1466,42,473,951,22.04.2019 00:22,118,11,Lvov
2128,2107,10,773,1348,7,1355,0,1355,49,455,851,22.04.2019 00:20,118,11,Lvov
2208,2214,12,774,1425,9,1434,0,1434,32,376,1026,22.04.2019 00:30,118,11,Lvov
2464,2469,10,936,1523,5,1528,0,1528,53,354,1121,22.04.2019 00:35,118,11,Lvov
2400,2391,11,887,1506,7,1513,0,1511,46,426,1039,22.04.2019 00:06,118,11,Lvov
1920,1979,14,681,1229,10,1239,0,1239,43,395,801,22.04.2019 00:10,118,11,Lvov
2064,2062,15,733,1322,9,1331,0,1331,43,417,871,22.04.2019 01:55,118,11,Lvov
2128,2136,43,778,1337,13,1350,0,1350,31,437,882,22.04.2019 00:15,118,11,Lvov
2160,2248,13,601,1548,11,1559,0,1559,36,470,1053,22.04.2019 00:22,118,11,Lvov
1632,1618,17,615,1005,12,1017,0,1017,31,336,650,22.04.2019 00:30,118,11,Lvov
1904,1893,17,741,1149,14,1163,0,1163,50,373,740,22.04.2019 00:20,118,11,Lvov
1296,1279,5,530,761,5,766,0,766,29,268,469,22.04.2019 00:20,118,11,Lvov
2032,1998,7,677,1349,6,1355,0,1355,37,324,994,22.04.2019 00:05,118,11,Lvov
2448,2478,16,719,1715,14,1729,0,1729,55,450,1224,22.04.2019 00:07,118,11,Lvov
2352,2350,17,672,1666,14,1680,0,1680,56,471,1153,22.04.2019 00:10,118,11,Lvov
2448,2442,15,734,1704,10,1714,0,1714,56,463,1195,22.04.2019 00:10,118,11,Lvov
2448,2448,11,738,1699,11,1710,0,1710,50,453,1207,22.04.2019 00:15,118,11,Lvov
2448,2456,10,716,1723,9,1732,0,1732,57,525,1150,22.04.2019 00:19,118,11,Lvov
2400,2414,12,733,1660,7,1667,0,1667,57,379,1231,22.04.2019 00:25,118,11,Lvov
2528,2565,16,756,1762,10,1772,0,1772,59,471,1242,22.04.2019 00:07,118,11,Lvov
2448,2435,4,959,1489,0,1489,0,1489,28,367,1094,22.04.2019 01:15,118,11,Lvov
2224,2224,5,817,1404,3,1407,0,1407,50,414,943,22.04.2019 00:07,118,11,Lvov
2256,2224,10,784,1463,9,1472,0,1472,40,408,1024,22.04.2019 00:28,118,11,Lvov
2176,2172,7,704,1467,5,1472,0,1472,38,433,1001,22.04.2019 00:35,118,11,Lvov
944,441,267,564,163,217,380,0,380,13,106,261,22.04.2019 00:10,118,11,Lvov
1120,674,10,453,657,10,667,0,667,47,533,87,22.04.2019 00:05,118,11,Lvov
1392,1377,32,377,983,32,1015,0,1015,20,162,833,22.04.2019 00:10,118,11,Lvov
1296,1285,34,243,1021,32,1053,0,1053,15,159,879,22.04.2019 00:32,118,11,Lvov
592,614,1,133,458,1,459,0,459,12,139,308,22.04.2019 00:20,118,11,Lvov
2256,2171,33,918,1306,32,1338,0,1338,24,561,753,22.04.2019 00:15,119,11,Lvov
1776,1742,33,726,1020,30,1050,0,1050,36,358,656,22.04.2019 00:08,119,11,Lvov
1520,1484,9,610,902,8,910,0,910,17,291,602,22.04.2019 01:10,119,11,Lvov
1728,1712,23,711,996,21,1017,0,1017,25,426,566,22.04.2019 00:15,119,11,Lvov
1984,1965,29,719,1241,24,1265,0,1265,26,427,812,22.04.2019 00:50,119,11,Lvov
2256,2242,19,890,1350,16,1366,0,1366,34,550,782,22.04.2019 00:10,119,11,Lvov
1872,1825,16,772,1086,14,1100,0,1100,33,393,674,22.04.2019 00:07,119,11,Lvov
2000,1957,19,747,1239,14,1253,0,1253,29,488,736,22.04.2019 00:25,119,11,Lvov
336,327,36,60,240,36,276,0,276,7,106,163,22.04.2019 00:50,119,11,Lvov
112,112,7,22,83,7,90,0,90,0,30,60,22.04.2019 01:30,119,11,Lvov
320,301,19,95,206,19,225,0,225,1,98,126,22.04.2019 00:17,119,11,Lvov
224,208,14,59,152,13,165,0,165,2,91,72,22.04.2019 00:10,119,11,Lvov
288,267,23,74,191,23,214,0,214,9,58,147,22.04.2019 01:10,119,11,Lvov
464,452,28,138,301,25,326,0,326,7,126,193,22.04.2019 00:13,119,11,Lvov
384,371,15,105,264,15,279,0,279,9,132,138,21.04.2019 23:53,119,11,Lvov
336,325,27,90,221,25,246,0,246,2,68,176,22.04.2019 00:07,119,11,Lvov
384,366,19,158,210,16,226,0,226,5,111,110,22.04.2019 00:10,119,11,Lvov
608,590,58,231,319,58,377,0,377,6,85,286,22.04.2019 00:40,119,11,Lvov
112,100,13,50,54,8,62,0,62,1,20,41,22.04.2019 00:25,119,11,Lvov
464,459,34,98,332,34,366,0,366,7,199,160,22.04.2019 00:40,119,11,Lvov
432,426,22,142,268,22,290,0,290,5,122,163,22.04.2019 01:50,119,11,Lvov
336,329,20,125,192,19,211,0,211,7,135,69,22.04.2019 00:30,119,11,Lvov
64,62,0,20,44,0,44,0,44,2,20,22,22.04.2019 00:35,119,11,Lvov
160,151,13,58,90,12,102,0,102,5,62,35,22.04.2019 00:25,119,11,Lvov
96,94,9,33,54,9,63,0,63,3,29,31,22.04.2019 00:25,119,11,Lvov
448,431,25,101,324,23,347,0,347,2,102,243,22.04.2019 00:17,119,11,Lvov
160,148,22,42,97,21,118,0,118,6,45,67,22.04.2019 00:10,119,11,Lvov
272,269,15,70,188,14,202,0,202,7,92,103,22.04.2019 00:10,119,11,Lvov
144,143,10,41,93,10,103,0,103,3,51,49,22.04.2019 00:15,119,11,Lvov
304,296,20,48,237,19,256,0,256,3,91,162,22.04.2019 00:10,119,11,Lvov
144,141,14,31,99,14,113,0,113,2,48,63,22.04.2019 00:37,119,11,Lvov
128,127,11,40,78,10,88,0,88,2,46,40,22.04.2019 00:10,119,11,Lvov
272,262,21,83,168,21,189,0,189,3,69,117,22.04.2019 00:17,119,11,Lvov
304,300,32,79,193,32,225,0,225,6,68,151,22.04.2019 01:35,119,11,Lvov
448,445,36,182,234,32,266,0,266,3,116,147,22.04.2019 05:30,119,11,Lvov
112,102,10,34,68,10,78,0,78,4,23,51,22.04.2019 00:15,119,11,Lvov
560,537,57,201,302,57,359,0,359,10,159,190,22.04.2019 00:12,119,11,Lvov
368,349,35,136,197,35,232,0,232,3,102,127,22.04.2019 00:17,119,11,Lvov
160,148,20,48,92,20,112,0,112,0,48,64,22.04.2019 00:20,119,11,Lvov
352,338,15,128,210,14,224,0,224,2,116,106,22.04.2019 00:11,119,11,Lvov
144,127,10,34,100,10,110,0,110,0,33,77,22.04.2019 00:55,119,11,Lvov
1152,1138,73,315,768,69,837,0,837,11,370,456,22.04.2019 03:45,119,11,Lvov
192,187,18,68,106,18,124,0,124,0,34,90,22.04.2019 00:05,119,11,Lvov
368,352,17,99,254,15,269,0,269,9,139,121,22.04.2019 00:45,119,11,Lvov
208,196,14,48,146,14,160,0,160,4,61,95,21.04.2019 22:14,119,11,Lvov
480,463,22,150,308,22,330,0,330,4,171,155,22.04.2019 00:20,119,11,Lvov
624,601,62,199,363,62,425,0,425,13,176,236,22.04.2019 00:30,119,11,Lvov
192,177,8,65,119,8,127,0,127,2,62,63,22.04.2019 00:30,119,11,Lvov
384,375,42,117,226,41,267,0,267,7,110,150,22.04.2019 00:20,119,11,Lvov
304,285,33,85,186,33,219,0,219,3,96,120,22.04.2019 00:30,119,11,Lvov
128,117,14,27,89,12,101,0,101,0,31,70,22.04.2019 00:15,119,11,Lvov
128,118,8,47,74,7,81,0,81,1,34,46,22.04.2019 00:35,119,11,Lvov
576,562,22,143,411,22,433,0,433,8,180,245,22.04.2019 00:09,119,11,Lvov
352,349,9,117,226,9,235,0,235,4,69,162,22.04.2019 00:20,119,11,Lvov
224,217,14,72,139,13,152,0,152,2,40,110,22.04.2019 00:20,119,11,Lvov
96,101,6,24,66,6,72,0,72,1,30,41,22.04.2019 00:37,119,11,Lvov
864,855,42,173,650,41,691,0,691,21,330,340,22.04.2019 00:25,119,11,Lvov
96,83,5,51,40,5,45,0,45,1,19,25,22.04.2019 00:10,119,11,Lvov
336,325,18,110,208,18,226,0,226,6,89,131,22.04.2019 00:15,119,11,Lvov
416,400,23,126,267,23,290,0,290,1,115,174,22.04.2019 00:22,119,11,Lvov
224,223,35,63,126,35,161,0,161,2,56,103,22.04.2019 00:40,119,11,Lvov
224,214,19,71,136,17,153,0,153,8,63,82,22.04.2019 00:27,119,11,Lvov
288,277,11,74,203,11,214,0,214,0,52,162,22.04.2019 00:02,119,11,Lvov
208,206,3,63,142,3,145,0,145,5,74,66,22.04.2019 00:15,119,11,Lvov
864,838,72,329,469,66,535,0,535,9,204,322,22.04.2019 00:10,119,11,Lvov
384,376,47,109,229,46,275,0,275,2,123,150,22.04.2019 00:20,119,11,Lvov
576,572,53,157,367,52,419,0,419,4,187,228,22.04.2019 00:15,119,11,Lvov
224,49,24,187,14,23,37,0,37,1,13,23,22.04.2019 00:15,119,11,Lvov
1088,1069,40,318,730,40,770,0,770,25,233,512,22.04.2019 01:10,119,11,Lvov
272,268,22,57,193,22,215,0,215,4,80,131,22.04.2019 00:05,119,11,Lvov
544,527,33,98,413,33,446,0,446,21,108,317,22.04.2019 00:05,119,11,Lvov
288,273,16,107,165,16,181,0,181,5,71,105,22.04.2019 00:10,119,11,Lvov
224,219,16,56,154,14,168,0,168,3,74,91,22.04.2019 00:20,119,11,Lvov
336,321,24,106,209,21,230,0,230,6,90,134,22.04.2019 01:55,119,11,Lvov
512,504,29,154,329,29,358,0,358,12,149,197,22.04.2019 00:20,119,11,Lvov
240,234,7,54,179,7,186,0,186,2,79,105,22.04.2019 01:40,119,11,Lvov
208,207,1,79,129,0,129,0,129,10,54,65,22.04.2019 00:04,119,11,Lvov
336,339,20,75,242,19,261,0,261,4,70,187,22.04.2019 00:04,119,11,Lvov
400,387,6,75,319,6,325,0,325,6,115,204,22.04.2019 00:02,119,11,Lvov
304,294,33,98,173,33,206,0,206,3,52,151,22.04.2019 00:15,119,11,Lvov
128,118,7,47,74,7,81,0,81,3,30,48,22.04.2019 00:15,119,11,Lvov
176,166,5,59,112,5,117,0,117,2,72,43,22.04.2019 00:10,119,11,Lvov
640,626,22,138,480,22,502,0,502,13,155,334,22.04.2019 00:05,119,11,Lvov
384,366,22,129,235,20,255,0,255,4,83,168,21.04.2019 21:10,119,11,Lvov
496,485,29,116,351,29,380,0,380,3,76,301,22.04.2019 00:43,119,11,Lvov
384,369,12,80,292,12,304,0,304,0,108,196,21.04.2019 22:00,119,11,Lvov
320,315,33,85,203,32,235,0,235,2,63,170,22.04.2019 00:15,119,11,Lvov
160,160,16,45,102,13,115,0,115,1,36,78,22.04.2019 00:10,119,11,Lvov
1616,1580,65,549,1006,61,1067,0,1067,23,493,551,22.04.2019 00:30,119,11,Lvov
176,165,12,45,119,12,131,0,131,1,56,74,22.04.2019 00:23,119,11,Lvov
1104,1089,52,364,693,47,740,0,740,41,291,408,22.04.2019 01:00,119,11,Lvov
224,219,27,71,131,22,153,0,153,2,47,104,22.04.2019 00:06,119,11,Lvov
128,127,11,39,78,11,89,0,89,1,35,53,22.04.2019 00:15,119,11,Lvov
320,324,25,98,200,22,222,0,222,14,56,152,22.04.2019 00:20,119,11,Lvov
576,566,62,146,374,56,430,0,430,9,149,272,22.04.2019 02:00,119,11,Lvov
496,484,39,182,277,37,314,0,314,6,114,194,21.04.2019 22:10,119,11,Lvov
592,595,19,193,380,19,399,0,399,9,174,216,22.04.2019 00:20,119,11,Lvov
1120,1101,98,395,632,93,725,0,725,20,331,374,22.04.2019 00:05,119,11,Lvov
256,241,23,54,179,23,202,0,202,0,99,103,22.04.2019 00:20,119,11,Lvov
400,392,64,113,226,61,287,0,287,4,121,162,22.04.2019 00:30,119,11,Lvov
432,423,50,48,337,47,384,0,384,6,177,201,22.04.2019 00:35,119,11,Lvov
640,625,13,254,373,13,386,0,386,11,173,202,22.04.2019 00:30,119,11,Lvov
464,451,24,146,298,20,318,0,318,6,152,160,21.04.2019 20:45,119,11,Lvov
192,180,7,88,98,6,104,0,104,3,36,65,21.04.2019 21:00,119,11,Lvov
272,50,38,224,12,36,48,0,48,0,20,28,22.04.2019 00:23,119,11,Lvov
2080,2084,19,753,1314,13,1327,0,1327,41,434,852,22.04.2019 00:30,119,11,Lvov
352,340,25,136,191,25,216,0,216,4,78,134,22.04.2019 01:00,119,11,Lvov
2208,2190,43,714,1453,41,1494,0,1494,27,423,1044,22.04.2019 00:26,119,11,Lvov
528,523,28,178,322,28,350,0,350,13,132,205,22.04.2019 00:15,119,11,Lvov
944,930,61,287,598,59,657,0,657,19,154,484,22.04.2019 06:30,119,11,Lvov
544,526,32,144,369,31,400,0,400,11,122,267,22.04.2019 00:12,119,11,Lvov
560,533,21,184,355,21,376,0,376,14,115,247,22.04.2019 00:20,119,11,Lvov
272,260,26,68,180,24,204,0,204,6,63,135,22.04.2019 00:47,119,11,Lvov
272,264,15,78,180,14,194,0,194,2,69,123,21.04.2019 21:20,119,11,Lvov
48,39,2,21,25,2,27,0,27,2,8,17,21.04.2019 22:00,119,11,Lvov
240,221,5,46,189,5,194,0,194,1,42,151,22.04.2019 00:30,119,11,Lvov
192,178,21,43,132,17,149,0,149,3,51,95,21.04.2019 23:50,119,11,Lvov
416,400,24,104,288,24,312,0,312,0,130,182,21.04.2019 23:30,119,11,Lvov
928,902,51,343,535,50,585,0,585,10,183,392,21.04.2019 23:12,119,11,Lvov
192,178,6,61,125,6,131,0,131,0,37,94,22.04.2019 00:25,119,11,Lvov
192,180,12,65,115,12,127,0,127,2,28,97,22.04.2019 00:15,119,11,Lvov
608,592,30,167,412,29,441,0,441,44,81,316,22.04.2019 00:15,119,11,Lvov
208,204,17,28,165,15,180,0,180,2,31,147,22.04.2019 00:20,119,11,Lvov
496,494,22,156,318,22,340,0,340,6,124,210,22.04.2019 00:05,119,11,Lvov
160,155,5,35,120,5,125,35,125,5,34,86,22.04.2019 00:10,119,11,Lvov
1104,1093,29,329,746,29,775,0,775,7,211,557,22.04.2019 00:35,119,11,Lvov
464,451,26,117,321,26,347,0,347,4,99,244,22.04.2019 00:43,119,11,Lvov
128,112,13,44,71,13,84,0,84,5,37,42,22.04.2019 01:10,119,11,Lvov
688,671,39,144,507,37,544,0,544,2,75,467,22.04.2019 00:15,119,11,Lvov
1536,1543,53,494,995,47,1042,0,1042,28,316,698,22.04.2019 02:10,119,11,Lvov
416,410,9,119,289,8,297,0,297,7,84,206,22.04.2019 00:09,119,11,Lvov
288,279,12,89,188,11,199,0,199,10,59,130,22.04.2019 00:16,119,11,Lvov
416,409,14,82,320,14,334,0,334,7,60,267,22.04.2019 01:13,119,11,Lvov
176,164,6,51,120,5,125,0,125,0,27,98,22.04.2019 00:07,119,11,Lvov
768,750,38,229,502,37,539,0,539,8,148,383,22.04.2019 00:10,119,11,Lvov
304,286,15,111,178,15,193,0,193,4,50,139,22.04.2019 01:00,119,11,Lvov
176,163,6,43,127,6,133,0,133,1,42,90,22.04.2019 00:15,119,11,Lvov
96,94,4,19,73,4,77,0,77,0,46,31,22.04.2019 00:15,119,11,Lvov
240,226,16,73,153,14,167,0,167,3,44,120,22.04.2019 00:07,119,11,Lvov
192,80,40,115,38,39,77,0,77,2,29,46,22.04.2019 00:30,119,11,Lvov
2432,2394,67,840,1529,63,1592,0,1592,59,953,580,22.04.2019 01:25,119,11,Lvov
256,237,19,101,138,17,155,0,155,2,62,91,22.04.2019 00:45,119,11,Lvov
704,680,66,173,467,64,531,0,531,15,299,217,21.04.2019 22:15,119,11,Lvov
400,386,20,102,280,18,298,0,298,8,101,189,22.04.2019 00:20,119,11,Lvov
608,597,18,230,363,15,378,0,378,7,148,223,22.04.2019 00:35,119,11,Lvov
240,224,8,66,166,8,174,0,174,1,129,44,22.04.2019 00:59,119,11,Lvov
144,133,5,58,81,5,86,0,86,2,45,39,22.04.2019 00:50,119,11,Lvov
160,145,9,38,113,9,122,0,122,0,57,65,21.04.2019 23:30,119,11,Lvov
1216,1195,47,385,786,45,831,0,831,11,319,501,22.04.2019 00:51,119,11,Lvov
368,354,13,90,266,12,278,0,278,4,115,159,22.04.2019 00:42,119,11,Lvov
512,502,30,121,361,30,391,0,391,9,145,237,22.04.2019 00:40,119,11,Lvov
240,227,8,87,145,8,153,0,153,0,73,80,22.04.2019 00:25,119,11,Lvov
992,971,53,250,689,53,742,0,742,14,311,417,22.04.2019 00:56,119,11,Lvov
240,236,20,70,151,19,170,0,170,2,72,96,22.04.2019 00:20,119,11,Lvov
320,307,19,79,225,16,241,0,241,5,106,130,22.04.2019 01:00,119,11,Lvov
512,508,29,150,333,29,362,0,362,8,237,117,22.04.2019 01:05,119,11,Lvov
400,396,29,66,305,29,334,0,334,4,128,202,22.04.2019 00:40,119,11,Lvov
160,161,6,27,127,6,133,0,133,2,47,84,22.04.2019 00:15,119,11,Lvov
496,497,53,95,355,46,401,0,401,14,157,230,22.04.2019 01:28,119,11,Lvov
256,240,19,106,133,17,150,0,150,4,77,69,22.04.2019 00:15,119,11,Lvov
912,905,67,100,746,66,812,0,812,5,384,423,22.04.2019 00:40,119,11,Lvov
496,484,37,170,292,34,326,0,326,7,126,193,22.04.2019 00:07,119,11,Lvov
704,694,77,144,487,73,560,0,560,14,218,328,22.04.2019 04:44,119,11,Lvov
192,179,13,50,130,12,142,0,142,2,47,93,22.04.2019 01:15,119,11,Lvov
848,842,55,206,587,55,642,0,642,6,238,398,21.04.2019 22:05,119,11,Lvov
256,248,24,66,166,24,190,0,190,0,38,152,21.04.2019 23:00,119,11,Lvov
272,270,22,50,201,21,222,0,222,5,70,147,21.04.2019 21:10,119,11,Lvov
1312,1291,30,513,771,28,799,0,799,30,318,451,22.04.2019 00:20,119,11,Lvov
480,459,16,200,265,15,280,0,280,4,130,146,21.04.2019 22:35,119,11,Lvov
688,671,45,189,454,45,499,0,499,14,149,336,22.04.2019 01:27,119,11,Lvov
592,584,22,237,336,19,355,0,355,5,169,181,22.04.2019 00:35,119,11,Lvov
432,420,27,89,318,25,343,0,343,5,120,218,22.04.2019 00:42,119,11,Lvov
240,228,25,57,160,23,183,0,183,2,74,107,22.04.2019 00:50,119,11,Lvov
400,384,16,78,306,16,322,0,322,9,130,183,21.04.2019 22:10,119,11,Lvov
368,361,28,85,257,26,283,0,283,3,107,173,21.04.2019 21:10,119,11,Lvov
592,581,57,205,333,54,387,0,387,9,197,181,21.04.2019 23:35,119,11,Lvov
336,316,21,131,187,18,205,0,205,6,84,115,22.04.2019 00:07,119,11,Lvov
368,355,27,111,233,24,257,0,257,1,121,135,22.04.2019 00:15,119,11,Lvov
96,86,2,39,56,1,57,0,57,0,22,35,22.04.2019 00:20,119,11,Lvov
304,290,21,65,222,17,239,0,239,10,115,114,22.04.2019 01:05,119,11,Lvov
416,413,36,107,278,31,309,0,309,3,92,214,22.04.2019 00:15,119,11,Lvov
816,792,38,239,540,37,577,0,577,9,239,329,22.04.2019 00:15,119,11,Lvov
256,248,20,69,167,20,187,0,187,2,60,125,21.04.2019 22:17,119,11,Lvov
176,172,20,60,99,17,116,0,116,4,59,53,22.04.2019 00:40,119,11,Lvov
512,504,43,129,344,39,383,0,383,11,190,182,22.04.2019 00:04,119,11,Lvov
64,32,6,38,20,6,26,0,26,0,11,15,21.04.2019 20:50,119,11,Lvov
240,224,18,81,143,16,159,0,159,1,49,109,21.04.2019 21:00,120,11,Lvov
816,801,37,232,547,37,584,0,584,16,148,420,21.04.2019 23:00,120,11,Lvov
1040,1035,33,219,790,31,821,0,821,19,205,597,22.04.2019 03:40,120,11,Lvov
688,675,31,164,493,31,524,0,524,13,143,368,22.04.2019 00:15,120,11,Lvov
240,230,27,50,163,27,190,0,190,3,26,161,22.04.2019 00:01,120,11,Lvov
1040,1024,41,323,678,39,717,0,717,23,187,507,22.04.2019 02:54,120,11,Lvov
1216,1213,25,484,713,19,732,0,732,20,179,533,22.04.2019 00:40,120,11,Lvov
1120,1115,8,363,751,6,757,0,757,20,273,464,22.04.2019 00:30,120,11,Lvov
1376,1360,9,516,851,9,860,0,860,14,278,568,22.04.2019 00:03,120,11,Lvov
1040,1024,11,399,630,11,641,0,641,19,227,395,22.04.2019 00:30,120,11,Lvov
576,558,29,122,426,28,454,0,454,13,54,387,21.04.2019 21:10,120,11,Lvov
624,619,24,189,411,24,435,0,435,6,86,343,21.04.2019 22:00,120,11,Lvov
128,131,11,26,91,11,102,0,102,1,18,83,21.04.2019 21:10,120,11,Lvov
1904,1878,12,628,1268,8,1276,0,1276,22,265,989,22.04.2019 03:50,120,11,Lvov
1600,1580,19,570,1014,16,1030,0,1030,21,230,779,22.04.2019 00:20,120,11,Lvov
1968,1956,17,666,1288,14,1302,0,1302,31,379,892,22.04.2019 00:07,120,11,Lvov
1616,1588,16,555,1050,11,1061,0,1061,20,312,729,21.04.2019 23:50,120,11,Lvov
1904,1881,15,637,1256,11,1267,0,1267,38,332,897,22.04.2019 00:50,120,11,Lvov
432,421,2,147,283,2,285,0,285,8,102,175,22.04.2019 00:12,120,11,Lvov
2432,2374,17,1054,1361,17,1378,0,1378,32,493,853,22.04.2019 01:15,120,11,Lvov
1088,1072,35,272,782,34,816,0,816,12,134,670,21.04.2019 23:30,120,11,Lvov
928,906,76,260,599,69,668,0,668,11,210,447,22.04.2019 00:15,120,11,Lvov
736,722,43,194,501,41,542,0,542,11,115,416,22.04.2019 00:11,120,11,Lvov
512,508,26,110,376,26,402,0,402,2,69,331,22.04.2019 00:30,120,11,Lvov
640,632,20,219,404,17,421,0,421,14,78,329,22.04.2019 01:20,120,11,Lvov
880,873,53,247,583,50,633,0,633,14,122,497,21.04.2019 22:10,120,11,Lvov
1328,1326,65,359,905,64,969,0,969,11,196,762,22.04.2019 00:20,120,11,Lvov
752,743,34,174,544,34,578,0,578,11,167,400,22.04.2019 00:05,120,11,Lvov
368,364,34,100,234,34,268,0,268,6,42,220,22.04.2019 00:15,120,11,Lvov
240,235,22,71,149,20,169,0,169,7,35,127,22.04.2019 00:05,120,11,Lvov
240,231,20,47,173,20,193,0,193,4,71,118,22.04.2019 00:05,120,11,Lvov
1008,1005,68,302,645,61,706,0,706,13,186,507,22.04.2019 00:10,120,11,Lvov
304,308,24,115,167,22,189,0,189,5,41,143,21.04.2019 21:30,120,11,Lvov
1600,1573,20,554,1028,18,1046,0,1046,28,258,760,21.04.2019 23:45,120,11,Lvov
1424,1404,24,562,838,24,862,0,862,41,228,593,21.04.2019 22:15,120,11,Lvov
480,465,40,119,325,36,361,0,361,7,106,248,21.04.2019 22:10,120,11,Lvov
240,227,13,59,168,13,181,0,181,12,33,136,22.04.2019 00:05,120,11,Lvov
288,271,22,64,202,22,224,0,224,3,103,118,22.04.2019 00:10,120,11,Lvov
272,259,24,64,184,24,208,0,208,1,57,150,21.04.2019 22:00,120,11,Lvov
288,275,17,50,222,16,238,0,238,8,64,166,22.04.2019 00:05,120,11,Lvov
368,366,13,168,187,13,200,0,200,4,57,139,22.04.2019 00:40,120,11,Lvov
352,342,26,80,247,25,272,0,272,1,42,229,22.04.2019 01:10,120,11,Lvov
192,189,12,44,136,12,148,0,148,1,50,97,22.04.2019 00:05,120,11,Lvov
352,353,37,24,291,37,328,0,328,2,58,268,22.04.2019 00:10,120,11,Lvov
192,185,23,34,138,20,158,0,158,4,40,114,22.04.2019 00:30,120,11,Lvov
2288,2265,49,570,1675,43,1718,0,1718,55,259,1404,22.04.2019 00:50,120,11,Lvov
656,650,62,135,464,57,521,0,521,9,91,421,22.04.2019 00:30,120,11,Lvov
736,731,57,273,411,52,463,0,463,10,144,309,22.04.2019 00:50,120,11,Lvov
848,839,29,260,559,29,588,0,588,11,185,392,22.04.2019 00:20,120,11,Lvov
576,560,50,172,355,49,404,0,404,10,167,227,22.04.2019 01:00,120,11,Lvov
176,171,16,28,132,16,148,0,148,9,20,119,22.04.2019 00:15,120,11,Lvov
864,856,28,224,612,28,640,0,640,2,199,439,22.04.2019 00:20,120,11,Lvov
432,427,7,113,312,7,319,0,319,0,85,234,21.04.2019 21:30,120,11,Lvov
304,294,9,119,176,9,185,0,185,2,31,152,21.04.2019 21:00,120,11,Lvov
400,381,32,125,244,31,275,0,275,9,82,184,21.04.2019 21:20,120,11,Lvov
1472,1452,73,464,936,72,1008,0,1008,20,266,722,21.04.2019 23:30,120,11,Lvov
128,120,6,41,81,6,87,0,87,0,15,72,22.04.2019 00:10,120,11,Lvov
208,198,7,28,174,6,180,0,180,7,38,135,22.04.2019 00:10,120,11,Lvov
1712,1702,9,469,1239,4,1243,0,1243,26,253,964,21.04.2019 22:30,120,11,Lvov
1776,1759,15,594,1170,12,1182,0,1182,38,254,890,22.04.2019 00:35,120,11,Lvov
336,336,38,141,161,34,195,0,195,9,41,145,22.04.2019 02:00,120,11,Lvov
416,414,23,91,304,21,325,0,325,5,68,252,22.04.2019 02:00,120,11,Lvov
320,321,63,88,174,58,232,0,232,12,52,168,21.04.2019 21:30,120,11,Lvov
816,800,46,202,572,42,614,0,614,14,187,413,22.04.2019 00:40,120,11,Lvov
416,410,34,96,290,30,320,0,320,18,82,220,22.04.2019 00:05,120,11,Lvov
448,442,19,118,313,17,330,0,330,11,64,255,21.04.2019 21:30,120,11,Lvov
976,956,11,297,668,11,679,0,679,15,161,503,21.04.2019 22:15,120,11,Lvov
224,207,12,70,142,12,154,0,154,1,25,128,22.04.2019 00:40,120,11,Lvov
320,322,30,110,183,27,210,0,210,3,53,154,21.04.2019 21:08,120,11,Lvov
224,32,20,193,11,20,31,0,31,1,11,19,21.04.2019 21:00,120,11,Lvov
1872,1872,14,753,1108,11,1119,0,1119,30,537,552,22.04.2019 00:42,120,11,Lvov
1280,1269,5,543,732,5,737,0,737,13,366,358,21.04.2019 21:50,120,11,Lvov
992,969,5,505,483,4,487,0,487,12,281,194,22.04.2019 00:45,120,11,Lvov
1280,1263,3,590,688,2,690,0,690,22,373,295,21.04.2019 20:30,120,11,Lvov
1952,1928,12,761,1179,12,1191,0,1191,38,496,657,22.04.2019 06:00,120,11,Lvov
1216,1204,11,436,769,11,780,0,780,15,259,506,21.04.2019 21:50,120,11,Lvov
1344,1327,23,586,739,19,758,0,758,39,280,439,22.04.2019 01:10,120,11,Lvov
768,760,28,309,431,28,459,0,459,14,180,265,22.04.2019 06:00,120,11,Lvov
1024,1008,81,410,539,75,614,0,614,22,229,363,21.04.2019 22:05,120,11,Lvov
256,251,24,77,155,24,179,0,179,3,48,128,21.04.2019 21:00,120,11,Lvov
96,89,4,22,70,4,74,0,74,1,31,42,22.04.2019 00:15,120,11,Lvov
720,710,52,258,415,47,462,0,462,22,180,260,21.04.2019 21:00,120,11,Lvov
496,487,39,127,332,37,369,0,369,12,100,257,21.04.2019 21:40,120,11,Lvov
784,768,23,324,438,22,460,0,460,13,188,259,21.04.2019 22:10,120,11,Lvov
816,812,26,257,535,24,559,0,559,19,258,282,22.04.2019 00:15,120,11,Lvov
448,438,21,99,328,21,349,0,349,10,122,217,22.04.2019 00:15,120,11,Lvov
512,494,37,170,308,34,342,0,342,3,160,179,21.04.2019 23:05,120,11,Lvov
160,149,16,70,74,16,90,0,90,1,31,58,21.04.2019 22:00,120,11,Lvov
336,328,39,121,178,37,215,0,215,4,77,134,22.04.2019 00:50,120,11,Lvov
224,221,25,55,149,20,169,0,169,6,51,112,22.04.2019 00:10,120,11,Lvov
432,421,33,86,314,32,346,0,346,6,76,264,21.04.2019 22:15,120,11,Lvov
480,466,11,154,315,11,326,0,326,8,104,214,22.04.2019 00:45,120,11,Lvov
368,356,11,92,265,11,276,0,276,2,121,153,22.04.2019 00:10,120,11,Lvov
1296,1283,61,526,713,57,770,0,770,26,255,489,22.04.2019 00:25,120,11,Lvov
592,587,28,276,292,24,316,0,316,7,87,222,22.04.2019 00:25,120,11,Lvov
912,898,20,362,536,14,550,0,550,6,206,338,22.04.2019 00:30,120,11,Lvov
528,514,40,225,267,36,303,0,303,8,149,146,22.04.2019 00:05,120,11,Lvov
240,220,22,99,119,22,141,0,141,0,69,72,22.04.2019 01:10,120,11,Lvov
240,235,17,59,164,17,181,0,181,2,54,125,21.04.2019 22:45,120,11,Lvov
80,65,7,36,37,7,44,0,44,3,5,36,22.04.2019 00:05,120,11,Lvov
368,357,24,122,222,24,246,0,246,3,83,160,22.04.2019 00:05,120,11,Lvov
400,400,28,122,250,28,278,0,278,3,109,166,21.04.2019 22:00,120,11,Lvov
64,49,6,35,23,6,29,0,29,2,16,11,21.04.2019 23:00,120,11,Lvov
112,110,7,37,68,7,75,0,75,0,47,28,22.04.2019 00:15,120,11,Lvov
544,520,15,222,308,14,322,0,322,5,186,131,21.04.2019 21:37,120,11,Lvov
224,214,10,50,164,10,174,0,174,4,72,98,22.04.2019 00:50,120,11,Lvov
400,397,10,175,217,8,225,0,225,7,141,77,22.04.2019 00:10,120,11,Lvov
736,729,36,229,472,35,507,0,507,8,303,196,22.04.2019 03:15,120,11,Lvov
192,183,9,55,128,9,137,0,137,7,65,65,22.04.2019 00:15,120,11,Lvov
224,219,8,26,190,8,198,0,198,4,165,29,22.04.2019 00:32,120,11,Lvov
464,455,21,167,276,21,297,0,297,12,133,152,22.04.2019 02:00,120,11,Lvov
384,373,1,179,204,1,205,0,205,1,177,27,22.04.2019 01:40,120,11,Lvov
928,933,44,285,600,43,643,0,643,13,320,310,21.04.2019 21:15,120,11,Lvov
464,445,19,131,314,19,333,0,333,3,206,124,22.04.2019 00:45,120,11,Lvov
448,437,8,101,340,7,347,0,347,6,143,198,21.04.2019 20:43,120,11,Lvov
224,212,22,76,126,22,148,0,148,1,40,107,22.04.2019 00:30,120,11,Lvov
400,379,30,189,183,28,211,0,211,3,31,177,22.04.2019 00:10,120,11,Lvov
608,600,49,201,360,47,407,0,407,3,102,302,22.04.2019 00:10,120,11,Lvov
160,144,16,48,96,16,112,0,112,4,29,79,21.04.2019 21:30,120,11,Lvov
144,137,10,60,74,10,84,0,84,0,45,39,21.04.2019 21:45,120,11,Lvov
752,728,8,310,437,5,442,0,442,17,226,199,21.04.2019 21:02,120,11,Lvov
336,333,34,80,227,29,256,0,256,8,81,167,22.04.2019 00:20,120,11,Lvov
128,116,18,36,76,16,92,0,92,4,28,60,22.04.2019 00:05,120,11,Lvov
848,828,21,343,485,20,505,0,505,8,337,160,21.04.2019 21:35,120,11,Lvov
576,565,25,241,310,25,335,0,335,7,127,201,21.04.2019 23:00,120,11,Lvov
464,444,50,187,230,47,277,0,277,14,95,168,22.04.2019 00:05,120,11,Lvov
144,144,8,50,88,6,94,0,94,1,54,39,22.04.2019 00:15,120,11,Lvov
208,214,11,57,140,11,151,0,151,3,71,77,22.04.2019 00:40,120,11,Lvov
928,906,78,370,483,75,558,0,558,15,228,315,22.04.2019 00:30,120,11,Lvov
224,207,10,114,101,9,110,0,110,2,24,84,21.04.2019 21:00,120,11,Lvov
576,563,55,276,251,49,300,0,300,9,99,192,22.04.2019 00:10,120,11,Lvov
128,116,6,66,56,6,62,0,62,0,18,44,22.04.2019 00:07,120,11,Lvov
192,177,17,45,130,17,147,0,147,2,28,117,21.04.2019 23:00,120,11,Lvov
256,245,13,93,150,13,163,0,163,6,56,101,21.04.2019 23:35,120,11,Lvov
208,201,19,77,116,15,131,0,131,1,49,81,21.04.2019 23:10,120,11,Lvov
512,492,29,123,360,29,389,0,389,6,205,178,21.04.2019 22:20,120,11,Lvov
480,470,35,151,294,35,329,0,329,11,86,232,21.04.2019 22:30,120,11,Lvov
160,159,21,43,96,21,117,0,117,5,36,76,22.04.2019 00:25,120,11,Lvov
448,445,16,143,290,15,305,0,305,5,159,141,21.04.2019 21:20,120,11,Lvov
304,285,24,98,182,24,206,0,206,4,113,89,21.04.2019 22:50,120,11,Lvov
176,174,15,46,115,15,130,0,130,1,58,71,21.04.2019 22:20,120,11,Lvov
192,181,8,56,128,8,136,0,136,2,41,93,21.04.2019 22:40,120,11,Lvov
160,147,9,52,100,8,108,0,108,3,43,62,22.04.2019 00:05,120,11,Lvov
256,247,34,66,158,32,190,0,190,4,54,132,21.04.2019 21:00,120,11,Lvov
208,194,22,92,95,21,116,0,116,3,40,73,21.04.2019 22:00,120,11,Lvov
736,716,32,211,496,29,525,0,525,13,191,321,22.04.2019 00:30,120,11,Lvov
800,777,28,207,568,25,593,0,593,15,283,295,22.04.2019 00:30,120,11,Lvov
112,111,16,43,55,14,69,0,69,1,28,40,22.04.2019 00:45,120,11,Lvov
240,21,3,226,13,1,14,0,14,0,7,7,21.04.2019 22:00,120,11,Lvov
1216,1189,46,351,820,45,865,0,865,29,422,414,22.04.2019 00:20,120,11,Lvov
608,591,31,165,413,30,443,0,443,20,206,217,21.04.2019 21:30,120,11,Lvov
1968,1973,66,741,1162,65,1227,0,1227,34,692,501,22.04.2019 01:30,120,11,Lvov
352,341,16,143,193,16,209,0,209,4,120,85,21.04.2019 21:20,120,11,Lvov
240,234,14,25,202,13,215,0,215,2,91,122,22.04.2019 03:30,120,11,Lvov
176,160,16,65,95,16,111,0,111,3,45,63,22.04.2019 00:10,120,11,Lvov
336,330,33,84,221,31,252,0,252,1,126,125,21.04.2019 21:40,120,11,Lvov
160,153,7,23,130,7,137,0,137,8,46,83,21.04.2019 21:05,120,11,Lvov
112,102,2,18,92,2,94,0,94,5,32,57,21.04.2019 21:15,120,11,Lvov
672,650,38,202,432,38,470,0,470,0,191,279,21.04.2019 23:55,120,11,Lvov
384,372,42,82,260,42,302,0,302,27,132,143,22.04.2019 00:10,120,11,Lvov
1312,1287,66,542,706,64,770,0,770,19,405,346,22.04.2019 00:30,120,11,Lvov
912,909,52,245,615,52,667,0,667,7,301,359,22.04.2019 00:10,120,11,Lvov
336,317,25,75,238,23,261,0,261,7,114,140,22.04.2019 00:15,120,11,Lvov
800,782,55,268,479,53,532,0,532,13,176,343,22.04.2019 00:30,120,11,Lvov
496,482,37,78,381,37,418,0,418,9,149,260,22.04.2019 01:10,120,11,Lvov
656,636,40,150,466,40,506,0,506,10,201,295,22.04.2019 00:10,120,11,Lvov
208,195,13,47,149,12,161,0,161,6,43,112,22.04.2019 00:30,120,11,Lvov
400,389,6,72,323,5,328,0,328,1,117,210,22.04.2019 00:30,120,11,Lvov
224,207,15,44,165,15,180,0,180,0,69,111,22.04.2019 00:05,120,11,Lvov
2112,2098,107,766,1252,94,1346,0,1346,32,630,684,22.04.2019 01:45,120,11,Lvov
640,625,88,141,417,82,499,0,499,4,144,351,21.04.2019 21:30,120,11,Lvov
384,374,13,106,266,12,278,0,278,8,76,194,21.04.2019 21:50,120,11,Lvov
416,437,31,27,358,31,389,0,389,3,184,202,22.04.2019 00:30,120,11,Lvov
1104,1093,76,252,776,76,852,0,852,10,163,679,21.04.2019 22:17,120,11,Lvov
400,396,24,48,328,24,352,0,352,14,48,290,22.04.2019 00:09,120,11,Lvov
336,332,7,110,220,6,226,0,226,5,99,122,22.04.2019 00:15,120,11,Lvov
224,218,13,90,121,13,134,0,134,3,61,70,21.04.2019 21:00,120,11,Lvov
656,647,41,210,406,40,446,0,446,9,130,307,22.04.2019 00:05,120,11,Lvov
208,203,30,46,134,28,162,0,162,5,41,116,22.04.2019 00:20,120,11,Lvov
256,241,17,68,173,15,188,0,188,3,95,90,21.04.2019 23:00,120,11,Lvov
1136,1125,71,394,674,68,742,0,742,18,268,456,22.04.2019 00:10,120,11,Lvov
240,226,16,47,177,16,193,0,193,0,40,153,21.04.2019 21:10,120,11,Lvov
304,286,21,122,162,20,182,0,182,4,70,108,21.04.2019 21:00,120,11,Lvov
192,186,8,40,144,8,152,0,152,0,77,75,21.04.2019 21:30,120,11,Lvov
128,122,5,31,92,5,97,0,97,3,22,72,21.04.2019 20:30,120,11,Lvov
144,133,14,63,67,14,81,0,81,0,27,54,22.04.2019 00:20,120,11,Lvov
144,133,7,36,101,7,108,0,108,0,43,65,22.04.2019 00:20,120,11,Lvov
624,605,32,187,406,31,437,0,437,5,96,336,22.04.2019 00:45,120,11,Lvov
736,720,27,290,423,23,446,0,446,8,145,293,21.04.2019 21:25,120,11,Lvov
512,502,22,86,404,22,426,0,426,9,165,252,22.04.2019 00:20,120,11,Lvov
320,306,7,102,211,7,218,0,218,2,69,147,21.04.2019 21:40,120,11,Lvov
448,435,22,124,302,22,324,0,324,8,97,219,22.04.2019 00:45,120,11,Lvov
592,587,31,107,455,30,485,0,485,8,189,288,22.04.2019 01:25,120,11,Lvov
192,174,19,51,124,17,141,0,141,0,44,97,22.04.2019 00:30,120,11,Lvov
176,158,12,46,118,12,130,0,130,1,60,69,21.04.2019 21:30,120,11,Lvov
240,236,19,92,132,16,148,0,148,8,78,62,21.04.2019 21:20,120,11,Lvov
256,239,25,82,153,21,174,0,174,2,49,123,21.04.2019 22:00,120,11,Lvov
96,87,4,42,52,2,54,0,54,4,21,29,22.04.2019 00:15,120,11,Lvov
128,123,7,38,83,7,90,0,90,3,36,51,21.04.2019 21:00,120,11,Lvov
304,290,19,37,248,19,267,0,267,2,130,135,21.04.2019 21:00,120,11,Lvov
368,356,25,48,296,24,320,0,320,2,87,231,22.04.2019 00:55,120,11,Lvov
320,316,33,40,247,33,280,0,280,2,78,200,22.04.2019 00:48,120,11,Lvov
2496,2423,10,1000,1489,7,1496,0,1496,55,671,770,22.04.2019 00:25,120,11,Lvov
912,903,12,255,645,12,657,0,657,10,173,474,22.04.2019 00:45,120,11,Lvov
1136,1104,44,366,728,42,770,0,770,30,237,503,21.04.2019 22:00,120,11,Lvov
480,465,35,109,339,32,371,0,371,7,235,129,21.04.2019 21:10,120,11,Lvov
384,369,16,147,225,12,237,0,237,8,124,105,21.04.2019 21:00,120,11,Lvov
480,485,35,181,265,34,299,0,299,6,146,147,21.04.2019 21:00,120,11,Lvov
1584,1553,45,647,892,45,937,0,937,24,448,465,22.04.2019 00:50,120,11,Lvov
96,91,4,26,67,3,70,0,70,1,33,36,22.04.2019 00:02,120,11,Lvov
1120,1104,49,362,711,47,758,0,758,17,241,500,22.04.2019 00:45,120,11,Lvov
336,331,3,125,208,3,211,0,211,7,88,116,21.04.2019 21:21,120,11,Lvov
864,845,36,246,585,33,618,0,618,25,272,321,22.04.2019 00:10,120,11,Lvov
800,787,17,346,437,17,454,0,454,21,226,207,22.04.2019 00:05,120,11,Lvov
1328,1321,28,455,847,26,873,0,873,29,362,482,22.04.2019 01:45,120,11,Lvov
272,271,20,47,206,19,225,0,225,43,35,147,21.04.2019 20:30,120,11,Lvov
1344,1315,31,608,708,28,736,0,736,35,280,421,21.04.2019 22:00,120,11,Lvov
1264,1250,22,485,759,20,779,0,779,28,267,484,21.04.2019 21:52,120,11,Lvov
1120,1105,29,445,651,24,675,0,674,28,255,391,22.04.2019 04:10,120,11,Lvov
304,296,27,93,184,27,211,0,211,6,60,145,21.04.2019 21:30,120,11,Lvov
528,520,19,134,375,19,394,0,394,1,196,197,21.04.2019 20:45,120,11,Lvov
416,398,10,100,306,10,316,0,316,3,71,242,22.04.2019 00:10,120,11,Lvov
192,173,9,50,134,8,142,0,142,13,23,106,22.04.2019 00:04,120,11,Lvov
528,522,30,186,314,28,342,0,342,5,136,201,21.04.2019 21:23,120,11,Lvov
448,430,23,189,239,20,259,0,259,6,144,109,22.04.2019 00:10,120,11,Lvov
1152,1137,99,481,584,87,671,0,671,15,310,346,21.04.2019 21:00,120,11,Lvov
272,264,10,80,182,10,192,0,192,2,94,96,22.04.2019 00:10,120,11,Lvov
1200,1189,80,446,678,76,754,0,754,17,388,349,21.04.2019 21:30,120,11,Lvov
128,32,7,100,23,5,28,0,28,1,10,17,22.04.2019 00:20,120,11,Lvov
304,303,9,91,204,9,213,0,213,6,57,150,22.04.2019 00:05,121,11,Lvov
208,201,13,72,123,13,136,0,136,1,37,98,22.04.2019 00:10,121,11,Lvov
1264,1245,64,328,872,64,936,0,936,18,267,651,22.04.2019 00:03,121,11,Lvov
672,661,48,237,388,47,435,0,435,11,200,224,22.04.2019 00:45,121,11,Lvov
272,240,8,159,105,8,113,0,113,1,46,66,22.04.2019 01:10,121,11,Lvov
896,885,36,263,597,36,633,0,633,11,254,368,22.04.2019 00:20,121,11,Lvov
272,271,12,102,158,12,170,0,170,5,56,109,22.04.2019 01:25,121,11,Lvov
1072,1052,89,299,686,87,773,0,773,6,290,477,22.04.2019 00:15,121,11,Lvov
592,584,52,184,358,50,408,0,408,20,175,213,22.04.2019 00:55,121,11,Lvov
832,812,57,300,475,57,532,0,532,13,222,297,22.04.2019 00:15,121,11,Lvov
592,586,24,227,341,24,365,0,365,8,159,198,22.04.2019 00:10,121,11,Lvov
848,831,26,220,602,26,628,0,628,18,119,491,22.04.2019 00:30,121,11,Lvov
720,707,33,215,472,33,505,0,505,9,220,276,22.04.2019 00:40,121,11,Lvov
112,112,10,30,72,10,82,0,82,1,20,61,22.04.2019 00:10,121,11,Lvov
1296,1280,31,452,813,31,844,0,844,17,259,568,22.04.2019 00:02,121,11,Lvov
1296,1274,26,420,851,25,876,0,876,17,312,547,22.04.2019 00:02,121,11,Lvov
896,876,39,255,602,39,641,0,641,13,157,471,22.04.2019 00:35,121,11,Lvov
1120,1097,21,404,697,19,716,0,716,19,286,411,22.04.2019 00:30,121,11,Lvov
720,656,27,334,359,27,386,0,386,6,136,244,22.04.2019 00:10,121,11,Lvov
512,509,27,164,322,26,348,0,348,6,180,162,22.04.2019 01:01,121,11,Lvov
304,297,9,117,179,8,187,0,187,10,72,105,21.04.2019 23:50,121,11,Lvov
128,107,6,31,91,6,97,0,97,0,30,67,22.04.2019 00:20,121,11,Lvov
896,847,36,313,548,35,583,0,583,14,275,294,22.04.2019 00:30,121,11,Lvov
608,593,26,166,417,25,442,0,442,5,153,284,22.04.2019 00:30,121,11,Lvov
1664,1645,67,578,1020,66,1086,0,1086,30,315,741,22.04.2019 00:10,121,11,Lvov
80,67,1,22,57,1,58,0,58,0,20,38,22.04.2019 00:05,121,11,Lvov
624,602,35,107,482,35,517,0,517,26,164,327,22.04.2019 00:15,121,11,Lvov
1936,1906,15,715,1206,15,1221,0,1221,30,423,768,22.04.2019 00:30,121,11,Lvov
336,312,13,164,159,13,172,0,172,2,75,95,22.04.2019 02:30,121,11,Lvov
576,558,19,219,338,19,357,0,357,14,128,215,22.04.2019 00:10,121,11,Lvov
720,705,13,240,467,13,480,0,480,13,150,317,22.04.2019 00:45,121,11,Lvov
1040,1023,22,390,628,22,650,0,650,13,266,371,22.04.2019 00:10,121,11,Lvov
272,266,23,74,175,23,198,0,198,7,67,124,22.04.2019 00:45,121,11,Lvov
224,216,9,88,127,9,136,0,136,3,60,73,22.04.2019 00:45,121,11,Lvov
1136,1084,72,494,573,69,642,0,642,16,308,318,22.04.2019 05:03,121,11,Lvov
384,374,12,108,264,12,276,0,276,11,69,196,22.04.2019 00:15,121,11,Lvov
1392,1345,72,533,789,70,859,0,859,21,414,424,22.04.2019 01:05,121,11,Lvov
112,105,3,37,72,3,75,0,75,1,48,26,22.04.2019 00:10,121,11,Lvov
1488,1399,29,551,908,29,937,0,937,19,373,545,22.04.2019 01:15,121,11,Lvov
144,138,3,22,119,3,122,0,122,0,44,78,22.04.2019 00:08,121,11,Lvov
1856,1837,47,753,1057,46,1103,0,1103,26,479,598,22.04.2019 00:10,121,11,Lvov
768,745,18,291,459,18,477,0,477,11,128,338,22.04.2019 00:40,121,11,Lvov
544,517,25,229,291,24,315,0,315,4,159,152,22.04.2019 00:30,121,11,Lvov
1664,1644,31,633,1000,31,1031,0,1031,25,346,660,22.04.2019 00:11,121,11,Lvov
1040,1049,29,390,621,29,650,0,650,16,286,348,22.04.2019 00:30,121,11,Lvov
656,651,40,219,397,40,437,0,437,12,152,273,22.04.2019 00:10,121,11,Lvov
112,113,9,46,57,9,66,0,66,0,25,41,22.04.2019 00:05,121,11,Lvov
352,330,28,108,216,28,244,0,244,1,137,106,22.04.2019 00:10,121,11,Lvov
736,724,30,234,472,30,502,0,502,10,215,277,22.04.2019 00:25,121,11,Lvov
608,592,18,240,350,18,368,0,368,15,170,183,22.04.2019 00:05,121,11,Lvov
992,981,35,281,676,35,711,0,711,24,276,411,22.04.2019 00:05,121,11,Lvov
736,716,37,269,430,37,467,0,467,6,196,265,22.04.2019 00:50,121,11,Lvov
528,531,23,122,384,22,406,0,406,27,89,290,22.04.2019 00:05,121,11,Lvov
1488,1442,13,641,834,13,847,0,847,21,258,568,22.04.2019 02:30,121,11,Lvov
352,351,29,115,208,29,237,0,237,2,98,137,22.04.2019 00:05,121,11,Lvov
336,331,24,77,235,24,259,0,259,2,109,148,22.04.2019 00:10,121,11,Lvov
1264,1238,41,434,790,40,830,0,830,14,260,556,22.04.2019 00:15,121,11,Lvov
1536,1511,44,551,941,44,985,0,985,21,340,624,22.04.2019 00:50,121,11,Lvov
928,902,26,282,620,26,646,0,646,5,204,437,22.04.2019 00:45,121,11,Lvov
832,810,42,232,558,42,600,0,600,14,218,368,22.04.2019 00:30,121,11,Lvov
1056,1033,52,309,695,52,747,0,747,21,234,492,21.04.2019 23:05,121,11,Lvov
688,679,27,227,434,27,461,0,461,5,119,337,22.04.2019 00:10,121,11,Lvov
192,188,11,37,144,11,155,0,155,0,26,129,22.04.2019 00:50,121,11,Lvov
688,681,46,163,479,46,525,0,525,17,131,377,22.04.2019 00:10,121,11,Lvov
480,463,20,158,304,18,322,0,322,7,120,195,22.04.2019 00:40,121,11,Lvov
112,103,0,37,75,0,75,0,75,0,23,52,22.04.2019 00:05,121,11,Lvov
976,965,13,390,577,9,586,0,586,25,173,388,22.04.2019 00:25,121,11,Lvov
1040,1026,16,377,651,12,663,0,663,11,195,457,22.04.2019 00:10,121,11,Lvov
1248,1229,13,529,706,13,719,0,719,23,213,483,22.04.2019 00:25,121,11,Lvov
1248,1242,27,398,823,27,850,0,850,57,222,571,22.04.2019 00:25,121,11,Lvov
976,959,72,266,638,72,710,0,710,7,165,538,22.04.2019 01:45,121,11,Lvov
880,863,21,299,561,20,581,0,580,10,194,376,22.04.2019 00:10,121,11,Lvov
144,138,1,63,80,1,81,0,81,1,33,47,22.04.2019 00:10,121,11,Lvov
512,505,25,123,364,25,389,0,389,12,145,232,22.04.2019 00:05,121,11,Lvov
640,635,5,271,364,5,369,0,369,16,151,202,22.04.2019 00:10,121,11,Lvov
816,793,12,375,433,8,441,0,441,19,195,227,22.04.2019 00:15,121,11,Lvov
1280,1265,17,594,674,12,686,0,686,32,322,332,22.04.2019 00:30,121,11,Lvov
1680,1667,10,744,926,10,936,0,936,43,423,470,22.04.2019 00:30,121,11,Lvov
1504,1489,12,641,851,12,863,0,863,34,362,467,22.04.2019 01:22,121,11,Lvov
2176,2151,10,943,1223,10,1233,0,1233,56,567,610,22.04.2019 02:00,121,11,Lvov
1936,1907,24,833,1081,22,1103,0,1103,41,478,584,22.04.2019 00:30,121,11,Lvov
1264,1238,7,550,708,6,714,0,714,32,323,359,21.04.2019 22:00,121,11,Lvov
928,932,6,396,526,6,532,0,532,21,250,261,22.04.2019 00:01,121,11,Lvov
1600,1587,5,779,816,5,821,0,821,31,379,411,22.04.2019 00:15,121,11,Lvov
1616,1606,33,695,893,28,921,0,921,38,411,472,22.04.2019 02:00,121,11,Lvov
2096,2094,26,841,1234,21,1255,0,1255,60,483,712,22.04.2019 01:10,121,11,Lvov
848,831,20,377,451,20,471,0,471,18,213,240,22.04.2019 00:10,121,11,Lvov
928,909,15,384,529,15,544,0,544,24,255,265,22.04.2019 00:05,121,11,Lvov
768,770,12,328,430,10,440,0,440,17,196,227,22.04.2019 00:30,121,11,Lvov
1040,1014,12,418,610,12,622,0,622,25,263,334,22.04.2019 00:30,121,11,Lvov
1264,1246,12,539,719,6,725,0,725,26,332,367,22.04.2019 00:35,121,11,Lvov
768,756,9,316,444,8,452,0,452,20,184,248,22.04.2019 00:45,121,11,Lvov
1216,1202,11,534,673,9,682,0,682,32,333,317,22.04.2019 01:00,121,11,Lvov
544,538,5,236,304,4,308,0,308,12,159,137,22.04.2019 00:40,121,11,Lvov
528,535,8,211,309,8,317,0,317,14,176,127,22.04.2019 00:15,121,11,Lvov
768,756,13,327,430,11,441,0,441,15,192,234,22.04.2019 00:25,121,11,Lvov
656,739,14,142,500,14,514,0,514,15,242,257,22.04.2019 00:05,121,11,Lvov
1520,1640,26,421,1073,26,1099,0,1099,20,513,566,22.04.2019 00:05,121,11,Lvov
1568,1550,13,693,866,9,875,0,875,30,314,531,22.04.2019 02:00,121,11,Lvov
1584,1556,19,625,943,16,959,0,959,27,331,601,22.04.2019 00:27,121,11,Lvov
2288,2253,28,885,1381,22,1403,0,1403,48,539,816,22.04.2019 02:50,121,11,Lvov
2080,2061,14,877,1194,9,1203,0,1203,44,457,702,22.04.2019 00:05,121,11,Lvov
1328,1310,7,567,756,5,761,0,761,18,254,489,22.04.2019 00:20,121,11,Lvov
2304,2301,12,924,1372,8,1380,0,1380,37,469,874,22.04.2019 00:30,121,11,Lvov
2336,2292,10,1097,1230,9,1239,0,1239,39,452,748,22.04.2019 00:30,121,11,Lvov
2064,2037,26,848,1197,19,1216,0,1216,51,473,692,22.04.2019 00:57,121,11,Lvov
1920,1900,26,749,1152,19,1171,0,1171,43,442,686,22.04.2019 00:03,121,11,Lvov
2352,2335,23,964,1369,19,1388,0,1388,43,516,829,22.04.2019 00:05,121,11,Lvov
2352,2318,38,926,1400,26,1426,0,1426,52,534,840,22.04.2019 00:25,121,11,Lvov
2368,2354,24,863,1486,19,1505,0,1505,86,460,959,22.04.2019 00:30,121,11,Lvov
2432,2414,20,818,1598,16,1614,0,1614,55,614,945,22.04.2019 01:05,121,11,Lvov
2160,2155,20,802,1340,18,1358,0,1358,46,415,897,22.04.2019 00:15,121,11,Lvov
2192,2158,15,847,1334,11,1345,0,1345,59,466,820,22.04.2019 00:15,121,11,Lvov
2240,2211,11,907,1323,10,1333,0,1333,51,456,826,22.04.2019 02:05,121,11,Lvov
2384,2361,33,938,1421,25,1446,0,1446,46,511,889,22.04.2019 04:00,121,11,Lvov
2336,2310,32,962,1351,23,1374,0,1374,58,457,859,22.04.2019 00:10,121,11,Lvov
2448,2473,31,868,1555,25,1580,0,1580,64,600,916,22.04.2019 00:15,121,11,Lvov
2416,2400,23,1072,1328,16,1344,0,1344,44,505,795,22.04.2019 01:10,121,11,Lvov
2336,2319,22,888,1432,16,1448,0,1448,64,628,756,22.04.2019 00:20,121,11,Lvov
2352,2347,20,971,1363,18,1381,0,1381,50,563,768,22.04.2019 00:37,121,11,Lvov
2400,2350,29,929,1446,25,1471,0,1471,47,524,900,22.04.2019 00:36,121,11,Lvov
1376,1363,13,485,879,12,891,0,891,33,318,540,22.04.2019 00:20,121,11,Lvov
1152,1139,33,372,748,32,780,0,780,22,298,460,22.04.2019 00:15,121,11,Lvov
1312,1289,6,582,725,5,730,0,730,23,292,415,22.04.2019 00:14,121,11,Lvov
1456,1434,11,725,723,8,731,0,731,20,325,386,22.04.2019 00:10,121,11,Lvov
1312,1294,12,553,751,8,759,0,759,24,255,480,22.04.2019 00:30,121,11,Lvov
1888,1857,15,765,1111,12,1123,0,1123,31,456,636,22.04.2019 00:30,121,11,Lvov
1392,1372,16,660,719,13,732,0,732,20,295,417,22.04.2019 02:20,121,11,Lvov
1840,1831,17,782,1044,14,1058,0,1058,30,427,601,22.04.2019 00:32,121,11,Lvov
2096,2065,20,895,1183,18,1201,0,1201,36,490,675,22.04.2019 00:46,121,11,Lvov
336,52,40,289,12,35,47,0,47,2,16,29,22.04.2019 00:10,121,11,Lvov
512,478,0,45,467,0,467,0,467,44,299,124,22.04.2019 00:10,121,11,Lvov
2192,2202,18,838,1343,11,1354,0,1354,49,482,823,22.04.2019 00:20,121,11,Lvov
2080,2083,16,777,1289,14,1303,0,1303,35,458,810,22.04.2019 02:38,121,11,Lvov
1504,1529,12,517,978,9,987,0,987,27,393,567,22.04.2019 00:30,121,11,Lvov
1776,1919,18,381,1382,13,1395,0,1395,31,682,682,21.04.2019 22:05,121,11,Lvov
2368,2401,16,888,1469,11,1480,0,1480,40,608,832,22.04.2019 00:20,121,11,Lvov
2064,2077,23,837,1213,14,1227,0,1227,40,455,732,22.04.2019 01:32,121,11,Lvov
2304,2319,24,866,1416,22,1438,0,1438,37,539,862,22.04.2019 00:10,121,11,Lvov
2208,2207,31,893,1293,22,1315,0,1315,31,546,738,22.04.2019 01:30,121,11,Lvov
1136,1088,115,415,606,115,721,0,721,19,250,452,22.04.2019 00:35,121,11,Lvov
2032,1483,0,772,1260,0,1260,0,1260,64,555,641,21.04.2019 21:59,122,11,Lvov
1104,1056,13,431,662,11,673,0,673,7,429,237,21.04.2019 23:25,122,11,Lvov
544,521,7,223,315,6,321,0,321,13,198,110,22.04.2019 00:50,122,11,Lvov
736,713,6,289,441,6,447,0,447,15,292,140,22.04.2019 02:10,122,11,Lvov
1008,985,46,306,657,45,702,0,702,5,274,423,22.04.2019 00:10,122,11,Lvov
464,453,15,171,278,15,293,0,293,6,126,161,21.04.2019 22:10,122,11,Lvov
1600,1575,56,537,1009,54,1063,0,1063,19,502,542,22.04.2019 00:50,122,11,Lvov
1712,1679,79,693,945,74,1019,0,1019,20,475,524,21.04.2019 22:00,122,11,Lvov
320,306,33,115,178,27,205,0,205,4,98,103,22.04.2019 00:15,122,11,Lvov
128,123,7,25,96,7,103,0,103,4,57,42,22.04.2019 00:05,122,11,Lvov
1872,1836,48,858,979,35,1014,0,1014,19,680,315,22.04.2019 00:55,122,11,Lvov
240,236,10,74,156,10,166,0,166,0,99,67,22.04.2019 00:06,122,11,Lvov
2000,1967,19,724,1259,17,1276,0,1276,44,744,488,22.04.2019 00:35,122,11,Lvov
2080,2043,22,775,1290,15,1305,0,1305,43,704,558,22.04.2019 00:15,122,11,Lvov
2016,1981,24,711,1286,19,1305,0,1305,36,741,528,22.04.2019 00:20,122,11,Lvov
480,470,47,134,304,42,346,0,346,9,170,167,22.04.2019 00:05,122,11,Lvov
288,277,28,72,188,28,216,0,216,2,117,97,21.04.2019 21:45,122,11,Lvov
320,305,23,97,207,16,223,0,223,6,162,55,22.04.2019 00:07,122,11,Lvov
304,291,28,80,200,24,224,0,224,4,138,82,21.04.2019 20:35,122,11,Lvov
624,602,37,184,403,37,440,0,440,7,168,265,21.04.2019 22:20,122,11,Lvov
192,182,22,43,127,22,149,0,149,3,54,92,21.04.2019 22:10,122,11,Lvov
1104,1092,42,370,697,37,734,0,734,16,311,407,22.04.2019 00:32,122,11,Lvov
320,311,28,92,202,26,228,0,228,4,104,120,21.04.2019 22:30,122,11,Lvov
688,673,60,206,425,57,482,0,482,8,174,300,21.04.2019 22:10,122,11,Lvov
464,459,36,132,303,29,332,0,332,9,122,201,21.04.2019 23:50,122,11,Lvov
1136,1122,19,553,566,17,583,0,583,10,249,324,22.04.2019 00:10,122,11,Lvov
1312,1297,38,389,886,37,923,0,923,14,320,589,22.04.2019 00:45,122,11,Lvov
592,580,42,210,344,38,382,0,382,12,100,270,22.04.2019 00:10,122,11,Lvov
704,692,49,253,405,46,451,0,451,22,251,178,22.04.2019 00:05,122,11,Lvov
448,445,13,93,342,13,355,0,355,5,221,129,22.04.2019 00:31,122,11,Lvov
432,419,44,112,279,41,320,0,320,6,98,216,22.04.2019 00:10,122,11,Lvov
448,445,42,133,273,42,315,0,315,3,123,189,22.04.2019 00:05,122,11,Lvov
448,436,44,152,255,41,296,0,296,5,123,168,21.04.2019 22:15,122,11,Lvov
784,767,22,172,590,22,612,0,612,2,156,454,22.04.2019 00:50,122,11,Lvov
848,832,22,289,539,20,559,0,559,7,214,338,22.04.2019 00:10,122,11,Lvov
448,431,7,176,266,6,272,0,272,5,76,191,22.04.2019 00:40,122,11,Lvov
992,974,30,350,612,30,642,0,642,7,188,447,22.04.2019 00:07,122,11,Lvov
1728,1709,70,497,1162,69,1231,0,1231,18,471,742,22.04.2019 00:10,122,11,Lvov
576,558,22,221,335,20,355,0,355,8,114,233,22.04.2019 01:30,122,11,Lvov
1664,1626,45,676,946,42,988,0,988,16,362,610,21.04.2019 21:45,122,11,Lvov
416,412,27,145,249,22,271,145,271,8,115,148,22.04.2019 00:05,122,11,Lvov
640,631,35,214,395,31,426,0,426,10,132,284,22.04.2019 00:05,122,11,Lvov
1280,1257,21,423,837,20,857,0,857,19,314,524,22.04.2019 02:15,122,11,Lvov
816,824,27,245,545,26,571,0,571,1,192,378,22.04.2019 06:10,122,11,Lvov
336,324,19,105,212,19,231,0,231,7,67,157,21.04.2019 20:46,122,11,Lvov
1440,1410,15,472,953,15,968,0,968,20,275,673,21.04.2019 21:30,122,11,Lvov
2208,2222,16,716,1480,12,1492,0,1492,43,518,931,21.04.2019 23:13,122,11,Lvov
2192,2160,28,715,1455,22,1477,0,1477,47,532,898,22.04.2019 01:23,122,11,Lvov
2496,2498,21,795,1684,17,1701,0,1701,43,603,1055,22.04.2019 01:12,122,11,Lvov
1792,1761,18,631,1145,16,1161,0,1161,44,387,730,22.04.2019 01:00,122,11,Lvov
1040,1029,40,344,657,39,696,0,696,25,204,467,22.04.2019 06:15,122,11,Lvov
368,364,35,62,271,35,306,0,306,8,70,228,22.04.2019 03:30,122,11,Lvov
816,798,52,108,656,52,708,0,708,10,168,530,22.04.2019 00:20,122,11,Lvov
848,826,20,222,608,18,626,0,626,12,162,452,22.04.2019 00:17,122,11,Lvov
736,717,30,261,450,25,475,0,475,15,123,337,22.04.2019 00:50,122,11,Lvov
736,718,14,287,435,14,449,0,449,9,167,273,22.04.2019 00:07,122,11,Lvov
720,718,48,157,520,43,563,0,563,14,192,357,22.04.2019 01:30,122,11,Lvov
160,158,5,25,130,5,135,0,135,4,41,90,22.04.2019 01:08,122,11,Lvov
528,517,18,152,359,17,376,0,376,5,84,287,22.04.2019 05:10,122,11,Lvov
1168,1152,43,372,754,42,796,0,796,18,173,605,22.04.2019 00:20,122,11,Lvov
208,196,4,62,143,3,146,0,146,2,27,117,22.04.2019 00:20,122,11,Lvov
960,938,6,387,567,6,573,0,573,11,171,391,22.04.2019 00:15,122,11,Lvov
144,142,1,27,116,1,117,0,117,3,45,69,22.04.2019 00:02,122,11,Lvov
336,320,18,55,263,18,281,0,281,6,103,172,22.04.2019 05:45,122,11,Lvov
624,620,36,79,509,36,545,0,545,38,41,466,22.04.2019 06:18,122,11,Lvov
512,503,30,109,375,28,403,0,403,7,56,340,22.04.2019 00:20,122,11,Lvov
368,354,13,118,237,13,250,0,250,2,102,146,21.04.2019 23:00,122,11,Lvov
464,461,16,111,337,16,353,0,353,8,153,192,21.04.2019 22:15,122,11,Lvov
336,323,18,91,227,18,245,0,245,7,60,178,21.04.2019 22:00,122,11,Lvov
928,922,15,326,588,14,602,0,602,21,129,452,22.04.2019 00:50,122,11,Lvov
1280,1265,20,419,842,19,861,0,861,20,146,695,22.04.2019 00:05,122,11,Lvov
496,488,18,190,289,17,306,0,306,7,59,240,22.04.2019 00:20,122,11,Lvov
1360,1336,35,429,896,35,931,0,931,24,206,701,21.04.2019 20:33,122,11,Lvov
2160,2130,17,646,1501,13,1514,0,1514,36,348,1130,22.04.2019 00:02,122,11,Lvov
784,743,0,561,223,0,223,0,223,1,127,95,21.04.2019 21:35,122,11,Lvov
1376,1364,15,385,976,15,991,0,991,23,232,736,22.04.2019 00:15,122,11,Lvov
288,268,6,79,203,6,209,0,209,2,32,175,22.04.2019 03:55,122,11,Lvov
1152,1128,18,359,775,18,793,0,793,21,176,596,22.04.2019 00:06,122,11,Lvov
1424,1413,8,500,919,5,924,0,924,43,404,477,22.04.2019 00:30,122,11,Lvov
1488,1477,7,536,945,7,952,0,952,47,348,557,22.04.2019 00:23,122,11,Lvov
1760,1083,8,677,1077,6,1083,0,1083,36,419,628,22.04.2019 00:15,122,11,Lvov
1504,1480,12,520,973,11,984,0,984,28,320,636,22.04.2019 00:15,122,11,Lvov
1184,1159,3,488,695,1,696,0,696,16,292,388,22.04.2019 01:00,122,11,Lvov
1744,1438,1,985,758,1,759,0,759,28,398,333,22.04.2019 02:07,122,11,Lvov
2096,2061,5,871,1221,4,1225,0,1225,37,436,752,22.04.2019 01:20,122,11,Lvov
2112,2072,3,866,1244,2,1246,0,1246,37,487,722,22.04.2019 00:30,122,11,Lvov
2016,1987,7,840,1169,7,1176,0,1176,49,435,692,22.04.2019 00:54,122,11,Lvov
1024,1009,4,385,635,4,639,0,639,17,190,432,22.04.2019 02:00,122,11,Lvov
1120,1098,6,435,679,6,685,0,685,22,232,431,22.04.2019 00:40,122,11,Lvov
1952,1945,1,689,1262,1,1263,0,1263,25,464,774,22.04.2019 00:50,122,11,Lvov
1344,1322,2,466,877,1,878,0,878,22,351,505,22.04.2019 02:20,122,11,Lvov
1744,1743,14,474,1257,13,1270,0,1270,43,397,830,22.04.2019 00:05,122,11,Lvov
1632,1619,16,482,1136,14,1150,0,1150,29,444,677,22.04.2019 00:30,122,11,Lvov
1248,1233,7,431,813,4,817,0,817,30,263,524,22.04.2019 00:36,122,11,Lvov
304,295,10,69,225,10,235,0,235,6,56,173,22.04.2019 00:04,122,11,Lvov
448,468,24,116,308,24,332,0,332,8,109,215,22.04.2019 01:25,122,11,Lvov
384,374,18,127,240,17,257,0,257,5,135,117,22.04.2019 02:00,122,11,Lvov
1584,1688,58,603,934,47,981,0,981,28,552,401,22.04.2019 00:20,122,11,Lvov
544,520,23,227,294,23,317,0,317,6,159,152,22.04.2019 00:20,122,11,Lvov
384,385,26,81,277,26,303,0,303,8,154,141,22.04.2019 00:47,122,11,Lvov
2496,2470,9,808,1679,9,1688,0,1688,56,669,963,22.04.2019 01:50,122,11,Lvov
1248,1219,7,432,809,7,816,0,816,28,293,495,22.04.2019 00:03,122,11,Lvov
672,655,3,225,444,3,447,0,447,15,180,252,22.04.2019 00:40,122,11,Lvov
288,284,2,107,179,2,181,0,181,3,77,101,22.04.2019 03:30,122,11,Lvov
544,538,26,117,401,26,427,0,427,2,141,284,22.04.2019 03:10,122,11,Lvov
560,540,29,193,339,28,367,0,367,4,114,249,22.04.2019 00:30,122,11,Lvov
528,514,31,101,396,31,427,0,427,6,96,325,22.04.2019 00:09,122,11,Lvov
2016,1993,23,472,1522,22,1544,0,1544,36,369,1139,22.04.2019 01:30,122,11,Lvov
272,263,15,58,200,14,214,0,214,1,59,154,22.04.2019 00:45,122,11,Lvov
576,553,56,188,337,51,388,0,388,7,146,235,22.04.2019 00:50,122,11,Lvov
128,117,18,36,76,16,92,1,92,1,34,57,22.04.2019 00:08,122,11,Lvov
400,387,21,97,283,20,303,0,303,3,35,265,22.04.2019 00:30,122,11,Lvov
304,294,9,52,244,8,252,0,252,3,34,215,22.04.2019 00:30,122,11,Lvov
1024,1097,15,242,768,14,782,0,782,22,361,399,22.04.2019 00:10,122,11,Lvov
528,527,16,197,315,16,331,0,331,11,193,127,22.04.2019 00:05,122,11,Lvov
1024,1007,25,232,767,25,792,0,792,22,264,506,22.04.2019 00:20,122,11,Lvov
880,869,25,247,608,25,633,0,633,16,153,464,22.04.2019 00:05,122,11,Lvov
176,163,4,49,124,3,127,0,127,2,55,70,22.04.2019 00:15,122,11,Lvov
128,122,1,60,67,1,68,0,68,0,12,56,22.04.2019 00:15,122,11,Lvov
992,987,23,288,682,22,704,0,704,17,124,563,22.04.2019 00:10,122,11,Lvov
480,463,12,93,375,12,387,0,387,10,49,328,22.04.2019 00:05,122,11,Lvov
416,403,2,128,286,2,288,0,288,9,43,236,22.04.2019 00:15,122,11,Lvov
960,949,54,175,731,54,785,0,785,46,142,597,22.04.2019 01:30,122,11,Lvov
480,468,39,99,343,38,381,0,381,9,71,301,22.04.2019 00:27,122,11,Lvov
320,315,17,37,269,14,283,0,283,0,77,206,22.04.2019 00:14,122,11,Lvov
832,809,50,220,562,50,612,0,612,12,241,359,22.04.2019 00:30,122,11,Lvov
96,91,10,20,66,10,76,0,76,3,22,51,22.04.2019 00:30,122,11,Lvov
416,413,20,116,280,20,300,0,300,10,165,125,22.04.2019 00:10,122,11,Lvov
928,911,39,279,611,38,649,0,649,6,278,365,22.04.2019 00:10,122,11,Lvov
192,178,14,47,132,13,145,0,145,6,62,77,22.04.2019 00:18,122,11,Lvov
208,192,8,59,141,8,149,0,149,2,67,80,22.04.2019 00:30,122,11,Lvov
336,323,10,125,202,9,211,0,211,4,71,136,22.04.2019 00:30,122,11,Lvov
1072,1058,49,344,679,49,728,0,728,15,310,403,22.04.2019 00:03,122,11,Lvov
944,937,40,308,598,38,636,0,636,9,246,381,22.04.2019 01:10,122,11,Lvov
592,575,31,239,324,29,353,0,353,10,179,164,22.04.2019 00:40,122,11,Lvov
288,284,11,107,176,5,181,0,181,4,38,139,22.04.2019 00:15,122,11,Lvov
368,357,17,148,203,17,220,0,220,3,90,127,22.04.2019 00:15,122,11,Lvov
400,390,22,180,198,22,220,0,220,7,143,70,22.04.2019 00:10,122,11,Lvov
336,334,22,79,237,20,257,0,257,10,74,173,22.04.2019 00:05,122,11,Lvov
880,863,67,184,630,66,696,0,696,7,130,559,22.04.2019 00:05,122,11,Lvov
672,664,41,182,449,41,490,0,490,6,316,168,22.04.2019 00:25,122,11,Lvov
368,359,29,117,222,29,251,0,251,2,139,110,21.04.2019 23:00,122,11,Lvov
656,649,37,164,456,36,492,0,492,7,144,341,22.04.2019 00:05,122,11,Lvov
464,458,39,85,340,39,379,0,379,4,50,325,22.04.2019 00:40,122,11,Lvov
272,271,10,53,209,10,219,0,219,8,20,191,22.04.2019 00:20,122,11,Lvov
752,735,43,279,430,43,473,0,473,8,153,312,22.04.2019 00:22,122,11,Lvov
2192,2165,120,803,1273,116,1389,0,1389,31,712,646,22.04.2019 00:15,122,11,Lvov
320,310,12,115,193,12,205,0,205,6,102,97,22.04.2019 00:30,122,11,Lvov
208,208,16,46,146,16,162,0,162,2,68,92,22.04.2019 00:10,122,11,Lvov
896,883,38,299,564,33,597,0,597,16,227,354,22.04.2019 00:20,122,11,Lvov
352,347,31,86,235,31,266,0,266,3,80,183,21.04.2019 23:45,122,11,Lvov
800,784,29,220,551,29,580,0,580,16,131,433,22.04.2019 00:40,122,11,Lvov
1856,1842,42,641,1178,37,1215,0,1215,23,419,773,22.04.2019 00:05,122,11,Lvov
1136,1117,42,420,678,38,716,0,716,10,286,420,22.04.2019 00:05,122,11,Lvov
704,693,25,271,409,24,433,0,433,13,171,249,22.04.2019 00:15,122,11,Lvov
672,650,45,196,431,45,476,0,476,8,187,281,22.04.2019 00:10,122,11,Lvov
912,894,63,406,446,60,506,0,506,7,280,219,22.04.2019 00:50,122,11,Lvov
448,435,29,172,247,29,276,0,276,8,160,108,22.04.2019 00:45,122,11,Lvov
1152,1132,64,476,612,64,676,0,676,7,316,353,22.04.2019 01:30,122,11,Lvov
2080,1965,24,861,1198,21,1219,0,1219,33,530,656,22.04.2019 00:15,122,11,Lvov
1888,1812,1,753,1134,1,1135,0,1135,18,560,557,22.04.2019 01:15,122,11,Lvov
256,243,16,111,132,13,145,0,145,3,39,103,22.04.2019 00:05,122,11,Lvov
880,869,25,300,558,22,580,0,580,7,201,372,22.04.2019 01:10,122,11,Lvov
192,178,11,64,118,10,128,0,128,3,49,76,22.04.2019 00:05,122,11,Lvov
1408,1392,19,361,1029,18,1047,0,1047,35,536,476,22.04.2019 00:15,122,11,Lvov
240,54,9,212,19,9,28,0,28,1,7,20,22.04.2019 00:10,122,11,Lvov
416,75,63,349,12,55,67,0,67,2,17,48,22.04.2019 00:05,122,11,Lvov
96,13,0,83,13,0,13,0,13,0,2,11,22.04.2019 00:03,122,11,Lvov
2192,2312,15,811,1367,14,1381,0,1381,38,660,683,22.04.2019 02:53,123,11,Lvov
2320,2271,13,993,1314,13,1327,0,1327,53,604,670,22.04.2019 02:10,123,11,Lvov
2208,2337,17,672,1521,15,1536,0,1536,38,770,728,22.04.2019 02:30,123,11,Lvov
2352,2316,22,1005,1327,20,1347,0,1347,39,553,755,22.04.2019 00:45,123,11,Lvov
2000,2031,7,783,1210,7,1217,0,1217,47,551,619,22.04.2019 01:05,123,11,Lvov
1984,1952,20,747,1219,18,1237,0,1237,41,478,718,22.04.2019 00:45,123,11,Lvov
1840,1809,15,677,1148,15,1163,0,1163,44,465,654,22.04.2019 00:15,123,11,Lvov
592,576,21,203,369,20,389,0,389,17,159,213,22.04.2019 00:15,123,11,Lvov
368,366,27,99,242,27,269,0,269,7,82,180,22.04.2019 00:35,123,11,Lvov
256,240,13,74,169,13,182,0,182,1,75,106,22.04.2019 02:00,123,11,Lvov
240,223,12,45,183,12,195,0,195,5,50,140,22.04.2019 00:15,123,11,Lvov
64,52,3,24,37,3,40,0,40,0,11,29,22.04.2019 00:07,123,11,Lvov
176,163,14,59,104,13,117,0,117,1,38,78,22.04.2019 00:15,123,11,Lvov
544,525,42,141,361,42,403,0,403,12,138,253,22.04.2019 00:05,123,11,Lvov
288,271,15,84,189,15,204,0,204,1,81,122,22.04.2019 00:05,123,11,Lvov
304,288,13,116,175,13,188,0,188,8,64,116,22.04.2019 02:45,123,11,Lvov
576,576,36,177,363,36,399,0,399,9,147,243,22.04.2019 00:10,123,11,Lvov
96,90,1,18,77,1,78,0,78,0,23,55,21.04.2019 23:50,123,11,Lvov
80,82,1,31,48,1,49,0,49,2,15,32,22.04.2019 00:10,123,11,Lvov
208,203,13,70,125,13,138,0,138,10,49,79,22.04.2019 00:12,123,11,Lvov
176,183,11,48,119,9,128,0,128,2,45,81,22.04.2019 00:59,123,11,Lvov
1376,1344,3,611,762,3,765,0,765,26,415,324,22.04.2019 01:10,123,11,Lvov
896,883,8,366,522,8,530,0,530,9,278,243,22.04.2019 01:01,123,11,Lvov
976,957,32,423,523,30,553,0,553,13,221,319,22.04.2019 01:50,123,11,Lvov
1264,1255,32,480,752,32,784,0,784,21,278,485,22.04.2019 00:59,123,11,Lvov
272,266,9,70,193,9,202,0,202,2,68,132,21.04.2019 22:20,123,11,Lvov
448,440,22,206,220,22,242,0,242,5,118,119,22.04.2019 00:05,123,11,Lvov
112,112,29,42,48,22,70,0,70,2,34,34,22.04.2019 01:45,123,11,Lvov
224,218,28,30,166,28,194,0,194,2,63,129,22.04.2019 00:50,123,11,Lvov
784,758,34,189,562,33,595,0,595,20,260,315,22.04.2019 00:08,123,11,Lvov
800,781,19,283,498,19,517,0,517,18,258,241,22.04.2019 00:20,123,11,Lvov
576,562,21,164,391,21,412,0,412,15,185,212,22.04.2019 00:11,123,11,Lvov
256,249,13,105,138,13,151,0,151,4,65,82,22.04.2019 00:05,123,11,Lvov
160,150,11,73,77,10,87,0,87,2,43,42,22.04.2019 01:30,123,11,Lvov
176,167,5,66,105,5,110,0,110,1,63,46,22.04.2019 00:15,123,11,Lvov
64,55,3,19,42,3,45,0,45,1,30,14,22.04.2019 00:45,123,11,Lvov
320,308,27,140,153,27,180,0,180,8,94,78,22.04.2019 00:45,123,11,Lvov
64,54,10,24,30,10,40,0,40,0,8,32,21.04.2019 23:25,123,11,Lvov
528,521,16,182,331,15,346,0,346,7,100,239,22.04.2019 00:10,123,11,Lvov
208,206,9,56,143,9,152,0,152,0,25,127,22.04.2019 00:10,123,11,Lvov
288,272,2,66,220,2,222,0,222,7,41,174,22.04.2019 00:05,123,11,Lvov
288,283,15,94,179,15,194,0,194,2,49,143,22.04.2019 00:40,123,11,Lvov
288,275,18,84,186,18,204,0,204,5,78,121,22.04.2019 00:30,123,11,Lvov
144,134,4,50,90,4,94,0,94,1,45,48,22.04.2019 01:30,123,11,Lvov
288,281,25,79,184,25,209,0,209,2,81,126,22.04.2019 00:10,123,11,Lvov
208,193,23,54,131,23,154,0,154,3,72,79,22.04.2019 00:40,123,11,Lvov
976,967,40,274,663,39,702,0,702,14,190,498,22.04.2019 00:10,123,11,Lvov
96,92,9,30,58,8,66,0,66,0,11,55,22.04.2019 00:10,123,11,Lvov
208,202,20,43,145,20,165,0,165,1,22,142,22.04.2019 00:05,123,11,Lvov
304,295,13,100,191,13,204,0,204,5,79,120,22.04.2019 00:10,123,11,Lvov
352,347,9,103,240,9,249,0,249,10,53,186,22.04.2019 00:30,123,11,Lvov
672,670,35,131,507,34,541,0,541,6,121,414,22.04.2019 00:25,123,11,Lvov
208,193,10,76,123,9,132,0,132,4,29,99,22.04.2019 01:18,123,11,Lvov
480,495,37,137,308,35,343,0,343,9,112,222,22.04.2019 00:05,123,11,Lvov
208,207,13,48,147,13,160,0,160,7,40,113,22.04.2019 00:15,123,11,Lvov
176,170,14,36,126,14,140,0,140,3,38,99,22.04.2019 00:15,123,11,Lvov
1120,1112,16,398,709,13,722,0,722,25,330,367,22.04.2019 00:50,123,11,Lvov
784,758,60,373,352,59,411,0,411,2,189,220,22.04.2019 00:10,123,11,Lvov
544,536,40,196,309,39,348,0,348,5,197,146,22.04.2019 01:18,123,11,Lvov
256,251,7,101,149,6,155,0,155,5,91,59,22.04.2019 00:15,123,11,Lvov
432,419,11,127,294,11,305,0,305,10,123,172,22.04.2019 00:15,123,11,Lvov
48,42,5,17,26,5,31,0,31,2,10,19,22.04.2019 00:15,123,11,Lvov
512,506,27,232,255,25,280,0,280,3,97,180,22.04.2019 00:20,123,11,Lvov
176,174,5,43,128,5,133,0,133,0,75,58,22.04.2019 00:15,123,11,Lvov
96,83,8,29,59,8,67,0,67,3,27,37,22.04.2019 00:30,123,11,Lvov
80,82,7,27,46,7,53,0,53,0,25,28,22.04.2019 00:35,123,11,Lvov
848,828,56,349,444,55,499,0,499,9,294,196,22.04.2019 00:30,123,11,Lvov
160,157,16,42,103,15,118,0,118,0,64,54,22.04.2019 00:30,123,11,Lvov
112,106,9,29,75,8,83,0,83,0,45,38,22.04.2019 00:15,123,11,Lvov
256,242,11,69,176,11,187,0,187,6,88,93,22.04.2019 00:43,123,11,Lvov
400,397,31,91,278,31,309,0,309,9,108,192,22.04.2019 00:10,123,11,Lvov
752,737,64,222,468,62,530,0,530,9,240,281,22.04.2019 00:05,123,11,Lvov
112,110,8,25,79,8,87,0,87,1,49,37,22.04.2019 00:10,123,11,Lvov
128,116,1,33,94,1,95,0,95,2,31,62,22.04.2019 00:40,123,11,Lvov
208,195,22,55,132,21,153,0,153,1,52,100,21.04.2019 20:45,123,11,Lvov
144,129,10,47,87,10,97,0,97,1,34,62,22.04.2019 00:10,123,11,Lvov
752,740,40,274,439,39,478,0,478,13,193,272,22.04.2019 01:30,123,11,Lvov
320,315,26,89,205,26,231,0,231,3,68,160,22.04.2019 00:47,123,11,Lvov
80,83,3,23,54,3,57,0,57,4,15,38,22.04.2019 00:07,123,11,Lvov
176,166,14,55,107,14,121,0,121,1,29,91,22.04.2019 01:00,123,11,Lvov
752,728,48,289,423,40,463,0,463,15,216,232,22.04.2019 00:10,123,11,Lvov
96,100,10,17,69,10,79,0,79,3,37,39,22.04.2019 02:00,123,11,Lvov
688,667,43,267,382,39,421,0,421,7,99,315,22.04.2019 00:15,123,11,Lvov
320,313,25,103,192,25,217,0,217,5,67,145,22.04.2019 00:05,123,11,Lvov
960,947,39,210,711,39,750,0,750,18,294,438,22.04.2019 00:05,123,11,Lvov
640,633,15,194,432,14,446,0,446,15,218,213,22.04.2019 00:30,123,11,Lvov
192,181,8,43,141,8,149,0,149,3,65,81,22.04.2019 00:35,123,11,Lvov
432,424,18,142,272,18,290,0,290,11,135,144,21.04.2019 23:45,123,11,Lvov
80,72,3,30,47,3,50,0,50,0,26,24,22.04.2019 00:17,123,11,Lvov
192,183,6,69,117,6,123,0,123,4,77,42,22.04.2019 00:45,123,11,Lvov
1248,1229,47,460,741,47,788,0,788,24,399,365,22.04.2019 00:40,123,11,Lvov
544,544,31,104,412,28,440,0,440,13,138,289,22.04.2019 01:10,123,11,Lvov
1296,1269,33,486,780,30,810,0,810,26,369,415,22.04.2019 00:45,123,11,Lvov
112,103,5,41,66,5,71,0,71,4,13,54,22.04.2019 00:05,123,11,Lvov
208,195,11,83,114,11,125,0,125,4,60,61,22.04.2019 00:30,123,11,Lvov
208,200,7,83,118,7,125,0,125,3,45,77,22.04.2019 00:20,123,11,Lvov
80,87,1,4,75,1,76,0,76,0,25,51,22.04.2019 00:05,123,11,Lvov
304,35,17,277,17,10,27,0,27,1,11,15,22.04.2019 00:25,123,11,Lvov
176,32,1,144,31,1,32,0,32,1,26,5,22.04.2019 00:55,123,11,Lvov
272,256,12,68,192,12,204,0,204,3,38,163,22.04.2019 00:15,123,11,Lvov
384,369,13,120,251,13,264,0,264,10,52,202,22.04.2019 00:05,123,11,Lvov
320,306,11,102,208,10,218,0,218,1,51,166,21.04.2019 21:15,123,11,Lvov
240,226,18,63,159,18,177,0,177,0,32,145,22.04.2019 00:30,123,11,Lvov
160,150,6,50,104,6,110,0,110,1,31,78,22.04.2019 00:45,123,11,Lvov
320,301,28,69,224,27,251,0,251,2,58,191,22.04.2019 00:55,123,11,Lvov
112,105,11,24,79,9,88,0,88,2,21,65,22.04.2019 00:15,123,11,Lvov
496,488,25,144,327,25,352,0,352,6,127,219,22.04.2019 00:15,123,11,Lvov
144,142,9,28,107,9,116,0,116,1,17,98,22.04.2019 00:40,123,11,Lvov
848,832,62,265,524,59,583,0,583,16,132,435,22.04.2019 00:15,123,11,Lvov
416,412,6,108,302,6,308,0,308,5,97,206,22.04.2019 00:45,123,11,Lvov
256,253,6,77,173,6,179,0,179,7,46,126,22.04.2019 00:12,123,11,Lvov
608,589,48,142,419,47,466,0,466,5,128,333,22.04.2019 01:30,123,11,Lvov
1200,1180,40,360,800,40,840,0,840,8,205,627,22.04.2019 00:25,123,11,Lvov
704,688,39,211,455,38,493,0,493,8,171,314,22.04.2019 00:20,123,11,Lvov
480,468,33,97,354,29,383,0,383,6,120,257,22.04.2019 00:48,123,11,Lvov
96,92,3,24,69,3,72,0,72,0,18,54,22.04.2019 00:20,123,11,Lvov
1744,1713,27,593,1128,23,1151,0,1151,21,285,845,22.04.2019 00:05,123,11,Lvov
880,867,17,199,665,16,681,0,681,14,184,483,22.04.2019 00:20,123,11,Lvov
224,216,2,59,163,2,165,0,165,4,37,124,22.04.2019 01:15,123,11,Lvov
2160,2116,28,803,1334,23,1357,0,1357,19,399,939,22.04.2019 00:30,123,11,Lvov
2128,2129,28,707,1395,26,1421,0,1421,46,494,881,22.04.2019 00:35,123,11,Lvov
1968,1942,23,713,1232,23,1255,0,1255,31,425,799,22.04.2019 00:10,123,11,Lvov
1568,1540,17,617,941,10,951,0,951,28,361,562,22.04.2019 00:34,123,11,Lvov
1504,1466,22,618,866,20,886,0,886,33,326,527,22.04.2019 00:15,123,11,Lvov
1936,1905,22,715,1205,16,1221,0,1221,29,401,791,22.04.2019 00:50,123,11,Lvov
864,845,2,327,535,2,537,0,537,15,181,341,22.04.2019 03:05,123,11,Lvov
256,246,2,57,197,2,199,0,199,1,86,112,22.04.2019 00:15,123,11,Lvov
656,648,34,182,440,34,474,0,474,6,101,367,22.04.2019 00:30,123,11,Lvov
320,308,5,55,260,5,265,0,265,3,80,182,22.04.2019 00:20,123,11,Lvov
208,204,3,59,146,3,149,0,149,1,71,77,22.04.2019 00:30,123,11,Lvov
160,149,24,54,85,21,106,0,106,1,12,93,22.04.2019 00:50,123,11,Lvov
624,609,22,241,365,18,383,0,383,5,121,257,22.04.2019 01:15,123,11,Lvov
160,156,7,50,103,7,110,0,110,2,37,71,22.04.2019 00:10,123,11,Lvov
2288,2258,42,836,1414,38,1452,0,1452,32,676,744,22.04.2019 01:50,123,11,Lvov
896,881,31,310,559,27,586,0,586,12,245,329,22.04.2019 00:30,123,11,Lvov
2384,2354,51,650,1685,49,1734,0,1734,50,342,1342,22.04.2019 00:10,123,11,Lvov
1200,1187,19,364,817,19,836,0,836,10,204,622,22.04.2019 01:15,123,11,Lvov
400,381,8,103,289,8,297,0,297,3,64,230,22.04.2019 00:05,123,11,Lvov
2000,1971,33,616,1352,32,1384,0,1384,20,317,1047,22.04.2019 00:15,123,11,Lvov
720,710,35,175,510,35,545,0,545,11,192,342,22.04.2019 00:15,123,11,Lvov
1056,1041,33,454,575,27,602,0,602,11,242,349,22.04.2019 00:10,123,11,Lvov
1504,1487,30,582,894,28,922,0,922,35,302,585,22.04.2019 01:55,123,11,Lvov
768,752,18,315,437,16,453,0,453,21,180,252,22.04.2019 00:15,123,11,Lvov
1184,1157,54,374,764,46,810,0,810,26,187,597,22.04.2019 02:19,123,11,Lvov
240,233,13,70,157,13,170,0,170,3,52,115,22.04.2019 01:43,123,11,Lvov
2416,2398,46,751,1621,44,1665,0,1665,47,523,1095,22.04.2019 01:30,123,11,Lvov
928,904,24,338,566,24,590,0,590,8,188,394,22.04.2019 00:15,123,11,Lvov
576,554,31,148,398,30,428,0,428,21,129,278,22.04.2019 00:20,123,11,Lvov
256,251,20,54,184,18,202,0,202,3,61,138,22.04.2019 00:35,123,11,Lvov
1328,1303,24,454,851,23,874,0,874,23,313,538,22.04.2019 00:50,123,11,Lvov
720,696,11,239,470,11,481,0,481,11,164,306,22.04.2019 01:30,123,11,Lvov
512,497,17,118,377,17,394,0,394,6,144,244,22.04.2019 03:45,123,11,Lvov
192,189,6,38,148,6,154,0,154,0,51,103,22.04.2019 00:30,123,11,Lvov
320,307,19,73,228,19,247,0,247,3,94,150,22.04.2019 02:54,123,11,Lvov
224,44,20,186,21,17,38,0,38,1,17,20,22.04.2019 00:45,123,11,Lvov
496,365,0,361,135,0,135,0,135,16,38,81,22.04.2019 00:20,123,11,Lvov
256,228,0,28,228,0,228,0,228,14,106,108,22.04.2019 00:20,123,11,Lvov
464,462,41,149,276,39,315,0,315,7,77,231,22.04.2019 00:06,123,11,Lvov
288,274,22,62,206,20,226,0,226,4,43,179,22.04.2019 00:03,123,11,Lvov
592,585,42,90,461,41,502,0,502,6,56,440,22.04.2019 00:26,123,11,Lvov
208,195,14,60,135,13,148,0,148,4,27,117,22.04.2019 00:35,123,11,Lvov
464,456,31,94,339,31,370,0,370,8,64,298,22.04.2019 00:05,123,11,Lvov
512,509,31,88,394,30,424,0,424,5,116,303,22.04.2019 01:45,123,11,Lvov
320,313,20,88,213,19,232,0,232,5,32,195,22.04.2019 00:10,123,11,Lvov
160,165,16,56,92,12,104,0,104,4,22,78,22.04.2019 00:15,123,11,Lvov
720,712,62,291,373,56,429,0,429,8,154,267,22.04.2019 00:10,123,11,Lvov
272,270,47,106,130,36,166,0,166,3,56,107,22.04.2019 00:16,123,11,Lvov
112,108,17,42,58,12,70,0,70,0,15,55,22.04.2019 00:15,123,11,Lvov
112,108,7,26,79,7,86,0,86,1,14,71,22.04.2019 00:15,123,11,Lvov
368,379,19,117,234,17,251,0,251,11,69,171,22.04.2019 00:15,123,11,Lvov
112,110,2,35,75,2,77,0,77,1,15,61,22.04.2019 00:17,123,11,Lvov
816,792,50,247,523,46,569,0,569,12,178,379,22.04.2019 00:53,123,11,Lvov
288,273,2,88,198,2,200,0,200,2,39,159,22.04.2019 00:07,123,11,Lvov
464,453,9,170,286,8,294,0,294,4,59,231,22.04.2019 00:10,123,11,Lvov
768,752,36,251,482,35,517,0,517,16,129,372,22.04.2019 00:40,123,11,Lvov
656,639,45,214,397,45,442,0,442,4,124,314,22.04.2019 00:05,123,11,Lvov
432,430,14,118,300,14,314,0,314,11,73,230,22.04.2019 00:10,123,11,Lvov
1632,1592,30,682,921,29,950,0,950,27,330,593,22.04.2019 02:01,123,11,Lvov
1632,1598,28,687,920,25,945,0,945,27,333,585,22.04.2019 00:16,123,11,Lvov
224,221,23,81,120,23,143,0,143,0,51,92,22.04.2019 00:05,123,11,Lvov
416,407,33,148,237,31,268,0,268,4,93,171,22.04.2019 00:20,123,11,Lvov
384,379,33,105,246,33,279,0,279,5,72,202,22.04.2019 00:45,123,11,Lvov
480,463,24,148,312,20,332,0,332,5,127,200,22.04.2019 00:15,123,11,Lvov
112,108,4,51,57,4,61,0,61,1,18,42,22.04.2019 00:30,123,11,Lvov
640,628,50,194,402,44,446,0,446,13,107,326,22.04.2019 00:20,123,11,Lvov
496,509,83,119,297,80,377,0,377,1,103,273,22.04.2019 00:31,123,11,Lvov
272,270,22,67,183,22,205,0,205,1,80,124,22.04.2019 00:05,123,11,Lvov
224,210,9,87,131,6,137,0,137,3,70,64,22.04.2019 00:05,123,11,Lvov
192,182,8,46,138,8,146,0,146,3,61,82,22.04.2019 00:30,123,11,Lvov
464,452,35,133,298,33,331,0,331,5,184,142,22.04.2019 00:25,123,11,Lvov
1872,1861,7,710,1155,7,1162,0,1162,39,391,732,22.04.2019 01:15,123,11,Lvov
1968,1959,27,732,1212,24,1236,0,1236,45,489,702,22.04.2019 00:40,123,11,Lvov
1536,1518,19,544,976,16,992,0,992,18,405,569,22.04.2019 01:10,123,11,Lvov
1072,1047,45,479,551,42,593,0,593,25,256,312,22.04.2019 00:37,123,11,Lvov
304,299,17,98,189,17,206,0,206,9,78,119,22.04.2019 00:15,123,11,Lvov
320,304,16,47,257,16,273,0,273,1,76,196,22.04.2019 01:00,123,11,Lvov
128,125,1,41,86,1,87,0,87,4,40,43,22.04.2019 00:20,123,11,Lvov
672,650,130,119,426,127,553,0,553,14,170,369,22.04.2019 01:15,123,11,Lvov
160,158,16,22,123,15,138,0,138,0,27,111,22.04.2019 00:15,123,11,Lvov
512,494,58,189,274,49,323,0,323,4,54,265,22.04.2019 00:20,123,11,Lvov
160,150,22,21,117,22,139,0,139,5,19,115,22.04.2019 00:20,123,11,Lvov
224,214,24,67,133,24,157,0,157,6,52,99,22.04.2019 00:10,123,11,Lvov
352,348,26,42,285,25,310,0,310,7,115,188,22.04.2019 00:45,123,11,Lvov
608,597,52,214,342,52,394,0,394,11,138,245,22.04.2019 00:15,123,11,Lvov
288,280,34,63,192,33,225,0,225,0,82,143,22.04.2019 00:30,123,11,Lvov
448,443,57,120,271,57,328,0,328,2,90,236,22.04.2019 01:40,123,11,Lvov
256,237,7,51,198,7,205,0,205,4,69,132,22.04.2019 00:30,123,11,Lvov
544,522,29,155,362,27,389,0,389,10,123,256,22.04.2019 00:20,123,11,Lvov
160,156,7,35,118,7,125,0,125,1,39,85,22.04.2019 00:10,123,11,Lvov
448,432,35,129,286,33,319,0,319,2,124,193,22.04.2019 00:05,123,11,Lvov
384,372,25,74,285,25,310,0,310,3,101,206,22.04.2019 00:50,123,11,Lvov
128,126,10,43,78,7,85,0,85,1,8,76,22.04.2019 00:10,123,11,Lvov
80,82,17,20,46,14,60,0,60,1,14,45,22.04.2019 00:20,123,11,Lvov
432,423,50,122,262,48,310,0,310,0,92,218,22.04.2019 00:15,123,11,Lvov
256,240,21,116,120,20,140,0,140,5,35,100,22.04.2019 00:08,123,11,Lvov
272,265,18,67,191,14,205,0,205,0,34,171,22.04.2019 00:00,123,11,Lvov
240,241,14,78,148,14,162,0,162,0,47,115,22.04.2019 00:30,123,11,Lvov
464,458,24,104,337,23,360,0,360,5,116,239,22.04.2019 00:20,123,11,Lvov
192,189,2,36,154,2,156,0,156,9,35,112,22.04.2019 00:45,123,11,Lvov
224,223,17,50,159,15,174,0,174,4,79,91,22.04.2019 00:15,123,11,Lvov
384,378,47,111,230,43,273,0,273,5,60,208,22.04.2019 01:10,123,11,Lvov
416,404,39,110,267,39,306,0,306,5,116,185,22.04.2019 00:30,123,11,Lvov
416,410,49,101,271,44,315,0,315,4,99,212,22.04.2019 00:25,123,11,Lvov
64,62,16,23,27,14,41,0,41,1,9,31,22.04.2019 00:30,123,11,Lvov
688,692,148,178,380,130,510,0,510,4,176,330,22.04.2019 00:20,123,11,Lvov
416,405,42,114,261,41,302,0,302,4,111,187,22.04.2019 00:30,123,11,Lvov
416,396,36,87,294,35,329,0,329,3,97,229,22.04.2019 00:30,123,11,Lvov
208,199,26,83,99,26,125,0,125,0,36,89,22.04.2019 00:55,123,11,Lvov
144,77,31,73,40,31,71,0,71,1,33,37,22.04.2019 00:20,123,11,Lvov
1376,1366,21,534,823,19,842,0,842,25,268,549,22.04.2019 02:30,123,11,Lvov
1552,1544,23,661,873,18,891,0,891,63,333,495,22.04.2019 00:30,123,11,Lvov
1568,1558,21,638,917,13,930,0,930,24,375,531,22.04.2019 02:30,123,11,Lvov
1680,1663,14,765,907,8,915,0,915,22,358,535,22.04.2019 00:10,123,11,Lvov
1488,1475,15,674,801,13,814,0,814,29,352,433,22.04.2019 00:30,123,11,Lvov
1504,1490,7,782,717,5,722,0,722,24,290,408,22.04.2019 00:30,123,11,Lvov
1488,1481,23,635,836,17,853,0,853,24,313,516,22.04.2019 02:10,123,11,Lvov
1488,1460,9,673,807,8,815,0,815,21,282,512,22.04.2019 00:25,123,11,Lvov
1584,1559,13,705,866,13,879,0,879,21,347,511,22.04.2019 03:55,123,11,Lvov
1520,1500,10,634,880,6,886,0,886,16,324,546,22.04.2019 03:00,123,11,Lvov
208,24,12,185,12,11,23,0,23,0,12,11,22.04.2019 00:30,123,11,Lvov
96,28,11,69,16,11,27,0,27,3,9,15,22.04.2019 00:05,123,11,Lvov
1552,1533,22,594,940,18,958,0,958,27,483,448,22.04.2019 02:00,124,11,Lvov
1392,1387,43,475,879,38,917,0,917,20,377,520,22.04.2019 00:20,124,11,Lvov
1936,1908,12,751,1176,9,1185,0,1185,33,612,540,22.04.2019 00:05,124,11,Lvov
1600,1578,75,601,934,65,999,0,999,15,443,541,22.04.2019 01:30,124,11,Lvov
496,498,24,70,402,24,426,0,426,9,123,294,22.04.2019 00:30,124,11,Lvov
112,109,13,17,82,13,95,0,95,1,37,57,22.04.2019 00:10,124,11,Lvov
176,168,8,32,136,8,144,0,144,1,35,108,22.04.2019 02:00,124,11,Lvov
128,128,1,16,111,1,112,0,112,1,42,69,22.04.2019 00:59,124,11,Lvov
384,380,5,87,292,5,297,0,297,7,109,181,22.04.2019 00:30,124,11,Lvov
736,718,29,288,419,29,448,0,448,9,125,314,22.04.2019 00:25,124,11,Lvov
592,578,18,92,482,18,500,0,500,6,169,325,22.04.2019 00:50,124,11,Lvov
112,97,3,24,85,3,88,0,88,4,32,52,22.04.2019 00:15,124,11,Lvov
320,310,21,62,237,21,258,0,258,6,119,133,22.04.2019 00:03,124,11,Lvov
576,562,40,188,352,36,388,0,388,3,128,257,22.04.2019 00:20,124,11,Lvov
256,247,25,62,169,25,194,0,194,4,99,91,22.04.2019 00:15,124,11,Lvov
256,247,24,62,170,24,194,0,194,3,85,106,22.04.2019 00:10,124,11,Lvov
896,887,88,276,534,86,620,0,620,11,315,294,22.04.2019 00:35,124,11,Lvov
944,932,55,323,572,49,621,0,621,18,238,365,22.04.2019 00:01,124,11,Lvov
320,309,15,95,210,15,225,0,225,11,113,101,22.04.2019 00:20,124,11,Lvov
240,224,3,78,159,3,162,0,162,7,68,87,22.04.2019 00:15,124,11,Lvov
512,501,61,190,270,52,322,0,322,5,139,178,22.04.2019 00:15,124,11,Lvov
96,95,10,15,71,10,81,0,81,0,46,35,22.04.2019 00:15,124,11,Lvov
112,95,8,37,68,7,75,0,75,0,39,36,22.04.2019 00:10,124,11,Lvov
352,344,25,71,256,25,281,0,281,1,116,164,22.04.2019 00:45,124,11,Lvov
448,429,19,136,295,17,312,0,312,8,137,167,22.04.2019 00:15,124,11,Lvov
320,311,11,77,234,9,243,0,243,5,160,78,22.04.2019 01:45,124,11,Lvov
80,66,5,25,51,4,55,0,55,0,23,32,22.04.2019 00:03,124,11,Lvov
176,165,10,48,118,10,128,0,128,1,58,69,22.04.2019 00:45,124,11,Lvov
592,580,46,151,397,44,441,0,441,8,173,260,22.04.2019 00:30,124,11,Lvov
400,398,24,83,293,24,317,0,317,6,122,189,22.04.2019 00:20,124,11,Lvov
752,740,48,318,388,46,434,0,434,10,224,200,22.04.2019 00:10,124,11,Lvov
640,633,35,267,339,34,373,0,373,7,187,179,22.04.2019 00:14,124,11,Lvov
720,715,39,224,459,37,496,0,496,8,231,257,22.04.2019 01:59,124,11,Lvov
1008,990,34,428,547,33,580,0,580,9,298,273,22.04.2019 00:15,124,11,Lvov
128,120,1,50,78,0,78,0,78,2,46,30,22.04.2019 01:05,124,11,Lvov
560,547,25,193,345,22,367,0,367,9,180,178,22.04.2019 00:05,124,11,Lvov
288,277,22,92,175,21,196,0,196,1,91,104,22.04.2019 00:15,124,11,Lvov
336,322,28,94,217,25,242,0,242,3,82,157,22.04.2019 00:28,124,11,Lvov
608,583,56,217,345,46,391,0,391,4,222,165,22.04.2019 00:15,124,11,Lvov
160,156,16,19,125,16,141,0,141,0,86,55,22.04.2019 00:48,124,11,Lvov
208,201,17,68,124,16,140,0,140,2,71,67,22.04.2019 00:35,124,11,Lvov
352,341,31,74,247,31,278,0,278,5,174,99,22.04.2019 02:05,124,11,Lvov
256,253,24,75,157,24,181,0,181,0,66,115,22.04.2019 00:02,124,11,Lvov
400,388,35,149,218,33,251,0,251,3,119,129,22.04.2019 02:20,124,11,Lvov
352,344,26,104,222,26,248,0,248,6,125,117,22.04.2019 00:15,124,11,Lvov
464,449,24,109,331,24,355,0,355,5,106,244,22.04.2019 00:50,124,11,Lvov
464,462,15,79,371,14,385,0,385,5,94,286,22.04.2019 00:35,124,11,Lvov
560,544,38,167,356,37,393,0,393,13,137,243,22.04.2019 00:21,124,11,Lvov
384,382,21,117,247,20,267,0,267,2,91,174,22.04.2019 00:21,124,11,Lvov
800,796,31,221,548,31,579,0,579,13,220,346,22.04.2019 00:40,124,11,Lvov
608,589,37,89,482,37,519,0,519,35,171,313,22.04.2019 00:15,124,11,Lvov
192,177,13,38,141,13,154,0,154,1,62,91,22.04.2019 00:30,124,11,Lvov
1248,1221,74,510,670,68,738,0,738,10,359,369,22.04.2019 00:02,124,11,Lvov
320,308,17,88,215,17,232,0,232,0,103,129,22.04.2019 00:25,124,11,Lvov
464,454,27,166,273,25,298,0,298,7,140,151,22.04.2019 00:20,124,11,Lvov
576,563,21,121,434,21,455,0,455,3,237,215,22.04.2019 00:05,124,11,Lvov
272,262,21,55,197,20,217,0,217,0,117,100,22.04.2019 00:10,124,11,Lvov
128,122,2,33,93,2,95,0,95,0,38,57,22.04.2019 00:15,124,11,Lvov
672,663,29,233,413,26,439,0,439,6,191,242,22.04.2019 00:10,124,11,Lvov
1328,1303,19,447,865,16,881,0,881,63,293,525,22.04.2019 01:30,124,11,Lvov
240,228,7,80,153,7,160,0,160,9,62,89,22.04.2019 00:48,124,11,Lvov
2208,2188,43,888,1283,37,1320,0,1320,48,572,700,22.04.2019 00:20,124,11,Lvov
1984,1956,25,831,1132,21,1153,0,1153,30,536,587,22.04.2019 01:10,124,11,Lvov
2368,2337,22,1037,1312,19,1331,0,1331,33,568,730,22.04.2019 02:00,124,11,Lvov
2224,2204,37,912,1281,31,1312,0,1312,40,607,665,22.04.2019 00:27,124,11,Lvov
2304,2261,36,1004,1276,24,1300,0,1300,28,624,648,22.04.2019 00:20,124,11,Lvov
2032,2012,37,956,1045,31,1076,0,1076,35,504,537,22.04.2019 04:45,124,11,Lvov
2080,2046,37,890,1159,31,1190,0,1190,36,542,612,22.04.2019 01:20,124,11,Lvov
1104,1091,52,356,697,51,748,0,748,14,346,388,22.04.2019 00:40,124,11,Lvov
480,470,12,113,355,12,367,0,367,5,203,159,22.04.2019 00:05,124,11,Lvov
352,340,17,79,257,16,273,0,273,5,129,139,22.04.2019 00:06,124,11,Lvov
656,649,26,120,513,23,536,0,536,9,179,348,22.04.2019 00:06,124,11,Lvov
160,154,6,39,115,6,121,0,121,1,51,69,22.04.2019 00:05,124,11,Lvov
128,127,6,31,91,6,97,0,97,0,43,54,22.04.2019 00:05,124,11,Lvov
224,222,55,47,132,45,177,0,177,1,49,127,22.04.2019 00:25,124,11,Lvov
416,410,26,124,266,26,292,0,292,3,135,154,22.04.2019 00:05,124,11,Lvov
496,477,36,114,346,36,382,0,382,15,186,181,22.04.2019 00:05,124,11,Lvov
1424,1409,40,574,810,40,850,0,850,20,425,405,22.04.2019 00:01,124,11,Lvov
1376,1344,30,521,827,28,855,0,855,25,422,408,22.04.2019 00:40,124,11,Lvov
880,869,54,256,577,47,624,0,624,18,225,381,22.04.2019 00:05,124,11,Lvov
736,721,26,215,495,26,521,0,521,10,232,279,22.04.2019 00:15,124,11,Lvov
656,635,39,166,451,39,490,0,490,13,209,268,22.04.2019 00:10,124,11,Lvov
1392,1375,45,336,1011,45,1056,0,1056,53,329,674,22.04.2019 00:45,124,11,Lvov
544,531,32,144,372,28,400,0,400,10,157,233,22.04.2019 02:00,124,11,Lvov
80,79,5,28,47,5,52,0,52,0,17,35,22.04.2019 00:04,124,11,Lvov
832,815,36,213,585,34,619,0,619,41,236,342,22.04.2019 00:01,124,11,Lvov
368,361,30,65,274,29,303,0,303,9,105,189,22.04.2019 00:05,124,11,Lvov
224,219,15,71,139,14,153,0,153,4,52,97,22.04.2019 01:40,124,11,Lvov
576,561,22,215,341,20,361,0,361,9,154,198,22.04.2019 00:10,124,11,Lvov
448,427,23,126,299,23,322,0,322,9,134,179,22.04.2019 00:10,124,11,Lvov
352,339,31,112,212,28,240,0,240,3,88,149,22.04.2019 00:15,124,11,Lvov
304,301,20,104,181,19,200,0,200,3,85,112,22.04.2019 00:20,124,11,Lvov
752,729,31,276,451,25,476,0,476,9,241,226,22.04.2019 00:10,124,11,Lvov
160,144,5,59,96,5,101,0,101,3,22,76,22.04.2019 00:40,124,11,Lvov
752,741,45,255,452,45,497,0,497,16,136,345,22.04.2019 00:30,124,11,Lvov
64,62,1,20,43,1,44,0,44,2,26,16,22.04.2019 00:35,124,11,Lvov
96,93,5,36,57,3,60,0,60,2,18,40,22.04.2019 00:10,124,11,Lvov
96,88,4,16,76,4,80,0,80,0,11,69,22.04.2019 00:30,124,11,Lvov
624,615,43,97,485,42,527,0,527,10,153,364,22.04.2019 00:55,124,11,Lvov
368,369,44,80,248,40,288,0,288,5,75,208,22.04.2019 00:15,124,11,Lvov
1552,1533,68,615,877,60,937,0,937,23,336,578,22.04.2019 00:20,124,11,Lvov
208,201,18,41,149,18,167,0,167,0,36,131,22.04.2019 00:15,124,11,Lvov
1440,1411,86,504,853,83,936,0,936,11,289,636,22.04.2019 01:42,124,11,Lvov
416,407,10,130,276,10,286,0,286,8,112,166,22.04.2019 00:10,124,11,Lvov
608,592,30,178,400,30,430,0,430,9,175,246,22.04.2019 00:10,124,11,Lvov
352,333,9,103,242,7,249,0,249,9,116,124,22.04.2019 00:05,124,11,Lvov
368,363,16,85,268,15,283,0,283,12,160,111,22.04.2019 00:40,124,11,Lvov
720,711,30,188,502,30,532,0,532,17,286,229,22.04.2019 00:12,124,11,Lvov
1344,1325,63,423,861,60,921,0,921,23,420,478,22.04.2019 00:15,124,11,Lvov
1680,1658,23,572,1085,23,1108,0,1108,40,565,503,22.04.2019 00:15,124,11,Lvov
976,957,15,361,600,15,615,0,615,14,296,305,22.04.2019 00:30,124,11,Lvov
640,631,34,170,439,31,470,0,470,11,187,272,22.04.2019 00:45,124,11,Lvov
1280,1257,25,389,866,25,891,0,891,28,393,470,22.04.2019 01:25,124,11,Lvov
1040,1012,48,386,608,46,654,0,654,19,279,356,22.04.2019 00:50,124,11,Lvov
432,424,16,154,262,16,278,0,278,13,133,132,22.04.2019 00:51,124,11,Lvov
144,131,48,28,69,47,116,0,116,2,42,72,22.04.2019 01:30,124,11,Lvov
416,402,10,137,269,10,279,0,279,8,104,167,22.04.2019 00:30,124,11,Lvov
336,325,18,64,256,16,272,0,272,7,154,111,22.04.2019 00:20,124,11,Lvov
2288,2244,52,815,1427,46,1473,0,1473,60,595,818,22.04.2019 00:15,124,11,Lvov
2352,2473,36,786,1533,33,1566,0,1566,50,602,914,22.04.2019 01:35,124,11,Lvov
1248,1236,29,415,806,27,833,0,833,18,368,447,22.04.2019 00:40,124,11,Lvov
320,309,25,100,195,25,220,0,220,2,95,123,22.04.2019 00:20,124,11,Lvov
384,51,38,336,12,36,48,0,48,0,21,27,22.04.2019 00:35,124,11,Lvov
96,19,10,79,9,8,17,0,17,1,10,6,22.04.2019 00:15,124,11,Lvov
80,14,0,66,14,0,14,0,14,0,7,7,22.04.2019 00:05,124,11,Lvov
2400,2368,16,938,1451,11,1462,0,1462,50,745,667,22.04.2019 01:25,124,11,Lvov
2000,1984,20,699,1285,16,1301,0,1301,53,595,653,22.04.2019 00:20,124,11,Lvov
2192,2162,25,811,1362,19,1381,0,1381,56,640,685,22.04.2019 00:03,124,11,Lvov
2224,2186,15,923,1289,12,1301,0,1301,60,602,639,22.04.2019 00:10,124,11,Lvov
2288,2251,9,832,1451,5,1456,0,1456,30,667,759,22.04.2019 00:30,124,11,Lvov
2080,2037,11,795,1278,7,1285,0,1285,41,556,688,22.04.2019 00:33,124,11,Lvov
2176,2133,20,856,1302,18,1320,0,1320,43,660,617,22.04.2019 00:35,124,11,Lvov
2096,2051,13,862,1224,10,1234,0,1234,45,600,589,22.04.2019 00:05,124,11,Lvov
2208,2164,17,890,1306,12,1318,0,1318,51,612,655,22.04.2019 00:30,124,11,Lvov
2192,2134,16,847,1336,9,1345,0,1345,39,617,689,22.04.2019 01:10,124,11,Lvov
2272,2225,27,838,1414,20,1434,0,1434,35,676,723,22.04.2019 00:10,124,11,Lvov
2208,2174,20,836,1356,16,1372,0,1372,48,640,684,22.04.2019 00:30,124,11,Lvov
2080,2039,38,844,1213,23,1236,0,1236,47,620,569,22.04.2019 00:10,124,11,Lvov
2192,2152,34,929,1243,20,1263,0,1263,46,593,624,22.04.2019 00:05,124,11,Lvov
2256,2228,14,909,1336,11,1347,0,1347,53,642,652,22.04.2019 00:55,124,11,Lvov
2192,2164,33,850,1325,17,1342,0,1342,29,636,677,22.04.2019 04:10,124,11,Lvov
2240,2176,29,879,1340,21,1361,0,1361,56,639,666,22.04.2019 00:05,124,11,Lvov
2032,1997,35,872,1132,28,1160,0,1160,54,574,532,22.04.2019 00:45,124,11,Lvov
2016,1885,16,764,1240,12,1252,0,1252,35,696,521,22.04.2019 00:30,124,11,Lvov
2272,2243,21,810,1450,12,1462,0,1462,50,617,795,22.04.2019 00:10,124,11,Lvov
1712,1670,20,662,1038,12,1050,0,1050,35,510,505,22.04.2019 00:30,124,11,Lvov
2304,2273,24,824,1465,15,1480,0,1480,62,693,725,22.04.2019 00:15,124,11,Lvov
2368,2367,44,841,1493,34,1527,0,1527,54,658,815,22.04.2019 01:35,124,11,Lvov
2128,2104,26,753,1352,23,1375,0,1375,42,639,694,22.04.2019 00:01,124,11,Lvov
2224,2180,38,923,1275,26,1301,0,1301,45,681,575,22.04.2019 00:10,124,11,Lvov
2176,2138,18,874,1286,16,1302,0,1302,52,646,604,22.04.2019 03:00,124,11,Lvov
1792,1752,19,736,1041,15,1056,0,1056,46,550,460,22.04.2019 00:05,124,11,Lvov
2032,2000,29,787,1220,25,1245,0,1245,58,551,636,22.04.2019 01:20,124,11,Lvov
464,65,47,406,15,43,58,0,58,2,25,31,22.04.2019 00:05,124,11,Lvov
48,17,0,31,17,0,17,0,17,0,9,8,22.04.2019 00:15,124,11,Lvov
752,750,36,246,472,34,506,0,506,13,283,210,22.04.2019 00:02,125,11,Lvov
576,557,31,217,328,31,359,0,359,8,169,182,22.04.2019 00:05,125,11,Lvov
896,877,59,325,512,59,571,0,571,11,279,281,22.04.2019 00:10,125,11,Lvov
416,391,47,189,183,44,227,0,227,1,97,129,21.04.2019 23:35,125,11,Lvov
160,138,16,83,61,16,77,0,77,1,29,47,22.04.2019 00:25,125,11,Lvov
176,171,10,56,110,10,120,0,120,5,42,73,22.04.2019 01:15,125,11,Lvov
1360,1334,85,432,843,85,928,0,928,19,264,645,21.04.2019 21:40,125,11,Lvov
2224,2199,37,850,1338,36,1374,0,1374,44,536,794,22.04.2019 00:20,125,11,Lvov
705,663,34,248,423,34,457,0,457,4,247,206,22.04.2019 00:30,125,11,Lvov
352,332,31,136,186,30,216,0,216,6,96,114,22.04.2019 01:15,125,11,Lvov
480,451,47,229,212,39,251,0,251,5,143,103,22.04.2019 01:55,125,11,Lvov
464,436,38,236,193,35,228,0,228,4,123,101,22.04.2019 01:30,125,11,Lvov
336,323,37,137,163,36,199,0,199,5,109,85,22.04.2019 00:30,125,11,Lvov
720,700,40,199,481,40,521,0,521,19,163,339,22.04.2019 00:25,125,11,Lvov
1376,1340,51,397,928,51,979,0,979,26,520,433,22.04.2019 00:18,125,11,Lvov
240,237,21,82,137,21,158,0,158,1,64,93,22.04.2019 00:30,125,11,Lvov
352,348,27,150,178,24,202,0,202,2,90,110,22.04.2019 00:10,125,11,Lvov
256,245,16,97,145,14,159,0,159,7,104,48,22.04.2019 00:17,125,11,Lvov
448,435,42,165,246,37,283,0,283,12,110,161,21.04.2019 23:45,125,11,Lvov
304,295,12,119,173,12,185,0,185,2,74,109,21.04.2019 23:45,125,11,Lvov
288,285,25,112,151,25,176,0,176,4,95,77,22.04.2019 00:50,125,11,Lvov
624,602,44,223,363,38,401,0,401,10,184,207,22.04.2019 01:42,125,11,Lvov
960,943,134,352,486,122,608,0,608,10,360,238,21.04.2019 20:50,125,11,Lvov
64,60,2,16,46,2,48,0,48,1,29,18,22.04.2019 00:20,125,11,Lvov
176,165,17,49,110,17,127,0,127,1,48,78,22.04.2019 03:20,125,11,Lvov
272,260,31,72,171,29,200,0,200,1,93,106,22.04.2019 00:10,125,11,Lvov
224,213,21,84,119,21,140,0,140,4,93,43,22.04.2019 01:30,125,11,Lvov
672,659,65,153,460,59,519,0,519,6,288,225,21.04.2019 23:40,125,11,Lvov
944,933,73,433,438,73,511,0,511,17,294,200,22.04.2019 02:55,125,11,Lvov
576,565,15,139,422,15,437,0,437,7,222,208,22.04.2019 00:35,125,11,Lvov
624,600,37,251,336,37,373,0,373,3,174,196,22.04.2019 00:15,125,11,Lvov
816,805,31,419,368,29,397,0,397,6,228,163,22.04.2019 00:02,125,11,Lvov
720,709,36,239,445,36,481,0,481,16,242,223,22.04.2019 01:30,125,11,Lvov
672,646,40,262,370,40,410,0,410,1,196,213,22.04.2019 00:18,125,11,Lvov
192,59,12,140,42,10,52,0,52,1,24,27,22.04.2019 00:25,125,11,Lvov
1616,1584,26,820,773,23,796,0,796,22,347,427,21.04.2019 21:50,125,11,Lvov
1456,1425,24,642,790,24,814,0,814,23,350,441,22.04.2019 00:45,125,11,Lvov
2304,2250,29,946,1329,29,1358,0,1358,36,600,722,22.04.2019 00:05,125,11,Lvov
2384,2348,27,1055,1308,21,1329,0,1329,36,656,637,22.04.2019 00:17,125,11,Lvov
1040,1018,51,389,603,48,651,0,651,24,333,294,21.04.2019 21:00,125,11,Lvov
1344,1321,70,536,748,60,808,0,808,20,387,401,21.04.2019 21:15,125,11,Lvov
832,811,35,230,569,33,602,0,602,20,239,343,21.04.2019 21:30,125,11,Lvov
544,531,28,173,343,28,371,0,371,6,135,230,22.04.2019 00:16,125,11,Lvov
1056,1026,79,519,464,73,537,0,537,9,263,265,22.04.2019 00:20,125,11,Lvov
448,444,29,81,338,29,367,0,367,11,164,192,22.04.2019 00:32,125,11,Lvov
336,327,17,110,210,16,226,0,226,3,109,114,22.04.2019 00:30,125,11,Lvov
224,220,20,86,119,19,138,0,138,0,37,101,21.04.2019 23:50,125,11,Lvov
288,281,21,99,168,21,189,0,189,1,68,120,21.04.2019 23:45,125,11,Lvov
944,914,49,393,504,47,551,0,551,11,206,334,22.04.2019 00:20,125,11,Lvov
304,290,13,128,165,11,176,0,176,2,77,97,21.04.2019 22:45,125,11,Lvov
368,346,49,95,224,49,273,0,273,2,99,172,21.04.2019 21:30,125,11,Lvov
304,292,33,60,212,32,244,0,244,10,86,148,22.04.2019 00:43,125,11,Lvov
960,935,61,182,717,61,778,0,778,21,274,483,22.04.2019 00:15,125,11,Lvov
928,912,51,319,558,51,609,0,609,15,296,298,22.04.2019 00:05,125,11,Lvov
752,736,31,213,508,31,539,0,539,17,177,345,22.04.2019 00:20,125,11,Lvov
464,448,51,190,228,46,274,0,274,1,143,130,21.04.2019 22:18,125,11,Lvov
224,210,28,52,144,28,172,0,172,0,52,120,21.04.2019 22:10,125,11,Lvov
688,652,42,308,340,40,380,0,380,4,126,250,21.04.2019 22:00,125,11,Lvov
928,878,129,402,400,126,526,0,526,6,256,264,22.04.2019 00:30,125,11,Lvov
288,276,26,74,189,25,214,0,214,2,101,111,22.04.2019 00:15,125,11,Lvov
480,458,45,206,233,41,274,0,274,5,114,155,22.04.2019 01:45,125,11,Lvov
80,69,2,28,50,2,52,0,52,1,21,30,22.04.2019 00:05,125,11,Lvov
336,318,27,85,224,27,251,0,251,9,106,136,22.04.2019 00:20,125,11,Lvov
224,213,10,45,170,9,179,0,179,0,36,143,21.04.2019 23:45,125,11,Lvov
64,65,4,8,52,4,56,0,56,1,32,23,22.04.2019 00:30,125,11,Lvov
336,324,19,61,256,19,275,0,275,8,100,167,22.04.2019 00:10,125,11,Lvov
304,299,21,87,199,18,217,0,217,5,102,110,22.04.2019 00:22,125,11,Lvov
48,42,4,13,31,4,35,0,35,0,7,28,22.04.2019 01:10,125,11,Lvov
96,91,6,31,60,5,65,0,65,0,29,36,22.04.2019 00:03,125,11,Lvov
480,469,12,165,303,12,315,0,315,6,147,162,22.04.2019 00:15,125,11,Lvov
496,500,41,72,383,41,424,0,424,5,121,298,22.04.2019 00:05,125,11,Lvov
368,354,13,87,271,10,281,0,281,13,155,113,22.04.2019 01:15,125,11,Lvov
96,97,5,20,71,5,76,0,76,0,22,54,22.04.2019 00:30,125,11,Lvov
400,388,22,122,258,20,278,0,278,9,148,121,22.04.2019 00:20,125,11,Lvov
576,568,44,153,381,42,423,0,423,3,183,237,22.04.2019 00:20,125,11,Lvov
512,507,25,175,314,23,337,0,337,9,97,231,22.04.2019 00:20,125,11,Lvov
480,463,56,108,316,56,372,0,372,4,190,178,21.04.2019 21:58,125,11,Lvov
688,660,45,128,517,43,560,0,560,15,234,311,22.04.2019 00:40,125,11,Lvov
368,355,27,95,247,26,273,0,273,4,98,171,21.04.2019 21:30,125,11,Lvov
144,131,17,35,92,17,109,0,109,1,24,84,22.04.2019 01:05,125,11,Lvov
432,414,27,69,336,27,363,0,363,10,147,206,22.04.2019 00:15,125,11,Lvov
208,193,4,44,160,4,164,0,164,7,48,109,22.04.2019 00:20,125,11,Lvov
176,169,11,32,133,11,144,0,144,2,67,75,22.04.2019 00:50,125,11,Lvov
128,127,7,14,107,7,114,0,114,2,44,68,22.04.2019 00:30,125,11,Lvov
288,275,40,95,161,32,193,0,193,4,61,128,22.04.2019 00:05,125,11,Lvov
96,79,9,53,35,8,43,0,43,1,8,34,21.04.2019 21:05,125,11,Lvov
128,117,18,59,55,14,69,0,69,5,19,45,22.04.2019 00:15,125,11,Lvov
640,624,25,225,391,24,415,0,415,13,167,235,22.04.2019 06:30,125,11,Lvov
464,447,23,109,332,23,355,0,355,6,162,187,22.04.2019 00:10,125,11,Lvov
176,167,16,41,119,16,135,0,135,4,59,72,22.04.2019 00:17,125,11,Lvov
224,216,22,64,138,22,160,0,160,2,46,112,22.04.2019 00:23,125,11,Lvov
368,357,32,126,210,32,242,0,242,9,82,151,22.04.2019 00:45,125,11,Lvov
496,477,19,155,325,16,341,0,341,4,167,170,22.04.2019 01:30,125,11,Lvov
224,214,22,45,157,22,179,0,179,3,118,58,22.04.2019 00:20,125,11,Lvov
240,219,15,59,166,15,181,0,181,5,67,109,21.04.2019 22:30,125,11,Lvov
912,891,37,312,565,35,600,0,600,20,340,240,21.04.2019 23:58,125,11,Lvov
112,101,4,30,78,4,82,0,82,5,48,29,22.04.2019 00:10,125,11,Lvov
368,352,7,132,229,7,236,0,236,3,150,83,22.04.2019 00:10,125,11,Lvov
528,510,24,180,328,20,348,0,348,10,180,158,22.04.2019 00:10,125,11,Lvov
512,490,23,196,294,22,316,0,316,10,210,96,22.04.2019 00:02,125,11,Lvov
336,325,13,98,225,13,238,0,238,2,92,144,22.04.2019 00:02,125,11,Lvov
1072,1042,63,268,741,63,804,0,804,22,380,402,22.04.2019 00:10,125,11,Lvov
320,315,24,80,216,24,240,0,240,1,99,140,22.04.2019 00:14,125,11,Lvov
800,794,48,312,440,48,488,0,488,8,246,234,22.04.2019 01:20,125,11,Lvov
464,449,21,205,238,21,259,0,259,6,79,174,22.04.2019 00:05,125,11,Lvov
544,528,23,196,326,22,348,0,348,12,144,192,22.04.2019 00:20,125,11,Lvov
1632,1577,75,647,912,73,985,0,985,15,501,469,22.04.2019 00:30,125,11,Lvov
400,389,17,141,244,15,259,0,259,9,158,92,22.04.2019 00:15,125,11,Lvov
1360,1330,83,561,724,75,799,0,799,16,401,382,21.04.2019 22:30,125,11,Lvov
848,832,56,192,600,56,656,0,656,13,345,298,22.04.2019 00:15,125,11,Lvov
848,839,45,303,500,45,545,0,545,9,256,280,21.04.2019 22:05,125,11,Lvov
720,720,40,243,441,36,477,0,477,7,285,185,21.04.2019 20:55,125,11,Lvov
224,208,21,62,141,21,162,0,162,3,59,100,22.04.2019 00:05,125,11,Lvov
736,725,50,218,470,48,518,0,518,5,181,332,22.04.2019 00:50,125,11,Lvov
608,597,46,219,343,46,389,0,389,4,183,202,21.04.2019 20:55,125,11,Lvov
736,733,29,264,443,29,472,0,472,12,173,287,22.04.2019 00:15,125,11,Lvov
144,143,1,19,124,1,125,0,125,0,34,91,21.04.2019 22:45,125,11,Lvov
400,381,5,147,249,4,253,0,253,9,123,121,22.04.2019 00:05,125,11,Lvov
304,302,13,83,208,13,221,0,221,9,95,117,22.04.2019 00:15,125,11,Lvov
528,505,61,124,343,61,404,0,404,5,151,248,22.04.2019 00:10,125,11,Lvov
1184,1161,96,432,656,96,752,0,752,13,355,384,22.04.2019 00:12,125,11,Lvov
160,156,16,15,129,16,145,0,145,2,22,121,22.04.2019 00:15,125,11,Lvov
736,732,26,248,463,25,488,0,488,15,198,275,21.04.2019 21:15,125,11,Lvov
256,267,12,73,173,10,183,0,183,1,86,96,21.04.2019 21:30,125,11,Lvov
624,612,35,228,361,35,396,0,396,8,184,204,21.04.2019 21:28,125,11,Lvov
256,239,22,79,155,22,177,0,177,4,38,135,22.04.2019 00:15,125,11,Lvov
384,372,34,136,214,34,248,0,248,4,134,110,22.04.2019 00:01,125,11,Lvov
624,608,55,123,446,55,501,0,501,12,216,273,22.04.2019 00:05,125,11,Lvov
176,166,29,31,116,29,145,0,145,2,72,71,22.04.2019 00:15,125,11,Lvov
192,187,32,56,104,32,136,0,136,2,41,93,22.04.2019 00:15,125,11,Lvov
656,638,23,254,380,22,402,0,402,7,196,199,21.04.2019 22:30,125,11,Lvov
480,470,21,185,274,21,295,0,295,7,114,174,21.04.2019 21:30,125,11,Lvov
80,69,4,28,48,4,52,0,52,0,29,23,21.04.2019 21:45,125,11,Lvov
176,164,7,73,97,6,103,0,103,2,57,44,21.04.2019 20:27,125,11,Lvov
816,795,51,317,452,47,499,0,499,8,205,286,22.04.2019 00:10,125,11,Lvov
256,251,24,103,129,24,153,0,153,3,55,95,22.04.2019 00:10,125,11,Lvov
304,290,30,100,179,25,204,0,204,3,98,103,22.04.2019 00:50,125,11,Lvov
176,51,17,125,34,17,51,0,51,1,20,30,22.04.2019 00:06,125,11,Lvov
96,21,11,75,10,11,21,0,21,0,9,12,22.04.2019 00:15,125,11,Lvov
48,26,0,22,26,0,26,0,26,0,11,15,22.04.2019 00:03,125,11,Lvov
48,24,0,24,24,0,24,0,24,0,11,13,22.04.2019 00:15,125,11,Lvov
32,15,0,17,15,0,15,0,15,0,4,11,22.04.2019 00:20,125,11,Lvov
48,23,0,26,22,0,22,0,22,0,9,13,21.04.2019 22:20,125,11,Lvov
32,30,0,2,30,0,30,0,30,0,11,19,22.04.2019 06:00,125,11,Lvov
2352,2311,22,1035,1298,19,1317,0,1317,46,730,541,22.04.2019 00:05,125,11,Lvov
1968,1936,17,892,1060,16,1076,0,1076,32,545,499,22.04.2019 00:55,125,11,Lvov
1376,1345,10,563,805,8,813,0,813,20,389,404,22.04.2019 06:00,125,11,Lvov
1056,1041,103,519,443,94,537,0,537,6,273,258,21.04.2019 23:50,125,11,Lvov
912,898,65,487,366,59,425,0,425,2,196,227,21.04.2019 22:00,125,11,Lvov
1440,1405,82,745,621,74,695,0,695,4,191,500,22.04.2019 00:20,125,11,Lvov
816,799,72,335,413,68,481,0,481,8,137,336,21.04.2019 22:00,125,11,Lvov
816,794,96,223,497,96,593,0,593,1,123,469,21.04.2019 23:50,125,11,Lvov
320,303,29,112,179,29,208,0,208,2,76,130,22.04.2019 00:17,125,11,Lvov
800,791,50,180,570,50,620,0,620,14,245,361,22.04.2019 00:50,125,11,Lvov
624,595,46,184,394,46,440,0,440,10,174,256,22.04.2019 00:50,125,11,Lvov
1328,1288,71,388,876,64,940,0,940,15,380,545,22.04.2019 00:20,125,11,Lvov
944,925,99,485,371,88,459,0,459,4,167,288,22.04.2019 00:52,125,11,Lvov
896,886,94,295,508,93,601,0,601,5,195,401,22.04.2019 00:25,125,11,Lvov
1024,998,95,241,689,94,783,0,783,10,326,447,22.04.2019 00:45,125,11,Lvov
256,243,18,66,172,18,190,0,190,0,99,91,22.04.2019 01:15,125,11,Lvov
704,684,69,337,309,58,367,0,367,1,223,143,22.04.2019 02:00,125,11,Lvov
592,560,32,280,285,27,312,0,312,10,139,163,21.04.2019 21:43,125,11,Lvov
304,295,42,140,122,42,164,0,164,2,72,90,21.04.2019 21:15,125,11,Lvov
784,766,47,356,382,46,428,0,428,14,225,189,22.04.2019 00:30,125,11,Lvov
208,189,7,87,114,7,121,0,121,1,92,28,21.04.2019 23:10,125,11,Lvov
1056,1010,48,478,530,48,578,0,578,13,254,311,21.04.2019 21:10,125,11,Lvov
752,725,42,368,346,38,384,0,384,7,228,149,22.04.2019 01:35,125,11,Lvov
176,163,6,78,92,6,98,0,98,1,64,33,22.04.2019 00:10,125,11,Lvov
800,782,101,387,319,94,413,0,413,5,204,204,22.04.2019 00:45,125,11,Lvov
640,629,44,264,334,42,376,0,376,9,137,230,22.04.2019 01:30,125,11,Lvov
1008,968,106,475,429,104,533,0,533,6,192,335,22.04.2019 00:16,125,11,Lvov
528,554,98,133,297,98,395,0,395,0,152,243,22.04.2019 00:15,125,11,Lvov
320,299,40,140,146,34,180,0,180,4,76,100,21.04.2019 23:40,125,11,Lvov
240,232,32,95,114,31,145,0,145,5,75,65,22.04.2019 00:20,125,11,Lvov
272,43,12,244,18,10,28,0,28,0,13,15,22.04.2019 00:15,125,11,Lvov
112,18,4,94,14,4,18,0,18,0,11,7,22.04.2019 00:19,125,11,Lvov
1168,1142,23,495,651,22,673,0,673,26,273,374,22.04.2019 00:07,125,11,Lvov
1536,1514,25,645,872,19,891,0,891,27,362,502,22.04.2019 00:15,125,11,Lvov
1536,1524,27,601,912,23,935,0,935,31,408,496,22.04.2019 00:30,125,11,Lvov
1504,1470,30,649,830,25,855,0,855,24,397,434,22.04.2019 00:05,125,11,Lvov
1616,1595,31,641,945,30,975,0,975,37,458,480,22.04.2019 00:15,125,11,Lvov
1744,1727,19,761,964,19,983,0,983,38,482,463,22.04.2019 00:10,125,11,Lvov
1680,1646,14,683,986,11,997,0,997,27,445,525,21.04.2019 21:36,125,11,Lvov
1312,1296,29,532,757,23,780,0,780,36,324,420,21.04.2019 21:28,125,11,Lvov
1408,1387,14,634,762,12,774,0,774,24,331,419,22.04.2019 00:30,125,11,Lvov
1392,1375,24,592,779,21,800,0,800,31,319,450,22.04.2019 00:05,125,11,Lvov
1504,1500,23,651,836,17,853,0,853,32,405,416,21.04.2019 22:49,125,11,Lvov
1472,1469,13,560,901,11,912,0,912,26,403,483,22.04.2019 00:10,125,11,Lvov
1456,1444,31,550,880,26,906,0,906,24,404,478,22.04.2019 02:30,125,11,Lvov
1520,1513,36,645,842,33,875,0,875,45,393,437,22.04.2019 00:01,125,11,Lvov
1440,1438,26,555,860,25,885,0,885,40,396,449,21.04.2019 22:00,125,11,Lvov
1504,1474,18,623,866,15,881,0,881,30,378,473,22.04.2019 01:45,125,11,Lvov
1504,1491,24,592,892,20,912,0,912,25,457,430,22.04.2019 00:25,125,11,Lvov
1424,1409,41,580,806,38,844,0,844,22,324,498,21.04.2019 21:50,125,11,Lvov
336,80,62,277,13,46,59,0,59,3,27,29,22.04.2019 00:25,125,11,Lvov
480,469,46,169,272,39,311,0,311,5,137,169,22.04.2019 00:45,125,11,Lvov
464,456,32,187,246,31,277,0,277,5,102,170,22.04.2019 00:10,126,11,Lvov
176,168,16,61,103,12,115,0,115,1,28,86,22.04.2019 00:30,126,11,Lvov
272,267,24,58,190,24,214,0,214,6,67,141,22.04.2019 00:15,126,11,Lvov
128,128,17,30,82,16,98,0,98,1,15,82,22.04.2019 00:10,126,11,Lvov
128,117,7,37,84,7,91,0,91,5,18,68,22.04.2019 00:12,126,11,Lvov
176,167,0,33,143,0,143,0,143,6,29,108,22.04.2019 04:15,126,11,Lvov
64,57,3,12,49,3,52,0,52,0,15,37,22.04.2019 00:40,126,11,Lvov
224,216,24,38,163,23,186,0,186,0,35,151,22.04.2019 00:55,126,11,Lvov
144,138,9,34,101,9,110,0,110,1,27,82,22.04.2019 00:10,126,11,Lvov
48,37,3,14,31,3,34,0,34,0,10,24,22.04.2019 00:20,126,11,Lvov
288,276,18,31,239,18,257,0,257,5,68,184,22.04.2019 00:05,126,11,Lvov
160,155,8,32,121,7,128,0,128,9,27,92,22.04.2019 04:10,126,11,Lvov
240,230,12,48,180,12,192,0,192,18,43,131,22.04.2019 00:10,126,11,Lvov
272,267,19,82,171,19,190,0,190,3,43,144,22.04.2019 05:04,126,11,Lvov
128,113,15,43,72,13,85,0,85,1,3,81,22.04.2019 00:10,126,11,Lvov
64,66,3,11,50,3,53,0,53,0,12,41,22.04.2019 00:30,126,11,Lvov
96,83,5,20,71,5,76,0,76,0,9,67,22.04.2019 00:01,126,11,Lvov
112,109,5,17,90,5,95,0,95,9,10,76,22.04.2019 01:20,126,11,Lvov
208,209,14,42,152,14,166,0,166,4,53,109,22.04.2019 01:30,126,11,Lvov
624,646,67,134,425,65,490,0,490,9,131,350,22.04.2019 00:30,126,11,Lvov
192,181,18,48,126,18,144,0,144,1,21,122,22.04.2019 00:05,126,11,Lvov
528,510,41,118,369,41,410,0,410,7,70,333,22.04.2019 00:35,126,11,Lvov
48,46,4,5,39,4,43,0,43,0,2,41,22.04.2019 01:00,126,11,Lvov
80,66,3,29,48,3,51,0,51,1,14,36,22.04.2019 00:22,126,11,Lvov
160,159,10,31,120,9,129,0,129,0,49,80,22.04.2019 00:20,126,11,Lvov
624,605,42,137,445,42,487,0,487,7,111,369,22.04.2019 00:10,126,11,Lvov
288,291,22,77,194,17,211,0,211,4,79,128,22.04.2019 00:30,126,11,Lvov
560,541,23,139,398,23,421,0,421,8,164,249,22.04.2019 00:05,126,11,Lvov
432,425,18,79,335,18,353,0,353,6,114,233,22.04.2019 00:20,126,11,Lvov
352,341,5,46,301,5,306,0,306,15,46,245,22.04.2019 00:15,126,11,Lvov
544,522,8,190,346,8,354,0,354,14,132,208,22.04.2019 00:10,126,11,Lvov
784,773,31,163,591,30,621,0,621,11,161,449,22.04.2019 00:05,126,11,Lvov
352,340,1,115,236,1,237,0,237,4,111,122,22.04.2019 00:01,126,11,Lvov
176,164,0,43,133,0,133,0,133,16,35,82,22.04.2019 00:03,126,11,Lvov
544,525,11,149,384,11,395,0,395,12,162,221,22.04.2019 00:15,126,11,Lvov
480,475,31,133,317,30,347,0,347,6,175,166,22.04.2019 00:14,126,11,Lvov
336,330,4,88,245,3,248,0,248,1,110,137,22.04.2019 00:20,126,11,Lvov
432,417,2,154,276,2,278,0,278,3,68,207,22.04.2019 00:55,126,11,Lvov
144,137,5,34,105,5,110,0,110,1,18,91,22.04.2019 00:15,126,11,Lvov
1504,1469,7,748,753,3,756,0,756,36,268,452,22.04.2019 01:00,126,11,Lvov
1648,1619,14,806,828,14,842,0,842,28,317,497,22.04.2019 00:50,126,11,Lvov
1456,1436,9,560,887,9,896,0,896,19,277,600,22.04.2019 01:20,126,11,Lvov
1600,1562,8,658,936,6,942,0,942,22,343,577,22.04.2019 00:52,126,11,Lvov
1568,1539,11,489,1069,10,1079,0,1079,44,272,763,22.04.2019 02:15,126,11,Lvov
208,205,1,55,152,1,153,0,153,15,19,119,22.04.2019 00:18,126,11,Lvov
768,761,16,256,496,16,512,0,512,28,143,341,22.04.2019 00:01,126,11,Lvov
336,323,4,75,257,4,261,0,261,6,64,191,22.04.2019 00:05,126,11,Lvov
272,267,3,106,163,3,166,0,166,3,46,117,22.04.2019 01:40,126,11,Lvov
592,580,2,139,451,2,453,0,453,15,182,256,22.04.2019 00:10,126,11,Lvov
544,529,5,92,447,5,452,0,452,15,156,281,22.04.2019 04:20,126,11,Lvov
320,306,14,65,241,14,255,0,255,12,78,165,22.04.2019 00:45,126,11,Lvov
304,299,11,42,251,11,262,0,262,5,100,157,22.04.2019 02:00,126,11,Lvov
448,436,13,74,361,13,374,0,374,17,187,170,22.04.2019 00:07,126,11,Lvov
320,305,11,75,234,11,245,0,245,3,126,116,22.04.2019 00:40,126,11,Lvov
1520,1492,13,658,849,13,862,0,862,39,341,482,22.04.2019 00:29,126,11,Lvov
1696,1680,14,666,1016,14,1030,0,1030,35,388,607,22.04.2019 00:45,126,11,Lvov
640,622,17,188,435,17,452,0,452,27,100,325,22.04.2019 00:15,126,11,Lvov
320,305,7,83,230,7,237,0,237,0,74,163,22.04.2019 00:20,126,11,Lvov
480,463,16,157,307,16,323,0,323,16,185,122,22.04.2019 04:40,126,11,Lvov
480,477,1,63,416,1,417,0,417,14,79,324,22.04.2019 01:20,126,11,Lvov
80,76,0,23,57,0,57,0,57,0,30,27,22.04.2019 00:20,126,11,Lvov
896,876,22,229,645,22,667,0,667,13,297,357,22.04.2019 01:10,126,11,Lvov
272,262,11,71,190,11,201,0,201,1,76,124,22.04.2019 00:25,126,11,Lvov
208,200,11,65,132,11,143,0,143,4,52,87,22.04.2019 00:15,126,11,Lvov
80,77,4,20,56,4,60,0,60,0,27,33,22.04.2019 00:50,126,11,Lvov
320,311,20,75,225,20,245,0,245,6,52,187,22.04.2019 05:40,126,11,Lvov
736,729,8,296,434,6,440,0,440,6,206,228,22.04.2019 03:55,126,11,Lvov
96,92,7,19,70,7,77,0,77,1,5,71,22.04.2019 00:30,126,11,Lvov
208,202,17,52,139,17,156,0,156,6,55,95,22.04.2019 00:59,126,11,Lvov
144,126,4,43,97,4,101,0,101,3,37,61,22.04.2019 00:39,126,11,Lvov
288,270,32,95,161,32,193,0,193,4,72,117,22.04.2019 00:05,126,11,Lvov
464,459,15,108,341,15,356,0,356,9,176,171,22.04.2019 00:15,126,11,Lvov
192,176,10,62,120,10,130,0,130,3,75,52,22.04.2019 00:20,126,11,Lvov
528,521,25,189,314,25,339,0,339,12,124,203,22.04.2019 00:10,126,11,Lvov
288,277,9,63,217,8,225,0,225,3,81,141,22.04.2019 00:25,126,11,Lvov
64,64,5,4,55,5,60,0,60,1,12,47,22.04.2019 00:12,126,11,Lvov
272,257,13,97,162,13,175,0,175,2,52,121,22.04.2019 00:40,126,11,Lvov
192,185,5,55,132,5,137,0,137,0,51,86,22.04.2019 00:59,126,11,Lvov
272,264,25,96,152,24,176,0,176,7,54,115,22.04.2019 00:05,126,11,Lvov
64,60,4,29,31,4,35,0,35,0,6,29,22.04.2019 00:20,126,11,Lvov
384,380,20,110,257,17,274,0,274,6,94,174,22.04.2019 00:25,126,11,Lvov
352,342,12,121,219,12,231,0,231,1,93,137,22.04.2019 00:20,126,11,Lvov
272,264,16,84,173,15,188,0,188,3,56,129,22.04.2019 00:40,126,11,Lvov
1392,1368,41,437,915,40,955,0,955,91,332,532,22.04.2019 00:35,126,11,Lvov
1232,1209,32,528,672,32,704,0,704,15,340,349,22.04.2019 07:30,126,11,Lvov
320,307,19,51,250,19,269,0,269,22,39,208,22.04.2019 05:00,126,11,Lvov
80,63,1,39,40,1,41,0,41,2,21,18,22.04.2019 00:15,126,11,Lvov
608,591,38,119,452,37,489,0,489,10,209,270,22.04.2019 00:12,126,11,Lvov
336,329,26,59,251,26,277,0,277,3,101,173,22.04.2019 00:10,126,11,Lvov
112,102,10,46,60,6,66,0,66,0,46,20,22.04.2019 00:09,126,11,Lvov
176,165,22,36,118,22,140,0,140,12,26,102,22.04.2019 00:15,126,11,Lvov
384,371,38,140,206,38,244,0,244,8,109,127,22.04.2019 00:25,126,11,Lvov
336,321,10,56,270,10,280,0,280,4,131,145,22.04.2019 01:30,126,11,Lvov
144,144,6,24,114,6,120,0,120,8,66,46,22.04.2019 00:48,126,11,Lvov
240,230,19,55,167,18,185,0,185,10,74,101,22.04.2019 00:01,126,11,Lvov
384,372,15,71,298,15,313,0,313,2,140,171,22.04.2019 00:55,126,11,Lvov
688,679,19,140,531,17,548,0,548,1,207,340,22.04.2019 01:40,126,11,Lvov
176,168,0,49,127,0,127,0,127,1,33,93,22.04.2019 00:10,126,11,Lvov
400,391,26,36,338,26,364,0,364,5,92,267,22.04.2019 00:10,126,11,Lvov
432,412,35,132,268,32,300,0,300,7,79,214,22.04.2019 00:30,126,11,Lvov
32,25,2,18,12,2,14,0,14,0,4,10,22.04.2019 00:10,126,11,Lvov
160,148,21,67,75,18,93,0,93,1,50,42,22.04.2019 00:20,126,11,Lvov
448,437,32,160,256,32,288,0,288,11,88,189,22.04.2019 00:30,126,11,Lvov
112,110,10,28,74,10,84,0,84,0,26,58,22.04.2019 00:42,126,11,Lvov
352,343,33,53,266,33,299,0,299,9,97,193,22.04.2019 01:15,126,11,Lvov
176,45,35,133,10,33,43,0,43,1,16,26,22.04.2019 00:18,126,11,Lvov
96,36,24,64,12,20,32,0,32,2,7,23,22.04.2019 02:45,126,11,Lvov
1792,1782,56,512,1233,47,1280,0,1280,37,532,711,22.04.2019 00:15,126,11,Lvov
192,176,6,43,143,6,149,0,149,1,70,78,22.04.2019 00:55,126,11,Lvov
480,465,23,125,333,22,355,0,355,10,166,179,22.04.2019 00:30,126,11,Lvov
1072,1046,34,254,784,34,818,0,818,9,283,526,22.04.2019 00:10,126,11,Lvov
512,511,17,123,375,14,389,0,389,10,162,217,22.04.2019 00:20,126,11,Lvov
624,611,19,135,471,18,489,0,489,13,181,295,22.04.2019 00:05,126,11,Lvov
432,428,14,74,344,14,358,0,358,5,161,192,22.04.2019 00:09,126,11,Lvov
1280,1257,43,220,1017,43,1060,0,1060,31,279,750,22.04.2019 01:30,126,11,Lvov
736,724,34,175,529,32,561,0,561,16,204,341,22.04.2019 00:35,126,11,Lvov
816,802,37,275,505,36,541,0,541,15,146,380,22.04.2019 00:10,126,11,Lvov
1280,1264,48,372,861,47,908,0,908,16,287,605,22.04.2019 00:05,126,11,Lvov
592,576,34,118,441,33,474,0,474,37,151,286,22.04.2019 00:28,126,11,Lvov
304,285,10,65,229,10,239,0,239,1,98,140,22.04.2019 00:20,126,11,Lvov
864,840,20,265,581,18,599,0,599,15,258,326,22.04.2019 00:03,126,11,Lvov
1504,1484,36,358,1118,28,1146,0,1146,28,418,700,22.04.2019 00:15,126,11,Lvov
320,307,13,78,229,13,242,0,242,4,58,180,22.04.2019 00:05,126,11,Lvov
608,597,20,130,460,18,478,0,478,7,69,402,22.04.2019 03:46,126,11,Lvov
304,291,19,67,218,19,237,0,237,8,93,136,22.04.2019 02:10,126,11,Lvov
240,230,11,57,172,11,183,0,183,14,35,134,22.04.2019 01:10,126,11,Lvov
432,423,25,92,315,25,340,0,340,14,73,253,22.04.2019 00:05,126,11,Lvov
272,270,10,57,206,9,215,0,215,0,60,155,22.04.2019 00:01,126,11,Lvov
1440,1413,35,434,973,33,1006,0,1006,23,336,647,22.04.2019 00:15,126,11,Lvov
1344,1310,51,390,907,47,954,0,954,17,305,632,22.04.2019 00:10,126,11,Lvov
928,909,39,190,700,38,738,0,738,14,169,555,22.04.2019 00:15,126,11,Lvov
976,952,38,319,619,38,657,0,657,15,365,277,22.04.2019 00:15,126,11,Lvov
576,558,7,134,435,7,442,0,442,10,173,259,22.04.2019 00:01,126,11,Lvov
656,655,21,64,571,21,592,0,592,14,329,249,22.04.2019 00:17,126,11,Lvov
1056,1038,27,320,709,27,736,0,736,33,306,397,22.04.2019 00:15,126,11,Lvov
224,223,7,51,166,7,173,0,173,2,37,134,22.04.2019 00:07,126,11,Lvov
640,634,13,54,573,13,586,0,586,43,74,469,22.04.2019 01:00,126,11,Lvov
880,860,44,307,532,41,573,0,573,13,253,307,22.04.2019 00:05,126,11,Lvov
1360,1340,31,425,905,30,935,0,935,27,408,500,22.04.2019 00:05,126,11,Lvov
896,882,31,235,631,30,661,0,661,9,168,484,22.04.2019 02:02,126,11,Lvov
1200,1182,62,201,940,59,999,0,999,64,328,607,22.04.2019 00:15,126,11,Lvov
272,259,12,64,196,12,208,0,208,3,86,119,22.04.2019 00:25,126,11,Lvov
432,423,23,48,361,23,384,0,384,58,56,270,22.04.2019 00:12,126,11,Lvov
816,813,45,145,627,44,671,0,671,11,151,509,22.04.2019 01:10,126,11,Lvov
608,592,12,139,458,11,469,0,469,9,156,304,22.04.2019 00:07,126,11,Lvov
256,245,11,43,203,10,213,0,213,4,41,168,22.04.2019 00:10,126,11,Lvov
1584,1566,42,444,1098,42,1140,0,1140,39,396,705,22.04.2019 00:10,126,11,Lvov
288,274,10,88,190,10,200,0,200,5,63,132,22.04.2019 00:05,126,11,Lvov
752,733,48,125,580,47,627,0,627,43,119,465,22.04.2019 00:25,126,11,Lvov
1152,1138,12,391,753,8,761,0,761,23,273,465,22.04.2019 00:15,126,11,Lvov
320,307,3,95,222,3,225,0,225,18,69,138,22.04.2019 01:05,126,11,Lvov
160,158,0,23,137,0,137,0,137,3,20,114,22.04.2019 00:20,126,11,Lvov
320,303,22,85,213,22,235,0,235,2,137,96,22.04.2019 00:05,126,11,Lvov
480,461,10,113,357,10,367,0,367,6,161,200,22.04.2019 00:10,126,11,Lvov
720,711,16,150,554,16,570,0,570,6,237,327,22.04.2019 00:10,126,11,Lvov
400,399,16,41,343,16,359,0,359,4,62,293,22.04.2019 01:30,126,11,Lvov
832,826,49,181,602,49,651,0,651,14,175,462,22.04.2019 00:10,126,11,Lvov
608,603,44,160,409,39,448,0,448,11,179,258,22.04.2019 01:35,126,11,Lvov
960,944,20,335,607,18,625,0,625,15,257,353,22.04.2019 00:20,126,11,Lvov
784,772,16,241,527,16,543,0,543,16,192,335,22.04.2019 00:15,126,11,Lvov
560,548,9,201,350,9,359,0,359,6,176,177,22.04.2019 00:50,126,11,Lvov
704,690,57,102,545,57,602,0,602,30,190,382,22.04.2019 00:30,126,11,Lvov
400,396,17,56,327,17,344,0,344,5,115,224,22.04.2019 00:10,126,11,Lvov
480,461,12,90,378,12,390,0,390,14,130,246,22.04.2019 00:30,126,11,Lvov
992,965,26,199,769,24,793,0,793,20,286,487,22.04.2019 00:10,126,11,Lvov
1376,1353,42,373,963,40,1003,0,1003,29,403,571,22.04.2019 00:40,126,11,Lvov
352,343,3,67,282,3,285,0,285,11,163,111,22.04.2019 00:03,126,11,Lvov
688,683,25,163,500,25,525,0,525,12,275,238,22.04.2019 00:05,126,11,Lvov
1808,1954,20,529,1261,18,1279,0,1279,26,481,772,22.04.2019 00:07,126,11,Lvov
1872,1958,24,594,1258,20,1278,0,1278,25,565,688,22.04.2019 00:05,126,11,Lvov
2336,2311,26,981,1334,21,1355,0,1355,35,598,722,22.04.2019 05:10,126,11,Lvov
2192,2180,25,866,1305,21,1326,0,1326,35,556,735,22.04.2019 00:12,126,11,Lvov
1728,1713,22,629,1082,17,1099,0,1099,41,433,625,22.04.2019 00:10,126,11,Lvov
2144,2129,8,799,1340,5,1345,0,1345,52,553,740,22.04.2019 00:03,126,11,Lvov
2000,2003,30,765,1208,27,1235,0,1235,37,536,662,22.04.2019 00:30,126,11,Lvov
1872,1868,19,742,1118,12,1130,0,1130,41,424,665,22.04.2019 00:30,126,11,Lvov
1248,1237,32,488,732,28,760,0,760,30,289,441,22.04.2019 00:15,126,11,Lvov
1600,1576,13,604,984,12,996,0,996,45,410,541,22.04.2019 00:30,126,11,Lvov
1232,1221,14,514,709,9,718,0,718,21,320,377,22.04.2019 00:40,126,11,Lvov
2192,2156,20,846,1329,17,1346,0,1346,51,549,746,22.04.2019 00:15,126,11,Lvov
1344,1314,25,566,762,16,778,0,778,30,335,413,22.04.2019 00:10,126,11,Lvov
1776,1750,24,712,1047,17,1064,0,1064,38,482,544,22.04.2019 00:15,126,11,Lvov
1600,1597,35,630,937,33,970,0,970,34,463,473,22.04.2019 01:20,126,11,Lvov
1760,1730,42,713,1023,24,1047,0,1047,33,467,547,22.04.2019 00:05,126,11,Lvov
1440,1405,24,542,876,22,898,0,898,26,400,472,22.04.2019 00:20,126,11,Lvov
1760,1688,27,706,1036,18,1054,0,1054,34,527,493,22.04.2019 00:35,126,11,Lvov
1376,1374,12,571,797,8,805,0,805,27,452,326,22.04.2019 02:08,126,11,Lvov
1376,1357,7,570,800,6,806,0,806,23,398,385,22.04.2019 00:07,126,11,Lvov
1424,1409,10,628,787,9,796,0,796,27,427,342,22.04.2019 02:45,126,11,Lvov
1152,1141,25,505,625,22,647,0,647,23,254,370,22.04.2019 00:05,126,11,Lvov
1264,1262,38,459,774,31,805,0,805,28,258,519,22.04.2019 00:07,126,11,Lvov
1856,1836,22,695,1140,21,1161,0,1161,46,440,675,22.04.2019 01:05,126,11,Lvov
288,128,37,176,78,34,112,0,112,6,42,64,22.04.2019 00:07,126,11,Lvov
160,45,0,118,42,0,42,0,42,1,16,25,22.04.2019 00:30,126,11,Lvov
224,11,7,214,4,6,10,0,10,0,6,4,22.04.2019 00:10,126,11,Lvov
1760,1754,26,758,982,20,1002,0,1002,20,869,113,22.04.2019 00:06,127,12,Nikolaev
1088,1064,38,498,561,29,590,0,590,8,530,52,21.04.2019 23:50,127,12,Nikolaev
448,440,10,199,241,8,249,0,249,3,233,13,22.04.2019 00:05,127,12,Nikolaev
112,110,4,45,67,0,67,0,67,1,59,7,21.04.2019 21:50,127,12,Nikolaev
160,157,6,50,105,5,110,0,110,1,79,30,21.04.2019 21:50,127,12,Nikolaev
208,201,8,76,125,7,132,0,132,1,115,16,21.04.2019 20:59,127,12,Nikolaev
112,113,3,36,73,3,76,0,76,0,68,8,21.04.2019 23:05,127,12,Nikolaev
352,347,10,138,205,9,214,0,214,1,187,26,21.04.2019 22:10,127,12,Nikolaev
1184,1186,48,402,747,35,782,0,782,16,677,89,21.04.2019 23:00,127,12,Nikolaev
400,383,5,182,214,4,218,0,218,4,175,39,21.04.2019 20:41,127,12,Nikolaev
416,396,5,206,208,2,210,0,210,0,182,28,21.04.2019 21:48,127,12,Nikolaev
1024,1016,46,442,541,41,582,0,582,11,483,88,21.04.2019 21:10,127,12,Nikolaev
512,498,13,216,284,12,296,0,296,1,263,32,21.04.2019 21:14,127,12,Nikolaev
528,507,7,230,292,6,298,0,298,3,260,35,21.04.2019 20:42,127,12,Nikolaev
256,245,12,129,116,11,127,0,127,1,106,20,21.04.2019 20:51,127,12,Nikolaev
304,293,5,148,151,5,156,0,156,3,143,10,21.04.2019 21:35,127,12,Nikolaev
224,218,3,97,124,3,127,0,127,1,115,11,21.04.2019 20:50,127,12,Nikolaev
720,713,26,272,427,21,448,0,448,7,390,51,22.04.2019 00:15,127,12,Nikolaev
256,252,12,110,137,9,146,0,146,2,127,17,21.04.2019 21:10,127,12,Nikolaev
1200,1177,39,478,689,33,722,0,722,17,606,99,21.04.2019 21:30,127,12,Nikolaev
720,710,34,288,400,32,432,0,432,10,371,51,21.04.2019 21:00,127,12,Nikolaev
192,174,0,113,79,0,79,0,79,0,68,11,21.04.2019 20:32,127,12,Nikolaev
176,165,0,92,84,0,84,0,84,1,74,9,21.04.2019 20:35,127,12,Nikolaev
736,725,33,302,407,27,434,0,434,4,360,70,21.04.2019 23:40,127,12,Nikolaev
720,710,28,251,446,23,469,0,469,8,418,43,22.04.2019 00:05,127,12,Nikolaev
1232,1214,32,624,580,28,608,0,608,14,548,46,21.04.2019 21:22,127,12,Nikolaev
448,431,3,217,228,3,231,0,231,3,213,15,21.04.2019 22:05,127,12,Nikolaev
176,174,0,86,90,0,90,0,90,0,76,14,21.04.2019 21:20,127,12,Nikolaev
144,139,3,47,94,3,97,0,97,1,86,10,22.04.2019 01:05,127,12,Nikolaev
880,859,33,379,476,25,501,0,501,13,442,46,21.04.2019 21:45,127,12,Nikolaev
656,639,19,289,350,17,367,0,367,6,317,44,21.04.2019 21:05,127,12,Nikolaev
1520,1501,42,606,879,35,914,0,914,13,730,171,21.04.2019 21:50,127,12,Nikolaev
688,677,27,249,413,26,439,0,439,9,367,63,21.04.2019 22:30,127,12,Nikolaev
1440,1423,41,524,879,37,916,0,916,10,836,70,21.04.2019 21:15,127,12,Nikolaev
400,389,20,182,202,16,218,0,218,2,195,21,21.04.2019 21:25,127,12,Nikolaev
784,768,15,375,400,9,409,0,409,7,332,70,21.04.2019 22:40,127,12,Nikolaev
1280,1250,32,537,716,27,743,0,743,11,612,120,21.04.2019 21:26,127,12,Nikolaev
208,198,12,80,117,11,128,0,128,2,99,27,21.04.2019 21:45,127,12,Nikolaev
496,481,5,223,269,4,273,0,273,2,231,40,21.04.2019 21:40,127,12,Nikolaev
144,130,3,64,77,3,80,0,80,0,50,30,21.04.2019 22:30,127,12,Nikolaev
128,124,15,49,66,13,79,0,79,0,63,16,21.04.2019 20:40,127,12,Nikolaev
256,243,3,129,125,2,127,0,127,1,105,21,22.04.2019 04:55,127,12,Nikolaev
144,137,1,69,75,0,75,0,75,0,62,13,21.04.2019 21:50,127,12,Nikolaev
112,97,0,60,52,0,52,0,52,0,45,7,21.04.2019 22:00,127,12,Nikolaev
416,142,12,290,116,10,126,0,126,5,109,12,22.04.2019 00:05,127,12,Nikolaev
1088,253,22,843,223,22,245,0,245,9,224,12,21.04.2019 21:30,127,12,Nikolaev
880,863,40,354,488,38,526,0,526,7,435,84,21.04.2019 21:21,127,12,Nikolaev
1104,1079,50,451,613,40,653,0,653,3,576,74,21.04.2019 23:17,127,12,Nikolaev
112,103,6,41,65,6,71,0,71,0,56,15,21.04.2019 22:10,127,12,Nikolaev
160,154,11,59,90,11,101,0,101,0,80,21,21.04.2019 21:15,127,12,Nikolaev
112,101,1,52,59,1,60,0,60,1,49,10,21.04.2019 21:00,127,12,Nikolaev
864,854,37,346,491,27,518,0,518,6,441,71,22.04.2019 00:30,127,12,Nikolaev
1552,1506,37,655,863,34,897,0,897,13,807,77,21.04.2019 22:30,127,12,Nikolaev
384,371,23,164,199,21,220,0,220,3,189,28,21.04.2019 21:30,127,12,Nikolaev
208,204,9,86,113,9,122,0,122,4,96,22,21.04.2019 20:30,127,12,Nikolaev
1584,1552,32,631,928,25,953,0,953,10,877,66,21.04.2019 21:06,127,12,Nikolaev
144,147,13,64,67,13,80,0,80,2,67,11,21.04.2019 23:15,127,12,Nikolaev
256,267,11,61,184,11,195,0,195,0,180,15,22.04.2019 00:30,127,12,Nikolaev
96,112,4,31,61,4,65,0,65,0,51,14,21.04.2019 20:31,127,12,Nikolaev
736,709,33,350,356,30,386,0,386,9,310,67,21.04.2019 21:10,127,12,Nikolaev
320,314,4,120,198,2,200,0,200,3,175,22,21.04.2019 20:33,127,12,Nikolaev
624,603,12,295,320,9,329,0,329,7,267,55,21.04.2019 21:28,127,12,Nikolaev
1872,1823,76,842,962,68,1030,0,1030,20,859,151,22.04.2019 01:33,127,12,Nikolaev
2032,1995,35,908,1102,22,1124,0,1124,29,963,132,22.04.2019 00:35,127,12,Nikolaev
1360,1334,34,661,671,28,699,0,699,16,606,77,21.04.2019 23:45,127,12,Nikolaev
1168,1142,31,523,618,27,645,0,645,9,563,73,22.04.2019 02:00,127,12,Nikolaev
2112,2129,18,912,1191,9,1200,0,1200,33,1017,150,22.04.2019 00:45,127,12,Nikolaev
2160,2137,21,757,1392,11,1403,0,1403,34,1219,150,22.04.2019 00:10,127,12,Nikolaev
2064,2031,16,706,1345,13,1358,0,1358,28,1142,188,22.04.2019 03:42,127,12,Nikolaev
2112,2073,12,758,1346,8,1354,0,1354,25,1194,135,22.04.2019 00:05,127,12,Nikolaev
2272,2236,15,775,1487,10,1497,0,1497,26,1311,160,22.04.2019 00:20,127,12,Nikolaev
2256,2204,10,776,1471,9,1480,0,1480,28,1284,168,22.04.2019 00:10,127,12,Nikolaev
2240,2206,25,764,1456,20,1476,0,1476,39,1255,182,22.04.2019 00:17,127,12,Nikolaev
1808,1786,33,638,1149,21,1170,0,1170,29,1011,130,21.04.2019 22:50,127,12,Nikolaev
1296,1279,30,464,812,20,832,0,832,16,719,97,21.04.2019 23:40,127,12,Nikolaev
2176,2148,20,865,1294,17,1311,0,1311,21,1119,171,22.04.2019 00:07,127,12,Nikolaev
2224,2182,24,806,1399,19,1418,0,1418,44,1194,180,21.04.2019 21:23,127,12,Nikolaev
2400,2369,35,898,1480,22,1502,0,1502,14,1322,166,21.04.2019 21:00,127,12,Nikolaev
2224,2191,12,898,1317,9,1326,0,1326,20,1153,153,21.04.2019 22:30,127,12,Nikolaev
1792,1769,19,630,1154,8,1162,0,1162,39,948,175,22.04.2019 00:05,127,12,Nikolaev
2128,2104,22,689,1429,10,1439,0,1439,39,1181,219,22.04.2019 00:15,127,12,Nikolaev
2192,2152,30,864,1310,18,1328,0,1328,31,1111,186,22.04.2019 01:50,127,12,Nikolaev
1888,1863,11,685,1194,9,1203,0,1203,32,969,202,22.04.2019 00:45,127,12,Nikolaev
1888,1862,29,728,1140,20,1160,0,1160,25,956,179,22.04.2019 01:47,127,12,Nikolaev
1936,1916,21,751,1173,12,1185,0,1185,26,1031,128,22.04.2019 00:10,127,12,Nikolaev
1856,1827,24,623,1222,11,1233,0,1233,30,1041,162,22.04.2019 00:03,127,12,Nikolaev
1888,1892,20,685,1189,14,1203,0,1203,30,1020,153,22.04.2019 00:03,127,12,Nikolaev
1568,1574,18,597,959,12,971,0,970,17,837,116,22.04.2019 00:30,127,12,Nikolaev
1520,1501,19,595,916,9,925,0,925,26,822,77,22.04.2019 00:35,127,12,Nikolaev
1504,1481,11,611,887,6,893,0,893,23,732,138,22.04.2019 00:20,127,12,Nikolaev
1392,1391,14,537,846,9,855,0,855,29,741,85,22.04.2019 00:20,127,12,Nikolaev
2233,2214,31,838,1374,21,1395,0,1395,25,1177,193,21.04.2019 22:14,127,12,Nikolaev
2192,2175,24,793,1383,16,1399,0,1399,43,1157,199,22.04.2019 00:10,127,12,Nikolaev
2160,2137,19,745,1400,15,1415,0,1415,21,1176,218,22.04.2019 00:07,127,12,Nikolaev
1504,1496,18,606,884,14,898,0,898,17,803,78,21.04.2019 22:30,127,12,Nikolaev
2160,2130,19,864,1277,19,1296,0,1296,30,1140,126,22.04.2019 01:15,127,12,Nikolaev
2448,2424,20,1014,1425,9,1434,0,1434,26,1256,152,22.04.2019 00:10,127,12,Nikolaev
1072,1055,23,460,589,23,612,0,612,8,544,60,21.04.2019 21:05,127,12,Nikolaev
272,92,18,188,67,17,84,0,84,2,74,8,22.04.2019 00:05,127,12,Nikolaev
528,123,55,416,61,51,112,0,112,0,96,16,21.04.2019 23:30,127,12,Nikolaev
128,61,0,73,55,0,55,0,55,0,49,6,21.04.2019 23:30,127,12,Nikolaev
368,47,34,326,16,26,42,0,42,0,38,4,21.04.2019 23:10,127,12,Nikolaev
2304,2272,17,888,1405,11,1416,0,1416,16,1273,127,22.04.2019 00:30,128,12,Nikolaev
2048,2025,16,738,1295,15,1310,0,1310,20,1198,92,22.04.2019 00:17,128,12,Nikolaev
1712,1685,15,603,1095,14,1109,0,1109,13,982,114,21.04.2019 21:15,128,12,Nikolaev
2208,2183,14,862,1340,6,1346,0,1346,30,1171,145,22.04.2019 00:30,128,12,Nikolaev
1504,1479,12,536,961,7,968,0,968,20,843,105,22.04.2019 01:40,128,12,Nikolaev
1744,1733,14,603,1133,8,1141,0,1141,24,1001,116,22.04.2019 00:20,128,12,Nikolaev
2464,2451,17,889,1564,11,1575,0,1575,38,1341,196,21.04.2019 23:30,128,12,Nikolaev
2112,2112,6,803,1304,5,1309,0,1309,20,1169,120,22.04.2019 00:10,128,12,Nikolaev
1632,1617,11,601,1023,8,1031,0,1031,26,871,134,22.04.2019 00:20,128,12,Nikolaev
2368,2356,14,1044,1311,13,1324,0,1324,32,1187,105,22.04.2019 01:52,128,12,Nikolaev
1440,1428,2,597,841,2,843,0,843,26,740,77,22.04.2019 00:30,128,12,Nikolaev
1536,1517,5,612,920,4,924,0,924,30,807,87,22.04.2019 00:59,128,12,Nikolaev
2384,2349,19,878,1492,14,1506,0,1506,33,1307,166,22.04.2019 00:05,128,12,Nikolaev
1759,1734,14,678,1073,8,1081,0,1081,26,932,123,22.04.2019 03:45,128,12,Nikolaev
2176,2152,3,832,1341,3,1344,0,1344,38,1177,129,22.04.2019 01:00,128,12,Nikolaev
2272,2246,19,812,1444,16,1460,0,1460,20,1280,160,22.04.2019 00:20,128,12,Nikolaev
1760,1753,10,710,1042,8,1050,0,1050,27,920,103,21.04.2019 21:22,128,12,Nikolaev
2480,2441,12,887,1582,11,1593,0,1593,27,1414,152,22.04.2019 00:15,128,12,Nikolaev
2368,2324,14,841,1517,10,1527,0,1527,26,1334,167,22.04.2019 05:40,128,12,Nikolaev
2256,2222,5,781,1473,2,1475,0,1475,26,1314,135,22.04.2019 00:22,128,12,Nikolaev
2160,2124,13,743,1412,5,1417,0,1417,44,1200,171,22.04.2019 00:05,128,12,Nikolaev
2160,2132,11,788,1365,7,1372,0,1372,35,1186,151,22.04.2019 00:15,128,12,Nikolaev
2048,2016,17,664,1368,16,1384,0,1384,24,1221,139,22.04.2019 00:10,128,12,Nikolaev
2064,2026,10,759,1301,4,1305,0,1305,22,1134,148,22.04.2019 06:30,128,12,Nikolaev
1968,1941,16,893,1064,11,1075,0,1075,21,943,111,22.04.2019 00:10,128,12,Nikolaev
1968,1954,9,760,1204,4,1208,0,1208,32,1051,125,22.04.2019 00:05,128,12,Nikolaev
2224,2230,10,686,1531,7,1538,0,1538,27,1311,200,22.04.2019 00:50,128,12,Nikolaev
1680,1651,10,705,965,10,975,0,975,14,874,87,22.04.2019 00:15,128,12,Nikolaev
1776,1759,10,699,1072,5,1077,0,1077,27,939,111,22.04.2019 00:35,128,12,Nikolaev
2400,2376,21,890,1495,15,1510,0,1510,32,1321,157,22.04.2019 00:45,128,12,Nikolaev
2384,2359,10,864,1513,7,1520,0,1520,21,1360,139,22.04.2019 00:03,128,12,Nikolaev
320,146,23,185,114,21,135,0,135,5,119,11,22.04.2019 00:05,128,12,Nikolaev
1456,1464,6,449,1003,4,1007,0,1007,22,865,120,22.04.2019 00:15,128,12,Nikolaev
1552,1533,4,590,959,3,962,0,962,14,841,107,22.04.2019 00:11,128,12,Nikolaev
1712,1707,15,618,1082,12,1094,0,1094,19,937,138,22.04.2019 01:50,128,12,Nikolaev
2096,2083,14,738,1349,9,1358,0,1358,24,1188,146,22.04.2019 01:02,128,12,Nikolaev
2144,2115,6,882,1259,3,1262,0,1262,29,1092,141,22.04.2019 00:10,128,12,Nikolaev
2224,2166,11,1834,386,4,390,0,390,2,347,41,22.04.2019 00:15,128,12,Nikolaev
2032,1998,13,705,1321,6,1327,0,1327,17,1151,159,22.04.2019 00:07,128,12,Nikolaev
2096,2059,11,740,1345,11,1356,0,1356,26,1167,162,22.04.2019 00:05,128,12,Nikolaev
1856,1829,13,653,1193,10,1203,0,1203,21,1027,155,22.04.2019 00:10,128,12,Nikolaev
1968,1957,4,775,1191,2,1193,0,1193,25,1042,126,22.04.2019 00:03,128,12,Nikolaev
1760,1746,17,564,1186,10,1196,0,1195,28,1023,144,22.04.2019 00:05,128,12,Nikolaev
2032,2008,22,710,1302,20,1322,0,1322,48,1102,172,21.04.2019 23:40,128,12,Nikolaev
2192,2166,12,881,1305,6,1311,0,1311,25,1128,158,22.04.2019 00:15,128,12,Nikolaev
1904,1875,10,650,1248,6,1254,0,1254,22,1063,169,22.04.2019 04:33,128,12,Nikolaev
2320,2300,13,898,1413,9,1422,0,1422,30,1227,165,22.04.2019 00:05,128,12,Nikolaev
2304,2282,19,916,1377,11,1388,0,1388,27,1187,174,22.04.2019 00:01,128,12,Nikolaev
2288,2252,22,882,1386,20,1406,0,1406,37,1252,117,21.04.2019 23:35,128,12,Nikolaev
2288,2260,126,798,1370,120,1490,0,1490,44,1290,156,22.04.2019 00:27,128,12,Nikolaev
1984,1960,10,720,1258,6,1264,0,1264,31,1097,136,22.04.2019 00:15,128,12,Nikolaev
1872,1849,6,700,1166,6,1172,0,1172,31,1055,86,22.04.2019 00:10,128,12,Nikolaev
1808,1787,8,732,1068,8,1076,0,1076,19,918,139,22.04.2019 03:38,128,12,Nikolaev
2080,2064,6,703,1371,6,1377,0,1377,35,1170,172,22.04.2019 00:50,128,12,Nikolaev
1952,1935,12,703,1242,7,1249,0,1249,33,1056,160,22.04.2019 00:35,128,12,Nikolaev
1648,1626,12,596,1046,6,1052,0,1052,29,906,117,22.04.2019 01:10,128,12,Nikolaev
1600,1605,3,537,1061,2,1063,0,1063,22,953,88,22.04.2019 00:10,128,12,Nikolaev
1376,1345,6,452,921,3,924,0,924,17,811,96,22.04.2019 03:10,128,12,Nikolaev
1840,1825,20,664,1162,14,1176,0,1176,16,1029,131,22.04.2019 00:45,128,12,Nikolaev
2096,2063,21,776,1302,18,1320,0,1320,40,1140,140,22.04.2019 00:10,128,12,Nikolaev
2128,2091,6,944,1178,6,1184,0,1184,20,1045,119,22.04.2019 00:06,128,12,Nikolaev
1840,1821,20,629,1195,16,1211,0,1211,31,1039,141,22.04.2019 02:10,128,12,Nikolaev
2016,1997,17,675,1330,11,1341,0,1341,39,1139,163,22.04.2019 00:05,128,12,Nikolaev
1488,1467,5,536,948,4,952,0,952,35,819,98,22.04.2019 00:50,128,12,Nikolaev
2080,2057,17,726,1343,11,1354,0,1354,30,1191,133,22.04.2019 00:22,128,12,Nikolaev
1392,1379,8,471,913,8,921,0,921,24,814,83,22.04.2019 02:30,128,12,Nikolaev
1520,1488,14,520,989,11,1000,0,1000,29,868,103,22.04.2019 00:05,128,12,Nikolaev
2224,2192,13,807,1406,11,1417,0,1417,39,1212,166,22.04.2019 00:10,128,12,Nikolaev
2207,2177,24,753,1433,21,1454,0,1454,34,1258,162,22.04.2019 00:07,128,12,Nikolaev
1552,1541,9,573,972,7,979,0,979,23,844,112,22.04.2019 00:02,128,12,Nikolaev
1664,1638,10,690,965,9,974,0,974,14,867,93,22.04.2019 00:10,128,12,Nikolaev
2288,2262,11,840,1441,7,1448,0,1448,32,1241,175,22.04.2019 00:05,128,12,Nikolaev
2048,2019,10,850,1190,8,1198,0,1198,19,1075,104,22.04.2019 01:30,128,12,Nikolaev
2000,1960,7,706,1289,5,1294,0,1294,20,1159,115,22.04.2019 00:01,128,12,Nikolaev
2288,2254,10,824,1455,9,1464,0,1464,24,1267,173,22.04.2019 01:15,128,12,Nikolaev
1680,1637,6,587,1088,5,1093,0,1093,21,921,151,22.04.2019 00:05,128,12,Nikolaev
2064,2020,4,794,1267,3,1270,0,1270,19,1109,142,22.04.2019 00:31,128,12,Nikolaev
2048,2005,6,749,1294,5,1299,0,1299,30,1115,154,22.04.2019 01:35,128,12,Nikolaev
2160,2129,2,739,1420,1,1421,0,1421,33,1223,165,21.04.2019 22:00,128,12,Nikolaev
2240,2200,9,870,1365,5,1370,0,1370,18,1225,127,22.04.2019 00:02,128,12,Nikolaev
2352,2289,15,1013,1328,11,1339,0,1339,26,1163,150,22.04.2019 00:01,128,12,Nikolaev
2016,1991,20,715,1290,11,1301,0,1301,33,1128,140,22.04.2019 00:15,128,12,Nikolaev
2160,2124,11,730,1420,10,1430,0,1430,34,1229,167,22.04.2019 00:15,128,12,Nikolaev
128,47,0,87,41,0,41,0,41,0,39,2,22.04.2019 00:05,128,12,Nikolaev
160,20,0,143,17,0,17,0,17,0,14,3,22.04.2019 00:05,128,12,Nikolaev
304,140,15,179,110,15,125,0,125,7,102,16,22.04.2019 00:25,128,12,Nikolaev
416,190,67,230,123,63,186,0,186,2,175,9,22.04.2019 00:05,128,12,Nikolaev
128,30,20,101,10,17,27,0,27,1,24,2,22.04.2019 00:03,128,12,Nikolaev
96,50,0,51,45,0,45,0,45,0,39,6,22.04.2019 00:10,128,12,Nikolaev
736,727,0,10,726,0,726,0,726,52,648,26,22.04.2019 06:53,129,12,Nikolaev
2176,2154,61,859,1270,47,1317,0,1317,30,1171,116,22.04.2019 05:45,129,12,Nikolaev
1568,1550,37,638,901,29,930,0,930,20,808,102,22.04.2019 05:40,129,12,Nikolaev
608,595,19,285,304,19,323,0,323,3,283,37,22.04.2019 01:15,129,12,Nikolaev
1936,1907,52,879,1010,47,1057,0,1057,20,963,74,22.04.2019 00:32,129,12,Nikolaev
592,591,7,268,319,5,324,0,324,4,289,31,22.04.2019 02:07,129,12,Nikolaev
352,344,5,150,197,5,202,0,202,1,160,41,22.04.2019 04:58,129,12,Nikolaev
336,316,4,178,154,4,158,0,158,1,126,31,22.04.2019 04:32,129,12,Nikolaev
1072,1041,42,346,684,42,726,0,726,6,663,57,22.04.2019 05:31,129,12,Nikolaev
2080,2039,50,805,1230,45,1275,0,1275,24,1074,177,22.04.2019 01:32,129,12,Nikolaev
1248,1235,50,525,681,42,723,0,723,15,652,56,22.04.2019 00:29,129,12,Nikolaev
384,377,5,167,212,5,217,0,217,4,187,26,22.04.2019 00:22,129,12,Nikolaev
208,200,5,95,108,5,113,0,113,0,94,19,22.04.2019 01:29,129,12,Nikolaev
992,973,28,373,591,28,619,0,619,6,559,54,22.04.2019 04:05,129,12,Nikolaev
1168,1153,31,476,667,25,692,0,692,10,618,64,22.04.2019 00:40,129,12,Nikolaev
1376,1357,23,568,787,21,808,0,808,8,744,56,22.04.2019 00:40,129,12,Nikolaev
624,622,32,216,377,31,408,0,408,5,357,46,22.04.2019 06:09,129,12,Nikolaev
432,428,10,162,263,7,270,0,270,2,260,8,22.04.2019 04:15,129,12,Nikolaev
400,389,11,149,247,4,251,0,251,1,218,32,22.04.2019 04:10,129,12,Nikolaev
1648,1627,10,793,850,5,855,0,855,19,750,86,22.04.2019 03:25,129,12,Nikolaev
1792,1768,45,773,978,41,1019,0,1019,16,903,100,22.04.2019 03:10,129,12,Nikolaev
928,906,13,396,521,11,532,0,532,9,472,51,22.04.2019 03:05,129,12,Nikolaev
128,123,27,10,91,27,118,0,118,3,95,20,22.04.2019 03:50,129,12,Nikolaev
1472,1441,17,606,851,15,866,0,866,21,752,93,22.04.2019 01:07,129,12,Nikolaev
1328,1314,8,541,779,8,787,0,787,15,691,81,22.04.2019 00:57,129,12,Nikolaev
1888,1870,19,758,1114,16,1130,0,1130,18,978,134,22.04.2019 05:21,129,12,Nikolaev
1616,1589,2,765,849,2,851,0,851,4,794,53,22.04.2019 00:17,129,12,Nikolaev
480,463,24,200,263,17,280,0,280,2,246,32,22.04.2019 03:30,129,12,Nikolaev
912,891,6,380,528,4,532,0,532,10,478,44,22.04.2019 03:20,129,12,Nikolaev
816,799,46,335,439,42,481,0,481,11,435,35,22.04.2019 03:58,129,12,Nikolaev
240,233,16,96,130,14,144,0,144,1,117,26,22.04.2019 03:57,129,12,Nikolaev
432,416,15,209,208,15,223,0,223,1,167,55,22.04.2019 04:56,129,12,Nikolaev
272,263,10,70,192,10,202,0,202,2,169,31,22.04.2019 05:05,129,12,Nikolaev
1312,1300,20,571,728,13,741,0,741,15,653,73,22.04.2019 01:25,129,12,Nikolaev
1104,1081,19,475,612,17,629,0,629,10,526,93,22.04.2019 02:30,129,12,Nikolaev
2160,2139,18,799,1345,16,1361,0,1361,48,1162,151,22.04.2019 02:00,129,12,Nikolaev
1168,1146,31,545,592,31,623,0,623,14,539,70,22.04.2019 03:15,129,12,Nikolaev
864,833,35,329,503,32,535,0,535,5,472,58,22.04.2019 03:15,129,12,Nikolaev
2176,2151,53,1004,1131,41,1172,0,1172,17,1030,125,22.04.2019 04:50,129,12,Nikolaev
320,314,8,120,194,6,200,0,200,3,174,23,22.04.2019 02:35,129,12,Nikolaev
192,177,8,86,102,4,106,0,106,0,79,27,22.04.2019 04:35,129,12,Nikolaev
672,646,5,295,372,5,377,0,377,7,321,49,22.04.2019 04:04,129,12,Nikolaev
2256,2213,7,975,1275,6,1281,0,1281,27,1109,145,22.04.2019 04:40,129,12,Nikolaev
1712,1697,13,678,1026,8,1034,0,1034,30,899,105,22.04.2019 05:00,129,12,Nikolaev
2032,1985,11,787,1239,6,1245,0,1245,43,1044,158,22.04.2019 01:59,129,12,Nikolaev
2272,2225,19,919,1336,17,1353,0,1353,27,1127,199,22.04.2019 06:19,129,12,Nikolaev
1616,1774,18,501,1105,10,1115,0,1115,35,875,205,22.04.2019 04:25,129,12,Nikolaev
2000,1988,21,753,1230,17,1247,0,1247,40,993,214,22.04.2019 06:50,129,12,Nikolaev
2176,2151,26,844,1311,21,1332,0,1332,55,1071,206,22.04.2019 02:11,129,12,Nikolaev
1824,1802,3,705,1118,1,1119,0,1119,28,904,187,22.04.2019 06:20,129,12,Nikolaev
1120,1111,11,469,642,9,651,0,651,14,512,125,22.04.2019 02:50,129,12,Nikolaev
1488,1474,16,595,882,11,893,0,893,18,742,133,22.04.2019 00:48,129,12,Nikolaev
2304,2267,9,950,1345,9,1354,0,1354,32,1097,225,22.04.2019 06:20,129,12,Nikolaev
1632,1640,17,630,992,10,1002,0,1002,30,823,149,22.04.2019 06:32,129,12,Nikolaev
1568,1573,16,566,989,13,1002,0,1002,27,787,188,22.04.2019 04:45,129,12,Nikolaev
1904,1884,8,792,1106,6,1112,0,1112,27,880,205,22.04.2019 02:20,129,12,Nikolaev
1040,1039,11,378,653,9,662,0,662,14,533,115,22.04.2019 02:45,129,12,Nikolaev
1216,1236,8,426,788,2,790,0,790,18,675,97,22.04.2019 03:45,129,12,Nikolaev
1712,1691,12,639,1063,10,1073,0,1073,20,881,172,22.04.2019 00:54,129,12,Nikolaev
1344,1332,2,594,749,1,750,0,750,14,615,121,22.04.2019 05:55,129,12,Nikolaev
2064,2057,6,689,1371,4,1375,0,1375,46,1149,180,22.04.2019 06:10,129,12,Nikolaev
2128,2122,6,696,1426,6,1432,0,1432,38,1218,176,22.04.2019 01:39,129,12,Nikolaev
1664,1656,9,626,1030,8,1038,0,1038,33,864,141,22.04.2019 03:49,129,12,Nikolaev
1760,1767,14,600,1150,10,1160,0,1160,22,922,216,22.04.2019 00:28,129,12,Nikolaev
1792,1764,13,651,1130,11,1141,0,1141,23,958,160,22.04.2019 05:55,129,12,Nikolaev
1824,1815,3,630,1193,1,1194,0,1194,41,987,166,22.04.2019 05:05,129,12,Nikolaev
1568,1568,29,564,985,19,1004,0,1004,34,847,123,22.04.2019 01:11,129,12,Nikolaev
2032,1994,12,715,1307,10,1317,0,1317,24,1111,181,22.04.2019 06:10,129,12,Nikolaev
2144,2130,19,723,1403,18,1421,0,1421,27,1209,185,22.04.2019 04:30,129,12,Nikolaev
2176,2146,18,743,1419,14,1433,0,1433,47,1204,182,22.04.2019 04:15,129,12,Nikolaev
1968,1977,15,621,1333,14,1347,0,1347,29,1133,185,22.04.2019 05:15,129,12,Nikolaev
2192,2155,10,817,1366,9,1375,0,1375,32,1166,177,22.04.2019 06:00,129,12,Nikolaev
1216,1214,7,456,754,6,760,0,760,13,623,124,22.04.2019 06:10,129,12,Nikolaev
1440,1520,7,516,917,7,924,0,924,19,738,167,22.04.2019 03:23,129,12,Nikolaev
1392,1386,5,539,848,5,853,0,853,22,730,101,22.04.2019 02:29,129,12,Nikolaev
1440,1421,4,591,845,4,849,0,849,16,759,74,22.04.2019 02:15,129,12,Nikolaev
2112,2048,5,806,1302,4,1306,0,1306,22,1011,273,22.04.2019 04:50,129,12,Nikolaev
1488,1469,6,600,883,5,888,0,888,20,765,103,22.04.2019 02:05,129,12,Nikolaev
2240,2223,18,854,1373,13,1386,0,1386,41,1164,181,22.04.2019 05:12,129,12,Nikolaev
880,863,4,338,541,1,542,0,542,9,473,60,22.04.2019 00:03,129,12,Nikolaev
1232,1222,6,458,769,5,774,0,774,16,659,99,22.04.2019 05:40,129,12,Nikolaev
1680,1646,7,572,1103,5,1108,0,1108,30,946,132,22.04.2019 03:28,129,12,Nikolaev
2208,2180,7,763,1439,6,1445,0,1445,30,1227,188,22.04.2019 03:35,129,12,Nikolaev
2176,2156,16,850,1314,12,1326,0,1326,44,1099,183,22.04.2019 05:33,129,12,Nikolaev
2016,2433,15,603,1401,12,1413,0,1413,32,1152,229,22.04.2019 06:15,129,12,Nikolaev
2624,2483,23,1058,1550,16,1566,0,1566,42,1296,228,22.04.2019 06:00,129,12,Nikolaev
2544,2320,9,1159,1381,4,1385,0,1385,38,1141,206,22.04.2019 05:58,129,12,Nikolaev
2288,2206,8,753,1528,7,1535,0,1535,31,1323,181,22.04.2019 01:02,129,12,Nikolaev
2320,2276,10,742,1568,10,1578,0,1578,33,1317,228,22.04.2019 03:55,129,12,Nikolaev
2480,2446,6,797,1678,5,1683,0,1683,31,1401,251,22.04.2019 02:40,129,12,Nikolaev
2288,2241,7,1642,645,1,646,0,646,11,557,78,22.04.2019 01:45,129,12,Nikolaev
2175,2160,15,796,1367,12,1379,0,1379,28,1229,122,22.04.2019 03:44,129,12,Nikolaev
2016,1990,17,749,1252,15,1267,0,1252,19,1119,114,22.04.2019 01:49,129,12,Nikolaev
2240,2219,4,916,1320,4,1324,0,1324,28,1170,126,22.04.2019 00:37,129,12,Nikolaev
1984,1951,5,843,1137,4,1141,0,1141,19,987,135,22.04.2019 05:29,129,12,Nikolaev
1888,1846,6,790,1094,4,1098,0,1098,17,939,142,22.04.2019 02:25,129,12,Nikolaev
1296,1270,12,575,711,10,721,0,721,13,621,87,22.04.2019 07:59,129,12,Nikolaev
144,42,20,113,22,9,31,0,31,0,24,7,22.04.2019 00:13,129,12,Nikolaev
224,67,30,169,34,21,55,0,55,2,48,5,22.04.2019 01:23,129,12,Nikolaev
80,13,3,67,10,3,13,0,13,0,12,1,22.04.2019 00:06,129,12,Nikolaev
144,31,0,113,31,0,31,0,31,0,28,3,22.04.2019 01:57,129,12,Nikolaev
352,64,54,295,10,47,57,0,57,2,50,5,22.04.2019 00:59,129,12,Nikolaev
512,38,0,479,33,0,33,0,33,1,24,8,22.04.2019 00:14,129,12,Nikolaev
96,32,0,68,28,0,28,0,28,0,25,3,22.04.2019 01:40,129,12,Nikolaev
64,46,0,23,41,0,41,0,41,0,36,5,22.04.2019 00:08,129,12,Nikolaev
224,60,0,165,59,0,59,0,59,0,40,19,22.04.2019 01:05,129,12,Nikolaev
1984,1945,20,888,1079,17,1096,0,1096,20,905,171,22.04.2019 00:20,130,12,Nikolaev
1760,1738,17,700,1046,14,1060,0,1060,22,922,116,21.04.2019 23:45,130,12,Nikolaev
2080,2028,13,927,1142,11,1153,0,1153,30,980,143,22.04.2019 00:05,130,12,Nikolaev
1488,1468,13,677,801,10,811,0,811,15,718,78,21.04.2019 23:55,130,12,Nikolaev
1472,1455,22,581,871,20,891,0,891,16,758,117,22.04.2019 01:35,130,12,Nikolaev
1744,1710,16,699,1030,15,1045,0,1045,24,847,174,21.04.2019 23:54,130,12,Nikolaev
128,115,5,67,56,5,61,0,61,0,55,6,22.04.2019 00:05,130,12,Nikolaev
96,93,0,36,60,0,60,0,60,1,37,22,22.04.2019 00:05,130,12,Nikolaev
128,118,0,53,75,0,75,0,75,0,58,17,22.04.2019 00:50,130,12,Nikolaev
1104,1092,18,522,568,14,582,0,582,11,515,56,22.04.2019 00:10,130,12,Nikolaev
1008,998,19,423,566,19,585,0,585,7,547,31,22.04.2019 00:57,130,12,Nikolaev
784,763,33,402,350,32,382,0,382,8,340,34,22.04.2019 00:20,130,12,Nikolaev
304,292,4,155,145,4,149,0,149,5,125,19,22.04.2019 00:15,130,12,Nikolaev
240,231,4,101,137,2,139,0,139,0,120,19,21.04.2019 21:40,130,12,Nikolaev
208,198,1,94,113,1,114,0,114,7,101,6,22.04.2019 00:30,130,12,Nikolaev
1472,1451,45,637,793,42,835,0,835,15,761,59,22.04.2019 01:45,130,12,Nikolaev
368,351,3,182,185,1,186,0,186,2,151,33,21.04.2019 21:50,130,12,Nikolaev
224,210,2,131,92,1,93,0,93,1,76,16,21.04.2019 21:30,130,12,Nikolaev
672,666,29,358,287,27,314,0,314,4,269,41,21.04.2019 20:50,130,12,Nikolaev
208,201,17,75,116,17,133,0,133,1,115,17,22.04.2019 00:15,130,12,Nikolaev
560,545,37,305,221,34,255,0,255,4,205,46,21.04.2019 20:46,130,12,Nikolaev
1264,1248,132,572,595,97,692,0,692,22,611,59,21.04.2019 23:30,130,12,Nikolaev
304,296,17,125,164,15,179,0,179,2,167,10,21.04.2019 23:10,130,12,Nikolaev
784,771,8,395,381,8,389,0,389,5,352,32,22.04.2019 01:45,130,12,Nikolaev
480,466,26,238,219,23,242,0,242,4,198,40,21.04.2019 21:50,130,12,Nikolaev
624,609,31,319,275,30,305,0,305,7,278,20,21.04.2019 21:10,130,12,Nikolaev
544,532,7,279,258,7,265,0,265,4,187,74,21.04.2019 20:50,130,12,Nikolaev
384,363,6,194,185,5,190,0,190,2,165,23,22.04.2019 00:05,130,12,Nikolaev
704,678,27,263,416,25,441,0,441,5,375,61,21.04.2019 22:45,130,12,Nikolaev
256,244,10,97,149,10,159,0,159,1,149,9,21.04.2019 23:00,130,12,Nikolaev
592,565,28,273,291,28,319,0,319,3,253,63,21.04.2019 20:15,130,12,Nikolaev
272,253,10,98,164,10,174,0,174,4,143,27,21.04.2019 21:30,130,12,Nikolaev
1536,1513,81,610,845,81,926,0,926,16,865,45,21.04.2019 20:58,130,12,Nikolaev
112,110,2,39,72,1,73,0,73,0,67,6,21.04.2019 20:25,130,12,Nikolaev
688,675,56,366,267,55,322,0,322,7,284,31,21.04.2019 23:30,130,12,Nikolaev
672,654,5,341,328,3,331,0,331,7,258,66,21.04.2019 21:05,130,12,Nikolaev
816,795,7,456,355,5,360,0,360,3,331,26,21.04.2019 20:27,130,12,Nikolaev
176,34,10,151,15,10,25,0,25,0,22,3,21.04.2019 21:43,130,12,Nikolaev
1360,1332,34,571,764,25,789,0,789,23,672,94,22.04.2019 03:10,130,12,Nikolaev
1344,1333,39,501,809,34,843,0,843,15,685,143,22.04.2019 00:20,130,12,Nikolaev
800,771,13,344,446,10,456,0,456,7,394,55,22.04.2019 01:30,130,12,Nikolaev
752,737,18,320,418,14,432,0,432,8,372,52,22.04.2019 02:45,130,12,Nikolaev
912,885,12,398,503,11,514,0,514,9,436,69,22.04.2019 00:05,130,12,Nikolaev
128,120,1,43,84,1,85,0,85,0,64,21,21.04.2019 20:57,130,12,Nikolaev
240,226,12,99,131,10,141,0,141,10,111,20,21.04.2019 20:30,130,12,Nikolaev
720,697,6,425,289,6,295,0,295,5,250,40,21.04.2019 22:05,130,12,Nikolaev
832,800,17,411,405,16,421,0,421,4,367,50,21.04.2019 21:45,130,12,Nikolaev
288,281,2,108,178,2,180,0,180,2,161,17,21.04.2019 20:55,130,12,Nikolaev
656,642,29,267,371,18,389,0,389,3,352,34,22.04.2019 00:55,130,12,Nikolaev
800,773,49,300,454,46,500,0,500,8,454,38,21.04.2019 23:40,130,12,Nikolaev
208,193,10,97,101,10,111,0,111,1,98,12,22.04.2019 00:45,130,12,Nikolaev
144,127,3,51,90,3,93,0,93,0,81,12,21.04.2019 21:10,130,12,Nikolaev
144,134,2,73,69,2,71,0,71,1,62,8,22.04.2019 00:15,130,12,Nikolaev
320,299,5,167,148,5,153,0,153,2,126,25,22.04.2019 00:10,130,12,Nikolaev
96,82,1,46,49,1,50,0,50,0,38,12,21.04.2019 20:40,130,12,Nikolaev
80,70,1,29,50,1,51,0,51,1,33,17,21.04.2019 21:40,130,12,Nikolaev
672,681,45,310,326,36,362,0,362,9,332,21,21.04.2019 20:30,130,12,Nikolaev
560,548,34,259,277,24,301,0,301,0,255,46,22.04.2019 00:13,130,12,Nikolaev
96,86,8,31,57,8,65,0,65,1,57,7,21.04.2019 20:45,130,12,Nikolaev
304,289,23,150,132,22,154,0,154,1,132,21,22.04.2019 00:05,130,12,Nikolaev
544,533,16,240,296,8,304,0,304,4,272,28,21.04.2019 22:30,130,12,Nikolaev
288,283,10,122,156,10,166,0,166,2,159,5,21.04.2019 20:40,130,12,Nikolaev
224,221,11,90,125,9,134,0,134,0,119,15,21.04.2019 21:20,130,12,Nikolaev
208,189,5,77,126,5,131,0,131,0,118,13,21.04.2019 20:57,130,12,Nikolaev
368,366,10,124,235,9,244,0,244,16,205,23,21.04.2019 21:35,130,12,Nikolaev
672,647,9,288,375,9,384,0,384,8,343,33,22.04.2019 01:25,130,12,Nikolaev
160,151,8,30,122,8,130,0,130,0,120,10,21.04.2019 21:00,130,12,Nikolaev
480,461,8,184,288,8,296,0,296,5,265,26,21.04.2019 23:00,130,12,Nikolaev
224,207,6,123,95,6,101,0,101,3,89,9,22.04.2019 00:05,130,12,Nikolaev
128,26,1,110,18,0,18,0,18,0,14,4,21.04.2019 20:20,130,12,Nikolaev
1920,1861,67,657,1198,65,1263,0,1263,14,1136,113,22.04.2019 00:50,130,12,Nikolaev
1440,1406,70,503,867,70,937,0,937,6,863,68,22.04.2019 00:45,130,12,Nikolaev
1536,1521,32,533,973,30,1003,0,1003,15,931,57,22.04.2019 00:50,130,12,Nikolaev
1008,995,16,359,635,14,649,0,649,4,592,53,22.04.2019 00:30,130,12,Nikolaev
544,525,22,224,300,20,320,0,320,2,293,25,21.04.2019 20:53,130,12,Nikolaev
320,310,22,123,176,21,197,0,197,1,178,18,22.04.2019 00:30,130,12,Nikolaev
368,369,29,125,217,26,243,0,243,3,221,19,22.04.2019 00:15,130,12,Nikolaev
864,839,26,368,472,24,496,0,496,7,430,59,22.04.2019 00:20,130,12,Nikolaev
288,278,24,97,168,23,191,0,191,2,174,15,21.04.2019 20:35,130,12,Nikolaev
352,346,19,142,191,19,210,0,210,1,190,19,22.04.2019 00:05,130,12,Nikolaev
480,474,45,197,244,39,283,0,283,4,251,28,21.04.2019 22:00,130,12,Nikolaev
304,289,12,143,149,12,161,0,161,2,136,23,21.04.2019 20:40,130,12,Nikolaev
704,684,62,321,324,59,383,0,383,6,351,26,22.04.2019 00:35,130,12,Nikolaev
560,545,22,224,314,22,336,0,336,11,296,29,22.04.2019 00:30,130,12,Nikolaev
432,419,27,144,262,26,288,0,288,3,258,27,21.04.2019 23:40,130,12,Nikolaev
192,173,5,111,77,4,81,0,81,1,68,12,22.04.2019 01:10,130,12,Nikolaev
528,511,19,211,300,17,317,0,317,0,292,25,22.04.2019 00:10,130,12,Nikolaev
432,431,15,194,223,15,238,0,238,3,206,29,22.04.2019 00:25,130,12,Nikolaev
480,474,27,201,259,20,279,0,279,9,241,29,21.04.2019 20:55,130,12,Nikolaev
256,240,14,77,165,14,179,0,179,2,163,14,21.04.2019 20:42,130,12,Nikolaev
192,182,7,75,110,7,117,0,117,1,104,12,21.04.2019 22:35,130,12,Nikolaev
128,124,3,52,73,3,76,0,76,0,61,15,21.04.2019 21:15,130,12,Nikolaev
768,758,46,212,513,43,556,0,556,9,519,28,22.04.2019 00:10,130,12,Nikolaev
256,242,4,108,144,4,148,0,148,0,136,12,21.04.2019 21:30,130,12,Nikolaev
80,10,6,71,4,5,9,0,9,0,5,4,21.04.2019 21:00,130,12,Nikolaev
528,474,0,54,474,0,474,0,474,26,421,27,21.04.2019 23:55,130,12,Nikolaev
560,550,33,259,273,28,301,0,301,2,283,16,21.04.2019 23:56,130,12,Nikolaev
512,490,19,243,253,16,269,0,269,2,254,13,21.04.2019 21:05,130,12,Nikolaev
544,528,9,233,305,6,311,0,311,2,273,36,22.04.2019 00:20,130,12,Nikolaev
1200,1186,10,542,648,10,658,0,658,12,605,41,22.04.2019 00:09,130,12,Nikolaev
1824,1788,35,753,1046,25,1071,0,1071,17,933,121,22.04.2019 00:15,130,12,Nikolaev
1168,1162,28,449,697,22,719,0,719,7,633,79,21.04.2019 22:00,130,12,Nikolaev
736,707,9,304,425,7,432,0,432,2,378,52,21.04.2019 21:15,130,12,Nikolaev
752,732,11,332,410,10,420,0,420,14,356,50,22.04.2019 00:02,130,12,Nikolaev
768,764,6,291,474,3,477,0,477,2,404,71,22.04.2019 00:10,130,12,Nikolaev
640,620,5,304,333,3,336,0,336,4,302,30,22.04.2019 00:52,130,12,Nikolaev
848,832,10,367,472,9,481,0,481,5,444,32,22.04.2019 00:30,130,12,Nikolaev
1152,1128,17,477,661,14,675,0,675,8,589,78,22.04.2019 00:02,130,12,Nikolaev
1424,1388,11,548,870,6,876,0,876,27,775,74,22.04.2019 00:24,130,12,Nikolaev
640,630,9,260,371,9,380,0,380,3,344,33,22.04.2019 00:05,130,12,Nikolaev
112,111,5,34,73,5,78,0,78,0,72,6,21.04.2019 21:20,130,12,Nikolaev
176,176,0,76,100,0,100,0,100,0,91,9,21.04.2019 21:20,130,12,Nikolaev
272,263,13,96,163,13,176,0,176,2,163,11,22.04.2019 00:01,130,12,Nikolaev
736,719,305,296,214,226,440,0,440,96,283,61,22.04.2019 00:30,130,12,Nikolaev
128,115,5,70,56,2,58,0,58,0,40,18,21.04.2019 22:50,130,12,Nikolaev
287,275,4,145,141,1,142,0,142,1,109,32,22.04.2019 00:20,130,12,Nikolaev
352,337,9,163,180,9,189,0,189,3,147,39,21.04.2019 21:00,130,12,Nikolaev
560,541,27,225,309,26,335,0,335,10,285,40,21.04.2019 22:00,130,12,Nikolaev
544,540,19,208,317,19,336,0,336,6,289,41,21.04.2019 23:45,130,12,Nikolaev
160,154,5,72,83,5,88,0,88,1,78,9,22.04.2019 00:15,130,12,Nikolaev
352,353,14,126,213,13,226,0,226,0,203,23,22.04.2019 00:20,130,12,Nikolaev
128,120,2,54,72,2,74,0,74,1,59,14,21.04.2019 21:45,130,12,Nikolaev
400,387,12,149,242,9,251,0,251,0,217,34,21.04.2019 21:20,130,12,Nikolaev
112,98,2,55,57,0,57,0,57,2,49,6,22.04.2019 00:05,130,12,Nikolaev
256,248,20,129,111,16,127,0,127,0,101,26,22.04.2019 00:05,130,12,Nikolaev
384,369,12,168,204,12,216,0,216,0,197,19,21.04.2019 20:56,130,12,Nikolaev
1200,1164,46,628,535,37,572,0,572,12,524,36,22.04.2019 00:05,130,12,Nikolaev
240,238,10,99,132,9,141,0,141,0,109,32,22.04.2019 00:05,130,12,Nikolaev
496,490,21,246,234,16,250,0,250,7,224,19,22.04.2019 00:20,130,12,Nikolaev
560,536,20,230,311,19,330,0,330,2,292,36,21.04.2019 21:02,130,12,Nikolaev
112,113,6,39,67,6,73,0,73,0,66,7,21.04.2019 22:55,130,12,Nikolaev
272,261,3,145,125,2,127,0,127,1,87,39,21.04.2019 23:15,130,12,Nikolaev
960,959,44,398,528,34,562,0,562,11,488,63,22.04.2019 00:10,130,12,Nikolaev
336,326,7,120,210,6,216,0,216,8,167,41,21.04.2019 23:55,130,12,Nikolaev
880,859,57,454,383,43,426,0,426,4,383,39,22.04.2019 00:01,130,12,Nikolaev
176,16,13,162,3,11,14,0,14,0,12,2,22.04.2019 00:10,130,12,Nikolaev
176,74,0,103,73,0,73,0,73,2,69,2,22.04.2019 00:05,130,12,Nikolaev
848,820,7,398,445,5,450,0,450,8,402,40,22.04.2019 01:10,130,12,Nikolaev
784,777,17,315,456,13,469,0,469,5,427,37,22.04.2019 00:15,130,12,Nikolaev
1040,1026,10,412,618,10,628,0,628,14,561,53,22.04.2019 00:06,130,12,Nikolaev
1088,1065,28,505,558,25,583,0,583,12,523,48,22.04.2019 00:10,130,12,Nikolaev
1200,1148,13,500,690,10,700,0,700,17,623,60,22.04.2019 01:50,130,12,Nikolaev
1152,1122,12,490,654,8,662,0,662,12,554,96,22.04.2019 00:59,130,12,Nikolaev
1680,1657,32,635,1016,29,1045,0,1045,31,863,151,22.04.2019 01:15,130,12,Nikolaev
1648,1625,16,630,1004,14,1018,0,1018,11,869,138,22.04.2019 00:30,130,12,Nikolaev
496,482,28,191,281,24,305,0,305,5,228,72,21.04.2019 21:20,130,12,Nikolaev
1920,1883,24,770,1128,22,1150,0,1150,17,984,149,22.04.2019 01:50,130,12,Nikolaev
1008,981,56,470,489,49,538,0,538,32,436,70,21.04.2019 21:23,130,12,Nikolaev
224,214,4,101,119,4,123,0,123,2,97,24,21.04.2019 21:45,130,12,Nikolaev
224,205,9,89,126,9,135,0,135,3,113,19,22.04.2019 00:10,130,12,Nikolaev
224,213,0,94,130,0,130,0,130,2,115,13,22.04.2019 00:10,130,12,Nikolaev
1072,1053,44,433,598,41,639,0,639,16,535,88,21.04.2019 23:55,130,12,Nikolaev
512,502,14,184,314,14,328,0,328,8,287,33,22.04.2019 01:20,130,12,Nikolaev
496,475,24,254,220,22,242,0,242,0,221,21,21.04.2019 22:20,130,12,Nikolaev
432,427,21,177,234,21,255,0,255,10,210,35,22.04.2019 00:30,130,12,Nikolaev
448,432,9,183,256,9,265,0,265,6,230,29,22.04.2019 00:45,130,12,Nikolaev
80,75,1,30,49,1,50,0,50,1,42,7,22.04.2019 00:35,130,12,Nikolaev
480,459,21,216,245,19,264,0,264,1,219,44,21.04.2019 20:20,130,12,Nikolaev
368,349,16,151,201,16,217,0,217,4,198,15,22.04.2019 00:45,130,12,Nikolaev
128,122,3,71,54,3,57,0,57,1,48,8,22.04.2019 01:00,130,12,Nikolaev
768,744,12,298,460,10,470,0,470,4,431,35,21.04.2019 22:08,130,12,Nikolaev
336,311,6,163,168,5,173,0,173,0,146,27,21.04.2019 21:35,130,12,Nikolaev
1904,1874,65,815,1032,57,1089,0,1089,21,921,147,22.04.2019 00:40,130,12,Nikolaev
192,187,12,91,89,12,101,0,101,4,79,18,21.04.2019 22:00,130,12,Nikolaev
320,313,11,112,198,10,208,0,208,1,195,12,22.04.2019 00:05,130,12,Nikolaev
128,121,4,62,63,3,66,0,66,0,61,5,21.04.2019 21:20,130,12,Nikolaev
128,127,1,63,64,1,65,0,65,0,53,12,21.04.2019 20:40,130,12,Nikolaev
1152,1141,55,438,664,50,714,0,714,21,649,44,21.04.2019 21:30,130,12,Nikolaev
672,639,25,303,346,23,369,0,369,7,322,40,22.04.2019 00:10,130,12,Nikolaev
224,214,15,94,117,13,130,0,130,2,116,12,22.04.2019 00:10,130,12,Nikolaev
1008,991,13,413,582,13,595,0,595,14,502,79,22.04.2019 00:15,130,12,Nikolaev
160,39,25,121,14,25,39,0,39,0,28,11,22.04.2019 00:30,130,12,Nikolaev
416,410,7,174,235,7,242,0,242,4,218,20,21.04.2019 21:15,130,12,Nikolaev
560,551,20,218,322,20,342,0,342,2,309,31,21.04.2019 21:20,130,12,Nikolaev
688,685,3,328,359,1,360,0,360,4,322,34,21.04.2019 22:10,130,12,Nikolaev
208,204,1,87,120,1,121,0,121,0,91,30,21.04.2019 21:20,130,12,Nikolaev
384,363,5,145,234,5,239,0,239,2,196,41,21.04.2019 21:56,130,12,Nikolaev
592,573,26,236,330,26,356,0,356,3,290,63,22.04.2019 00:15,130,12,Nikolaev
320,306,12,149,159,12,171,0,171,1,146,24,22.04.2019 00:10,130,12,Nikolaev
592,584,10,289,295,8,303,0,303,3,253,47,22.04.2019 00:31,130,12,Nikolaev
608,593,2,283,323,2,325,0,325,2,276,47,21.04.2019 21:23,130,12,Nikolaev
256,240,17,89,150,17,167,0,167,0,144,23,21.04.2019 23:00,130,12,Nikolaev
160,148,4,63,93,4,97,0,97,0,75,22,21.04.2019 23:15,130,12,Nikolaev
688,671,17,288,384,16,400,0,400,6,367,27,21.04.2019 21:35,130,12,Nikolaev
96,91,3,57,36,3,39,0,39,0,34,5,21.04.2019 21:25,130,12,Nikolaev
672,660,0,319,353,0,353,0,353,6,304,43,21.04.2019 20:52,130,12,Nikolaev
176,166,0,86,90,0,90,0,90,2,69,19,22.04.2019 00:10,130,12,Nikolaev
432,422,2,192,238,2,240,0,240,2,211,27,21.04.2019 21:10,130,12,Nikolaev
512,501,13,260,239,13,252,0,252,3,223,26,21.04.2019 21:35,130,12,Nikolaev
144,134,2,65,77,2,79,0,79,0,70,9,21.04.2019 21:00,130,12,Nikolaev
528,512,10,221,297,10,307,0,307,3,252,52,21.04.2019 21:20,130,12,Nikolaev
336,323,12,119,205,12,217,0,217,2,195,20,22.04.2019 00:05,130,12,Nikolaev
208,195,8,81,119,8,127,0,127,2,99,26,21.04.2019 22:00,130,12,Nikolaev
368,358,0,167,201,0,201,0,201,4,156,41,21.04.2019 21:00,130,12,Nikolaev
496,492,22,190,285,21,306,0,306,8,253,45,22.04.2019 00:55,130,12,Nikolaev
992,975,18,470,504,18,522,0,522,10,450,62,21.04.2019 21:45,130,12,Nikolaev
816,791,27,358,434,24,458,0,458,8,358,92,22.04.2019 02:20,130,12,Nikolaev
320,305,9,157,154,9,163,0,163,2,141,20,21.04.2019 22:00,130,12,Nikolaev
464,452,0,243,221,0,221,0,221,3,201,17,21.04.2019 21:05,130,12,Nikolaev
320,308,0,189,131,0,131,0,131,3,112,16,21.04.2019 20:50,130,12,Nikolaev
688,675,16,317,355,16,371,0,371,5,332,34,21.04.2019 21:45,130,12,Nikolaev
272,253,9,107,156,9,165,0,165,1,126,38,22.04.2019 01:13,130,12,Nikolaev
480,468,11,169,300,11,311,0,311,3,294,14,22.04.2019 00:15,130,12,Nikolaev
544,526,15,174,355,15,370,0,370,1,327,42,21.04.2019 22:20,130,12,Nikolaev
288,275,7,150,131,7,138,0,138,1,110,27,21.04.2019 23:40,130,12,Nikolaev
176,164,1,96,80,0,80,0,80,1,60,19,21.04.2019 21:50,130,12,Nikolaev
496,480,3,208,285,3,288,0,288,6,222,60,21.04.2019 21:40,130,12,Nikolaev
416,406,12,166,238,12,250,0,250,5,222,23,22.04.2019 01:15,130,12,Nikolaev
224,211,4,97,125,2,127,0,127,1,112,14,22.04.2019 00:15,130,12,Nikolaev
64,63,0,24,40,0,40,0,40,0,30,10,21.04.2019 22:25,130,12,Nikolaev
1808,1765,33,815,963,30,993,0,993,21,887,85,22.04.2019 00:20,130,12,Nikolaev
1072,1070,17,500,559,13,572,0,572,16,500,56,22.04.2019 00:10,130,12,Nikolaev
1328,1298,17,550,763,15,778,0,778,18,666,94,22.04.2019 00:20,130,12,Nikolaev
2144,2121,39,1005,1112,27,1139,0,1139,20,1018,101,22.04.2019 00:35,130,12,Nikolaev
2336,2302,40,1035,1267,34,1301,0,1301,28,1127,146,22.04.2019 00:27,130,12,Nikolaev
1920,1903,28,793,1104,23,1127,0,1127,27,965,135,22.04.2019 00:15,130,12,Nikolaev
144,56,24,93,30,21,51,0,51,0,41,10,22.04.2019 00:10,130,12,Nikolaev
528,114,3,414,111,3,114,0,114,6,94,14,21.04.2019 21:30,130,12,Nikolaev
2304,2266,49,909,1352,43,1395,0,1395,27,1202,166,22.04.2019 00:18,131,12,Nikolaev
1184,1164,10,490,685,9,694,0,694,16,614,64,22.04.2019 00:29,131,12,Nikolaev
480,472,14,206,260,14,274,0,274,4,250,20,22.04.2019 00:12,131,12,Nikolaev
528,512,53,217,264,47,311,0,311,6,273,32,21.04.2019 20:47,131,12,Nikolaev
704,697,37,294,377,33,410,0,410,4,355,51,22.04.2019 00:40,131,12,Nikolaev
352,344,11,141,200,11,211,0,211,2,187,22,21.04.2019 21:45,131,12,Nikolaev
256,238,0,113,143,0,143,0,143,1,133,9,21.04.2019 20:40,131,12,Nikolaev
560,536,48,202,316,42,358,0,358,2,333,23,21.04.2019 22:15,131,12,Nikolaev
384,368,26,173,185,26,211,0,211,0,195,16,22.04.2019 00:15,131,12,Nikolaev
864,854,24,444,401,19,420,0,420,6,350,64,22.04.2019 00:32,131,12,Nikolaev
2128,2086,22,948,1161,19,1180,0,1180,25,1070,85,21.04.2019 22:00,131,12,Nikolaev
400,393,4,167,231,2,233,0,233,2,213,18,21.04.2019 20:53,131,12,Nikolaev
912,901,27,346,541,25,566,0,566,10,505,51,21.04.2019 21:44,131,12,Nikolaev
816,794,33,351,436,29,465,0,465,10,398,57,21.04.2019 23:50,131,12,Nikolaev
464,453,23,210,234,20,254,0,254,2,227,25,21.04.2019 21:17,131,12,Nikolaev
208,192,8,103,97,8,105,0,105,1,86,18,21.04.2019 21:07,131,12,Nikolaev
304,287,5,167,132,5,137,0,137,4,103,30,22.04.2019 00:50,131,12,Nikolaev
240,220,15,113,113,14,127,0,127,5,108,14,21.04.2019 21:20,131,12,Nikolaev
944,924,34,356,558,30,588,0,588,9,506,73,21.04.2019 21:15,131,12,Nikolaev
1216,1207,22,498,703,15,718,0,718,15,598,105,22.04.2019 00:20,131,12,Nikolaev
304,296,12,120,172,12,184,0,184,1,167,16,21.04.2019 20:22,131,12,Nikolaev
384,375,21,152,214,18,232,0,232,0,218,14,22.04.2019 01:01,131,12,Nikolaev
224,211,9,98,117,9,126,0,126,3,112,11,21.04.2019 21:03,131,12,Nikolaev
656,649,55,217,384,55,439,0,439,5,409,25,21.04.2019 21:15,131,12,Nikolaev
768,762,40,348,382,38,420,0,420,2,364,54,21.04.2019 22:15,131,12,Nikolaev
640,623,32,270,340,30,370,0,370,2,321,47,21.04.2019 20:46,131,12,Nikolaev
1328,1313,40,615,678,35,713,0,713,16,640,57,22.04.2019 00:20,131,12,Nikolaev
1504,1466,33,643,844,17,861,0,861,11,720,130,22.04.2019 00:12,131,12,Nikolaev
1248,1230,48,525,684,39,723,0,723,16,620,87,21.04.2019 21:40,131,12,Nikolaev
1344,1310,33,549,771,24,795,0,795,19,690,86,22.04.2019 00:05,131,12,Nikolaev
528,514,32,236,263,29,292,0,292,2,264,26,22.04.2019 00:02,131,12,Nikolaev
304,290,12,132,163,9,172,0,172,0,155,17,22.04.2019 03:18,131,12,Nikolaev
144,129,3,70,73,1,74,0,74,0,69,5,21.04.2019 20:33,131,12,Nikolaev
592,588,58,249,289,54,343,0,343,4,275,64,21.04.2019 21:45,131,12,Nikolaev
624,606,33,240,355,29,384,0,384,8,327,49,21.04.2019 21:52,131,12,Nikolaev
240,229,22,109,113,18,131,0,131,2,112,17,22.04.2019 00:35,131,12,Nikolaev
144,127,9,52,86,6,92,0,92,3,79,10,21.04.2019 21:17,131,12,Nikolaev
1424,1399,20,730,677,17,694,0,694,11,630,53,21.04.2019 23:10,131,12,Nikolaev
384,375,4,178,205,1,206,0,206,2,187,17,21.04.2019 22:36,131,12,Nikolaev
320,310,2,155,163,2,165,0,165,12,136,17,21.04.2019 20:50,131,12,Nikolaev
432,424,18,227,189,16,205,0,205,2,175,28,22.04.2019 00:25,131,12,Nikolaev
288,264,20,127,143,18,161,0,161,1,129,31,21.04.2019 20:40,131,12,Nikolaev
544,537,29,178,338,28,366,0,366,13,318,35,21.04.2019 21:20,131,12,Nikolaev
96,95,3,33,60,3,63,0,63,1,45,17,21.04.2019 21:44,131,12,Nikolaev
960,944,207,361,419,180,599,0,599,14,428,157,22.04.2019 00:15,131,12,Nikolaev
576,551,44,268,269,39,308,0,308,10,267,31,22.04.2019 00:40,131,12,Nikolaev
800,784,36,364,403,33,436,0,436,6,373,57,22.04.2019 00:15,131,12,Nikolaev
464,444,28,227,213,24,237,0,237,0,213,24,21.04.2019 21:00,131,12,Nikolaev
304,300,16,151,140,13,153,0,153,3,137,13,21.04.2019 21:33,131,12,Nikolaev
784,767,44,340,403,41,444,0,444,9,383,52,22.04.2019 00:35,131,12,Nikolaev
352,337,22,86,246,20,266,0,266,2,239,25,21.04.2019 21:16,131,12,Nikolaev
336,320,17,122,197,17,214,0,214,3,179,32,21.04.2019 20:23,131,12,Nikolaev
384,383,28,146,215,23,238,0,238,0,176,62,22.04.2019 00:15,131,12,Nikolaev
1120,1102,60,473,593,54,647,0,647,9,559,79,22.04.2019 00:31,131,12,Nikolaev
1264,1235,26,543,697,24,721,0,721,9,643,69,22.04.2019 00:30,131,12,Nikolaev
1264,1234,40,539,689,36,725,0,725,8,656,61,21.04.2019 20:55,131,12,Nikolaev
800,788,27,374,401,25,426,0,426,7,390,29,21.04.2019 21:02,131,12,Nikolaev
1072,1045,16,505,554,13,567,0,567,8,528,31,22.04.2019 00:05,131,12,Nikolaev
640,620,15,273,356,11,367,0,367,2,333,32,21.04.2019 21:01,131,12,Nikolaev
720,712,40,314,370,36,406,0,406,5,368,33,22.04.2019 00:10,131,12,Nikolaev
1488,1467,33,629,827,32,859,0,859,5,782,72,22.04.2019 00:02,131,12,Nikolaev
784,764,22,397,365,22,387,0,387,5,315,67,22.04.2019 00:07,131,12,Nikolaev
80,76,0,34,46,0,46,0,46,0,32,14,22.04.2019 00:50,131,12,Nikolaev
208,193,5,105,98,5,103,0,103,0,81,22,22.04.2019 00:35,131,12,Nikolaev
928,916,43,421,464,43,507,0,507,2,455,50,22.04.2019 00:15,131,12,Nikolaev
272,258,15,125,133,14,147,0,147,2,127,18,22.04.2019 00:30,131,12,Nikolaev
176,164,6,97,74,5,79,0,79,1,59,19,22.04.2019 00:15,131,12,Nikolaev
560,551,44,298,223,39,262,0,262,1,241,20,22.04.2019 00:15,131,12,Nikolaev
1440,1420,65,607,771,62,833,0,833,13,743,77,22.04.2019 00:05,131,12,Nikolaev
304,290,9,130,169,5,174,0,174,3,148,23,21.04.2019 22:20,131,12,Nikolaev
80,75,3,28,49,3,52,0,52,0,37,15,21.04.2019 22:00,131,12,Nikolaev
768,761,7,340,423,5,428,0,428,3,391,34,22.04.2019 00:15,131,12,Nikolaev
512,493,7,127,378,7,385,0,385,2,330,53,21.04.2019 21:40,131,12,Nikolaev
784,762,41,403,352,29,381,0,381,8,338,35,22.04.2019 00:14,131,12,Nikolaev
1248,1219,32,523,707,18,725,0,725,14,603,108,21.04.2019 21:10,131,12,Nikolaev
144,159,7,32,106,6,112,0,112,0,103,9,21.04.2019 22:25,131,12,Nikolaev
1696,1677,19,804,874,18,892,0,892,9,809,74,22.04.2019 00:10,131,12,Nikolaev
1376,1375,57,563,756,57,813,0,813,5,736,72,22.04.2019 00:15,131,12,Nikolaev
576,552,21,259,296,21,317,0,317,6,257,54,22.04.2019 00:20,131,12,Nikolaev
64,59,0,16,48,0,48,0,48,2,34,12,21.04.2019 21:30,131,12,Nikolaev
1360,1344,63,643,659,58,717,0,717,5,668,44,21.04.2019 21:00,131,12,Nikolaev
368,348,5,170,193,5,198,0,198,1,169,28,21.04.2019 21:10,131,12,Nikolaev
1232,1203,0,607,625,0,625,0,625,12,557,56,22.04.2019 00:10,131,12,Nikolaev
224,208,5,122,100,2,102,0,102,3,86,13,21.04.2019 21:35,131,12,Nikolaev
192,182,0,84,108,0,108,0,108,1,98,9,22.04.2019 00:08,131,12,Nikolaev
80,62,0,40,40,0,40,0,40,0,30,10,21.04.2019 20:15,131,12,Nikolaev
768,771,38,307,424,37,461,0,461,6,374,81,22.04.2019 00:22,131,12,Nikolaev
64,70,10,17,38,9,47,0,47,0,36,11,22.04.2019 00:05,131,12,Nikolaev
1152,1125,24,569,562,21,583,0,583,13,525,45,22.04.2019 00:15,131,12,Nikolaev
1584,1550,19,678,890,16,906,0,906,18,804,84,22.04.2019 00:22,131,12,Nikolaev
976,960,11,435,534,7,541,0,541,5,493,43,21.04.2019 21:23,131,12,Nikolaev
1392,1361,47,576,779,37,816,0,816,22,719,75,21.04.2019 23:40,131,12,Nikolaev
192,191,10,43,140,9,149,0,149,0,122,27,21.04.2019 21:15,131,12,Nikolaev
144,136,4,66,74,4,78,0,78,0,71,7,22.04.2019 00:05,131,12,Nikolaev
304,291,5,141,159,4,163,0,163,1,131,31,21.04.2019 20:45,131,12,Nikolaev
528,516,31,212,289,27,316,0,316,2,278,36,21.04.2019 22:00,131,12,Nikolaev
1184,1157,27,589,571,24,595,0,595,11,496,88,21.04.2019 21:04,131,12,Nikolaev
240,228,7,119,114,7,121,0,121,0,99,22,21.04.2019 21:05,131,12,Nikolaev
128,128,0,51,77,0,77,0,77,2,56,19,21.04.2019 20:30,131,12,Nikolaev
448,433,5,215,229,4,233,0,233,3,199,31,22.04.2019 00:05,131,12,Nikolaev
320,317,3,119,198,3,201,0,201,3,112,86,21.04.2019 20:39,131,12,Nikolaev
608,595,28,283,301,24,325,0,325,6,256,63,21.04.2019 23:05,131,12,Nikolaev
304,281,19,142,144,18,162,0,162,1,145,16,21.04.2019 20:30,131,12,Nikolaev
144,140,12,69,64,11,75,0,75,1,62,12,21.04.2019 20:45,131,12,Nikolaev
160,161,15,68,79,13,92,0,92,2,77,13,21.04.2019 20:30,131,12,Nikolaev
576,559,21,235,321,20,341,0,341,4,290,47,21.04.2019 21:30,131,12,Nikolaev
96,88,5,57,34,5,39,0,39,0,34,5,22.04.2019 00:10,131,12,Nikolaev
896,873,38,459,402,35,437,0,437,6,390,41,21.04.2019 21:42,131,12,Nikolaev
688,671,6,352,332,4,336,0,336,3,295,38,21.04.2019 21:05,131,12,Nikolaev
208,189,1,110,97,1,98,0,98,1,82,15,22.04.2019 00:35,131,12,Nikolaev
1184,1166,28,603,553,28,581,0,581,6,513,62,21.04.2019 21:20,131,12,Nikolaev
336,320,7,178,154,4,158,0,158,2,128,28,21.04.2019 22:20,131,12,Nikolaev
736,717,27,355,358,23,381,0,381,10,303,68,21.04.2019 20:55,131,12,Nikolaev
736,714,26,345,366,25,391,0,391,4,324,63,22.04.2019 00:03,131,12,Nikolaev
128,123,6,66,56,6,62,0,62,2,47,13,22.04.2019 00:55,131,12,Nikolaev
544,519,24,265,256,23,279,0,279,2,210,67,21.04.2019 22:10,131,12,Nikolaev
368,348,3,155,210,3,213,0,213,4,178,31,21.04.2019 21:30,131,12,Nikolaev
256,246,16,113,130,13,143,0,143,0,115,28,22.04.2019 00:25,131,12,Nikolaev
352,337,26,160,166,26,192,0,192,4,155,33,22.04.2019 00:05,131,12,Nikolaev
416,401,17,189,212,15,227,0,227,4,187,36,22.04.2019 02:55,131,12,Nikolaev
512,490,9,263,240,9,249,0,249,9,217,23,22.04.2019 00:08,131,12,Nikolaev
144,132,9,77,58,9,67,0,67,2,53,12,22.04.2019 00:50,131,12,Nikolaev
416,397,29,165,225,26,251,0,251,5,192,54,21.04.2019 20:56,131,12,Nikolaev
176,156,14,71,91,14,105,0,105,0,77,28,21.04.2019 23:35,131,12,Nikolaev
128,33,11,102,17,9,26,0,26,0,24,2,22.04.2019 00:15,131,12,Nikolaev
672,654,12,266,396,10,406,0,406,4,370,32,22.04.2019 00:30,131,12,Nikolaev
864,841,18,388,461,15,476,0,476,2,443,31,22.04.2019 01:10,131,12,Nikolaev
1776,1723,34,681,1064,31,1095,0,1095,14,1011,70,21.04.2019 21:23,131,12,Nikolaev
944,919,14,329,604,11,615,0,615,6,586,23,22.04.2019 00:03,131,12,Nikolaev
240,224,4,121,115,4,119,0,119,1,99,19,22.04.2019 00:59,131,12,Nikolaev
272,264,4,109,160,3,163,0,163,2,140,21,21.04.2019 21:10,131,12,Nikolaev
320,303,10,148,163,9,172,0,172,0,136,36,22.04.2019 00:30,131,12,Nikolaev
480,465,26,226,233,21,254,0,254,1,223,30,21.04.2019 21:00,131,12,Nikolaev
352,344,16,136,200,16,216,0,216,1,167,48,22.04.2019 00:20,131,12,Nikolaev
96,80,5,43,50,3,53,0,53,0,44,9,21.04.2019 20:40,131,12,Nikolaev
1440,1405,52,711,682,47,729,0,729,17,621,91,21.04.2019 21:55,131,12,Nikolaev
704,672,39,280,389,35,424,0,424,9,371,44,22.04.2019 00:12,131,12,Nikolaev
368,361,16,175,177,16,193,0,193,5,171,17,22.04.2019 00:41,131,12,Nikolaev
656,633,47,269,341,46,387,0,387,2,365,20,21.04.2019 20:50,131,12,Nikolaev
272,269,12,112,150,10,160,0,160,3,147,10,21.04.2019 22:40,131,12,Nikolaev
96,87,3,32,61,3,64,0,64,0,49,15,21.04.2019 21:05,131,12,Nikolaev
336,317,7,156,176,4,180,0,180,3,163,14,21.04.2019 21:00,131,12,Nikolaev
416,412,30,147,247,22,269,0,269,3,248,18,21.04.2019 21:06,131,12,Nikolaev
432,418,29,154,252,26,278,0,278,4,240,34,21.04.2019 21:40,131,12,Nikolaev
144,136,5,57,83,4,87,0,87,0,67,20,21.04.2019 21:57,131,12,Nikolaev
384,365,26,151,208,25,233,0,233,1,175,57,21.04.2019 20:38,131,12,Nikolaev
384,370,12,146,231,7,238,0,238,3,206,29,21.04.2019 20:40,131,12,Nikolaev
80,73,2,23,55,2,57,0,57,0,43,14,21.04.2019 20:41,131,12,Nikolaev
144,143,6,62,77,5,82,0,82,2,77,3,21.04.2019 22:50,131,12,Nikolaev
64,59,0,18,46,0,46,0,46,0,44,2,22.04.2019 00:20,131,12,Nikolaev
64,15,0,52,12,0,12,0,12,1,9,2,21.04.2019 21:15,131,12,Nikolaev
1536,1513,17,656,868,12,880,0,880,13,775,92,22.04.2019 00:06,131,12,Nikolaev
1472,1453,16,613,845,14,859,0,859,13,784,62,22.04.2019 00:10,131,12,Nikolaev
1792,1750,23,759,1015,18,1033,0,1033,15,949,69,22.04.2019 00:10,131,12,Nikolaev
1776,1768,21,667,1092,17,1109,0,1109,9,964,136,21.04.2019 22:00,131,12,Nikolaev
2208,2189,35,804,1374,30,1404,0,1404,16,1235,153,21.04.2019 21:40,131,12,Nikolaev
1392,1367,14,534,845,13,858,0,858,14,756,88,22.04.2019 00:15,131,12,Nikolaev
1664,1632,139,581,948,135,1083,0,1083,15,932,136,22.04.2019 00:13,131,12,Nikolaev
1776,1735,23,659,1095,22,1117,0,1117,29,941,147,22.04.2019 01:41,131,12,Nikolaev
2048,2013,20,743,1288,17,1305,0,1305,26,1135,144,22.04.2019 00:30,131,12,Nikolaev
2128,2114,24,896,1211,21,1232,0,1232,19,1081,132,22.04.2019 00:32,131,12,Nikolaev
1312,1322,31,511,771,30,801,0,801,26,688,87,22.04.2019 00:40,131,12,Nikolaev
1728,1694,26,694,1014,20,1034,0,1034,20,903,111,22.04.2019 00:22,131,12,Nikolaev
1376,1349,18,543,817,16,833,0,833,14,726,93,22.04.2019 00:04,131,12,Nikolaev
1760,1747,15,637,1110,13,1123,0,1123,14,994,115,22.04.2019 00:10,131,12,Nikolaev
1920,1882,17,849,1056,15,1071,0,1071,18,972,81,21.04.2019 22:00,131,12,Nikolaev
1840,1816,16,777,1051,12,1063,0,1063,15,984,64,22.04.2019 00:10,131,12,Nikolaev
1712,1674,25,660,1027,25,1052,0,1052,10,949,93,22.04.2019 00:30,131,12,Nikolaev
1686,1674,12,644,1033,9,1042,0,1042,18,921,103,22.04.2019 00:40,131,12,Nikolaev
704,633,7,304,393,7,400,0,400,9,359,32,22.04.2019 00:07,131,12,Nikolaev
784,330,0,454,330,0,330,0,330,14,296,20,22.04.2019 00:30,131,12,Nikolaev
2128,2073,11,966,1152,10,1162,0,1162,23,1001,138,22.04.2019 00:15,131,12,Nikolaev
1952,1911,7,732,1213,7,1220,0,1220,19,994,207,22.04.2019 00:30,131,12,Nikolaev
1808,1774,12,681,1118,9,1127,0,1127,24,910,193,22.04.2019 00:40,131,12,Nikolaev
1696,1650,10,659,1031,6,1037,0,1037,11,836,190,22.04.2019 00:05,131,12,Nikolaev
1792,1759,18,689,1093,10,1103,0,1103,18,910,175,22.04.2019 00:37,131,12,Nikolaev
1744,1706,12,685,1049,10,1059,0,1059,16,867,176,22.04.2019 00:25,131,12,Nikolaev
1776,1756,9,659,1111,6,1117,0,1117,23,912,182,22.04.2019 00:35,131,12,Nikolaev
2128,2111,12,747,1370,11,1381,0,1381,29,1101,251,22.04.2019 00:19,131,12,Nikolaev
2112,2075,9,797,1308,7,1315,0,1315,26,1087,202,22.04.2019 00:07,131,12,Nikolaev
2192,2139,7,856,1332,4,1336,0,1336,30,1061,245,22.04.2019 00:10,131,12,Nikolaev
1712,1683,5,621,1087,4,1091,0,1091,20,876,195,21.04.2019 23:25,131,12,Nikolaev
1712,1675,7,683,1022,7,1029,0,1029,14,820,195,22.04.2019 00:30,131,12,Nikolaev
1744,1730,11,723,1014,7,1021,0,1021,17,841,163,22.04.2019 00:40,131,12,Nikolaev
1904,1868,4,761,1139,4,1143,0,1143,23,935,185,22.04.2019 00:15,131,12,Nikolaev
1904,1866,7,667,1233,4,1237,0,1237,22,982,233,22.04.2019 00:10,131,12,Nikolaev
1808,1781,11,696,1106,6,1112,0,1112,21,904,187,21.04.2019 22:15,131,12,Nikolaev
1888,1848,5,678,1206,4,1210,0,1210,25,980,205,22.04.2019 00:03,131,12,Nikolaev
400,380,18,208,177,15,192,0,192,3,174,15,21.04.2019 21:30,131,12,Nikolaev
672,663,44,232,405,35,440,0,440,9,369,62,22.04.2019 00:10,132,12,Nikolaev
1184,1151,57,426,711,47,758,0,758,8,621,129,22.04.2019 00:10,132,12,Nikolaev
1104,1072,28,520,561,23,584,0,584,7,500,77,22.04.2019 00:05,132,12,Nikolaev
848,832,32,383,442,23,465,0,465,10,400,55,22.04.2019 00:05,132,12,Nikolaev
656,642,23,307,330,19,349,0,349,9,297,43,22.04.2019 00:05,132,12,Nikolaev
624,602,23,239,366,19,385,0,385,5,333,47,22.04.2019 00:05,132,12,Nikolaev
240,229,12,99,129,12,141,0,141,2,110,29,21.04.2019 21:02,132,12,Nikolaev
1040,1019,21,464,558,18,576,0,576,11,486,79,22.04.2019 00:05,132,12,Nikolaev
1056,1046,19,487,554,15,569,0,569,10,512,47,22.04.2019 00:02,132,12,Nikolaev
192,184,7,80,107,5,112,0,112,1,94,17,21.04.2019 21:00,132,12,Nikolaev
624,601,27,281,325,18,343,0,343,6,284,53,21.04.2019 21:05,132,12,Nikolaev
848,827,36,397,417,34,451,0,451,4,410,37,22.04.2019 00:30,132,12,Nikolaev
1072,1055,64,364,644,64,708,0,708,12,620,76,22.04.2019 00:05,132,12,Nikolaev
864,843,39,419,413,32,445,0,445,7,376,62,22.04.2019 01:15,132,12,Nikolaev
416,398,28,154,238,24,262,0,262,2,234,26,22.04.2019 00:10,132,12,Nikolaev
224,203,18,91,117,16,133,0,133,1,119,13,22.04.2019 03:20,132,12,Nikolaev
224,224,20,82,126,16,142,0,142,2,117,23,21.04.2019 20:29,132,12,Nikolaev
224,213,15,102,110,12,122,0,122,0,112,10,21.04.2019 20:55,132,12,Nikolaev
896,869,40,445,415,36,451,0,451,6,422,23,22.04.2019 00:09,132,12,Nikolaev
320,310,10,127,184,9,193,0,193,2,162,29,22.04.2019 00:05,132,12,Nikolaev
384,376,15,166,203,15,218,0,218,2,186,30,22.04.2019 00:50,132,12,Nikolaev
128,121,4,56,69,3,72,0,72,0,56,16,22.04.2019 00:05,132,12,Nikolaev
720,697,33,342,351,27,378,0,378,5,287,86,22.04.2019 00:05,132,12,Nikolaev
1104,1081,81,412,624,68,692,0,692,7,468,217,22.04.2019 00:05,132,12,Nikolaev
112,108,14,39,61,12,73,0,73,0,43,30,22.04.2019 00:10,132,12,Nikolaev
1168,371,0,797,371,0,371,0,371,26,332,13,22.04.2019 00:18,132,12,Nikolaev
1680,1637,33,673,974,33,1007,0,1007,6,870,131,22.04.2019 00:25,132,12,Nikolaev
1696,1666,20,679,1003,14,1017,0,1017,12,903,102,22.04.2019 01:25,132,12,Nikolaev
224,218,3,96,125,3,128,0,128,1,113,14,21.04.2019 23:55,132,12,Nikolaev
192,190,2,74,116,2,118,0,118,5,95,18,22.04.2019 00:10,132,12,Nikolaev
224,211,19,83,123,18,141,0,141,1,117,23,22.04.2019 03:50,132,12,Nikolaev
448,445,21,197,234,17,251,0,251,2,208,41,22.04.2019 00:05,132,12,Nikolaev
272,258,13,76,183,13,196,0,196,2,186,8,22.04.2019 02:24,132,12,Nikolaev
336,315,6,179,153,4,157,0,157,4,138,15,21.04.2019 20:55,132,12,Nikolaev
208,204,5,85,118,5,123,0,123,0,97,26,21.04.2019 22:50,132,12,Nikolaev
272,259,3,148,124,0,124,0,124,4,87,33,21.04.2019 21:01,132,12,Nikolaev
352,348,24,126,206,20,226,0,226,5,199,22,22.04.2019 00:55,132,12,Nikolaev
336,340,35,102,201,33,234,0,234,3,194,37,21.04.2019 23:55,132,12,Nikolaev
352,341,9,155,189,8,197,0,197,1,182,14,22.04.2019 06:50,132,12,Nikolaev
448,423,26,160,264,24,288,0,288,5,235,48,22.04.2019 00:10,132,12,Nikolaev
752,722,21,290,442,20,462,0,462,3,387,72,21.04.2019 23:30,132,12,Nikolaev
192,183,7,85,100,7,107,0,107,0,96,11,21.04.2019 20:52,132,12,Nikolaev
416,409,32,151,233,32,265,0,265,4,232,29,21.04.2019 21:50,132,12,Nikolaev
320,309,18,126,178,16,194,0,194,2,175,17,21.04.2019 22:15,132,12,Nikolaev
448,433,17,219,214,15,229,0,229,4,195,30,21.04.2019 21:10,132,12,Nikolaev
336,345,7,121,209,6,215,0,215,3,156,56,22.04.2019 00:10,132,12,Nikolaev
560,542,20,254,290,16,306,0,306,4,281,21,21.04.2019 21:10,132,12,Nikolaev
336,344,7,97,232,7,239,0,239,4,202,33,21.04.2019 21:30,132,12,Nikolaev
176,178,8,48,121,7,128,0,128,3,102,23,21.04.2019 20:21,132,12,Nikolaev
368,352,25,176,169,23,192,0,192,3,159,30,21.04.2019 23:30,132,12,Nikolaev
2112,2072,23,984,1111,17,1128,0,1128,25,968,135,22.04.2019 02:15,132,12,Nikolaev
928,902,9,453,468,7,475,0,475,9,436,30,22.04.2019 01:40,132,12,Nikolaev
768,749,5,350,413,5,418,0,418,11,369,38,22.04.2019 00:20,132,12,Nikolaev
496,477,20,211,267,18,285,0,285,7,252,26,22.04.2019 00:45,132,12,Nikolaev
336,316,2,222,112,2,114,0,114,1,87,26,22.04.2019 07:00,132,12,Nikolaev
112,106,0,66,46,0,46,0,46,0,36,10,21.04.2019 20:40,132,12,Nikolaev
544,529,18,272,257,15,272,0,272,5,218,49,21.04.2019 22:55,132,12,Nikolaev
176,166,2,111,64,1,65,0,65,1,48,16,21.04.2019 20:45,132,12,Nikolaev
336,332,7,168,162,6,168,0,168,1,148,19,21.04.2019 21:30,132,12,Nikolaev
320,318,13,129,178,13,191,0,191,0,169,22,21.04.2019 21:35,132,12,Nikolaev
208,195,15,88,106,14,120,0,120,1,102,17,21.04.2019 21:20,132,12,Nikolaev
416,399,9,175,234,7,241,0,241,7,132,102,21.04.2019 21:27,132,12,Nikolaev
256,247,26,135,95,26,121,0,121,2,57,62,22.04.2019 00:03,132,12,Nikolaev
272,265,12,146,115,11,126,0,126,3,81,42,22.04.2019 00:35,132,12,Nikolaev
320,309,23,145,155,20,175,0,175,3,149,23,21.04.2019 21:40,132,12,Nikolaev
272,262,24,105,147,20,167,0,167,1,140,26,22.04.2019 00:00,132,12,Nikolaev
272,254,18,108,147,17,164,0,164,2,139,23,22.04.2019 05:20,132,12,Nikolaev
512,498,9,323,184,5,189,0,189,2,140,47,21.04.2019 21:50,132,12,Nikolaev
848,841,42,392,416,40,456,0,456,3,382,71,21.04.2019 21:45,132,12,Nikolaev
1008,993,15,520,475,13,488,0,488,11,432,45,22.04.2019 00:10,132,12,Nikolaev
128,20,8,110,12,6,18,0,18,0,13,5,21.04.2019 21:43,132,12,Nikolaev
480,476,11,207,264,9,273,0,273,2,227,44,22.04.2019 04:25,132,12,Nikolaev
96,83,2,48,47,1,48,0,48,0,15,33,22.04.2019 06:05,132,12,Nikolaev
736,727,29,330,380,26,406,0,406,11,330,65,22.04.2019 00:05,132,12,Nikolaev
784,755,18,362,407,15,422,0,422,3,345,74,21.04.2019 22:01,132,12,Nikolaev
224,212,15,98,111,15,126,0,126,1,100,25,22.04.2019 00:15,132,12,Nikolaev
80,63,2,50,28,2,30,0,30,0,21,9,22.04.2019 00:10,132,12,Nikolaev
640,630,52,257,337,46,383,0,383,15,242,126,22.04.2019 00:15,132,12,Nikolaev
1072,1074,17,469,586,17,603,0,603,16,519,68,22.04.2019 00:10,132,12,Nikolaev
880,854,6,395,481,4,485,0,485,7,408,70,22.04.2019 01:13,132,12,Nikolaev
928,892,8,411,510,7,517,0,517,6,452,59,22.04.2019 00:15,132,12,Nikolaev
1200,1194,16,536,652,12,664,0,664,14,576,74,22.04.2019 00:20,132,12,Nikolaev
928,909,3,400,526,2,528,0,528,14,404,110,21.04.2019 22:35,132,12,Nikolaev
832,806,2,397,433,2,435,0,435,14,329,92,21.04.2019 21:30,132,12,Nikolaev
832,809,46,358,431,43,474,0,474,8,291,175,21.04.2019 21:30,132,12,Nikolaev
832,818,16,391,426,15,441,0,441,6,357,78,22.04.2019 00:20,132,12,Nikolaev
1200,1171,17,521,664,15,679,0,679,6,574,99,22.04.2019 00:30,132,12,Nikolaev
128,121,8,49,71,8,79,0,79,0,69,10,22.04.2019 00:20,132,12,Nikolaev
1024,1002,80,440,510,74,584,0,584,12,479,93,22.04.2019 00:05,132,12,Nikolaev
416,408,6,180,230,6,236,0,236,3,163,70,22.04.2019 00:10,132,12,Nikolaev
784,771,50,348,393,43,436,0,436,8,353,75,21.04.2019 22:00,132,12,Nikolaev
384,377,23,135,229,20,249,0,249,0,191,58,21.04.2019 22:00,132,12,Nikolaev
160,147,13,64,84,12,96,0,96,0,87,9,21.04.2019 22:10,132,12,Nikolaev
480,460,19,240,224,16,240,0,240,5,181,54,21.04.2019 21:40,132,12,Nikolaev
480,476,45,161,278,41,319,0,319,5,225,89,22.04.2019 00:10,132,12,Nikolaev
624,624,25,241,358,25,383,0,383,4,283,96,22.04.2019 04:20,132,12,Nikolaev
736,735,18,334,385,17,402,0,402,9,345,48,22.04.2019 00:30,132,12,Nikolaev
112,15,1,97,14,1,15,0,15,0,9,6,22.04.2019 00:15,132,12,Nikolaev
1664,1636,34,777,862,25,887,0,887,17,744,126,22.04.2019 00:30,132,12,Nikolaev
320,312,29,100,194,26,220,0,220,1,186,33,22.04.2019 00:05,132,12,Nikolaev
352,336,28,121,205,26,231,0,231,5,194,32,21.04.2019 21:05,132,12,Nikolaev
880,859,51,390,446,44,490,0,490,15,389,86,22.04.2019 00:20,132,12,Nikolaev
1296,1271,36,666,600,30,630,0,630,10,551,69,21.04.2019 21:31,132,12,Nikolaev
1328,1308,22,612,696,20,716,0,716,18,604,94,21.04.2019 22:05,132,12,Nikolaev
768,754,49,331,392,45,437,0,437,6,389,42,22.04.2019 00:50,132,12,Nikolaev
816,793,47,352,418,46,464,0,464,13,371,80,22.04.2019 00:15,132,12,Nikolaev
800,783,79,353,375,72,447,0,447,7,365,75,21.04.2019 21:00,132,12,Nikolaev
576,553,46,256,278,42,320,0,320,4,262,54,22.04.2019 00:38,132,12,Nikolaev
608,597,58,230,323,55,378,0,378,5,305,68,22.04.2019 00:30,132,12,Nikolaev
848,821,55,340,458,50,508,0,508,8,417,83,22.04.2019 04:20,132,12,Nikolaev
624,606,61,291,277,56,333,0,333,3,277,53,22.04.2019 00:17,132,12,Nikolaev
400,385,25,223,160,17,177,0,177,4,110,63,22.04.2019 00:49,132,12,Nikolaev
384,381,21,121,244,19,263,0,263,4,229,30,22.04.2019 00:30,132,12,Nikolaev
1568,1537,44,689,841,38,879,0,879,15,684,180,22.04.2019 02:30,132,12,Nikolaev
80,75,0,38,42,0,42,0,42,0,27,15,22.04.2019 00:20,132,12,Nikolaev
160,159,4,68,88,4,92,0,92,1,62,29,22.04.2019 01:15,132,12,Nikolaev
208,201,10,75,123,10,133,0,133,2,83,48,22.04.2019 00:20,132,12,Nikolaev
352,333,29,154,174,24,198,0,198,4,160,34,22.04.2019 01:10,132,12,Nikolaev
176,159,20,79,79,18,97,0,97,2,57,38,22.04.2019 00:05,132,12,Nikolaev
528,517,22,182,325,21,346,0,346,6,301,39,22.04.2019 00:05,132,12,Nikolaev
288,273,16,135,139,14,153,0,153,4,118,31,22.04.2019 00:10,132,12,Nikolaev
112,101,4,52,59,1,60,0,60,0,47,13,22.04.2019 00:01,132,12,Nikolaev
176,172,2,88,86,2,88,0,88,4,63,21,22.04.2019 00:07,132,12,Nikolaev
1072,1049,68,512,510,50,560,0,560,9,440,111,22.04.2019 00:05,132,12,Nikolaev
736,715,44,303,390,43,433,0,433,12,349,72,22.04.2019 00:10,132,12,Nikolaev
512,501,16,125,374,13,387,0,387,7,345,35,21.04.2019 22:00,132,12,Nikolaev
496,485,29,194,279,23,302,0,302,12,242,48,22.04.2019 00:03,132,12,Nikolaev
864,836,57,385,427,52,479,0,479,4,414,61,22.04.2019 00:10,132,12,Nikolaev
640,626,60,265,331,44,375,0,375,8,320,47,21.04.2019 20:50,132,12,Nikolaev
192,179,21,82,90,20,110,0,110,2,84,24,22.04.2019 00:10,132,12,Nikolaev
448,433,22,200,231,17,248,0,248,6,216,26,21.04.2019 23:15,132,12,Nikolaev
976,946,79,490,422,64,486,0,486,3,399,84,21.04.2019 23:15,132,12,Nikolaev
240,218,14,91,136,13,149,0,149,2,123,24,22.04.2019 00:02,132,12,Nikolaev
144,133,8,61,78,5,83,0,83,4,71,8,22.04.2019 00:45,132,12,Nikolaev
144,137,7,53,85,6,91,0,91,2,69,20,22.04.2019 00:05,132,12,Nikolaev
1904,1866,29,781,1098,25,1123,0,1123,26,893,204,22.04.2019 00:04,132,12,Nikolaev
1632,1621,22,621,992,19,1011,621,1011,26,795,190,22.04.2019 00:45,132,12,Nikolaev
736,756,9,264,465,7,472,0,472,11,392,69,22.04.2019 00:10,132,12,Nikolaev
1008,986,18,518,478,12,490,0,490,9,425,56,22.04.2019 00:17,132,12,Nikolaev
976,952,13,430,535,11,546,0,546,9,457,80,22.04.2019 00:33,132,12,Nikolaev
2352,2199,23,1118,1215,19,1234,0,1234,31,1047,156,22.04.2019 00:05,132,12,Nikolaev
2096,2046,17,944,1139,13,1152,0,1152,25,930,197,22.04.2019 03:08,132,12,Nikolaev
1856,1822,11,914,937,5,942,0,942,19,808,115,22.04.2019 00:09,132,12,Nikolaev
1920,1899,15,783,1126,11,1137,0,1137,22,957,158,22.04.2019 00:05,132,12,Nikolaev
1648,1617,31,706,914,28,942,0,942,20,787,135,21.04.2019 23:30,132,12,Nikolaev
1152,1121,14,574,566,12,578,0,578,10,495,73,22.04.2019 00:07,132,12,Nikolaev
1344,1313,13,573,759,12,771,0,771,17,658,96,22.04.2019 00:05,132,12,Nikolaev
1600,1564,41,738,829,33,862,13,849,0,716,133,22.04.2019 00:10,132,12,Nikolaev
1200,1182,36,555,613,32,645,0,645,6,553,86,22.04.2019 00:05,132,12,Nikolaev
1904,1869,49,819,1049,36,1085,0,1085,26,882,177,22.04.2019 00:10,132,12,Nikolaev
528,510,8,246,276,6,282,0,282,4,229,49,22.04.2019 00:30,132,12,Nikolaev
1376,1354,27,590,766,20,786,0,786,13,652,121,22.04.2019 00:20,132,12,Nikolaev
1280,1260,12,584,688,8,696,0,696,16,569,111,21.04.2019 22:12,132,12,Nikolaev
736,723,5,336,397,3,400,0,400,10,305,85,22.04.2019 00:10,132,12,Nikolaev
1952,1915,73,786,1101,65,1166,0,1166,39,938,189,22.04.2019 00:30,132,12,Nikolaev
1888,1845,17,837,1037,14,1051,0,1051,22,873,156,22.04.2019 00:19,132,12,Nikolaev
2176,2133,37,999,1150,27,1177,0,1177,22,963,192,22.04.2019 00:00,132,12,Nikolaev
1360,1332,15,637,710,13,723,0,723,14,597,112,22.04.2019 00:02,132,12,Nikolaev
1264,1240,12,629,628,7,635,0,635,8,522,105,22.04.2019 00:05,132,12,Nikolaev
1424,1397,16,620,789,15,804,0,804,9,693,102,22.04.2019 00:05,132,12,Nikolaev
1936,1884,5,883,1050,3,1053,0,1053,15,902,136,22.04.2019 00:04,132,12,Nikolaev
2032,1973,18,959,1059,14,1073,0,1073,22,895,156,22.04.2019 00:15,132,12,Nikolaev
2208,2169,27,860,1330,18,1348,0,1348,36,1115,197,21.04.2019 23:10,132,12,Nikolaev
2368,2304,19,943,1408,17,1425,0,1425,27,1185,213,22.04.2019 00:20,132,12,Nikolaev
224,29,13,200,12,12,24,0,24,0,20,4,22.04.2019 00:10,132,12,Nikolaev
80,21,2,59,19,2,21,0,21,1,13,7,21.04.2019 23:50,132,12,Nikolaev
144,17,2,127,15,2,17,0,17,0,11,6,22.04.2019 00:10,132,12,Nikolaev
2112,2160,8,686,1421,5,1426,0,1426,33,1259,134,21.04.2019 22:51,133,13,Odessa
2224,2230,5,733,1488,3,1491,0,1491,34,1319,138,22.04.2019 01:15,133,13,Odessa
2272,2259,2,718,1552,2,1554,0,1554,47,1330,177,22.04.2019 02:00,133,13,Odessa
2208,2193,14,750,1451,7,1458,0,1458,37,1248,173,22.04.2019 01:05,133,13,Odessa
2368,2376,8,798,1564,6,1570,0,1570,38,1299,233,22.04.2019 00:04,133,13,Odessa
2080,2069,13,772,1297,11,1308,0,1308,24,1156,128,22.04.2019 00:05,133,13,Odessa
2256,2272,10,844,1403,9,1412,0,1412,35,1204,173,21.04.2019 22:53,133,13,Odessa
1808,1777,23,724,1070,14,1084,0,1084,30,934,120,21.04.2019 22:55,133,13,Odessa
1904,1897,11,725,1171,8,1179,0,1179,28,1019,132,22.04.2019 00:15,133,13,Odessa
2080,2072,7,820,1253,7,1260,0,1260,35,1059,166,22.04.2019 00:05,133,13,Odessa
2032,2013,5,813,1215,4,1219,0,1219,29,1004,186,21.04.2019 22:53,133,13,Odessa
1631,1624,6,614,1014,3,1017,0,1017,30,867,120,21.04.2019 23:10,133,13,Odessa
2240,2233,10,835,1398,7,1405,0,1404,48,1173,183,22.04.2019 01:15,133,13,Odessa
2400,2404,8,863,1530,7,1537,0,1537,32,1290,215,22.04.2019 00:30,133,13,Odessa
2336,2348,7,884,1447,5,1452,0,1452,44,1182,226,21.04.2019 23:50,133,13,Odessa
2224,2216,13,845,1370,9,1379,0,1379,30,1147,202,22.04.2019 00:45,133,13,Odessa
2288,2291,11,1024,1257,7,1264,0,1264,20,1065,179,22.04.2019 01:30,133,13,Odessa
2288,2312,9,887,1394,7,1401,0,1401,33,1218,150,22.04.2019 00:40,133,13,Odessa
2480,2508,6,1038,1439,3,1442,0,1442,26,1219,197,22.04.2019 00:05,133,13,Odessa
2336,2343,14,853,1474,9,1483,0,1483,36,1256,191,22.04.2019 00:10,133,13,Odessa
2192,2210,9,766,1420,6,1426,0,1425,28,1218,179,22.04.2019 01:10,133,13,Odessa
2096,2121,8,762,1331,3,1334,0,1334,17,1144,173,21.04.2019 22:26,133,13,Odessa
2224,2219,4,727,1496,1,1497,0,1497,52,1233,212,21.04.2019 23:48,133,13,Odessa
1760,1767,14,770,984,6,990,0,990,16,849,125,22.04.2019 01:00,133,13,Odessa
1568,1628,10,553,1009,6,1015,0,1015,37,854,124,22.04.2019 00:20,133,13,Odessa
1824,1826,10,846,970,8,978,0,978,18,855,105,22.04.2019 00:10,133,13,Odessa
2480,2626,7,939,1534,7,1541,0,1541,63,1312,166,22.04.2019 01:15,133,13,Odessa
2464,2466,18,1026,1429,9,1438,0,1438,37,1247,154,22.04.2019 02:25,133,13,Odessa
1504,1512,4,553,948,3,951,0,951,29,820,102,22.04.2019 00:05,133,13,Odessa
1664,1669,4,632,1029,3,1032,0,1032,18,886,128,22.04.2019 00:40,133,13,Odessa
2240,2225,12,819,1412,9,1421,0,1421,23,1224,174,22.04.2019 00:15,133,13,Odessa
2208,2217,8,742,1461,5,1466,0,1466,33,1252,181,22.04.2019 00:10,133,13,Odessa
2416,2448,0,835,1581,0,1581,0,1581,34,1317,230,22.04.2019 01:10,133,13,Odessa
2176,2181,12,733,1435,8,1443,0,1443,33,1237,173,22.04.2019 00:20,133,13,Odessa
2144,2139,12,788,1347,9,1356,0,1356,42,1134,180,22.04.2019 00:05,133,13,Odessa
2128,2119,9,752,1368,8,1376,0,1376,35,1160,181,22.04.2019 00:05,133,13,Odessa
2304,2293,7,856,1443,5,1448,0,1448,46,1228,174,21.04.2019 22:00,133,13,Odessa
2016,2003,10,709,1302,5,1307,0,1307,20,1142,145,22.04.2019 00:08,133,13,Odessa
1936,1919,8,661,1269,6,1275,0,1274,25,1086,163,22.04.2019 03:01,133,13,Odessa
2048,2040,9,689,1350,9,1359,0,1359,30,1175,154,22.04.2019 00:03,133,13,Odessa
2064,2063,12,697,1360,7,1367,0,1367,38,1159,170,22.04.2019 00:10,133,13,Odessa
2048,2048,19,641,1391,16,1407,0,1407,53,1191,163,22.04.2019 01:19,133,13,Odessa
2224,2256,7,852,1369,3,1372,0,1372,41,1174,157,21.04.2019 22:34,133,13,Odessa
1952,1932,14,725,1217,10,1227,0,1227,41,1033,153,22.04.2019 00:26,133,13,Odessa
2336,2327,13,868,1465,3,1468,0,1468,30,1269,169,22.04.2019 00:03,133,13,Odessa
2192,2175,9,822,1364,6,1370,0,1370,48,1183,139,22.04.2019 05:06,133,13,Odessa
1968,1980,7,729,1235,4,1239,0,1239,18,1070,151,21.04.2019 21:40,133,13,Odessa
2192,2207,8,774,1411,7,1418,0,1417,44,1183,190,22.04.2019 03:10,133,13,Odessa
2256,2234,8,886,1364,6,1370,0,1370,36,1170,164,21.04.2019 23:05,133,13,Odessa
2336,2335,7,833,1500,3,1503,0,1503,58,1275,170,22.04.2019 01:15,133,13,Odessa
2176,2160,7,773,1399,4,1403,0,1403,30,1219,154,22.04.2019 04:30,133,13,Odessa
2080,2080,7,699,1375,6,1381,0,1381,33,1176,172,22.04.2019 01:10,133,13,Odessa
2256,2255,4,878,1374,4,1378,0,1378,30,1199,149,21.04.2019 21:50,133,13,Odessa
2160,2153,3,761,1397,2,1399,0,1399,35,1172,192,22.04.2019 00:05,133,13,Odessa
1952,1960,6,664,1284,4,1288,0,1288,34,1124,130,22.04.2019 00:02,133,13,Odessa
2238,2217,9,769,1461,8,1469,0,1469,31,1288,150,22.04.2019 00:01,133,13,Odessa
2144,2135,4,738,1404,2,1406,0,1406,43,1192,171,22.04.2019 00:15,133,13,Odessa
1952,1963,6,667,1280,5,1285,0,1285,24,1133,128,22.04.2019 00:25,133,13,Odessa
1760,1759,3,637,1122,1,1123,0,1123,33,977,113,21.04.2019 21:25,133,13,Odessa
2144,2114,9,822,1313,9,1322,0,1322,42,1122,158,22.04.2019 00:10,133,13,Odessa
2208,2239,15,767,1432,9,1441,0,1441,48,1212,181,22.04.2019 01:07,133,13,Odessa
1920,1935,10,633,1279,8,1287,0,1287,41,1077,169,22.04.2019 02:00,133,13,Odessa
2160,2189,3,778,1381,1,1382,0,1382,38,1175,169,22.04.2019 00:30,133,13,Odessa
2384,2381,10,860,1516,8,1524,0,1524,35,1357,132,22.04.2019 00:30,133,13,Odessa
2352,2384,6,840,1509,3,1512,0,1512,38,1272,202,22.04.2019 00:02,133,13,Odessa
2416,2226,2,988,1426,2,1428,0,1428,28,1126,274,22.04.2019 00:45,133,13,Odessa
2240,2260,12,758,1473,9,1482,0,1482,22,1301,159,22.04.2019 00:22,133,13,Odessa
2224,2214,8,798,1418,8,1426,0,1426,42,1218,166,21.04.2019 22:47,133,13,Odessa
2176,2173,13,819,1348,9,1357,0,1357,21,1166,170,22.04.2019 00:10,133,13,Odessa
2192,2218,9,744,1442,6,1448,0,1448,32,1233,183,22.04.2019 01:30,133,13,Odessa
2112,2180,14,673,1428,11,1439,0,1439,42,1235,162,21.04.2019 21:52,133,13,Odessa
2079,2069,11,701,1367,11,1378,0,1378,55,1176,147,22.04.2019 00:15,133,13,Odessa
1952,1958,12,766,1177,9,1186,0,1186,35,1028,123,21.04.2019 23:30,133,13,Odessa
1952,1944,12,720,1224,8,1232,0,1232,50,1033,149,22.04.2019 01:20,133,13,Odessa
2352,2370,17,856,1486,10,1496,0,1496,44,1245,207,22.04.2019 00:15,133,13,Odessa
1856,1840,6,688,1163,5,1168,0,1168,21,974,173,22.04.2019 00:26,133,13,Odessa
1744,1740,17,703,1029,12,1041,0,1041,35,890,116,22.04.2019 00:30,133,13,Odessa
2352,2351,9,908,1439,5,1444,0,1444,31,1242,171,21.04.2019 22:50,133,13,Odessa
368,90,10,298,65,5,70,0,70,1,62,7,21.04.2019 23:15,133,13,Odessa
320,54,0,299,21,0,21,0,21,1,18,2,21.04.2019 23:00,133,13,Odessa
208,60,1,150,57,1,58,0,58,1,51,6,22.04.2019 00:16,133,13,Odessa
144,52,0,103,41,0,41,0,41,5,31,5,21.04.2019 23:30,133,13,Odessa
176,53,0,124,52,0,52,0,52,0,28,24,21.04.2019 21:16,133,13,Odessa
112,109,12,26,80,6,86,0,86,1,79,6,21.04.2019 21:35,133,13,Odessa
1264,1119,0,149,1115,0,1115,0,1115,114,955,46,22.04.2019 01:10,134,13,Odessa
2432,2460,17,910,1515,7,1522,0,1522,41,1271,210,22.04.2019 00:10,134,13,Odessa
2208,2535,21,634,1557,17,1574,0,1574,33,1296,245,22.04.2019 00:20,134,13,Odessa
2592,2432,2,1000,1590,2,1592,0,1592,37,1145,410,22.04.2019 00:15,134,13,Odessa
2240,2197,9,883,1351,6,1357,0,1357,29,1150,178,22.04.2019 00:05,134,13,Odessa
2096,2098,24,721,1354,21,1375,0,1375,40,1126,209,22.04.2019 00:30,134,13,Odessa
1888,1931,23,704,1165,19,1184,0,1184,23,995,166,22.04.2019 01:00,134,13,Odessa
1808,1862,19,587,1208,13,1221,0,1221,32,1055,134,22.04.2019 00:01,134,13,Odessa
2112,2248,24,666,1431,15,1446,0,1446,37,1225,184,22.04.2019 00:05,134,13,Odessa
2160,2167,25,782,1364,14,1378,0,1378,39,1198,141,22.04.2019 00:11,134,13,Odessa
2160,2174,23,784,1357,19,1376,0,1376,28,1201,147,22.04.2019 00:15,134,13,Odessa
2144,2157,19,809,1321,14,1335,0,1335,24,1187,124,22.04.2019 00:20,134,13,Odessa
2192,2192,17,763,1415,14,1429,0,1429,27,1259,143,21.04.2019 22:10,134,13,Odessa
1456,1487,15,482,960,14,974,0,974,26,812,136,22.04.2019 00:23,134,13,Odessa
1952,1950,11,630,1311,11,1322,0,1322,34,1122,166,22.04.2019 00:53,134,13,Odessa
1904,1917,21,768,1123,13,1136,0,1136,27,977,132,22.04.2019 00:30,134,13,Odessa
1328,1334,13,513,803,12,815,0,815,18,700,97,22.04.2019 00:10,134,13,Odessa
2160,2157,18,718,1427,15,1442,0,1442,39,1227,176,22.04.2019 00:30,134,13,Odessa
1968,1981,16,629,1327,12,1339,0,1339,18,1164,157,21.04.2019 23:00,134,13,Odessa
2096,2159,18,677,1407,12,1419,0,1419,39,1212,168,22.04.2019 00:20,134,13,Odessa
1744,1794,20,559,1169,16,1185,0,1185,28,983,174,21.04.2019 22:28,134,13,Odessa
1824,1812,19,659,1152,13,1165,0,1165,32,978,155,22.04.2019 00:17,134,13,Odessa
2096,2084,18,735,1351,10,1361,0,1361,39,1157,165,22.04.2019 00:22,134,13,Odessa
1600,1599,16,590,998,12,1010,0,1010,27,866,117,22.04.2019 00:56,134,13,Odessa
2112,2133,21,756,1344,12,1356,0,1356,31,1160,165,22.04.2019 00:24,134,13,Odessa
1584,1589,12,543,1032,9,1041,0,1041,31,896,114,22.04.2019 00:10,134,13,Odessa
1744,1778,16,529,1207,8,1215,0,1215,22,1028,165,22.04.2019 00:25,134,13,Odessa
928,937,3,400,527,1,528,0,528,24,451,53,21.04.2019 23:10,134,13,Odessa
2256,2249,3,1465,791,0,791,0,791,13,697,81,22.04.2019 00:05,134,13,Odessa
2304,2262,17,933,1357,14,1371,0,1371,33,1202,136,22.04.2019 01:10,134,13,Odessa
1296,1277,17,450,831,15,846,0,846,24,713,109,22.04.2019 00:05,134,13,Odessa
2048,2083,19,754,1283,11,1294,0,1294,29,1121,144,22.04.2019 00:26,134,13,Odessa
2192,2196,19,867,1314,11,1325,0,1325,33,1168,124,22.04.2019 00:10,134,13,Odessa
2352,2364,21,800,1537,15,1552,0,1551,38,1305,208,22.04.2019 02:30,134,13,Odessa
2128,2116,26,808,1304,16,1320,0,1320,38,1083,199,22.04.2019 00:20,134,13,Odessa
992,1011,15,331,650,11,661,0,661,11,571,79,22.04.2019 01:05,134,13,Odessa
2320,2331,17,845,1462,13,1475,0,1475,21,1313,141,21.04.2019 22:10,134,13,Odessa
2496,2502,17,940,1546,10,1556,0,1555,39,1319,197,22.04.2019 00:08,134,13,Odessa
2480,2469,7,878,1595,7,1602,0,1602,35,1384,183,22.04.2019 00:05,134,13,Odessa
2528,2512,12,841,1677,10,1687,0,1687,46,1424,217,22.04.2019 00:35,134,13,Odessa
2352,2351,19,997,1342,13,1355,0,1355,34,1162,159,22.04.2019 00:03,134,13,Odessa
1248,1246,20,489,748,11,759,0,759,14,648,97,22.04.2019 00:10,134,13,Odessa
2192,2172,21,935,1243,14,1257,0,1257,36,1079,142,21.04.2019 22:15,134,13,Odessa
2416,2416,8,921,1492,3,1495,0,1495,25,1301,169,22.04.2019 00:25,134,13,Odessa
1936,1933,9,644,1287,5,1292,0,1292,31,1145,116,22.04.2019 00:15,134,13,Odessa
2256,2288,27,742,1496,18,1514,0,1514,29,1270,215,22.04.2019 00:05,134,13,Odessa
2272,2261,20,818,1440,14,1454,0,1454,35,1245,174,22.04.2019 00:37,134,13,Odessa
2272,2197,14,1056,1206,10,1216,0,1216,18,1064,134,22.04.2019 00:20,134,13,Odessa
2224,2226,18,754,1457,13,1470,0,1470,25,1305,140,22.04.2019 04:03,134,13,Odessa
2272,2274,9,862,1401,9,1410,0,1410,33,1233,144,22.04.2019 00:20,134,13,Odessa
2368,2382,17,858,1493,17,1510,0,1510,29,1264,217,22.04.2019 00:15,134,13,Odessa
1456,1449,10,667,782,7,789,0,789,16,697,76,22.04.2019 00:30,134,13,Odessa
2016,2008,24,809,1187,20,1207,0,1207,28,1089,90,22.04.2019 00:38,134,13,Odessa
1760,1744,12,758,992,10,1002,0,1002,30,859,113,22.04.2019 00:01,134,13,Odessa
2176,2140,27,915,1245,16,1261,0,1261,24,1087,150,22.04.2019 00:15,134,13,Odessa
2480,2469,38,1034,1416,30,1446,0,1446,11,1321,114,22.04.2019 02:10,134,13,Odessa
2416,2392,29,925,1469,22,1491,0,1491,29,1331,131,22.04.2019 00:20,134,13,Odessa
2368,2354,22,919,1437,12,1449,0,1449,36,1284,129,22.04.2019 00:30,134,13,Odessa
2303,2303,45,974,1295,34,1329,0,1329,10,1177,142,22.04.2019 01:30,134,13,Odessa
176,169,0,69,107,0,107,0,107,1,96,10,22.04.2019 00:02,134,13,Odessa
2160,2060,4,1041,1115,4,1119,0,1119,19,1010,90,22.04.2019 00:30,134,13,Odessa
2384,2392,18,940,1434,10,1444,0,1444,37,1247,160,22.04.2019 00:05,134,13,Odessa
2352,2348,21,858,1483,11,1494,0,1494,24,1293,177,22.04.2019 00:10,134,13,Odessa
2288,2275,27,1049,1220,19,1239,0,1239,16,1127,96,22.04.2019 00:30,134,13,Odessa
2288,2297,14,817,1462,9,1471,0,1471,25,1280,166,21.04.2019 22:30,134,13,Odessa
2128,2137,10,900,1220,8,1228,0,1228,33,1064,131,22.04.2019 00:20,134,13,Odessa
2384,2388,25,836,1528,20,1548,0,1548,50,1313,185,21.04.2019 23:20,134,13,Odessa
2416,2411,11,889,1519,8,1527,0,1527,41,1275,211,22.04.2019 01:05,134,13,Odessa
2512,2513,18,907,1590,15,1605,0,1605,41,1395,169,22.04.2019 01:00,134,13,Odessa
2352,2325,16,903,1440,9,1449,0,1449,27,1251,171,22.04.2019 00:15,134,13,Odessa
2448,2436,26,1034,1393,21,1414,0,1414,25,1252,137,22.04.2019 00:20,134,13,Odessa
1408,1396,14,546,849,13,862,0,862,19,740,103,22.04.2019 00:38,134,13,Odessa
2224,2225,17,862,1350,12,1362,0,1362,22,1202,138,21.04.2019 21:48,134,13,Odessa
2208,2203,16,850,1344,14,1358,0,1358,32,1180,146,22.04.2019 00:01,134,13,Odessa
2304,2301,20,925,1364,15,1379,0,1379,15,1216,148,22.04.2019 00:01,134,13,Odessa
2304,2285,26,1003,1285,16,1301,0,1301,33,1133,135,22.04.2019 00:30,134,13,Odessa
2240,2237,16,1014,1215,11,1226,0,1226,24,1087,115,21.04.2019 22:00,134,13,Odessa
2256,2247,11,883,1365,8,1373,0,1373,29,1209,135,22.04.2019 00:08,134,13,Odessa
2544,2535,16,962,1571,11,1582,0,1582,39,1339,204,21.04.2019 21:31,134,13,Odessa
1904,1894,11,734,1162,8,1170,0,1170,29,1029,112,22.04.2019 00:12,134,13,Odessa
496,123,71,395,44,57,101,0,101,0,94,7,21.04.2019 21:26,134,13,Odessa
448,188,74,264,115,69,184,0,184,7,164,13,22.04.2019 00:11,134,13,Odessa
848,452,0,400,448,0,448,0,448,26,387,35,22.04.2019 00:37,134,13,Odessa
912,553,0,360,552,0,552,0,552,27,491,34,22.04.2019 01:25,134,13,Odessa
656,148,0,508,148,0,148,0,148,5,134,9,22.04.2019 00:14,134,13,Odessa
1056,1040,3,485,569,2,571,0,571,10,520,41,22.04.2019 00:03,134,13,Odessa
2464,2394,1,2065,399,0,399,0,399,5,338,56,21.04.2019 21:59,134,13,Odessa
64,30,0,34,30,0,30,0,30,0,29,1,22.04.2019 00:17,135,13,Odessa
2240,2266,12,1025,1203,12,1215,0,1215,35,1074,106,21.04.2019 22:54,135,13,Odessa
2288,2276,11,982,1296,10,1306,0,1296,145,1006,145,22.04.2019 03:20,135,13,Odessa
2144,2154,10,914,1222,8,1230,0,1230,32,1045,153,22.04.2019 00:30,135,13,Odessa
2224,2203,13,897,1320,7,1327,0,1327,48,1145,134,21.04.2019 23:55,135,13,Odessa
2080,2104,7,822,1252,6,1258,0,1258,33,1035,190,22.04.2019 00:10,135,13,Odessa
2384,2382,10,1008,1370,6,1376,0,1376,32,1146,198,22.04.2019 01:00,135,13,Odessa
2080,2115,6,916,1162,2,1164,0,1164,19,982,163,21.04.2019 22:31,135,13,Odessa
2032,2018,3,956,1074,2,1076,0,1076,15,915,146,22.04.2019 00:17,135,13,Odessa
2448,2418,15,1041,1396,11,1407,0,1407,63,1165,179,22.04.2019 00:10,135,13,Odessa
2464,2439,9,1403,1060,1,1061,0,1061,24,903,134,22.04.2019 06:28,135,13,Odessa
2368,2342,6,1108,1255,5,1260,0,1260,22,1080,158,22.04.2019 00:10,135,13,Odessa
1760,1753,5,775,981,4,985,0,985,29,803,153,22.04.2019 00:10,135,13,Odessa
2480,2455,7,969,1505,6,1511,1,1510,41,1247,222,22.04.2019 02:15,135,13,Odessa
2128,2107,4,963,1163,2,1165,0,1165,14,1020,131,22.04.2019 00:22,135,13,Odessa
2400,2377,11,1018,1378,4,1382,0,1382,29,1182,171,21.04.2019 22:18,135,13,Odessa
1616,1612,8,664,949,3,952,0,952,20,803,129,22.04.2019 02:37,135,13,Odessa
2256,2258,7,982,1271,3,1274,0,1274,40,1069,165,22.04.2019 03:30,135,13,Odessa
2256,2261,17,1158,1084,14,1098,0,1098,46,904,148,21.04.2019 21:50,135,13,Odessa
2400,2378,6,1043,1356,1,1357,0,1357,38,1099,220,21.04.2019 23:32,135,13,Odessa
1792,1781,7,950,838,4,842,0,842,41,667,134,22.04.2019 02:29,135,13,Odessa
1552,1550,8,644,902,6,908,0,908,24,763,121,22.04.2019 00:20,135,13,Odessa
1856,1852,15,835,1013,8,1021,0,1021,23,829,169,22.04.2019 07:00,135,13,Odessa
2368,2320,1,1903,465,0,465,0,465,5,382,78,22.04.2019 00:11,135,13,Odessa
2336,2334,16,960,1362,14,1376,0,1376,31,1130,215,22.04.2019 04:04,135,13,Odessa
1664,1760,14,623,1030,11,1041,0,1041,31,829,181,22.04.2019 00:02,135,13,Odessa
2272,2277,11,967,1298,7,1305,0,1305,31,1077,197,22.04.2019 00:05,135,13,Odessa
1840,1832,13,808,1021,11,1032,0,1032,37,832,163,22.04.2019 00:26,135,13,Odessa
2400,2363,2,1951,449,0,449,0,449,10,387,52,22.04.2019 00:22,135,13,Odessa
2304,2289,10,987,1312,5,1317,0,1317,29,1092,196,22.04.2019 00:55,135,13,Odessa
2288,2303,4,946,1339,3,1342,0,1342,32,1132,178,22.04.2019 00:15,135,13,Odessa
1376,1374,2,615,759,2,761,0,761,26,601,134,22.04.2019 02:50,135,13,Odessa
2272,2203,4,1063,1205,4,1209,0,1209,16,933,260,21.04.2019 22:40,135,13,Odessa
1008,1045,5,427,577,4,581,0,581,21,455,105,22.04.2019 00:20,135,13,Odessa
2112,2115,9,927,1178,7,1185,0,1185,41,935,209,22.04.2019 00:15,135,13,Odessa
2160,2170,11,950,1203,7,1210,0,1210,41,996,173,22.04.2019 01:00,135,13,Odessa
1968,1989,5,786,1178,4,1182,0,1182,46,931,205,22.04.2019 00:18,135,13,Odessa
1584,1554,3,661,920,3,923,0,923,22,737,164,22.04.2019 06:20,135,13,Odessa
2208,2205,6,1029,1176,3,1179,0,1179,35,974,170,22.04.2019 00:08,135,13,Odessa
2128,2142,16,913,1205,10,1215,0,1215,38,973,204,22.04.2019 02:03,135,13,Odessa
2352,2336,9,943,1400,9,1409,0,1409,26,1178,205,22.04.2019 01:30,135,13,Odessa
1936,1939,5,789,1143,4,1147,0,1147,36,904,207,22.04.2019 01:00,135,13,Odessa
2206,2252,11,985,1213,8,1221,0,1221,27,1022,172,22.04.2019 00:26,135,13,Odessa
2224,2222,8,915,1304,5,1309,0,1309,32,1089,188,22.04.2019 00:30,135,13,Odessa
2000,1965,4,1362,634,4,638,0,638,15,533,90,22.04.2019 06:26,135,13,Odessa
2144,2070,3,1032,1110,2,1112,0,1112,29,925,158,22.04.2019 00:15,135,13,Odessa
2192,2176,13,969,1215,8,1223,0,1223,38,1000,185,22.04.2019 01:06,135,13,Odessa
2192,2177,16,913,1267,12,1279,0,1279,42,1068,169,21.04.2019 21:47,135,13,Odessa
1952,1985,5,844,1104,4,1108,0,1108,22,939,147,21.04.2019 22:25,135,13,Odessa
1840,1862,9,805,1031,4,1035,0,1035,20,886,129,22.04.2019 00:30,135,13,Odessa
2560,2387,4,1156,1400,4,1404,0,1404,32,800,572,22.04.2019 00:10,135,13,Odessa
2288,2288,6,987,1296,5,1301,0,1301,34,1125,142,21.04.2019 23:55,135,13,Odessa
1952,1985,9,719,1227,6,1233,0,1233,37,1010,186,22.04.2019 01:20,135,13,Odessa
1296,1290,6,493,799,4,803,0,803,23,698,82,22.04.2019 00:30,135,13,Odessa
2048,2043,4,977,1067,4,1071,0,1071,37,889,145,21.04.2019 23:20,135,13,Odessa
1632,1629,0,793,839,0,839,0,839,27,682,130,22.04.2019 00:15,135,13,Odessa
2160,2211,5,776,1380,4,1384,0,1384,44,1087,253,22.04.2019 00:22,135,13,Odessa
2032,2079,15,734,1288,10,1298,0,1298,36,1056,206,22.04.2019 00:30,135,13,Odessa
2080,2080,8,951,1121,8,1129,0,1129,37,912,180,22.04.2019 00:29,135,13,Odessa
2176,2177,0,1035,1141,0,1141,0,1141,17,981,143,21.04.2019 22:50,135,13,Odessa
2080,2055,2,837,1241,2,1243,0,1243,21,1015,207,22.04.2019 00:20,135,13,Odessa
1984,2096,9,725,1251,8,1259,0,1259,29,1047,183,22.04.2019 00:05,135,13,Odessa
2480,2453,17,881,1584,15,1599,0,1599,40,1319,240,22.04.2019 00:12,135,13,Odessa
2240,2312,5,823,1413,4,1417,0,1417,43,1104,270,21.04.2019 23:40,135,13,Odessa
2064,2104,17,750,1299,15,1314,0,1314,42,1075,197,22.04.2019 00:12,135,13,Odessa
2144,2137,12,794,1341,9,1350,0,1350,51,1087,212,22.04.2019 02:20,135,13,Odessa
2400,2382,14,1053,1337,10,1347,29,1347,29,1119,199,22.04.2019 00:20,135,13,Odessa
2288,2297,16,910,1368,10,1378,0,1378,43,1105,230,21.04.2019 22:30,135,13,Odessa
2384,2390,6,837,1541,6,1547,0,1547,31,1256,260,21.04.2019 23:35,135,13,Odessa
2160,2168,10,910,1244,6,1250,0,1250,27,1009,214,22.04.2019 01:00,135,13,Odessa
2527,2546,8,901,1620,6,1626,0,1626,27,1326,273,22.04.2019 00:20,135,13,Odessa
2128,2281,12,635,1483,10,1493,0,1493,36,1196,261,21.04.2019 23:10,135,13,Odessa
2528,2537,8,1034,1490,4,1494,0,1494,39,1216,239,22.04.2019 00:15,135,13,Odessa
2478,2486,10,1096,1374,8,1382,0,1382,41,1116,225,22.04.2019 00:31,135,13,Odessa
2272,2283,9,833,1433,6,1439,0,1439,43,1160,236,22.04.2019 00:45,135,13,Odessa
2016,2007,10,854,1157,5,1162,0,1162,28,937,197,22.04.2019 00:17,135,13,Odessa
1872,1890,5,859,1011,2,1013,0,1013,28,835,150,22.04.2019 00:01,135,13,Odessa
1952,1992,9,778,1168,6,1174,0,1174,47,932,195,22.04.2019 00:16,135,13,Odessa
1136,1122,0,410,726,0,726,0,726,18,587,121,21.04.2019 22:43,135,13,Odessa
2048,2071,6,772,1272,4,1276,0,1276,28,1050,198,22.04.2019 00:25,135,13,Odessa
2064,2121,10,735,1321,8,1329,0,1329,34,1061,234,22.04.2019 00:38,135,13,Odessa
2400,2435,6,970,1425,5,1430,0,1430,42,1171,217,22.04.2019 00:40,135,13,Odessa
144,34,0,111,33,0,33,0,33,0,33,0,21.04.2019 20:40,135,13,Odessa
80,34,0,47,33,0,33,0,33,0,31,2,22.04.2019 00:10,135,13,Odessa
256,56,0,207,49,0,49,0,49,1,46,2,22.04.2019 00:45,135,13,Odessa
368,79,70,291,11,66,77,0,77,1,70,6,21.04.2019 20:51,135,13,Odessa
208,21,2,187,19,2,21,0,21,0,21,0,21.04.2019 22:11,135,13,Odessa
128,40,0,89,39,0,39,0,39,0,38,1,21.04.2019 20:30,135,13,Odessa
336,47,5,289,42,5,47,0,47,1,44,2,21.04.2019 22:25,135,13,Odessa
224,110,36,134,67,23,90,0,90,2,81,7,21.04.2019 20:40,135,13,Odessa
240,86,10,155,77,8,85,0,85,5,74,6,21.04.2019 21:10,135,13,Odessa
144,28,0,116,28,0,28,0,28,0,24,4,22.04.2019 00:10,135,13,Odessa
704,173,41,537,128,39,167,0,167,7,132,28,22.04.2019 00:30,135,13,Odessa
496,135,0,371,125,0,125,0,125,3,98,24,22.04.2019 00:24,135,13,Odessa
176,81,0,122,54,0,54,0,54,3,47,4,21.04.2019 21:15,135,13,Odessa
192,105,46,89,58,45,103,0,103,4,87,12,21.04.2019 20:40,135,13,Odessa
1536,1536,3,617,916,3,919,0,919,28,725,166,22.04.2019 00:30,135,13,Odessa
2000,2030,2,730,1268,2,1270,0,1270,37,1054,179,22.04.2019 00:01,135,13,Odessa
2160,2180,13,890,1263,7,1270,0,1270,30,1143,97,22.04.2019 00:15,136,13,Odessa
2000,2036,6,736,1261,3,1264,0,1264,28,1044,192,22.04.2019 04:15,136,13,Odessa
2336,2343,18,856,1464,16,1480,0,1480,27,1260,193,22.04.2019 00:18,136,13,Odessa
2160,2162,14,794,1355,11,1366,0,1366,29,1150,187,22.04.2019 00:30,136,13,Odessa
2352,2348,8,1010,1337,5,1342,0,1342,16,1203,123,22.04.2019 00:02,136,13,Odessa
2352,2347,16,989,1358,5,1363,0,1363,36,1210,117,22.04.2019 00:10,136,13,Odessa
2208,2183,14,941,1257,10,1267,0,1267,32,1134,101,22.04.2019 00:06,136,13,Odessa
2128,2090,4,998,1126,4,1130,0,1130,24,969,137,22.04.2019 00:37,136,13,Odessa
1904,1901,9,720,1179,5,1184,0,1184,18,1017,149,22.04.2019 00:15,136,13,Odessa
1808,1816,19,709,1088,11,1099,0,1099,35,956,108,22.04.2019 00:22,136,13,Odessa
2208,2200,19,847,1350,11,1361,0,1361,30,1231,100,21.04.2019 21:30,136,13,Odessa
2512,2510,13,1069,1432,11,1443,0,1443,48,1305,90,22.04.2019 00:22,136,13,Odessa
2384,2368,18,986,1383,15,1398,0,1398,28,1254,116,21.04.2019 22:25,136,13,Odessa
2303,2301,14,941,1352,10,1362,0,1362,13,1236,113,22.04.2019 00:10,136,13,Odessa
2416,2400,21,1142,1258,16,1274,0,1274,27,1157,90,22.04.2019 00:10,136,13,Odessa
1072,1055,2,480,590,2,592,0,592,13,541,38,22.04.2019 01:15,136,13,Odessa
1536,1544,14,719,807,10,817,0,817,16,747,54,22.04.2019 00:20,136,13,Odessa
2144,2142,16,960,1173,11,1184,0,1184,29,1059,96,22.04.2019 00:40,136,13,Odessa
2112,2114,11,1017,1087,8,1095,0,1095,23,990,82,22.04.2019 00:20,136,13,Odessa
2320,2298,10,1046,1266,8,1274,0,1274,26,1151,97,22.04.2019 00:15,136,13,Odessa
2400,2400,17,1126,1265,9,1274,0,1274,30,1128,116,22.04.2019 00:10,136,13,Odessa
1744,1715,10,758,978,8,986,0,986,28,905,53,22.04.2019 00:28,136,13,Odessa
1200,1195,12,416,773,11,784,0,784,19,704,61,22.04.2019 00:24,136,13,Odessa
2288,2284,20,946,1330,12,1342,0,1342,37,1199,106,22.04.2019 00:15,136,13,Odessa
1216,1239,17,474,729,13,742,0,742,17,678,47,22.04.2019 00:12,136,13,Odessa
2208,2220,20,827,1363,18,1381,0,1381,19,1224,138,22.04.2019 00:08,136,13,Odessa
1872,1186,20,710,1148,14,1162,0,1162,28,1035,99,22.04.2019 00:40,136,13,Odessa
2112,2130,18,901,1202,9,1211,0,1211,28,1043,140,22.04.2019 01:30,136,13,Odessa
1952,1994,24,653,1280,19,1299,0,1299,25,1153,121,21.04.2019 21:33,136,13,Odessa
2128,2165,23,730,1379,19,1398,0,1398,26,1248,124,21.04.2019 23:05,136,13,Odessa
2384,2366,18,855,1515,14,1529,0,1529,33,1373,123,22.04.2019 02:00,136,13,Odessa
1920,1928,16,613,1295,12,1307,0,1307,21,1158,128,22.04.2019 00:11,136,13,Odessa
2096,2080,22,686,1394,16,1410,0,1410,43,1244,123,22.04.2019 00:02,136,13,Odessa
2064,2073,22,860,1190,14,1204,0,1204,22,1103,79,21.04.2019 23:17,136,13,Odessa
2000,2014,20,714,1268,18,1286,0,1286,17,1142,127,22.04.2019 00:03,136,13,Odessa
1984,1986,19,649,1320,15,1335,0,1335,22,1174,139,22.04.2019 00:16,136,13,Odessa
2256,2263,30,804,1435,17,1452,0,1452,44,1271,137,22.04.2019 00:45,136,13,Odessa
2336,2326,30,797,1514,25,1539,0,1539,33,1366,140,22.04.2019 03:00,136,13,Odessa
1952,1946,17,811,1129,12,1141,0,1141,16,1038,87,22.04.2019 00:20,136,13,Odessa
2208,2216,21,785,1407,16,1423,0,1423,22,1263,138,22.04.2019 00:26,136,13,Odessa
2192,2208,24,770,1406,16,1422,0,1422,38,1247,137,22.04.2019 00:11,136,13,Odessa
2352,2242,110,814,1455,83,1538,0,1538,55,1356,127,22.04.2019 00:40,136,13,Odessa
2192,2195,15,691,1491,10,1501,0,1501,33,1332,136,22.04.2019 00:05,136,13,Odessa
2128,2139,24,718,1397,13,1410,0,1410,41,1214,155,22.04.2019 00:05,136,13,Odessa
2048,2057,18,669,1364,15,1379,0,1379,30,1198,151,22.04.2019 00:07,136,13,Odessa
2272,2288,19,721,1536,15,1551,0,1551,35,1373,143,22.04.2019 00:05,136,13,Odessa
2256,2253,14,757,1487,12,1499,0,1499,25,1309,165,22.04.2019 00:06,136,13,Odessa
2160,2147,16,773,1377,10,1387,0,1387,27,1209,151,22.04.2019 00:22,136,13,Odessa
2160,2160,19,765,1386,9,1395,0,1395,37,1211,147,22.04.2019 00:14,136,13,Odessa
2080,2071,20,711,1363,6,1369,0,1369,28,1185,156,22.04.2019 00:15,136,13,Odessa
2176,2188,22,730,1433,13,1446,0,1446,26,1262,158,22.04.2019 00:20,136,13,Odessa
2000,2009,22,654,1329,17,1346,0,1346,29,1197,120,21.04.2019 22:30,136,13,Odessa
2224,2205,15,783,1427,14,1441,0,1441,30,1230,181,22.04.2019 00:04,136,13,Odessa
2080,2103,17,661,1406,13,1419,0,1419,20,1221,178,22.04.2019 03:30,136,13,Odessa
2320,2335,11,741,1571,8,1579,0,1579,32,1355,192,21.04.2019 22:10,136,13,Odessa
2112,2111,16,694,1407,11,1418,0,1418,39,1239,140,22.04.2019 00:15,136,13,Odessa
2128,2132,29,666,1442,20,1462,0,1462,47,1275,140,22.04.2019 00:05,136,13,Odessa
2128,2116,34,739,1362,27,1389,0,1389,33,1219,137,22.04.2019 00:05,136,13,Odessa
1952,1956,20,666,1268,18,1286,0,1286,35,1139,112,22.04.2019 00:22,136,13,Odessa
2288,2296,13,830,1448,10,1458,0,1458,32,1291,135,22.04.2019 00:15,136,13,Odessa
1968,1994,10,573,1388,7,1395,0,1395,51,1183,161,22.04.2019 00:06,136,13,Odessa
2128,2135,9,722,1399,7,1406,0,1406,23,1184,199,22.04.2019 00:40,136,13,Odessa
2400,2470,14,769,1623,8,1631,0,1631,19,1412,200,22.04.2019 00:15,136,13,Odessa
2432,2448,16,784,1638,10,1648,0,1648,35,1442,171,22.04.2019 00:06,136,13,Odessa
1936,1944,20,602,1325,9,1334,0,1334,33,1188,113,22.04.2019 00:50,136,13,Odessa
1936,1948,14,565,1361,10,1371,0,1371,37,1191,143,22.04.2019 07:00,136,13,Odessa
2176,2187,19,709,1452,15,1467,0,1467,27,1276,164,22.04.2019 00:26,136,13,Odessa
1808,1810,17,647,1151,10,1161,0,1161,26,1032,103,22.04.2019 00:11,136,13,Odessa
2064,2057,14,768,1285,11,1296,0,1296,25,1135,136,22.04.2019 00:16,136,13,Odessa
1952,1971,18,663,1275,14,1289,0,1289,32,1126,131,22.04.2019 00:20,136,13,Odessa
2048,2051,17,672,1363,13,1376,0,1376,33,1213,130,22.04.2019 00:23,136,13,Odessa
2128,2122,13,744,1371,13,1384,0,1384,43,1182,159,21.04.2019 23:02,136,13,Odessa
2288,2358,15,662,1616,10,1626,0,1626,29,1415,182,22.04.2019 00:11,136,13,Odessa
2411,2437,11,723,1681,7,1688,0,1685,36,1463,186,22.04.2019 00:10,136,13,Odessa
2480,2464,12,831,1641,8,1649,0,1649,38,1452,159,22.04.2019 00:45,136,13,Odessa
2352,2437,6,748,1600,4,1604,0,1604,23,1368,213,22.04.2019 00:40,136,13,Odessa
2192,2259,8,623,1564,5,1569,0,1569,30,1352,187,22.04.2019 00:12,136,13,Odessa
2480,2469,10,867,1603,10,1613,0,1613,13,1388,212,22.04.2019 00:27,136,13,Odessa
2464,2471,19,881,1573,10,1583,0,1583,40,1379,164,22.04.2019 00:01,136,13,Odessa
2336,2370,14,779,1548,9,1557,0,1557,36,1338,183,22.04.2019 00:15,136,13,Odessa
2048,2066,15,647,1389,12,1401,0,1401,36,1237,128,22.04.2019 00:33,136,13,Odessa
592,170,145,439,23,130,153,0,153,2,141,10,22.04.2019 00:20,136,13,Odessa
416,112,11,314,91,11,102,0,102,4,90,8,22.04.2019 00:52,136,13,Odessa
512,189,79,327,110,75,185,0,185,8,165,12,22.04.2019 00:05,136,13,Odessa
528,104,1,444,83,1,84,0,84,3,76,5,22.04.2019 00:05,136,13,Odessa
1040,129,0,915,125,0,125,0,125,14,97,14,22.04.2019 00:18,136,13,Odessa
128,16,0,112,16,0,16,0,16,0,16,0,22.04.2019 00:12,136,13,Odessa
96,73,3,23,70,3,73,0,73,1,67,5,21.04.2019 22:35,136,13,Odessa
1008,463,191,610,230,168,398,0,398,12,360,26,21.04.2019 20:40,136,13,Odessa
2080,2092,17,669,1401,10,1411,0,1411,16,1209,186,22.04.2019 00:20,136,13,Odessa
1376,1337,12,724,644,8,652,0,652,16,558,78,22.04.2019 01:27,137,13,Odessa
1872,1837,15,1002,860,10,870,0,870,13,776,81,22.04.2019 00:35,137,13,Odessa
1536,1490,4,723,809,4,813,0,813,26,674,113,22.04.2019 00:20,137,13,Odessa
1568,1472,10,713,849,6,855,0,855,11,710,134,22.04.2019 00:05,137,13,Odessa
1328,1289,11,636,685,7,692,0,692,8,598,86,21.04.2019 22:00,137,13,Odessa
864,841,6,390,469,5,474,0,474,6,396,72,22.04.2019 01:15,137,13,Odessa
1040,1010,7,508,526,6,532,0,532,11,456,65,22.04.2019 01:07,137,13,Odessa
1184,1145,12,548,629,7,636,0,636,12,531,93,22.04.2019 00:20,137,13,Odessa
1520,1490,6,749,766,5,771,0,771,12,637,122,22.04.2019 00:15,137,13,Odessa
1296,1249,17,624,657,15,672,0,672,18,556,98,21.04.2019 23:25,137,13,Odessa
320,306,25,140,157,23,180,0,180,4,142,34,22.04.2019 00:30,137,13,Odessa
768,751,38,315,421,32,453,0,453,5,382,66,22.04.2019 00:50,137,13,Odessa
304,292,36,99,173,32,205,0,205,6,127,72,22.04.2019 02:15,137,13,Odessa
256,255,18,98,143,15,158,0,158,1,137,20,22.04.2019 00:45,137,13,Odessa
320,316,11,185,128,7,135,0,135,3,96,36,22.04.2019 01:00,137,13,Odessa
1056,1034,49,506,514,36,550,0,550,6,462,82,22.04.2019 00:30,137,13,Odessa
848,840,21,411,418,19,437,0,437,11,384,42,22.04.2019 01:55,137,13,Odessa
960,947,40,487,444,29,473,0,473,5,394,74,22.04.2019 00:31,137,13,Odessa
864,854,32,392,446,26,472,0,472,8,384,80,22.04.2019 00:05,137,13,Odessa
640,613,29,296,318,26,344,0,344,11,253,80,21.04.2019 21:15,137,13,Odessa
512,503,56,209,253,50,303,0,303,1,244,58,21.04.2019 23:30,137,13,Odessa
192,171,6,98,91,3,94,0,94,0,84,10,22.04.2019 00:10,137,13,Odessa
272,261,12,88,175,9,184,0,184,1,149,34,22.04.2019 00:45,137,13,Odessa
64,64,6,12,46,6,52,0,52,1,24,27,22.04.2019 00:28,137,13,Odessa
128,121,5,60,63,5,68,0,68,0,43,25,21.04.2019 21:30,137,13,Odessa
224,222,24,97,103,24,127,0,127,2,81,44,22.04.2019 00:49,137,13,Odessa
272,265,20,100,152,20,172,0,172,0,115,57,21.04.2019 20:50,137,13,Odessa
528,518,38,170,325,33,358,0,358,4,231,123,22.04.2019 00:45,137,13,Odessa
288,271,17,149,127,12,139,0,139,1,91,47,22.04.2019 00:05,137,13,Odessa
576,567,16,238,324,14,338,0,338,2,266,70,22.04.2019 01:00,137,13,Odessa
384,385,26,150,209,25,234,0,234,5,168,61,21.04.2019 21:30,137,13,Odessa
400,400,31,135,240,25,265,0,265,9,212,44,22.04.2019 01:05,137,13,Odessa
208,203,8,93,110,5,115,0,115,0,96,19,22.04.2019 00:15,137,13,Odessa
384,395,43,142,207,35,242,0,242,4,194,44,22.04.2019 00:42,137,13,Odessa
528,508,43,298,195,35,230,0,230,6,188,36,22.04.2019 00:35,137,13,Odessa
432,420,37,189,214,29,243,0,243,2,188,53,22.04.2019 00:05,137,13,Odessa
1296,1280,85,633,607,56,663,0,663,17,499,147,22.04.2019 02:30,137,13,Odessa
592,582,59,242,300,50,350,0,350,5,240,105,22.04.2019 02:00,137,13,Odessa
1424,1381,43,693,703,28,731,0,731,19,615,97,22.04.2019 01:30,137,13,Odessa
1680,1625,27,763,892,25,917,0,917,7,759,151,22.04.2019 00:45,137,13,Odessa
1600,1563,32,697,876,27,903,0,903,28,734,141,21.04.2019 23:00,137,13,Odessa
1536,1520,35,758,751,27,778,0,778,11,669,98,22.04.2019 01:00,137,13,Odessa
736,710,80,346,324,66,390,0,390,9,312,69,22.04.2019 00:05,137,13,Odessa
160,155,5,64,93,3,96,0,96,4,49,43,21.04.2019 20:50,137,13,Odessa
176,170,13,79,85,12,97,0,97,1,86,10,21.04.2019 23:45,137,13,Odessa
1152,1132,46,571,545,36,581,0,581,9,485,87,22.04.2019 00:10,137,13,Odessa
480,469,32,265,183,32,215,0,215,2,186,27,22.04.2019 00:35,137,13,Odessa
48,37,1,20,28,0,28,0,28,0,21,7,21.04.2019 21:14,137,13,Odessa
272,261,12,96,164,12,176,0,176,2,133,41,21.04.2019 23:00,137,13,Odessa
768,733,17,360,393,15,408,0,408,9,342,57,22.04.2019 00:05,137,13,Odessa
368,362,6,187,177,4,181,0,181,3,151,27,22.04.2019 00:10,137,13,Odessa
176,185,7,49,120,7,127,0,127,2,96,29,22.04.2019 00:25,137,13,Odessa
208,205,8,73,127,8,135,0,135,1,117,17,22.04.2019 00:20,137,13,Odessa
656,645,17,276,363,17,380,0,380,9,336,35,22.04.2019 00:05,137,13,Odessa
128,120,2,56,70,2,72,0,72,1,55,16,22.04.2019 00:10,137,13,Odessa
512,500,14,244,255,13,268,0,268,14,239,15,22.04.2019 00:01,137,13,Odessa
720,699,28,271,425,24,449,0,449,12,388,49,22.04.2019 00:30,137,13,Odessa
128,119,2,46,80,2,82,0,82,0,78,4,22.04.2019 00:15,137,13,Odessa
416,414,19,174,224,18,242,0,242,1,185,56,22.04.2019 00:50,137,13,Odessa
112,105,11,50,51,11,62,0,62,0,38,24,22.04.2019 00:55,137,13,Odessa
112,104,12,43,59,10,69,0,69,1,43,25,22.04.2019 00:20,137,13,Odessa
384,381,37,139,213,32,245,0,245,4,195,46,22.04.2019 00:20,137,13,Odessa
32,30,5,6,22,4,26,0,26,0,23,3,22.04.2019 00:00,137,13,Odessa
32,18,2,16,15,1,16,0,16,0,9,7,22.04.2019 00:20,137,13,Odessa
64,66,0,20,44,0,44,0,44,0,32,12,22.04.2019 00:05,137,13,Odessa
192,182,2,108,82,2,84,0,84,0,47,37,22.04.2019 00:20,137,13,Odessa
160,161,7,64,91,5,96,0,96,0,48,48,22.04.2019 00:05,137,13,Odessa
768,750,26,332,412,24,436,0,436,11,360,65,22.04.2019 00:34,137,13,Odessa
64,64,2,35,28,1,29,0,29,1,22,6,21.04.2019 21:30,137,13,Odessa
624,608,44,263,317,44,361,0,361,3,323,35,22.04.2019 00:08,137,13,Odessa
1216,1198,27,476,717,23,740,0,740,18,649,73,22.04.2019 00:15,137,13,Odessa
272,257,1,164,107,1,108,0,108,1,96,11,22.04.2019 00:04,137,13,Odessa
432,402,20,202,211,19,230,0,230,2,213,15,22.04.2019 00:09,137,13,Odessa
48,40,1,16,32,0,32,0,32,0,14,18,21.04.2019 20:35,137,13,Odessa
416,396,7,209,202,5,207,0,207,5,186,16,22.04.2019 00:21,137,13,Odessa
1040,1015,26,542,479,19,498,0,498,14,403,81,21.04.2019 23:00,137,13,Odessa
576,570,11,334,236,6,242,0,242,4,230,8,22.04.2019 02:10,137,13,Odessa
816,798,25,368,430,18,448,0,448,5,396,47,22.04.2019 00:50,137,13,Odessa
304,292,42,70,192,42,234,0,234,3,188,43,22.04.2019 00:50,137,13,Odessa
928,911,43,482,410,36,446,0,446,4,390,52,21.04.2019 21:35,137,13,Odessa
1072,1045,79,380,613,79,692,0,692,8,500,184,22.04.2019 01:15,137,13,Odessa
96,99,1,22,74,0,74,0,74,1,41,32,22.04.2019 00:45,137,13,Odessa
80,69,1,27,53,0,53,0,53,0,36,17,22.04.2019 00:05,137,13,Odessa
64,54,6,37,22,5,27,0,27,0,19,8,22.04.2019 00:15,137,13,Odessa
160,162,6,47,107,6,113,0,113,1,76,36,22.04.2019 00:15,137,13,Odessa
1136,1114,32,550,564,22,586,0,586,8,502,76,22.04.2019 00:05,137,13,Odessa
176,172,5,68,106,2,108,0,108,4,81,23,22.04.2019 00:10,137,13,Odessa
496,485,7,229,260,7,267,0,267,3,238,26,22.04.2019 00:05,137,13,Odessa
288,281,8,156,126,6,132,0,132,0,105,27,22.04.2019 00:15,137,13,Odessa
416,399,10,197,211,8,219,0,219,1,192,26,22.04.2019 00:17,137,13,Odessa
320,311,10,132,179,9,188,0,188,3,172,13,22.04.2019 00:02,137,13,Odessa
64,58,8,26,32,6,38,0,38,0,34,4,22.04.2019 02:00,137,13,Odessa
224,212,8,89,129,6,135,0,135,3,114,18,21.04.2019 21:30,137,13,Odessa
32,23,0,19,13,0,13,0,13,0,12,1,22.04.2019 00:10,137,13,Odessa
160,155,6,64,93,3,96,0,96,0,76,20,22.04.2019 00:10,137,13,Odessa
160,149,3,58,100,2,102,0,102,6,80,16,22.04.2019 01:20,137,13,Odessa
704,696,48,344,314,46,360,0,360,9,291,60,22.04.2019 00:15,137,13,Odessa
96,90,9,54,35,7,42,0,42,0,34,8,22.04.2019 00:45,137,13,Odessa
656,645,61,280,321,55,376,0,376,4,289,83,22.04.2019 00:30,137,13,Odessa
224,207,18,91,117,16,133,0,133,2,112,19,22.04.2019 00:30,137,13,Odessa
160,144,13,77,73,10,83,0,83,1,63,19,22.04.2019 00:04,137,13,Odessa
192,187,13,76,104,12,116,0,116,0,92,24,22.04.2019 00:20,137,13,Odessa
2224,2160,31,1070,1129,25,1154,0,1154,27,1006,121,22.04.2019 01:50,137,13,Odessa
2096,2030,39,1007,1055,34,1089,0,1089,21,933,135,22.04.2019 01:40,137,13,Odessa
560,546,17,270,275,15,290,0,290,3,260,27,22.04.2019 02:56,137,13,Odessa
160,155,11,80,70,10,80,0,80,0,60,20,22.04.2019 00:40,137,13,Odessa
592,575,40,287,269,36,305,0,305,10,219,76,22.04.2019 01:15,137,13,Odessa
176,173,3,44,132,0,132,0,132,3,114,15,21.04.2019 20:55,137,13,Odessa
864,846,16,396,456,12,468,0,468,3,390,75,22.04.2019 00:10,137,13,Odessa
1344,1334,8,529,808,7,815,0,815,16,705,94,22.04.2019 00:10,137,13,Odessa
2000,1950,9,798,1193,9,1202,0,1202,19,1067,116,22.04.2019 00:05,137,13,Odessa
2048,2028,20,754,1277,17,1294,0,1294,19,1132,143,22.04.2019 00:45,137,13,Odessa
1696,1676,20,730,950,16,966,0,966,28,837,101,22.04.2019 01:05,137,13,Odessa
1072,1060,11,468,597,7,604,0,604,19,556,29,22.04.2019 02:15,137,13,Odessa
2064,1955,5,913,1147,4,1151,0,1151,29,996,126,22.04.2019 00:15,137,13,Odessa
2432,2383,17,1023,1399,10,1409,0,1409,33,1277,99,22.04.2019 00:05,137,13,Odessa
2304,2263,23,944,1339,21,1360,0,1360,31,1214,115,22.04.2019 00:30,137,13,Odessa
1824,1790,18,827,981,16,997,0,997,14,918,65,22.04.2019 00:15,137,13,Odessa
2272,2236,15,977,1281,14,1295,0,1295,18,1207,70,22.04.2019 00:20,137,13,Odessa
1712,1677,12,738,968,6,974,0,974,17,894,63,22.04.2019 00:20,137,13,Odessa
1680,1655,14,699,972,9,981,0,981,20,897,64,22.04.2019 00:15,137,13,Odessa
1904,1858,26,797,1085,22,1107,0,1107,31,980,96,22.04.2019 00:20,137,13,Odessa
2272,2245,18,874,1385,13,1398,0,1398,26,1236,136,22.04.2019 02:05,137,13,Odessa
368,26,12,346,11,11,22,0,22,0,20,2,22.04.2019 00:02,137,13,Odessa
144,28,16,119,11,14,25,0,25,0,20,5,22.04.2019 00:05,137,13,Odessa
704,672,7,337,360,7,367,0,367,1,348,18,21.04.2019 21:35,138,13,Odessa
800,771,14,434,354,12,366,0,366,6,343,17,21.04.2019 21:40,138,13,Odessa
592,584,1,245,346,1,347,0,347,8,304,35,21.04.2019 21:14,138,13,Odessa
416,409,5,239,173,4,177,0,177,5,153,19,21.04.2019 21:15,138,13,Odessa
416,407,7,233,182,1,183,0,183,5,165,13,22.04.2019 00:55,138,13,Odessa
592,583,2,350,240,2,242,0,242,6,224,12,21.04.2019 23:57,138,13,Odessa
128,109,15,66,52,10,62,0,62,0,61,1,21.04.2019 21:30,138,13,Odessa
528,504,45,279,207,42,249,0,249,4,206,39,21.04.2019 20:30,138,13,Odessa
400,389,34,185,186,29,215,0,215,1,182,32,21.04.2019 20:35,138,13,Odessa
368,355,27,174,172,22,194,0,194,8,159,27,21.04.2019 20:48,138,13,Odessa
496,488,10,270,218,8,226,0,226,4,197,25,21.04.2019 23:45,138,13,Odessa
448,429,41,185,228,35,263,0,263,1,223,39,21.04.2019 23:15,138,13,Odessa
480,455,22,235,231,14,245,0,245,1,217,27,21.04.2019 21:00,138,13,Odessa
608,587,24,284,301,23,324,0,324,4,295,25,22.04.2019 00:30,138,13,Odessa
496,492,36,226,239,31,270,0,270,4,241,25,21.04.2019 21:15,138,13,Odessa
416,403,14,223,183,10,193,0,193,1,172,20,21.04.2019 20:25,138,13,Odessa
528,519,2,287,239,2,241,0,241,6,219,16,21.04.2019 20:32,138,13,Odessa
144,138,5,59,80,5,85,0,85,2,75,8,21.04.2019 20:37,138,13,Odessa
688,673,33,393,264,31,295,0,295,5,275,15,21.04.2019 20:45,138,13,Odessa
496,482,13,229,257,10,267,0,267,4,226,37,21.04.2019 21:40,138,13,Odessa
240,237,14,60,166,14,180,0,180,1,172,7,21.04.2019 20:30,138,13,Odessa
160,154,0,38,122,0,122,0,122,1,96,25,21.04.2019 20:22,138,13,Odessa
128,128,0,8,120,0,120,0,120,1,103,16,21.04.2019 20:00,138,13,Odessa
432,418,3,210,220,2,222,0,222,2,193,27,21.04.2019 21:15,138,13,Odessa
240,230,0,147,93,0,93,0,93,0,62,31,21.04.2019 20:17,138,13,Odessa
96,91,6,40,50,6,56,0,56,0,47,9,21.04.2019 20:26,138,13,Odessa
128,114,0,46,82,0,82,0,82,1,61,20,21.04.2019 23:30,138,13,Odessa
160,148,1,79,80,1,81,0,81,2,62,17,21.04.2019 20:21,138,13,Odessa
240,221,9,84,147,9,156,0,156,0,140,16,21.04.2019 21:15,138,13,Odessa
496,487,11,249,240,7,247,0,247,8,221,18,21.04.2019 20:40,138,13,Odessa
192,181,2,79,111,2,113,0,113,0,107,6,21.04.2019 20:35,138,13,Odessa
112,108,3,53,56,3,59,0,59,1,51,7,22.04.2019 00:05,138,13,Odessa
64,59,1,25,38,1,39,0,39,0,31,8,21.04.2019 20:35,138,13,Odessa
400,394,15,181,205,14,219,0,219,4,176,39,21.04.2019 20:31,138,13,Odessa
320,308,9,144,168,8,176,0,176,6,141,29,21.04.2019 21:48,138,13,Odessa
256,241,2,129,127,0,127,0,127,2,104,21,21.04.2019 21:27,138,13,Odessa
240,238,18,141,86,13,99,0,99,0,85,14,21.04.2019 20:41,138,13,Odessa
704,686,17,348,342,14,356,0,356,2,321,33,21.04.2019 21:05,138,13,Odessa
1232,1208,24,637,579,16,595,0,595,16,561,18,21.04.2019 20:20,138,13,Odessa
144,129,0,54,90,0,90,0,90,0,86,4,21.04.2019 20:15,138,13,Odessa
336,324,7,180,149,7,156,0,156,3,132,21,21.04.2019 21:25,138,13,Odessa
848,826,8,370,471,7,478,0,478,14,407,57,22.04.2019 01:40,138,13,Odessa
336,322,20,164,157,15,172,0,172,0,146,26,21.04.2019 20:50,138,13,Odessa
96,94,0,36,60,0,60,0,60,0,47,13,22.04.2019 00:07,138,13,Odessa
112,100,7,62,45,5,50,0,50,0,38,12,21.04.2019 22:00,138,13,Odessa
560,546,43,255,273,32,305,0,305,13,259,33,21.04.2019 20:55,138,13,Odessa
992,964,9,530,455,7,462,0,462,7,430,25,21.04.2019 20:28,138,13,Odessa
1536,1501,13,860,666,10,676,0,676,10,630,36,21.04.2019 20:40,138,13,Odessa
1392,1368,1,661,730,1,731,0,731,20,642,69,21.04.2019 21:45,138,13,Odessa
336,327,5,117,216,3,219,0,219,1,201,17,21.04.2019 21:00,138,13,Odessa
448,434,8,238,202,8,210,0,210,2,192,16,21.04.2019 20:41,138,13,Odessa
80,81,3,38,40,2,42,0,42,0,41,1,22.04.2019 01:05,138,13,Odessa
336,322,15,176,147,13,160,0,160,10,138,12,21.04.2019 21:20,138,13,Odessa
1280,1257,78,572,639,69,708,0,708,11,642,55,22.04.2019 00:20,138,13,Odessa
1632,1611,96,628,921,83,1004,0,1004,22,831,151,21.04.2019 20:35,138,13,Odessa
192,186,8,60,124,8,132,0,132,6,109,17,21.04.2019 20:44,138,13,Odessa
112,107,4,36,72,4,76,0,76,1,60,15,21.04.2019 20:35,138,13,Odessa
112,26,7,91,14,7,21,0,21,0,18,3,21.04.2019 23:50,138,13,Odessa
144,136,4,54,86,4,90,0,90,2,76,12,21.04.2019 20:38,138,13,Odessa
128,124,4,47,77,4,81,0,81,0,54,27,21.04.2019 20:45,138,13,Odessa
1200,1195,24,517,661,22,683,0,683,8,615,60,21.04.2019 21:40,138,13,Odessa
112,102,1,43,68,1,69,0,69,1,66,2,21.04.2019 22:30,138,13,Odessa
1808,1799,22,775,1011,22,1033,0,1033,13,918,102,21.04.2019 21:00,138,13,Odessa
2320,2313,16,882,1422,16,1438,0,1438,29,1209,200,21.04.2019 22:00,138,13,Odessa
336,333,49,130,163,43,206,0,206,2,123,81,21.04.2019 20:37,138,13,Odessa
704,691,48,301,361,42,403,0,403,3,331,69,21.04.2019 21:00,138,13,Odessa
560,546,20,330,217,13,230,0,230,6,192,32,21.04.2019 21:25,138,13,Odessa
608,597,32,301,279,28,307,0,307,5,236,66,21.04.2019 20:54,138,13,Odessa
592,583,26,334,236,22,258,0,258,1,228,29,21.04.2019 21:23,138,13,Odessa
272,268,6,137,129,6,135,0,135,3,115,17,22.04.2019 06:40,138,13,Odessa
1088,1063,59,531,505,52,557,0,557,9,490,58,22.04.2019 00:40,138,13,Odessa
240,229,25,115,103,22,125,0,125,1,116,8,21.04.2019 21:00,138,13,Odessa
272,257,18,126,129,17,146,0,146,2,123,21,22.04.2019 02:00,138,13,Odessa
144,140,6,69,70,5,75,0,75,0,59,16,22.04.2019 00:15,138,13,Odessa
1104,1082,30,521,561,22,583,0,583,15,513,55,21.04.2019 20:47,138,13,Odessa
960,949,23,454,487,19,506,0,506,5,455,46,21.04.2019 21:20,138,13,Odessa
528,520,40,194,300,34,334,0,334,5,293,36,21.04.2019 20:40,138,13,Odessa
368,359,24,192,158,18,176,0,176,6,139,31,21.04.2019 21:05,138,13,Odessa
320,309,19,66,235,19,254,0,254,1,241,12,21.04.2019 21:20,138,13,Odessa
176,160,16,49,111,16,127,0,127,0,91,36,21.04.2019 20:30,138,13,Odessa
400,381,15,177,209,14,223,0,223,3,202,18,21.04.2019 21:15,138,13,Odessa
416,413,36,186,200,30,230,0,230,5,193,32,21.04.2019 21:00,138,13,Odessa
992,981,66,443,488,61,549,0,549,4,468,77,21.04.2019 20:55,138,13,Odessa
848,831,31,418,404,26,430,0,430,9,384,37,21.04.2019 21:30,138,13,Odessa
224,209,17,126,84,14,98,0,98,4,80,14,21.04.2019 21:00,138,13,Odessa
288,243,32,142,118,28,146,0,146,2,125,19,21.04.2019 20:56,138,13,Odessa
432,424,10,160,262,10,272,0,272,10,211,51,21.04.2019 21:08,138,13,Odessa
1312,1293,40,533,743,36,779,0,779,13,648,118,21.04.2019 21:10,138,13,Odessa
1152,1128,59,508,585,59,644,0,644,7,594,43,21.04.2019 21:40,138,13,Odessa
224,218,13,111,101,12,113,0,113,2,86,25,21.04.2019 20:50,138,13,Odessa
512,494,24,231,257,24,281,0,281,0,249,32,21.04.2019 21:00,138,13,Odessa
592,575,45,274,276,42,318,0,318,2,284,32,21.04.2019 21:00,138,13,Odessa
624,615,40,282,304,38,342,0,342,7,267,68,21.04.2019 20:47,138,13,Odessa
960,950,33,422,514,24,538,0,538,4,483,51,21.04.2019 22:30,138,13,Odessa
464,446,17,239,208,17,225,0,225,3,192,30,21.04.2019 21:10,138,13,Odessa
288,274,6,161,124,3,127,0,127,0,117,10,21.04.2019 20:43,138,13,Odessa
208,204,0,99,109,0,109,0,109,3,84,22,21.04.2019 23:15,138,13,Odessa
240,226,1,109,130,1,131,0,131,4,104,23,21.04.2019 20:15,138,13,Odessa
448,426,8,210,232,6,238,0,238,1,211,26,21.04.2019 23:40,138,13,Odessa
384,380,6,173,210,1,211,0,211,0,193,18,21.04.2019 23:50,138,13,Odessa
432,422,19,204,210,18,228,0,228,6,202,20,21.04.2019 22:00,138,13,Odessa
848,830,21,380,447,21,468,0,468,6,399,63,21.04.2019 21:15,138,13,Odessa
848,822,30,407,414,27,441,0,441,6,363,72,22.04.2019 00:25,138,13,Odessa
304,297,6,170,128,6,134,0,134,2,119,13,21.04.2019 21:10,138,13,Odessa
112,109,0,49,63,0,63,0,63,0,52,11,21.04.2019 21:00,138,13,Odessa
128,115,0,51,77,0,77,0,77,0,69,8,21.04.2019 22:40,138,13,Odessa
272,269,18,142,115,15,130,0,130,1,98,31,21.04.2019 20:35,138,13,Odessa
224,218,16,127,84,13,97,0,97,0,84,13,21.04.2019 20:35,138,13,Odessa
560,537,52,257,262,41,303,0,303,8,258,37,21.04.2019 21:15,138,13,Odessa
304,288,19,148,141,15,156,0,156,0,137,19,21.04.2019 20:45,138,13,Odessa
1920,1890,82,974,889,57,946,0,946,19,818,109,21.04.2019 22:00,138,13,Odessa
640,627,19,334,292,14,306,0,306,3,266,37,21.04.2019 21:20,138,13,Odessa
240,243,23,77,141,22,163,0,163,4,119,40,21.04.2019 21:30,138,13,Odessa
624,613,43,333,252,39,291,0,291,1,260,30,21.04.2019 20:31,138,13,Odessa
496,488,17,216,264,16,280,0,280,6,255,19,21.04.2019 21:40,138,13,Odessa
992,974,68,521,413,58,471,0,471,7,404,60,21.04.2019 23:57,138,13,Odessa
160,155,5,63,94,3,97,0,97,3,86,8,21.04.2019 20:15,138,13,Odessa
496,488,14,235,248,13,261,0,261,4,207,50,22.04.2019 03:10,138,13,Odessa
368,366,18,193,159,16,175,0,175,3,151,21,21.04.2019 21:05,138,13,Odessa
592,580,62,276,259,57,316,0,316,1,293,22,21.04.2019 21:35,138,13,Odessa
400,390,37,195,170,35,205,0,205,2,183,20,21.04.2019 20:45,138,13,Odessa
416,405,31,200,189,27,216,0,216,3,195,18,21.04.2019 20:50,138,13,Odessa
784,760,76,340,371,73,444,0,444,4,363,77,21.04.2019 21:10,138,13,Odessa
528,521,27,256,249,23,272,0,272,3,238,31,21.04.2019 21:00,138,13,Odessa
224,210,7,101,118,5,123,0,123,2,110,11,21.04.2019 21:15,138,13,Odessa
352,341,27,191,141,20,161,0,161,3,126,32,21.04.2019 22:20,138,13,Odessa
816,801,46,377,402,37,439,0,439,8,399,32,21.04.2019 21:35,138,13,Odessa
480,472,40,270,173,37,210,0,210,5,147,58,21.04.2019 20:37,138,13,Odessa
976,952,5,414,557,5,562,0,562,2,491,69,22.04.2019 00:15,138,13,Odessa
1680,1644,13,743,925,12,937,0,937,6,808,123,21.04.2019 20:51,138,13,Odessa
80,54,0,37,43,0,43,0,43,2,40,1,21.04.2019 20:35,138,13,Odessa
144,14,4,130,10,4,14,0,14,0,10,4,21.04.2019 20:39,138,13,Odessa
224,215,12,100,112,12,124,0,124,0,104,20,21.04.2019 20:15,138,13,Odessa
1088,1071,13,467,610,11,621,0,621,8,537,76,21.04.2019 22:15,138,13,Odessa
1296,1279,7,493,799,4,803,0,803,12,739,52,21.04.2019 20:45,139,13,Odessa
160,146,1,65,94,1,95,0,95,2,89,4,21.04.2019 20:28,139,13,Odessa
1488,1463,28,712,752,24,776,0,776,15,679,82,21.04.2019 22:00,139,13,Odessa
1984,1957,32,970,992,22,1014,0,1014,21,917,76,21.04.2019 22:55,139,13,Odessa
1136,1116,14,539,586,11,597,0,597,22,533,42,21.04.2019 23:40,139,13,Odessa
2000,1972,17,868,1115,17,1132,0,1132,35,1000,97,21.04.2019 21:20,139,13,Odessa
1632,1603,11,627,998,7,1005,0,1005,12,882,111,21.04.2019 20:54,139,13,Odessa
1648,1622,27,637,994,17,1011,0,1011,17,932,62,21.04.2019 21:37,139,13,Odessa
1232,1212,52,514,684,34,718,0,718,15,662,41,22.04.2019 01:10,139,13,Odessa
1040,1019,28,446,570,24,594,0,594,6,562,26,21.04.2019 21:20,139,13,Odessa
1696,1673,21,636,1048,12,1060,0,1060,23,980,57,21.04.2019 21:20,139,13,Odessa
464,446,3,179,282,3,285,0,285,3,269,13,21.04.2019 20:35,139,13,Odessa
384,377,0,150,234,0,234,0,234,7,219,8,21.04.2019 20:35,139,13,Odessa
416,409,24,149,244,23,267,0,267,2,251,14,21.04.2019 21:15,139,13,Odessa
704,699,9,357,341,6,347,0,347,5,303,39,21.04.2019 21:15,139,13,Odessa
368,362,0,147,221,0,221,0,221,4,206,11,21.04.2019 21:10,139,13,Odessa
784,768,19,339,427,18,445,0,445,8,379,58,21.04.2019 21:35,139,13,Odessa
2240,2242,21,914,1311,15,1326,0,1326,28,1167,131,21.04.2019 21:47,139,13,Odessa
320,311,10,147,163,10,173,0,173,3,164,6,21.04.2019 20:40,139,13,Odessa
224,214,8,93,125,6,131,0,131,1,110,20,21.04.2019 21:00,139,13,Odessa
944,948,38,490,422,32,454,0,454,14,411,29,22.04.2019 00:05,139,13,Odessa
1536,1516,33,711,802,23,825,0,825,23,727,75,21.04.2019 21:18,139,13,Odessa
1696,1665,29,767,905,24,929,0,929,18,834,77,21.04.2019 22:35,139,13,Odessa
1392,1366,22,608,775,9,784,0,784,17,686,81,21.04.2019 20:50,139,13,Odessa
2336,2319,143,1258,995,83,1078,0,1078,16,1029,33,21.04.2019 23:10,139,13,Odessa
896,865,77,489,352,55,407,0,407,3,372,32,21.04.2019 20:35,139,13,Odessa
704,695,31,385,295,24,319,0,319,5,292,22,21.04.2019 21:10,139,13,Odessa
128,122,11,84,39,5,44,0,44,2,40,2,21.04.2019 20:42,139,13,Odessa
576,558,32,291,259,26,285,0,285,6,253,26,21.04.2019 22:03,139,13,Odessa
1904,1876,32,1109,769,26,795,0,795,21,690,84,21.04.2019 21:30,139,13,Odessa
320,314,10,160,151,9,160,0,160,5,136,19,21.04.2019 21:05,139,13,Odessa
1520,1504,26,743,752,25,777,0,777,11,709,57,21.04.2019 21:20,139,13,Odessa
320,320,31,99,194,27,221,0,221,0,190,31,21.04.2019 20:43,139,13,Odessa
608,591,31,325,259,24,283,0,283,6,252,25,21.04.2019 21:35,139,13,Odessa
592,583,49,302,262,28,290,0,290,4,262,24,21.04.2019 21:00,139,13,Odessa
496,479,39,202,261,33,294,0,294,8,248,38,21.04.2019 21:15,139,13,Odessa
784,766,51,340,395,49,444,0,444,4,409,31,21.04.2019 20:53,139,13,Odessa
560,546,26,300,245,15,260,0,260,8,240,12,21.04.2019 20:39,139,13,Odessa
432,427,11,204,219,9,228,0,228,3,185,40,21.04.2019 21:00,139,13,Odessa
304,290,22,135,151,18,169,0,169,1,149,19,21.04.2019 20:41,139,13,Odessa
464,444,27,229,216,19,235,0,235,2,228,5,22.04.2019 06:16,139,13,Odessa
640,637,42,320,278,42,320,0,320,4,266,50,21.04.2019 20:48,139,13,Odessa
432,430,41,190,207,35,242,0,242,3,207,32,21.04.2019 20:25,139,13,Odessa
464,458,21,222,221,21,242,0,242,2,206,34,21.04.2019 22:00,139,13,Odessa
304,298,6,135,163,6,169,0,169,3,143,23,21.04.2019 20:40,139,13,Odessa
496,500,7,187,302,7,309,0,309,3,272,34,21.04.2019 22:00,139,13,Odessa
1600,1597,22,591,990,19,1009,0,1009,22,884,103,21.04.2019 20:41,139,13,Odessa
1824,1805,10,734,1082,8,1090,0,1090,24,962,104,21.04.2019 22:12,139,13,Odessa
576,577,0,205,371,0,371,0,371,9,339,23,21.04.2019 22:30,139,13,Odessa
832,846,28,292,516,24,540,0,540,9,483,48,21.04.2019 21:54,139,13,Odessa
1824,1821,26,593,1214,17,1231,0,1231,25,1095,111,22.04.2019 00:21,139,13,Odessa
2544,2546,20,880,1649,15,1664,0,1664,21,1472,171,21.04.2019 21:43,139,13,Odessa
752,737,3,272,477,3,480,0,480,8,402,70,21.04.2019 21:21,139,13,Odessa
2352,2318,3,909,1442,1,1443,0,1443,35,1246,162,21.04.2019 21:14,139,13,Odessa
1456,1449,3,488,966,2,968,0,968,29,806,133,21.04.2019 22:20,139,13,Odessa
704,714,0,262,442,0,442,0,442,8,384,50,21.04.2019 20:28,139,13,Odessa
1088,1080,4,355,730,3,733,0,733,7,654,72,21.04.2019 21:20,139,13,Odessa
2272,2254,3,865,1405,2,1407,0,1407,48,1008,351,21.04.2019 22:45,139,13,Odessa
608,83,0,529,79,0,79,0,79,11,55,13,21.04.2019 21:30,139,13,Odessa
2512,2493,6,1205,1305,2,1307,0,1307,32,1173,102,21.04.2019 23:00,139,13,Odessa
2352,2337,14,1168,1174,10,1184,0,1184,28,1079,77,22.04.2019 00:10,139,13,Odessa
2272,2238,9,1063,1207,2,1209,0,1209,19,1068,122,22.04.2019 04:00,139,13,Odessa
2416,2391,29,1039,1352,25,1377,0,1377,27,1215,135,22.04.2019 00:03,139,13,Odessa
2336,2320,3,1059,1274,3,1277,0,1277,41,1134,102,21.04.2019 23:45,139,13,Odessa
2240,2207,5,1155,1081,4,1085,0,1085,31,978,76,22.04.2019 00:05,139,13,Odessa
1744,1726,11,896,839,9,848,0,848,12,794,42,22.04.2019 00:15,139,13,Odessa
1488,1466,15,818,661,9,670,0,670,15,605,50,21.04.2019 21:20,139,13,Odessa
2336,2296,12,1304,1024,8,1032,0,1032,22,935,75,22.04.2019 00:15,139,13,Odessa
336,331,29,114,198,24,222,0,222,10,172,40,22.04.2019 00:00,139,13,Odessa
256,246,22,120,116,20,136,0,136,1,112,23,21.04.2019 21:50,139,13,Odessa
912,892,5,503,404,5,409,0,409,7,369,33,22.04.2019 00:30,139,13,Odessa
1824,1800,65,764,1001,59,1060,0,1060,22,964,74,21.04.2019 22:35,139,13,Odessa
512,503,30,229,255,28,283,0,283,4,269,10,21.04.2019 20:30,139,13,Odessa
464,463,20,194,250,20,270,0,270,5,240,25,21.04.2019 21:30,139,13,Odessa
896,892,29,397,470,29,499,0,499,5,456,38,21.04.2019 20:35,139,13,Odessa
1072,1050,30,418,624,30,654,0,654,9,606,39,21.04.2019 21:00,139,13,Odessa
768,755,42,290,437,41,478,0,478,5,328,145,21.04.2019 20:45,139,13,Odessa
624,617,8,280,337,7,344,0,344,5,280,59,21.04.2019 20:45,139,13,Odessa
1472,1453,16,836,623,13,636,0,636,13,593,30,21.04.2019 20:55,139,13,Odessa
912,904,38,378,504,30,534,0,534,16,479,39,21.04.2019 20:30,139,13,Odessa
624,607,14,269,342,13,355,0,355,10,320,25,21.04.2019 20:48,139,13,Odessa
1472,1441,29,696,750,26,776,0,776,38,674,64,21.04.2019 21:20,139,13,Odessa
1488,1455,27,745,724,19,743,0,743,12,699,32,21.04.2019 21:30,139,13,Odessa
512,506,8,231,276,5,281,0,281,5,259,17,21.04.2019 20:40,139,13,Odessa
816,809,56,386,387,43,430,0,430,11,354,65,21.04.2019 20:26,139,13,Odessa
800,791,36,429,339,32,371,0,371,4,345,22,21.04.2019 21:40,139,13,Odessa
1456,1429,24,727,713,16,729,0,729,14,656,59,21.04.2019 22:10,139,13,Odessa
448,437,5,292,154,2,156,0,156,1,122,33,22.04.2019 01:30,139,13,Odessa
1744,1789,42,759,946,39,985,0,985,19,864,102,21.04.2019 22:50,139,13,Odessa
928,904,13,503,413,12,425,0,425,16,377,32,22.04.2019 00:20,139,13,Odessa
1168,1146,46,593,549,26,575,0,575,3,536,36,21.04.2019 21:00,139,13,Odessa
400,391,16,173,218,9,227,0,227,0,215,12,21.04.2019 20:50,139,13,Odessa
1184,1168,34,539,620,25,645,0,645,8,612,25,21.04.2019 20:35,139,13,Odessa
1440,1433,59,753,634,53,687,0,687,12,608,67,21.04.2019 23:30,139,13,Odessa
288,282,5,123,162,3,165,0,165,3,128,34,21.04.2019 21:00,139,13,Odessa
224,215,0,173,51,0,51,0,51,2,45,4,21.04.2019 21:05,139,13,Odessa
432,418,2,211,221,0,221,0,221,3,200,18,21.04.2019 21:05,139,13,Odessa
1392,1373,37,779,587,26,613,0,613,10,562,41,21.04.2019 21:05,139,13,Odessa
1520,1499,41,825,664,31,695,0,695,21,637,37,21.04.2019 21:10,139,13,Odessa
672,655,9,365,305,2,307,0,307,4,264,39,21.04.2019 21:00,139,13,Odessa
592,575,13,284,297,11,308,0,308,3,275,30,21.04.2019 21:15,139,13,Odessa
624,611,1,358,265,1,266,0,266,4,244,18,21.04.2019 22:45,139,13,Odessa
432,415,11,225,199,8,207,0,207,8,184,15,21.04.2019 21:12,139,13,Odessa
448,438,5,223,221,4,225,0,225,2,170,53,21.04.2019 21:27,139,13,Odessa
336,326,11,185,142,9,151,0,151,5,117,29,22.04.2019 00:10,139,13,Odessa
272,269,1,141,131,0,131,0,131,1,113,17,21.04.2019 20:40,139,13,Odessa
336,324,3,194,139,3,142,0,142,2,121,19,21.04.2019 23:55,139,13,Odessa
784,774,11,435,342,7,349,0,349,12,313,24,21.04.2019 20:40,139,13,Odessa
176,169,2,80,94,2,96,0,96,5,77,14,21.04.2019 21:10,139,13,Odessa
1216,1200,6,641,571,4,575,0,575,12,521,42,21.04.2019 22:15,139,13,Odessa
496,484,4,229,264,3,267,0,267,3,241,23,21.04.2019 21:00,139,13,Odessa
2464,2430,9,1104,1352,8,1360,0,1360,28,1207,125,21.04.2019 21:25,139,13,Odessa
1776,1753,23,842,912,22,934,0,934,15,857,62,21.04.2019 20:58,139,13,Odessa
2400,2477,16,637,1751,12,1763,0,1763,40,1527,196,22.04.2019 01:30,139,13,Odessa
2400,2368,30,899,1478,23,1501,0,1501,46,1314,141,21.04.2019 23:00,139,13,Odessa
2192,2170,25,810,1366,16,1382,0,1382,35,1214,133,21.04.2019 21:30,139,13,Odessa
736,729,3,283,450,3,453,0,453,7,414,32,22.04.2019 00:01,139,13,Odessa
2208,2227,22,873,1314,21,1335,0,1335,28,1167,140,21.04.2019 21:35,139,13,Odessa
944,916,7,370,569,5,574,0,574,7,534,33,21.04.2019 20:57,140,13,Odessa
2272,2249,7,960,1308,4,1312,0,1312,29,1191,92,22.04.2019 01:10,140,13,Odessa
1920,1917,7,797,1117,6,1123,0,1123,18,1037,68,22.04.2019 01:00,140,13,Odessa
2048,2042,10,861,1179,8,1187,0,1187,13,1070,104,21.04.2019 22:45,140,13,Odessa
2256,2234,17,908,1332,16,1348,0,1348,24,1196,128,22.04.2019 01:30,140,13,Odessa
2304,2296,16,887,1408,9,1417,0,1417,26,1309,82,22.04.2019 00:04,140,13,Odessa
1264,1243,11,573,682,9,691,0,691,14,640,37,21.04.2019 21:39,140,13,Odessa
1120,1118,8,477,639,4,643,0,643,16,566,61,21.04.2019 23:00,140,13,Odessa
2192,2192,13,895,1284,13,1297,0,1297,22,1114,161,21.04.2019 22:30,140,13,Odessa
1536,1519,9,591,939,6,945,0,945,17,830,98,22.04.2019 00:04,140,13,Odessa
2048,2045,1,906,1141,1,1142,0,1142,27,998,117,21.04.2019 22:50,140,13,Odessa
800,802,5,344,451,5,456,0,456,8,427,21,22.04.2019 00:10,140,13,Odessa
1696,1674,43,716,940,40,980,0,980,14,951,15,21.04.2019 22:18,140,13,Odessa
1808,1778,39,933,840,35,875,0,875,17,825,33,21.04.2019 22:00,140,13,Odessa
464,460,7,206,253,5,258,0,258,2,220,36,21.04.2019 20:10,140,13,Odessa
1648,1560,0,748,900,0,900,0,900,17,774,109,21.04.2019 20:50,140,13,Odessa
1136,1118,11,606,525,5,530,0,530,5,479,46,22.04.2019 00:45,140,13,Odessa
272,267,2,116,154,2,156,0,156,3,142,11,21.04.2019 20:40,140,13,Odessa
1040,1020,3,530,509,1,510,0,510,5,470,35,21.04.2019 21:40,140,13,Odessa
1536,1524,19,701,822,13,835,0,835,14,740,81,21.04.2019 23:10,140,13,Odessa
1520,1514,12,639,873,8,881,0,881,16,778,87,21.04.2019 21:30,140,13,Odessa
1200,1191,13,480,709,11,720,0,720,7,655,58,21.04.2019 21:30,140,13,Odessa
2048,2047,24,779,1248,21,1269,0,1269,26,1086,157,21.04.2019 22:57,140,13,Odessa
2192,2191,13,699,1482,11,1493,0,1493,29,1322,142,21.04.2019 22:45,140,13,Odessa
2112,2117,26,806,1289,17,1306,0,1306,18,1181,107,22.04.2019 02:04,140,13,Odessa
1296,1285,9,463,824,9,833,0,833,12,761,60,22.04.2019 00:05,140,13,Odessa
768,750,4,307,458,3,461,0,461,7,435,19,21.04.2019 20:30,140,13,Odessa
288,289,9,109,170,9,179,0,179,4,167,8,21.04.2019 21:00,140,13,Odessa
2176,2139,9,1134,1034,8,1042,0,1042,27,981,34,21.04.2019 21:08,140,13,Odessa
1616,1596,10,838,768,10,778,0,778,7,748,23,21.04.2019 20:30,140,13,Odessa
2256,2234,6,922,1329,5,1334,0,1334,27,1195,112,21.04.2019 22:10,140,13,Odessa
2304,2318,17,855,1440,9,1449,0,1449,31,1333,85,21.04.2019 22:00,140,13,Odessa
2352,2318,9,1088,1256,8,1264,0,1264,29,1163,72,21.04.2019 22:04,140,13,Odessa
1808,1795,5,611,1193,4,1197,0,1197,15,1070,112,21.04.2019 21:41,140,13,Odessa
480,481,0,187,293,0,293,0,293,5,236,52,21.04.2019 22:00,140,13,Odessa
624,604,25,249,353,22,375,0,375,8,337,30,21.04.2019 20:55,140,13,Odessa
1552,1530,14,722,818,12,830,0,830,21,775,34,21.04.2019 21:10,140,13,Odessa
1616,1604,29,835,755,26,781,0,781,13,714,54,21.04.2019 20:45,140,13,Odessa
80,31,0,55,25,0,25,0,25,0,22,3,21.04.2019 23:35,140,13,Odessa
2112,2109,25,747,1350,15,1365,0,1365,21,1226,118,21.04.2019 21:30,140,13,Odessa
2192,2195,24,800,1378,14,1392,0,1392,27,1275,90,21.04.2019 21:25,140,13,Odessa
2176,2155,14,942,1223,11,1234,0,1234,23,1108,103,21.04.2019 23:32,140,13,Odessa
1744,1734,1,779,964,1,965,0,965,20,863,82,21.04.2019 21:30,140,13,Odessa
2096,2081,5,951,1142,3,1145,0,1145,35,1014,96,21.04.2019 21:55,140,13,Odessa
1872,1861,15,674,1185,13,1198,0,1198,30,1093,75,21.04.2019 21:55,140,13,Odessa
2368,2362,13,909,1451,8,1459,0,1459,16,1283,160,21.04.2019 22:58,140,13,Odessa
2352,2341,20,865,1470,17,1487,0,1487,23,1318,146,22.04.2019 00:35,140,13,Odessa
2304,2307,11,915,1379,10,1389,0,1389,25,1233,131,22.04.2019 00:10,140,13,Odessa
2384,2374,6,1030,1348,6,1354,0,1354,25,1236,93,21.04.2019 21:30,140,13,Odessa
1648,1642,1,602,1046,0,1046,0,1046,28,897,121,22.04.2019 01:57,140,13,Odessa
1232,1217,49,480,721,31,752,0,752,14,675,63,21.04.2019 21:00,140,13,Odessa
1008,995,19,418,577,13,590,0,590,11,536,43,21.04.2019 21:30,140,13,Odessa
368,365,7,113,249,6,255,0,255,3,232,20,21.04.2019 20:35,140,13,Odessa
672,667,4,246,422,4,426,0,426,7,384,35,21.04.2019 22:48,140,13,Odessa
1472,1463,33,580,867,25,892,0,892,17,816,59,21.04.2019 21:00,140,13,Odessa
1520,1496,17,641,864,15,879,0,879,17,785,77,21.04.2019 21:06,140,13,Odessa
1200,1205,11,512,677,11,688,0,688,17,622,49,21.04.2019 21:20,140,13,Odessa
1824,1818,14,754,1061,9,1070,0,1070,17,966,87,21.04.2019 21:06,140,13,Odessa
880,862,23,362,499,19,518,0,518,7,467,44,21.04.2019 21:40,140,13,Odessa
1184,1179,13,516,656,12,668,0,668,6,618,44,21.04.2019 21:50,140,13,Odessa
1504,1518,9,492,1004,8,1012,0,1012,25,907,80,21.04.2019 20:56,140,13,Odessa
1696,1722,9,598,1091,7,1098,0,1098,23,969,106,21.04.2019 21:05,140,13,Odessa
1456,1449,39,534,890,32,922,0,922,9,799,114,21.04.2019 21:20,140,13,Odessa
1536,1507,52,680,809,47,856,0,856,12,767,77,21.04.2019 22:10,140,13,Odessa
1840,1866,41,646,1163,31,1194,0,1194,10,1092,92,21.04.2019 21:16,140,13,Odessa
1248,1225,5,541,704,3,707,0,707,17,642,48,21.04.2019 22:20,140,13,Odessa
1264,1257,6,539,721,4,725,0,725,18,646,61,22.04.2019 01:20,140,13,Odessa
2128,2122,21,905,1211,12,1223,0,1223,17,1114,92,21.04.2019 22:03,140,13,Odessa
1856,1840,18,668,1173,15,1188,0,1188,21,1080,87,21.04.2019 23:20,140,13,Odessa
1312,1289,16,586,712,14,726,0,726,3,658,65,21.04.2019 20:45,140,13,Odessa
1360,1347,5,499,858,3,861,0,861,11,772,78,21.04.2019 21:46,140,13,Odessa
2176,2180,17,619,1545,12,1557,0,1557,40,1339,178,22.04.2019 00:00,140,13,Odessa
2128,2140,20,627,1488,13,1501,0,1501,48,1298,155,22.04.2019 00:40,140,13,Odessa
2288,2293,17,717,1557,14,1571,0,1571,32,1327,212,21.04.2019 21:50,140,13,Odessa
2320,2333,33,731,1561,28,1589,0,1589,40,1341,208,21.04.2019 22:35,140,13,Odessa
2256,2240,20,719,1524,13,1537,0,1537,38,1310,189,21.04.2019 23:30,140,13,Odessa
2208,2190,15,694,1501,13,1514,0,1514,36,1329,149,21.04.2019 21:20,140,13,Odessa
2512,2546,11,770,1737,5,1742,0,1742,45,1468,229,21.04.2019 22:00,140,13,Odessa
2224,2237,13,581,1636,7,1643,0,1643,30,1434,179,21.04.2019 23:20,140,13,Odessa
768,767,4,228,538,2,540,0,540,13,454,73,21.04.2019 21:15,140,13,Odessa
2080,2074,19,649,1417,14,1431,0,1431,28,1252,151,22.04.2019 00:10,140,13,Odessa
2352,2358,12,798,1550,4,1554,0,1554,27,1383,144,21.04.2019 22:50,140,13,Odessa
736,739,2,248,486,2,488,0,488,8,452,28,21.04.2019 21:35,140,13,Odessa
1568,1589,8,434,1128,6,1134,0,1134,27,984,123,22.04.2019 06:45,140,13,Odessa
1328,1329,6,453,872,3,875,0,875,15,784,76,21.04.2019 22:20,140,13,Odessa
1600,1593,9,595,998,7,1005,0,1005,26,876,103,21.04.2019 23:02,140,13,Odessa
1408,1416,5,503,901,4,905,0,905,17,803,85,22.04.2019 00:30,140,13,Odessa
1616,1616,12,500,1108,8,1116,0,1116,31,940,145,22.04.2019 00:09,140,13,Odessa
2368,2366,15,712,1643,13,1656,0,1656,28,1448,180,21.04.2019 23:00,140,13,Odessa
1952,1943,7,796,1149,7,1156,0,1156,24,1059,73,22.04.2019 00:25,140,13,Odessa
1904,1885,5,979,922,3,925,0,925,16,828,81,21.04.2019 21:42,140,13,Odessa
1648,1625,16,616,1024,8,1032,0,1032,26,931,75,22.04.2019 00:04,140,13,Odessa
1504,1501,11,535,961,8,969,0,969,26,848,95,21.04.2019 21:15,140,13,Odessa
1392,1376,7,566,821,5,826,0,826,21,744,61,21.04.2019 21:15,140,13,Odessa
928,918,10,377,545,6,551,0,551,5,506,40,21.04.2019 21:29,140,13,Odessa
1888,1864,8,717,1166,5,1171,0,1171,25,1049,97,21.04.2019 22:40,140,13,Odessa
2256,2242,13,864,1382,10,1392,0,1392,17,1240,135,21.04.2019 22:45,140,13,Odessa
2272,2245,14,908,1355,9,1364,0,1364,34,1212,118,21.04.2019 22:10,140,13,Odessa
1072,1064,6,421,647,4,651,0,651,23,570,58,21.04.2019 22:05,140,13,Odessa
1856,1901,11,707,1142,7,1149,0,1149,25,970,154,21.04.2019 21:40,140,13,Odessa
64,13,9,53,4,7,11,0,11,0,10,1,21.04.2019 20:30,140,13,Odessa
400,110,0,324,76,0,76,0,76,0,69,7,21.04.2019 20:57,140,13,Odessa
320,308,14,108,198,14,212,0,212,1,184,27,21.04.2019 20:40,141,13,Odessa
176,164,1,67,108,1,109,0,109,3,80,26,21.04.2019 20:48,141,13,Odessa
144,139,2,55,87,2,89,0,89,2,63,24,21.04.2019 20:20,141,13,Odessa
752,746,6,318,428,6,434,0,434,13,377,44,21.04.2019 21:00,141,13,Odessa
400,385,6,160,235,5,240,0,240,4,216,20,22.04.2019 00:11,141,13,Odessa
2368,2334,36,911,1426,31,1457,0,1457,30,1325,102,21.04.2019 21:45,141,13,Odessa
528,521,11,220,297,11,308,0,308,3,293,12,21.04.2019 22:10,141,13,Odessa
112,108,3,18,91,3,94,0,94,0,86,8,21.04.2019 21:40,141,13,Odessa
176,173,2,51,123,2,125,0,125,0,116,9,21.04.2019 20:35,141,13,Odessa
464,450,28,103,335,26,361,0,361,6,341,14,22.04.2019 00:35,141,13,Odessa
432,419,9,129,294,9,303,0,303,2,292,9,22.04.2019 00:40,141,13,Odessa
144,140,4,72,68,4,72,0,72,2,60,10,22.04.2019 00:10,141,13,Odessa
192,186,10,50,133,9,142,0,142,3,104,35,22.04.2019 00:08,141,13,Odessa
448,438,26,203,219,26,245,0,245,3,237,5,22.04.2019 00:10,141,13,Odessa
912,900,5,383,524,5,529,0,529,4,507,18,22.04.2019 01:40,141,13,Odessa
2384,2360,11,1060,1317,7,1324,0,1324,28,1224,72,22.04.2019 00:10,141,13,Odessa
2272,2252,15,1000,1262,10,1272,0,1272,33,1165,74,22.04.2019 00:30,141,13,Odessa
1312,1295,6,456,850,6,856,0,856,23,771,62,22.04.2019 00:15,141,13,Odessa
576,563,17,272,289,15,304,0,304,12,266,26,22.04.2019 00:15,141,13,Odessa
1056,1039,39,495,525,36,561,0,561,9,511,41,21.04.2019 22:15,141,13,Odessa
784,776,19,332,437,15,452,0,452,10,420,22,21.04.2019 20:30,141,13,Odessa
1392,1392,49,721,636,35,671,0,671,12,639,20,21.04.2019 21:15,141,13,Odessa
1184,1159,15,639,530,15,545,0,545,6,513,26,22.04.2019 00:25,141,13,Odessa
960,944,38,427,502,31,533,0,533,11,486,36,22.04.2019 00:15,141,13,Odessa
1040,1012,72,496,486,58,544,0,544,5,505,34,21.04.2019 21:30,141,13,Odessa
272,270,4,118,152,2,154,0,154,6,129,19,21.04.2019 23:40,141,13,Odessa
544,526,45,137,366,41,407,0,407,2,389,16,21.04.2019 20:48,141,13,Odessa
560,547,35,286,246,28,274,0,274,5,240,29,21.04.2019 21:30,141,13,Odessa
752,739,19,364,373,15,388,0,388,10,363,15,21.04.2019 21:10,141,13,Odessa
528,512,24,251,258,19,277,0,277,6,231,40,21.04.2019 20:45,141,13,Odessa
736,724,26,334,379,23,402,0,402,6,359,37,22.04.2019 00:15,141,13,Odessa
272,261,6,136,130,6,136,0,136,4,116,16,21.04.2019 21:25,141,13,Odessa
560,569,13,238,311,11,322,0,322,1,281,40,22.04.2019 00:15,141,13,Odessa
112,99,2,56,54,2,56,0,56,0,49,7,22.04.2019 02:48,141,13,Odessa
208,194,0,28,180,0,180,0,180,2,162,16,21.04.2019 21:55,141,13,Odessa
160,153,2,42,116,2,118,0,118,1,99,18,21.04.2019 21:15,141,13,Odessa
112,111,1,29,82,1,83,0,83,0,78,5,21.04.2019 20:35,141,13,Odessa
128,120,6,43,79,6,85,0,85,1,83,1,21.04.2019 23:28,141,13,Odessa
672,653,17,288,370,14,384,0,384,5,348,31,21.04.2019 22:55,141,13,Odessa
400,394,18,150,233,17,250,0,250,4,230,16,22.04.2019 00:10,141,13,Odessa
96,89,0,41,55,0,55,0,55,0,54,1,22.04.2019 00:40,141,13,Odessa
1872,1875,48,787,1039,46,1085,0,1085,17,1026,42,22.04.2019 00:30,141,13,Odessa
1152,1131,45,592,526,34,560,0,560,21,506,33,22.04.2019 04:09,141,13,Odessa
1312,1278,69,591,662,59,721,0,721,11,607,103,21.04.2019 20:55,141,13,Odessa
928,910,8,307,613,8,621,0,621,8,583,30,22.04.2019 00:15,141,13,Odessa
1392,1380,15,626,757,9,766,0,766,13,710,43,22.04.2019 03:00,141,13,Odessa
2080,2049,23,976,1086,18,1104,0,1104,18,1039,47,22.04.2019 07:19,141,13,Odessa
2384,2338,19,1012,1362,10,1372,0,1372,24,1275,73,22.04.2019 00:20,141,13,Odessa
816,801,29,247,547,22,569,0,569,14,529,26,21.04.2019 20:30,141,13,Odessa
1552,1522,19,734,807,11,818,0,818,10,736,72,21.04.2019 21:46,141,13,Odessa
1136,1110,32,565,543,28,571,0,571,20,501,50,22.04.2019 01:28,141,13,Odessa
1328,1313,18,637,681,10,691,0,691,14,616,61,21.04.2019 21:30,141,13,Odessa
1504,1488,17,717,771,16,787,0,787,28,698,61,22.04.2019 00:12,141,13,Odessa
1440,1416,25,727,694,19,713,0,713,18,642,53,22.04.2019 00:10,141,13,Odessa
2352,2316,28,1125,1206,21,1227,0,1227,40,1072,115,21.04.2019 21:52,141,13,Odessa
1216,1177,20,558,645,13,658,0,658,12,580,66,21.04.2019 21:27,141,13,Odessa
1680,1645,28,763,892,25,917,0,917,26,794,97,22.04.2019 00:30,141,13,Odessa
1088,1067,11,548,531,9,540,0,540,10,470,60,22.04.2019 00:19,141,13,Odessa
592,582,18,231,346,15,361,0,361,11,308,42,21.04.2019 21:15,141,13,Odessa
960,938,18,487,467,6,473,0,473,4,454,15,22.04.2019 01:25,141,13,Odessa
1312,1284,14,704,596,12,608,0,608,19,575,14,21.04.2019 22:15,141,13,Odessa
1088,1075,18,611,461,16,477,0,477,13,440,24,21.04.2019 22:18,141,13,Odessa
1312,1361,16,624,676,12,688,0,688,29,610,49,22.04.2019 03:20,141,13,Odessa
1040,1012,46,404,591,45,636,0,636,6,613,17,21.04.2019 20:55,141,13,Odessa
1152,1151,56,599,505,48,553,0,553,16,488,49,21.04.2019 22:00,141,13,Odessa
432,420,7,244,183,5,188,0,188,3,155,30,21.04.2019 20:50,141,13,Odessa
1296,1265,33,612,655,29,684,0,684,21,630,33,21.04.2019 20:55,141,13,Odessa
1312,1292,31,626,661,25,686,0,686,10,602,74,21.04.2019 21:49,141,13,Odessa
256,33,4,224,29,3,32,0,32,0,30,2,21.04.2019 21:00,141,13,Odessa
64,18,5,46,13,5,18,0,18,0,16,2,22.04.2019 00:13,141,13,Odessa
1712,1678,10,709,993,10,1003,0,1003,34,840,129,22.04.2019 00:15,141,13,Odessa
2000,1973,16,852,1140,8,1148,0,1148,21,1001,126,22.04.2019 00:40,141,13,Odessa
1280,1266,15,597,671,12,683,0,683,15,590,78,22.04.2019 01:49,141,13,Odessa
2096,2065,14,1012,1073,11,1084,0,1084,21,945,118,22.04.2019 00:12,141,13,Odessa
1552,1517,12,708,833,11,844,0,844,31,735,78,22.04.2019 00:10,141,13,Odessa
816,792,10,394,414,8,422,0,422,4,393,25,21.04.2019 22:00,141,13,Odessa
656,644,19,299,344,13,357,0,357,8,307,42,21.04.2019 21:10,141,13,Odessa
1472,1452,25,750,705,17,722,0,722,12,647,63,22.04.2019 00:15,141,13,Odessa
1312,1301,30,583,701,28,729,0,729,11,687,31,21.04.2019 22:10,141,13,Odessa
832,823,25,407,407,18,425,0,425,11,387,27,22.04.2019 00:05,141,13,Odessa
672,654,27,328,319,25,344,0,344,8,317,19,21.04.2019 21:30,141,13,Odessa
624,597,31,311,286,27,313,0,313,7,276,30,21.04.2019 20:46,141,13,Odessa
1696,1672,46,741,915,40,955,0,955,28,872,55,22.04.2019 00:35,141,13,Odessa
1424,1395,61,623,744,57,801,0,801,30,721,50,21.04.2019 21:25,141,13,Odessa
464,460,26,149,289,26,315,0,315,2,293,20,21.04.2019 21:23,141,13,Odessa
208,200,8,76,124,8,132,0,132,5,105,22,21.04.2019 23:15,141,13,Odessa
112,104,10,40,62,10,72,0,72,1,65,6,21.04.2019 21:36,141,13,Odessa
128,112,12,29,87,12,99,0,99,0,90,9,22.04.2019 00:20,141,13,Odessa
320,302,29,72,221,27,248,0,248,3,195,50,21.04.2019 21:25,141,13,Odessa
1056,1058,61,484,521,51,572,0,572,8,398,166,22.04.2019 00:20,141,13,Odessa
608,593,38,291,282,35,317,0,317,8,268,41,22.04.2019 00:30,141,13,Odessa
624,607,19,277,328,19,347,0,347,4,322,21,22.04.2019 00:08,141,13,Odessa
1264,1232,28,686,555,23,578,0,578,13,473,92,21.04.2019 20:25,141,13,Odessa
64,56,1,40,24,0,24,0,24,1,19,4,22.04.2019 00:15,141,13,Odessa
480,458,29,197,261,22,283,0,283,7,162,114,22.04.2019 00:50,141,13,Odessa
1280,1253,75,619,594,67,661,0,661,12,609,40,22.04.2019 00:53,141,13,Odessa
528,517,12,238,279,11,290,0,290,6,246,38,21.04.2019 21:07,141,13,Odessa
688,671,11,364,315,9,324,0,324,8,270,46,21.04.2019 21:16,141,13,Odessa
416,400,8,196,214,6,220,0,220,2,190,28,21.04.2019 21:00,141,13,Odessa
160,157,10,62,93,5,98,0,98,2,85,11,21.04.2019 21:00,141,13,Odessa
1872,1882,22,825,1031,16,1047,0,1047,18,909,120,22.04.2019 00:15,141,13,Odessa
1392,1374,24,573,796,23,819,0,819,21,740,58,22.04.2019 00:15,141,13,Odessa
1856,1819,20,728,1113,15,1128,0,1128,34,1010,84,22.04.2019 01:25,141,13,Odessa
1920,1873,29,862,1036,22,1058,0,1058,24,929,105,22.04.2019 01:00,141,13,Odessa
1376,1359,13,601,765,10,775,0,775,18,699,58,22.04.2019 00:20,141,13,Odessa
1200,1196,18,483,702,15,717,0,717,17,651,49,22.04.2019 00:07,141,13,Odessa
1968,1937,20,746,1207,15,1222,0,1222,32,1111,79,21.04.2019 22:00,141,13,Odessa
1984,1979,32,762,1201,21,1222,0,1222,28,1097,97,22.04.2019 00:03,141,13,Odessa
1712,1674,16,683,1018,11,1029,0,1029,29,921,79,21.04.2019 21:19,141,13,Odessa
2048,2013,19,861,1169,18,1187,0,1187,19,1101,67,22.04.2019 01:30,141,13,Odessa
1824,1813,12,721,1092,11,1103,0,1103,24,988,91,22.04.2019 00:16,141,13,Odessa
1312,1294,21,523,771,18,789,0,789,12,721,56,22.04.2019 02:30,141,13,Odessa
2176,2149,15,929,1235,12,1247,0,1247,34,1136,77,21.04.2019 22:00,141,13,Odessa
1904,1860,15,716,1173,15,1188,0,1188,18,1089,81,22.04.2019 00:20,141,13,Odessa
2080,2039,10,848,1225,7,1232,0,1232,37,1078,117,22.04.2019 01:10,141,13,Odessa
1632,1628,16,712,907,13,920,0,920,18,803,99,21.04.2019 21:30,141,13,Odessa
224,37,27,192,10,22,32,0,32,0,29,3,22.04.2019 00:01,141,13,Odessa
176,33,4,143,29,4,33,0,33,0,31,2,22.04.2019 00:08,141,13,Odessa
48,15,0,33,15,0,15,0,15,0,12,3,22.04.2019 00:30,141,13,Odessa
304,11,0,295,9,0,9,0,9,0,9,0,22.04.2019 00:05,141,13,Odessa
96,39,5,57,34,5,39,0,39,0,37,2,22.04.2019 02:30,141,13,Odessa
2128,2079,29,1031,1080,17,1097,0,1097,35,1000,62,21.04.2019 21:25,142,13,Odessa
1776,1744,32,870,878,28,906,0,906,21,816,69,21.04.2019 20:43,142,13,Odessa
1488,1468,20,643,829,16,845,0,845,18,770,57,22.04.2019 00:33,142,13,Odessa
1840,1788,25,795,1026,19,1045,0,1045,10,933,102,22.04.2019 00:10,142,13,Odessa
656,651,18,281,360,15,375,0,375,9,332,34,21.04.2019 20:34,142,13,Odessa
656,647,9,277,372,7,379,0,379,2,360,17,22.04.2019 00:15,142,13,Odessa
2496,2436,20,1224,1255,17,1272,0,1272,19,1145,108,21.04.2019 21:25,142,13,Odessa
1376,1347,14,631,737,8,745,0,745,14,668,63,21.04.2019 21:09,142,13,Odessa
896,884,71,420,414,62,476,0,476,7,436,33,22.04.2019 00:10,142,13,Odessa
192,176,3,96,93,3,96,0,96,2,87,7,21.04.2019 20:39,142,13,Odessa
1152,1126,72,225,859,68,927,0,927,19,624,284,22.04.2019 00:10,142,13,Odessa
1088,1056,56,281,758,49,807,0,807,42,510,255,22.04.2019 00:38,142,13,Odessa
304,299,14,62,228,14,242,0,242,0,166,76,22.04.2019 01:00,142,13,Odessa
656,632,26,263,370,23,393,0,393,7,348,38,21.04.2019 20:37,142,13,Odessa
400,390,10,189,204,7,211,0,211,2,196,13,21.04.2019 20:35,142,13,Odessa
848,832,49,372,432,44,476,0,476,3,456,17,22.04.2019 00:15,142,13,Odessa
848,827,54,403,397,48,445,0,445,2,431,12,22.04.2019 00:10,142,13,Odessa
912,884,45,396,474,42,516,0,516,5,471,40,22.04.2019 00:30,142,13,Odessa
960,939,57,442,469,49,518,0,518,6,488,24,21.04.2019 21:40,142,13,Odessa
352,338,31,133,194,25,219,0,219,3,170,46,21.04.2019 20:40,142,13,Odessa
528,518,10,213,305,10,315,0,315,4,292,19,21.04.2019 20:55,142,13,Odessa
1136,1100,77,468,605,63,668,0,668,17,561,90,21.04.2019 23:00,142,13,Odessa
976,953,67,77,836,63,899,0,899,9,556,334,21.04.2019 21:14,142,13,Odessa
784,773,59,110,618,56,674,0,674,7,400,267,21.04.2019 21:30,142,13,Odessa
1456,1431,220,664,593,199,792,0,792,17,693,82,22.04.2019 00:15,142,13,Odessa
528,513,17,218,294,16,310,0,310,5,278,27,21.04.2019 20:45,142,13,Odessa
1344,1309,76,599,675,70,745,0,745,7,656,82,22.04.2019 01:30,142,13,Odessa
432,418,22,203,207,22,229,0,229,3,206,20,21.04.2019 20:45,142,13,Odessa
320,318,14,155,154,11,165,0,165,0,151,14,21.04.2019 20:33,142,13,Odessa
736,723,63,332,353,51,404,0,404,3,358,43,22.04.2019 00:15,142,13,Odessa
1712,1683,54,790,873,49,922,0,922,11,856,55,21.04.2019 21:50,142,13,Odessa
768,754,18,321,433,14,447,0,447,6,407,34,21.04.2019 20:30,142,13,Odessa
1056,1046,67,457,533,66,599,0,599,12,540,47,21.04.2019 21:40,142,13,Odessa
784,762,31,352,401,31,432,0,432,15,406,11,21.04.2019 20:44,142,13,Odessa
864,834,65,368,444,52,496,0,496,10,420,66,21.04.2019 20:45,142,13,Odessa
816,794,58,228,541,47,588,0,588,19,426,143,21.04.2019 21:30,142,13,Odessa
80,75,3,37,40,3,43,0,43,0,31,12,21.04.2019 20:47,142,13,Odessa
2336,2235,24,1222,1098,16,1114,0,1114,79,980,55,22.04.2019 00:27,142,13,Odessa
1632,1592,12,780,841,11,852,0,852,23,795,34,22.04.2019 00:47,142,13,Odessa
1328,1291,20,645,672,11,683,0,683,20,645,18,22.04.2019 00:15,142,13,Odessa
1392,1364,28,605,765,22,787,0,787,15,735,37,22.04.2019 01:10,142,13,Odessa
1280,1259,39,642,610,28,638,0,638,14,591,33,22.04.2019 01:20,142,13,Odessa
1296,1276,39,606,659,31,690,0,690,17,641,32,22.04.2019 00:38,142,13,Odessa
1424,1390,25,715,693,16,709,0,709,23,660,26,21.04.2019 21:15,142,13,Odessa
1440,1418,33,735,684,21,705,0,705,26,656,23,21.04.2019 21:45,142,13,Odessa
1456,1426,96,740,620,96,716,0,716,6,680,30,22.04.2019 00:20,142,13,Odessa
896,879,52,448,407,41,448,0,448,5,411,32,21.04.2019 21:10,142,13,Odessa
1856,1801,71,831,959,66,1025,0,1025,17,979,29,22.04.2019 00:45,142,13,Odessa
1664,1634,64,662,938,64,1002,0,1002,30,952,20,22.04.2019 00:45,142,13,Odessa
1744,1697,24,1163,559,22,581,0,581,11,555,15,22.04.2019 00:48,142,13,Odessa
1792,1743,57,1129,620,43,663,0,663,13,638,12,22.04.2019 00:10,142,13,Odessa
1936,1893,88,832,1022,82,1104,0,1104,26,1007,71,22.04.2019 01:10,142,13,Odessa
1440,1413,41,703,701,36,737,0,737,19,698,20,22.04.2019 00:34,142,13,Odessa
1040,1017,34,482,528,30,558,0,558,1,536,21,22.04.2019 00:35,142,13,Odessa
1136,1102,60,611,471,54,525,0,525,10,503,12,22.04.2019 00:35,142,13,Odessa
1168,1134,62,645,467,56,523,0,523,7,501,15,21.04.2019 23:45,142,13,Odessa
1552,1535,84,377,1097,78,1175,0,1175,33,1080,62,22.04.2019 01:45,142,13,Odessa
1456,1426,47,280,1131,45,1176,0,1176,27,1085,64,21.04.2019 22:30,142,13,Odessa
128,112,5,34,90,4,94,0,94,0,85,9,22.04.2019 00:30,142,13,Odessa
1520,1470,83,817,623,80,703,0,703,14,678,11,22.04.2019 00:04,142,13,Odessa
1472,1434,77,749,651,72,723,0,723,13,700,10,22.04.2019 00:07,142,13,Odessa
976,956,33,470,477,29,506,0,506,6,468,32,22.04.2019 00:15,142,13,Odessa
1760,1716,67,823,875,62,937,0,937,6,897,34,22.04.2019 00:25,142,13,Odessa
1664,1623,100,929,657,78,735,0,735,9,696,30,22.04.2019 00:31,142,13,Odessa
2272,2212,68,1179,1031,62,1093,0,1093,27,1057,9,22.04.2019 00:23,142,13,Odessa
2272,2213,69,1091,1122,59,1181,0,1181,31,1133,17,22.04.2019 01:05,142,13,Odessa
1488,1442,95,665,733,90,823,0,823,11,714,98,22.04.2019 00:15,142,13,Odessa
2144,2108,100,1171,889,84,973,0,973,16,860,97,22.04.2019 00:30,142,13,Odessa
1184,1144,83,574,533,77,610,0,610,17,568,25,22.04.2019 00:10,142,13,Odessa
560,532,27,264,269,27,296,0,296,2,277,17,22.04.2019 00:25,142,13,Odessa
976,950,57,504,426,46,472,0,472,12,408,52,22.04.2019 01:40,142,13,Odessa
1024,1002,34,534,460,30,490,0,490,11,447,32,22.04.2019 00:05,142,13,Odessa
2016,1980,60,842,1114,60,1174,0,1174,22,923,229,22.04.2019 01:25,142,13,Odessa
1952,1921,63,857,1032,63,1095,0,1095,40,823,232,22.04.2019 00:32,142,13,Odessa
656,639,32,287,340,29,369,0,369,3,347,19,22.04.2019 02:50,142,13,Odessa
656,647,19,300,340,16,356,0,356,7,317,32,21.04.2019 21:30,142,13,Odessa
400,386,9,200,191,9,200,0,200,4,153,43,22.04.2019 00:41,142,13,Odessa
2112,2072,24,891,1198,23,1221,0,1221,20,1111,90,21.04.2019 22:08,142,13,Odessa
2048,2026,11,801,1236,11,1247,0,1247,12,1147,88,21.04.2019 21:35,142,13,Odessa
976,961,80,282,625,69,694,0,694,8,578,108,21.04.2019 21:43,142,13,Odessa
240,220,16,72,152,16,168,0,168,4,145,19,21.04.2019 22:03,142,13,Odessa
1344,1317,37,418,891,35,926,0,926,14,872,40,21.04.2019 21:01,142,13,Odessa
1456,1446,40,574,844,38,882,0,882,20,832,30,21.04.2019 21:20,142,13,Odessa
144,134,3,70,72,2,74,0,74,2,70,2,21.04.2019 20:40,142,13,Odessa
1360,1336,69,583,715,62,777,0,777,3,616,158,21.04.2019 21:30,142,13,Odessa
1008,988,51,565,404,39,443,0,443,11,389,43,21.04.2019 21:30,142,13,Odessa
256,246,12,149,95,12,107,0,107,0,100,7,21.04.2019 21:00,142,13,Odessa
448,446,22,201,226,21,247,0,247,5,208,34,21.04.2019 20:35,142,13,Odessa
816,794,36,359,426,31,457,0,457,15,423,19,21.04.2019 20:30,142,13,Odessa
240,229,4,110,126,4,130,0,130,1,117,12,21.04.2019 22:00,142,13,Odessa
576,571,29,286,269,21,290,0,290,3,264,23,21.04.2019 20:45,142,13,Odessa
288,273,3,195,91,2,93,0,93,0,76,17,22.04.2019 01:13,142,13,Odessa
880,864,25,356,503,21,524,0,524,2,496,26,21.04.2019 20:50,142,13,Odessa
1376,1349,39,643,705,28,733,0,733,16,673,44,21.04.2019 21:00,142,13,Odessa
720,714,21,402,303,15,318,0,318,5,293,20,21.04.2019 21:25,142,13,Odessa
656,644,20,306,331,19,350,0,350,5,313,32,21.04.2019 20:50,142,13,Odessa
768,741,15,346,410,12,422,0,422,12,358,52,21.04.2019 20:42,142,13,Odessa
640,627,13,294,338,8,346,0,346,3,308,35,21.04.2019 20:40,142,13,Odessa
704,677,14,317,374,13,387,0,387,9,338,40,21.04.2019 21:01,142,13,Odessa
736,727,16,302,423,11,434,0,434,6,352,76,21.04.2019 20:45,142,13,Odessa
608,598,16,281,312,15,327,0,327,6,291,30,21.04.2019 22:15,142,13,Odessa
1200,1179,73,513,624,63,687,0,687,13,547,127,21.04.2019 21:57,142,13,Odessa
640,623,27,258,363,19,382,0,382,6,312,64,21.04.2019 21:30,142,13,Odessa
928,896,28,306,600,22,622,0,622,20,532,70,21.04.2019 20:43,142,13,Odessa
1184,1155,47,674,467,43,510,0,510,9,475,26,21.04.2019 20:50,142,13,Odessa
1408,1388,56,632,729,47,776,0,776,9,733,34,21.04.2019 21:40,142,13,Odessa
1248,1236,22,707,521,20,541,0,541,13,476,52,22.04.2019 00:15,142,13,Odessa
288,273,1,149,138,1,139,0,139,4,124,11,21.04.2019 20:50,142,13,Odessa
960,948,36,434,497,29,526,0,526,13,434,79,21.04.2019 20:00,142,13,Odessa
2032,1975,29,930,1078,24,1102,0,1102,25,932,145,21.04.2019 23:10,142,13,Odessa
2208,2203,29,919,1267,22,1289,0,1289,25,1052,212,22.04.2019 00:02,142,13,Odessa
1296,1261,21,718,557,21,578,0,578,8,546,24,21.04.2019 21:10,142,13,Odessa
1056,1046,35,490,534,32,566,0,566,20,524,22,21.04.2019 22:00,142,13,Odessa
1136,1107,4,695,439,2,441,0,441,7,417,17,21.04.2019 21:20,142,13,Odessa
656,638,27,371,259,26,285,0,285,8,258,19,21.04.2019 21:00,142,13,Odessa
1120,1074,25,522,575,23,598,0,598,8,564,26,21.04.2019 21:30,142,13,Odessa
736,726,9,321,408,7,415,0,415,3,395,17,21.04.2019 20:37,142,13,Odessa
1152,1114,59,591,510,51,561,0,561,6,548,7,21.04.2019 20:50,142,13,Odessa
400,379,17,196,190,14,204,0,204,6,186,12,21.04.2019 20:46,142,13,Odessa
416,399,31,208,178,30,208,0,208,3,193,12,21.04.2019 20:38,142,13,Odessa
576,560,3,265,308,3,311,0,311,4,292,15,21.04.2019 20:15,142,13,Odessa
976,945,22,560,399,17,416,0,416,6,393,17,21.04.2019 21:08,142,13,Odessa
976,963,35,487,457,32,489,0,489,6,433,50,21.04.2019 21:00,142,13,Odessa
480,463,4,289,191,0,191,0,191,6,176,9,21.04.2019 20:40,142,13,Odessa
224,219,0,104,120,0,120,0,120,2,115,3,21.04.2019 21:00,142,13,Odessa
480,470,1,250,230,0,230,0,230,1,226,3,21.04.2019 21:15,142,13,Odessa
896,870,2,545,350,1,351,0,351,8,328,15,21.04.2019 21:15,142,13,Odessa
528,508,9,222,299,7,306,0,306,4,284,18,21.04.2019 20:30,142,13,Odessa
1072,1042,5,604,464,4,468,0,468,6,448,14,21.04.2019 21:00,142,13,Odessa
1088,1064,40,480,568,40,608,0,608,9,576,23,21.04.2019 21:20,142,13,Odessa
432,413,29,108,295,29,324,0,324,6,297,21,21.04.2019 21:20,142,13,Odessa
528,506,3,245,280,3,283,0,283,5,262,16,21.04.2019 20:41,142,13,Odessa
192,185,2,88,103,1,104,0,104,0,73,31,21.04.2019 21:14,142,13,Odessa
1136,1129,8,638,490,8,498,0,498,16,442,40,22.04.2019 04:45,142,13,Odessa
464,445,1,215,248,1,249,0,249,2,236,11,22.04.2019 01:00,142,13,Odessa
176,170,0,88,88,0,88,0,88,1,81,6,21.04.2019 20:20,142,13,Odessa
1104,1087,4,642,458,4,462,0,462,11,446,5,21.04.2019 21:50,142,13,Odessa
656,633,24,306,328,22,350,0,350,2,322,26,21.04.2019 21:00,142,13,Odessa
320,305,13,172,136,12,148,0,148,3,137,8,21.04.2019 20:56,142,13,Odessa
1344,1321,1,744,600,0,600,0,600,11,577,12,21.04.2019 21:05,142,13,Odessa
1024,980,2,557,467,0,467,0,467,7,446,14,21.04.2019 20:55,142,13,Odessa
256,239,2,99,155,2,157,0,157,1,146,10,21.04.2019 20:35,142,13,Odessa
1328,1288,18,731,586,11,597,0,597,12,566,19,21.04.2019 21:18,142,13,Odessa
1568,1528,24,756,793,19,812,0,812,22,759,31,21.04.2019 22:29,142,13,Odessa
2096,2047,60,907,1136,53,1189,0,1189,28,1085,76,21.04.2019 21:30,142,13,Odessa
1024,980,32,455,547,22,569,0,569,12,538,19,21.04.2019 21:25,142,13,Odessa
672,654,36,310,331,31,362,0,362,4,353,5,21.04.2019 20:40,142,13,Odessa
224,218,0,130,94,0,94,0,94,1,86,7,21.04.2019 20:30,142,13,Odessa
832,819,27,362,444,26,470,0,470,6,443,21,21.04.2019 21:50,142,13,Odessa
368,364,0,112,256,0,256,0,256,1,191,64,21.04.2019 20:36,142,13,Odessa
240,15,0,226,14,0,14,0,14,0,13,1,21.04.2019 20:10,142,13,Odessa
48,30,0,19,29,0,29,0,29,0,13,16,21.04.2019 22:00,143,13,Odessa
320,288,1,32,287,1,288,0,288,25,251,12,21.04.2019 20:50,143,13,Odessa
0,12,0,0,12,0,12,0,12,0,12,0,21.04.2019 10:30,143,13,Odessa
0,12,0,0,12,0,12,0,12,0,11,1,21.04.2019 08:20,143,13,Odessa
0,12,0,0,12,0,12,0,12,0,11,1,21.04.2019 12:00,143,13,Odessa
0,11,0,0,11,0,11,0,11,0,6,5,21.04.2019 10:30,143,13,Odessa
0,13,0,0,13,0,13,0,13,0,13,0,21.04.2019 08:28,143,13,Odessa
0,12,0,0,12,0,12,0,12,0,12,0,21.04.2019 09:00,143,13,Odessa
0,9,0,0,9,0,9,0,9,0,9,0,21.04.2019 09:00,143,13,Odessa
0,9,0,0,9,0,9,0,9,0,9,0,21.04.2019 09:00,143,13,Odessa
0,8,0,0,8,0,8,0,8,1,7,0,21.04.2019 09:30,143,13,Odessa
0,8,0,0,8,0,8,0,8,0,8,0,21.04.2019 12:05,143,13,Odessa
0,12,0,0,12,0,12,0,12,0,11,1,21.04.2019 11:00,143,13,Odessa
0,6,0,0,6,0,6,0,6,0,5,1,21.04.2019 10:15,143,13,Odessa
0,12,0,0,12,0,12,0,12,0,11,1,21.04.2019 10:00,143,13,Odessa
0,11,0,0,11,0,11,0,11,0,11,0,21.04.2019 20:30,143,13,Odessa
0,8,0,0,8,0,8,0,8,1,7,0,21.04.2019 10:00,143,13,Odessa
896,876,21,410,466,20,486,0,486,4,468,14,21.04.2019 21:07,143,13,Odessa
1328,1315,72,550,710,68,778,0,778,9,719,50,21.04.2019 21:20,143,13,Odessa
1408,1379,77,643,696,69,765,0,765,6,712,47,21.04.2019 21:04,143,13,Odessa
1488,1449,85,696,712,80,792,0,792,9,769,14,21.04.2019 21:30,143,13,Odessa
1568,1556,82,687,802,79,881,0,881,17,855,9,21.04.2019 21:01,143,13,Odessa
944,906,37,459,454,31,485,0,485,18,429,38,21.04.2019 22:10,143,13,Odessa
1776,1744,32,847,899,30,929,0,929,20,893,16,21.04.2019 21:51,143,13,Odessa
1488,1461,42,612,839,37,876,0,876,8,836,32,21.04.2019 21:18,143,13,Odessa
1344,1306,47,555,751,38,789,0,789,14,751,24,21.04.2019 20:33,143,13,Odessa
1408,1389,30,567,817,24,841,0,841,16,753,72,21.04.2019 22:45,143,13,Odessa
1344,1321,23,549,775,20,795,0,795,19,700,76,21.04.2019 21:30,143,13,Odessa
1024,1012,56,474,501,49,550,0,550,15,519,16,21.04.2019 21:15,143,13,Odessa
1264,1236,56,327,883,54,937,0,937,18,897,22,21.04.2019 21:25,143,13,Odessa
1440,1405,63,490,897,53,950,0,950,33,883,34,21.04.2019 21:45,143,13,Odessa
2368,2336,73,1358,939,71,1010,0,1010,19,941,50,22.04.2019 00:15,143,13,Odessa
1616,1575,53,752,815,49,864,0,864,8,830,26,22.04.2019 00:05,143,13,Odessa
2032,1989,26,1078,938,16,954,0,954,18,822,114,21.04.2019 21:20,143,13,Odessa
1664,1639,31,716,922,26,948,0,948,24,855,69,22.04.2019 00:08,143,13,Odessa
1136,1108,25,546,565,25,590,0,590,10,547,33,22.04.2019 00:08,143,13,Odessa
1664,1624,46,666,959,39,998,0,998,19,882,97,21.04.2019 22:15,143,13,Odessa
736,710,43,323,375,38,413,0,413,2,344,67,21.04.2019 21:05,143,13,Odessa
1440,1401,32,596,813,31,844,0,844,8,798,38,21.04.2019 21:18,143,13,Odessa
656,632,48,306,309,41,350,0,350,6,316,28,21.04.2019 21:01,143,13,Odessa
1984,1946,19,1144,825,15,840,0,840,20,755,65,21.04.2019 23:50,143,13,Odessa
2048,2023,10,1111,927,10,937,0,937,28,877,32,21.04.2019 22:10,143,13,Odessa
1280,1263,41,653,594,33,627,0,627,8,542,77,21.04.2019 21:32,143,13,Odessa
2192,2151,53,1000,1150,42,1192,0,1192,15,1068,109,21.04.2019 22:15,143,13,Odessa
2160,2134,63,946,1175,39,1214,0,1214,19,1155,40,21.04.2019 22:20,143,13,Odessa
416,406,18,144,254,18,272,0,272,7,254,11,21.04.2019 21:44,143,13,Odessa
1776,1737,33,865,889,22,911,0,911,13,857,41,21.04.2019 20:43,143,13,Odessa
1472,1423,22,727,730,15,745,0,745,17,693,35,21.04.2019 20:48,143,13,Odessa
1280,1239,69,527,691,62,753,0,753,6,726,21,21.04.2019 20:47,143,13,Odessa
1744,1715,89,657,1002,85,1087,0,1087,15,1016,56,21.04.2019 21:12,143,13,Odessa
64,41,4,27,33,4,37,0,37,0,28,9,21.04.2019 21:30,143,13,Odessa
1504,1479,43,798,672,34,706,0,706,18,665,23,22.04.2019 00:10,143,13,Odessa
1440,1420,32,750,669,21,690,0,690,11,638,41,22.04.2019 04:25,143,13,Odessa
1408,1374,24,703,684,21,705,0,705,22,657,26,21.04.2019 23:50,143,13,Odessa
1504,1468,28,699,782,23,805,0,805,25,747,33,22.04.2019 02:15,143,13,Odessa
1264,1234,32,569,664,31,695,0,695,8,641,46,22.04.2019 00:10,143,13,Odessa
1232,1212,16,644,577,11,588,0,588,12,535,41,21.04.2019 21:30,143,13,Odessa
1232,1208,24,584,629,19,648,0,648,16,583,49,22.04.2019 01:55,143,13,Odessa
1712,1687,25,835,856,21,877,0,877,15,820,42,22.04.2019 00:10,143,13,Odessa
1584,1542,20,852,716,16,732,0,732,23,687,22,21.04.2019 22:12,143,13,Odessa
1872,1836,20,956,897,19,916,0,916,35,828,53,21.04.2019 21:00,143,13,Odessa
1520,1471,28,841,656,23,679,0,679,21,628,30,21.04.2019 23:30,143,13,Odessa
1920,1869,100,977,855,88,943,0,943,18,895,30,21.04.2019 21:30,143,13,Odessa
1984,1945,118,948,927,109,1036,0,1036,16,986,34,21.04.2019 20:15,143,13,Odessa
2336,2303,85,1384,878,74,952,0,952,19,874,59,21.04.2019 21:08,143,13,Odessa
1824,1798,81,841,912,71,983,0,983,24,881,78,21.04.2019 22:00,143,13,Odessa
2416,2405,156,1193,1141,82,1223,0,1223,37,1149,37,22.04.2019 06:30,143,13,Odessa
2208,2176,96,1157,980,71,1051,0,1051,14,1008,29,21.04.2019 21:30,143,13,Odessa
1360,1340,83,667,631,62,693,0,693,16,657,20,21.04.2019 22:00,143,13,Odessa
128,45,7,83,38,7,45,0,45,1,42,2,22.04.2019 00:15,143,13,Odessa
128,58,12,73,44,11,55,0,55,0,50,5,22.04.2019 00:08,143,13,Odessa
2400,2312,31,955,1416,29,1445,0,1445,42,1244,159,21.04.2019 21:50,143,13,Odessa
2288,2231,25,992,1278,18,1296,0,1296,38,1141,117,21.04.2019 21:38,143,13,Odessa
2272,2232,28,964,1286,22,1308,0,1308,33,1173,102,21.04.2019 22:05,143,13,Odessa
2256,2204,19,971,1270,15,1285,0,1285,31,1161,93,21.04.2019 21:30,143,13,Odessa
2080,2061,36,836,1223,21,1244,0,1244,16,1152,76,21.04.2019 22:30,143,13,Odessa
2128,2093,48,886,1208,34,1242,0,1242,38,1100,104,21.04.2019 22:30,143,13,Odessa
2000,1976,24,813,1175,12,1187,0,1187,27,1071,89,21.04.2019 22:10,143,13,Odessa
2208,2181,33,880,1309,19,1328,0,1328,38,1173,117,21.04.2019 22:05,143,13,Odessa
2224,2204,33,925,1279,20,1299,0,1298,33,1167,98,21.04.2019 22:32,143,13,Odessa
1872,1839,57,750,1076,46,1122,0,1122,29,1001,92,21.04.2019 21:30,143,13,Odessa
1856,1826,35,789,1045,22,1067,0,1067,28,957,82,21.04.2019 21:30,143,13,Odessa
2064,2050,45,848,1192,24,1216,0,1216,24,1104,88,21.04.2019 20:20,143,13,Odessa
2320,2321,22,882,1424,14,1438,0,1438,34,1296,108,22.04.2019 01:20,143,13,Odessa
2208,2169,76,881,1269,58,1327,0,1327,34,1170,123,21.04.2019 22:20,143,13,Odessa
2304,2268,36,956,1321,27,1348,0,1348,37,1214,97,22.04.2019 00:09,143,13,Odessa
1488,1491,23,562,908,18,926,0,926,25,833,68,21.04.2019 22:30,143,13,Odessa
2432,2413,28,972,1440,20,1460,0,1460,41,1278,141,21.04.2019 21:50,143,13,Odessa
2000,1999,62,773,1171,56,1227,0,1227,27,1086,114,21.04.2019 21:35,143,13,Odessa
1904,1871,26,708,1177,19,1196,0,1196,25,1056,115,21.04.2019 21:50,143,13,Odessa
2272,2248,26,902,1353,17,1370,0,1370,40,1221,109,21.04.2019 22:00,143,13,Odessa
2272,2238,33,847,1393,32,1425,0,1425,45,1225,155,22.04.2019 00:15,143,13,Odessa
2128,2110,48,800,1290,38,1328,0,1328,31,1169,128,21.04.2019 22:00,143,13,Odessa
1952,1941,26,734,1204,14,1218,0,1218,34,1080,104,21.04.2019 22:00,143,13,Odessa
2112,2077,15,837,1262,13,1275,0,1275,26,1131,118,21.04.2019 21:48,143,13,Odessa
2128,2094,50,876,1215,37,1252,0,1252,11,1127,114,21.04.2019 21:30,143,13,Odessa
2400,2352,63,916,1437,47,1484,0,1484,49,1293,142,21.04.2019 23:30,143,13,Odessa
2128,2055,29,885,1220,23,1243,0,1243,39,1063,141,21.04.2019 21:50,143,13,Odessa
1344,1323,13,492,841,11,852,0,852,14,731,107,21.04.2019 21:30,143,13,Odessa
208,22,6,187,16,5,21,0,21,0,18,3,21.04.2019 20:15,143,13,Odessa
176,22,8,156,14,6,20,0,20,0,17,3,21.04.2019 21:40,143,13,Odessa
80,16,0,65,15,0,15,0,15,0,10,5,22.04.2019 00:25,143,13,Odessa
176,82,41,100,39,37,76,0,76,0,69,7,21.04.2019 20:40,143,13,Odessa
128,18,0,111,17,0,17,0,17,0,14,3,21.04.2019 22:15,143,13,Odessa
96,13,0,83,13,0,13,0,13,0,11,2,21.04.2019 20:08,143,13,Odessa
80,29,4,51,25,4,29,0,29,0,24,5,21.04.2019 20:45,143,13,Odessa
2016,1960,3,1519,495,2,497,0,497,9,451,37,21.04.2019 23:50,143,13,Odessa
1568,1575,19,474,1080,14,1094,0,1094,36,847,211,22.04.2019 00:05,144,14,Poltava
2144,2171,26,665,1459,20,1479,0,1479,46,1167,266,22.04.2019 00:15,144,14,Poltava
2048,2046,35,647,1369,32,1401,0,1401,37,1119,245,22.04.2019 00:15,144,14,Poltava
2128,2137,13,619,1498,11,1509,0,1509,49,1221,239,22.04.2019 00:25,144,14,Poltava
1840,1823,16,591,1236,13,1249,0,1249,33,1051,165,22.04.2019 00:30,144,14,Poltava
2128,2133,20,644,1471,13,1484,0,1484,39,1182,263,21.04.2019 22:45,144,14,Poltava
1520,1505,22,502,1002,16,1018,0,1018,18,839,161,22.04.2019 00:18,144,14,Poltava
1840,1835,51,670,1129,41,1170,0,1170,34,966,170,22.04.2019 00:20,144,14,Poltava
1376,1367,27,510,845,21,866,0,866,28,702,136,21.04.2019 22:30,144,14,Poltava
1344,1328,12,486,848,10,858,0,858,26,702,130,22.04.2019 00:20,144,14,Poltava
2048,2037,30,672,1357,19,1376,0,1376,47,1130,199,21.04.2019 23:35,144,14,Poltava
1664,1646,10,675,982,7,989,0,989,17,856,116,21.04.2019 22:50,144,14,Poltava
1312,1300,15,460,837,15,852,0,852,16,708,128,21.04.2019 21:49,144,14,Poltava
1536,1521,38,525,977,34,1011,0,1011,13,850,148,22.04.2019 00:30,144,14,Poltava
2416,2429,14,768,1640,8,1648,0,1648,45,1327,276,21.04.2019 23:50,144,14,Poltava
2448,2427,14,737,1700,11,1711,0,1711,59,1344,308,22.04.2019 00:25,144,14,Poltava
2400,2407,13,709,1684,7,1691,0,1691,42,1318,331,21.04.2019 23:55,144,14,Poltava
1696,1684,20,493,1187,16,1203,0,1203,26,964,213,21.04.2019 21:30,144,14,Poltava
2272,2263,21,645,1611,16,1627,0,1627,43,1300,284,22.04.2019 00:20,144,14,Poltava
1920,1910,64,612,1255,53,1308,0,1308,26,1089,193,21.04.2019 22:35,144,14,Poltava
320,11,0,309,11,0,11,0,11,0,11,0,21.04.2019 21:09,144,14,Poltava
1120,505,0,615,505,0,505,0,505,25,452,28,21.04.2019 20:55,144,14,Poltava
1616,1628,12,555,1054,7,1061,0,1061,31,814,216,22.04.2019 00:10,144,14,Poltava
1312,1307,13,435,865,12,877,0,877,29,667,181,21.04.2019 21:45,144,14,Poltava
2176,2143,21,820,1341,15,1356,0,1356,48,1014,294,21.04.2019 21:48,144,14,Poltava
1472,1428,0,859,613,0,613,0,613,11,556,46,21.04.2019 22:41,144,14,Poltava
2176,2179,6,757,1413,6,1419,0,1419,34,1106,279,22.04.2019 00:05,144,14,Poltava
2048,2059,27,600,1428,20,1448,0,1448,42,1093,313,22.04.2019 00:30,144,14,Poltava
1808,1816,30,685,1098,25,1123,0,1123,25,917,181,22.04.2019 00:45,144,14,Poltava
1184,1175,16,373,801,10,811,0,811,25,657,129,22.04.2019 00:25,144,14,Poltava
2016,1988,18,782,1220,14,1234,0,1234,46,1018,170,22.04.2019 00:15,144,14,Poltava
2256,2244,17,812,1434,10,1444,0,1444,28,1209,207,21.04.2019 23:13,144,14,Poltava
2112,2113,32,705,1381,26,1407,0,1407,38,1161,208,21.04.2019 21:30,144,14,Poltava
2160,2171,5,668,1487,5,1492,0,1492,39,1260,193,21.04.2019 21:36,144,14,Poltava
2080,2066,37,715,1335,30,1365,0,1365,25,1098,242,22.04.2019 01:00,144,14,Poltava
672,671,5,243,425,4,429,0,429,5,357,67,21.04.2019 21:45,144,14,Poltava
2080,2052,27,725,1332,23,1355,0,1355,30,1134,191,22.04.2019 00:05,144,14,Poltava
1920,1916,16,605,1304,11,1315,0,1315,35,1072,208,21.04.2019 21:40,144,14,Poltava
2384,2360,15,774,1597,13,1610,0,1610,40,1301,269,22.04.2019 00:05,144,14,Poltava
2448,2441,22,794,1641,13,1654,0,1654,45,1363,246,22.04.2019 00:20,144,14,Poltava
2208,2180,29,637,1550,21,1571,0,1571,39,1280,252,22.04.2019 00:33,144,14,Poltava
1984,1985,21,600,1366,18,1384,0,1384,29,1119,236,21.04.2019 22:08,144,14,Poltava
2144,2135,17,644,1486,14,1500,0,1500,41,1229,230,21.04.2019 21:50,144,14,Poltava
2352,2341,14,672,1670,10,1680,0,1680,40,1341,299,22.04.2019 00:25,144,14,Poltava
2240,2225,20,682,1542,16,1558,0,1558,33,1278,247,22.04.2019 00:16,144,14,Poltava
2176,2168,7,633,1537,6,1543,0,1543,39,1249,255,22.04.2019 00:12,144,14,Poltava
2224,2194,26,692,1515,17,1532,0,1532,45,1244,243,21.04.2019 21:45,144,14,Poltava
2224,2239,18,738,1476,10,1486,0,1486,51,1197,238,22.04.2019 00:05,144,14,Poltava
2144,2144,18,751,1382,11,1393,0,1393,41,1120,232,22.04.2019 04:04,144,14,Poltava
1872,1859,17,617,1245,10,1255,0,1255,56,970,229,22.04.2019 00:38,144,14,Poltava
2192,2173,10,651,1531,10,1541,0,1541,30,1271,240,22.04.2019 00:26,144,14,Poltava
1968,1959,18,648,1304,16,1320,0,1320,34,1073,213,22.04.2019 01:25,144,14,Poltava
2288,2255,23,878,1396,14,1410,0,1410,24,1178,208,22.04.2019 00:10,144,14,Poltava
2048,2082,37,617,1399,32,1431,0,1431,32,1181,218,22.04.2019 00:08,144,14,Poltava
2272,2267,23,742,1513,17,1530,0,1530,40,1229,261,22.04.2019 01:30,144,14,Poltava
592,563,201,182,212,198,410,0,410,19,321,70,22.04.2019 00:20,144,14,Poltava
2032,2047,24,617,1395,20,1415,0,1415,39,1173,203,22.04.2019 00:05,144,14,Poltava
2240,2226,26,766,1453,21,1474,0,1474,48,1190,236,22.04.2019 00:05,144,14,Poltava
2320,2328,16,710,1600,10,1610,0,1610,46,1301,263,22.04.2019 00:10,144,14,Poltava
2128,2124,15,632,1484,12,1496,0,1496,35,1198,263,22.04.2019 00:20,144,14,Poltava
2240,2221,20,688,1535,17,1552,0,1552,47,1265,240,22.04.2019 00:35,144,14,Poltava
176,29,17,150,10,16,26,0,26,1,23,2,21.04.2019 21:26,144,14,Poltava
96,46,22,50,24,22,46,0,46,1,36,9,21.04.2019 22:55,144,14,Poltava
432,91,35,359,45,28,73,0,73,3,63,7,22.04.2019 00:01,144,14,Poltava
224,32,2,192,30,2,32,0,32,0,28,4,21.04.2019 20:40,144,14,Poltava
144,18,0,127,17,0,17,0,17,0,12,5,22.04.2019 00:35,144,14,Poltava
144,54,14,95,35,14,49,0,49,2,42,5,21.04.2019 22:30,144,14,Poltava
192,31,18,165,10,17,27,0,27,1,23,3,22.04.2019 00:02,144,14,Poltava
256,29,14,228,14,14,28,0,28,2,20,6,21.04.2019 20:45,144,14,Poltava
96,16,0,81,15,0,15,0,15,0,14,1,21.04.2019 20:20,144,14,Poltava
816,150,108,669,42,105,147,0,147,3,133,11,22.04.2019 00:08,144,14,Poltava
688,678,88,14,587,87,674,0,674,46,598,30,22.04.2019 00:33,145,14,Poltava
1504,1496,25,544,937,23,960,0,960,19,784,157,22.04.2019 02:22,145,14,Poltava
656,646,22,240,397,19,416,0,416,11,340,65,22.04.2019 00:10,145,14,Poltava
720,698,12,264,444,12,456,0,456,13,378,65,22.04.2019 00:15,145,14,Poltava
960,954,17,425,519,16,535,0,535,13,448,74,22.04.2019 00:20,145,14,Poltava
1024,1011,20,365,639,20,659,0,659,9,562,88,22.04.2019 05:25,145,14,Poltava
1440,1407,16,536,888,16,904,0,904,10,803,91,22.04.2019 00:10,145,14,Poltava
1792,1766,38,728,1028,36,1064,0,1064,24,875,165,21.04.2019 21:07,145,14,Poltava
1504,1471,38,578,896,30,926,0,926,23,763,140,21.04.2019 22:11,145,14,Poltava
144,147,2,52,91,1,92,0,92,3,61,28,22.04.2019 02:13,145,14,Poltava
688,677,62,175,453,60,513,0,513,15,426,72,21.04.2019 21:40,145,14,Poltava
960,968,61,294,610,56,666,0,666,9,583,74,22.04.2019 00:50,145,14,Poltava
640,631,62,245,348,47,395,0,395,10,312,73,22.04.2019 00:25,145,14,Poltava
112,101,4,44,65,3,68,1,68,1,60,7,22.04.2019 00:20,145,14,Poltava
304,289,25,104,178,22,200,0,200,1,170,29,22.04.2019 00:32,145,14,Poltava
416,398,22,142,258,16,274,0,274,1,224,48,22.04.2019 00:02,145,14,Poltava
272,270,18,87,171,14,185,0,185,3,164,18,21.04.2019 20:15,145,14,Poltava
112,120,11,16,85,11,96,0,96,0,86,10,21.04.2019 21:30,145,14,Poltava
400,345,38,158,212,30,242,0,242,0,230,12,21.04.2019 22:15,145,14,Poltava
64,60,5,23,38,3,41,0,41,0,35,6,21.04.2019 20:45,145,14,Poltava
144,135,12,56,81,7,88,0,88,3,77,8,21.04.2019 20:32,145,14,Poltava
720,727,59,173,492,55,547,0,547,5,488,54,22.04.2019 00:15,145,14,Poltava
160,146,16,68,76,16,92,0,92,0,78,14,22.04.2019 00:10,145,14,Poltava
272,269,17,94,161,17,178,0,178,1,152,25,22.04.2019 00:30,145,14,Poltava
160,153,9,70,82,8,90,0,90,1,74,15,21.04.2019 20:45,145,14,Poltava
1296,1287,38,446,819,31,850,0,850,15,721,114,22.04.2019 05:38,145,14,Poltava
496,489,32,139,328,29,357,0,357,7,304,46,21.04.2019 20:55,145,14,Poltava
352,346,21,118,216,18,234,0,234,5,177,52,21.04.2019 20:50,145,14,Poltava
496,476,33,203,261,32,293,0,293,6,232,55,22.04.2019 00:20,145,14,Poltava
592,573,40,230,322,40,362,0,362,8,310,44,22.04.2019 00:05,145,14,Poltava
752,749,18,325,409,18,427,0,427,13,360,54,21.04.2019 20:16,145,14,Poltava
512,495,12,191,309,12,321,0,321,3,269,49,21.04.2019 21:10,145,14,Poltava
736,728,24,308,408,20,428,0,428,12,342,74,21.04.2019 21:20,145,14,Poltava
336,321,21,152,165,19,184,0,184,1,154,29,22.04.2019 00:40,145,14,Poltava
384,377,37,137,213,34,247,0,247,3,208,36,21.04.2019 22:33,145,14,Poltava
864,853,33,276,556,32,588,0,588,11,515,62,21.04.2019 21:35,145,14,Poltava
1248,1233,34,510,705,33,738,0,738,12,652,74,21.04.2019 23:53,145,14,Poltava
1616,1582,33,628,955,33,988,0,988,30,798,160,21.04.2019 22:20,145,14,Poltava
768,750,6,280,482,6,488,0,488,13,412,63,22.04.2019 00:19,145,14,Poltava
528,527,6,225,297,6,303,0,303,2,265,36,22.04.2019 00:10,145,14,Poltava
864,844,7,389,468,7,475,0,475,8,376,91,22.04.2019 00:10,145,14,Poltava
1104,1082,25,447,634,23,657,0,657,22,519,116,21.04.2019 21:00,145,14,Poltava
912,895,44,352,519,41,560,0,560,11,475,74,22.04.2019 03:30,145,14,Poltava
1440,1417,6,542,892,6,898,0,898,23,762,113,22.04.2019 00:15,145,14,Poltava
1376,1351,6,518,852,6,858,0,858,10,735,113,22.04.2019 02:20,145,14,Poltava
1168,1137,40,409,719,40,759,0,759,10,649,100,22.04.2019 01:07,145,14,Poltava
992,973,9,417,566,9,575,0,575,10,488,77,22.04.2019 00:33,145,14,Poltava
496,488,14,185,297,14,311,0,311,4,268,39,21.04.2019 22:35,145,14,Poltava
336,327,36,122,179,35,214,0,214,3,183,28,22.04.2019 00:35,145,14,Poltava
928,915,13,311,604,13,617,0,617,16,505,96,21.04.2019 22:10,145,14,Poltava
304,287,18,152,137,15,152,0,152,3,131,18,22.04.2019 00:47,145,14,Poltava
224,221,15,89,120,15,135,0,135,1,107,27,21.04.2019 21:15,145,14,Poltava
1392,1377,63,505,831,56,887,0,887,28,722,137,21.04.2019 22:35,145,14,Poltava
192,180,4,77,112,3,115,0,115,2,95,18,22.04.2019 03:45,145,14,Poltava
688,675,24,260,405,23,428,0,428,6,374,48,22.04.2019 00:07,145,14,Poltava
1376,1340,30,523,830,23,853,0,853,17,734,102,22.04.2019 00:50,145,14,Poltava
1072,1056,22,365,685,22,707,0,707,12,597,98,21.04.2019 22:40,145,14,Poltava
1584,1552,2,588,995,1,996,0,996,20,790,186,22.04.2019 01:15,145,14,Poltava
1984,1960,3,689,1292,3,1295,0,1295,22,1023,250,21.04.2019 22:00,145,14,Poltava
672,657,7,235,430,7,437,0,437,5,375,57,21.04.2019 21:08,145,14,Poltava
560,546,8,196,356,8,364,0,364,4,316,44,21.04.2019 20:45,145,14,Poltava
1824,1804,22,693,1110,21,1131,0,1131,20,971,140,21.04.2019 22:21,145,14,Poltava
848,837,38,363,453,32,485,0,485,7,404,74,22.04.2019 00:07,145,14,Poltava
1872,1850,13,626,1234,12,1246,0,1246,19,1053,174,21.04.2019 21:30,145,14,Poltava
1888,1865,23,675,1193,20,1213,0,1213,17,1015,181,21.04.2019 23:17,145,14,Poltava
896,874,20,269,607,20,627,0,627,16,537,74,22.04.2019 00:30,145,14,Poltava
320,307,3,127,191,2,193,0,193,1,172,20,21.04.2019 21:05,145,14,Poltava
240,233,0,121,119,0,119,0,119,4,94,21,22.04.2019 00:15,145,14,Poltava
512,505,24,175,313,24,337,0,337,1,269,67,21.04.2019 21:05,145,14,Poltava
512,500,21,192,301,19,320,0,320,4,272,44,22.04.2019 02:30,145,14,Poltava
960,965,3,289,670,1,671,0,671,15,554,102,21.04.2019 22:50,145,14,Poltava
1856,1826,7,633,1217,6,1223,0,1223,16,1020,187,22.04.2019 00:05,145,14,Poltava
560,557,0,197,363,0,363,0,363,12,290,61,21.04.2019 21:40,145,14,Poltava
688,682,0,229,459,0,459,0,459,7,364,88,21.04.2019 21:27,145,14,Poltava
1872,1852,9,616,1247,9,1256,0,1256,31,1016,209,22.04.2019 00:25,145,14,Poltava
2192,2177,2,753,1438,1,1439,0,1439,31,1106,302,22.04.2019 00:35,145,14,Poltava
2288,2260,3,780,1506,2,1508,0,1508,25,1188,295,22.04.2019 00:06,145,14,Poltava
640,257,1,383,256,1,257,0,257,6,224,27,22.04.2019 00:17,145,14,Poltava
992,239,0,753,239,0,239,0,239,5,215,19,21.04.2019 21:30,145,14,Poltava
336,99,0,239,97,0,97,0,97,3,87,7,22.04.2019 00:15,145,14,Poltava
2016,2015,12,770,1236,10,1246,0,1246,37,969,240,21.04.2019 22:30,145,14,Poltava
1264,1256,2,639,623,2,625,0,625,9,494,122,21.04.2019 21:34,145,14,Poltava
1392,1432,5,640,747,5,752,0,752,16,628,108,21.04.2019 21:05,145,14,Poltava
1216,1259,11,350,856,10,866,0,866,18,660,188,21.04.2019 22:59,145,14,Poltava
1984,1961,18,668,1307,9,1316,0,1316,42,976,298,22.04.2019 00:45,145,14,Poltava
1920,1968,11,672,1240,8,1248,0,1248,25,1039,184,21.04.2019 21:40,145,14,Poltava
1952,1949,31,636,1293,23,1316,34,1316,34,1062,220,21.04.2019 23:05,145,14,Poltava
2032,2140,25,545,1465,22,1487,0,1487,34,1215,238,21.04.2019 22:30,145,14,Poltava
2320,2324,16,766,1542,12,1554,0,1554,46,1244,264,22.04.2019 00:05,145,14,Poltava
2016,1995,22,705,1296,15,1311,0,1311,26,1061,224,22.04.2019 06:40,145,14,Poltava
2432,2446,17,733,1688,11,1699,0,1699,53,1403,243,22.04.2019 00:05,145,14,Poltava
1696,1910,6,313,1379,4,1383,0,1383,31,1063,289,22.04.2019 00:08,145,14,Poltava
2416,2371,47,902,1471,43,1514,0,1514,27,1253,234,21.04.2019 21:35,145,14,Poltava
976,963,16,383,584,9,593,0,593,9,462,122,22.04.2019 00:10,145,14,Poltava
1248,1219,15,465,772,11,783,0,783,17,674,92,21.04.2019 20:51,145,14,Poltava
1024,1010,24,374,628,22,650,0,650,14,546,90,22.04.2019 00:10,145,14,Poltava
1952,1948,24,701,1227,24,1251,0,1251,30,1046,175,21.04.2019 21:45,145,14,Poltava
1312,1294,22,555,738,19,757,0,757,22,611,124,22.04.2019 00:05,145,14,Poltava
2000,1972,31,679,1294,27,1321,0,1321,32,1072,217,21.04.2019 22:10,145,14,Poltava
2288,2273,13,860,1416,12,1428,0,1428,36,1158,234,21.04.2019 22:00,145,14,Poltava
2096,2092,16,823,1262,11,1273,823,1273,42,1010,221,22.04.2019 00:01,145,14,Poltava
2384,2395,33,736,1622,26,1648,0,1648,57,1220,371,22.04.2019 00:15,145,14,Poltava
2096,2099,28,716,1362,18,1380,0,1380,22,1107,251,22.04.2019 01:45,145,14,Poltava
1920,1901,30,692,1208,20,1228,0,1228,41,966,221,22.04.2019 01:20,145,14,Poltava
2016,2013,14,666,1341,9,1350,0,1350,31,1032,287,21.04.2019 22:30,145,14,Poltava
2352,2328,10,782,1562,8,1570,0,1570,28,1304,238,22.04.2019 00:03,145,14,Poltava
2144,2142,24,655,1466,23,1489,0,1489,33,1187,269,21.04.2019 21:31,145,14,Poltava
2256,2272,28,752,1481,23,1504,0,1504,51,1221,232,21.04.2019 22:08,145,14,Poltava
2240,2203,30,798,1419,23,1442,0,1442,31,1192,219,22.04.2019 05:10,145,14,Poltava
2080,2047,9,721,1352,7,1359,0,1359,32,1135,192,22.04.2019 00:10,145,14,Poltava
1840,1829,4,690,1148,2,1150,0,1150,29,869,252,21.04.2019 22:50,145,14,Poltava
2016,2004,10,685,1327,4,1331,0,1331,40,1091,200,22.04.2019 00:08,145,14,Poltava
2096,2063,15,716,1366,14,1380,0,1380,36,1132,212,22.04.2019 06:12,145,14,Poltava
2192,2161,24,661,1512,19,1531,0,1531,45,1212,274,21.04.2019 22:50,145,14,Poltava
2352,2322,30,861,1469,22,1491,0,1491,58,1216,217,22.04.2019 03:08,145,14,Poltava
2128,2125,18,651,1459,18,1477,0,1477,38,1197,242,22.04.2019 00:10,145,14,Poltava
1712,1682,19,582,1112,18,1130,0,1130,33,909,188,21.04.2019 22:00,145,14,Poltava
2128,2122,18,742,1373,13,1386,0,1386,38,1134,214,22.04.2019 01:10,145,14,Poltava
176,23,11,153,12,11,23,0,23,0,19,4,22.04.2019 00:15,145,14,Poltava
864,231,70,656,139,69,208,0,208,14,153,41,21.04.2019 21:00,145,14,Poltava
112,41,0,86,26,0,26,0,26,1,21,4,22.04.2019 01:30,145,14,Poltava
48,22,0,26,22,0,22,0,22,2,18,2,21.04.2019 23:00,145,14,Poltava
320,11,11,309,0,11,11,0,11,0,9,2,21.04.2019 20:35,145,14,Poltava
208,16,0,193,15,0,15,0,15,0,13,2,21.04.2019 21:59,145,14,Poltava
80,19,0,61,19,0,19,0,19,1,12,6,21.04.2019 20:30,145,14,Poltava
64,18,0,47,17,0,17,0,17,0,14,3,21.04.2019 22:03,145,14,Poltava
208,48,0,164,44,0,44,0,44,1,37,6,22.04.2019 01:00,145,14,Poltava
1392,1369,5,558,832,2,834,0,834,17,681,136,22.04.2019 00:25,145,14,Poltava
1200,1206,0,381,819,0,819,0,819,18,681,120,22.04.2019 00:25,145,14,Poltava
1696,1724,7,687,1003,6,1009,0,1009,20,795,194,22.04.2019 00:05,146,14,Poltava
1664,1663,16,582,1070,12,1082,0,1082,27,824,231,22.04.2019 00:28,146,14,Poltava
1712,1712,6,602,1104,6,1110,0,1110,23,821,266,22.04.2019 00:15,146,14,Poltava
1696,1679,12,595,1093,8,1101,0,1101,18,826,257,22.04.2019 00:04,146,14,Poltava
1888,1883,17,636,1241,11,1252,0,1252,37,940,275,22.04.2019 00:03,146,14,Poltava
1776,1786,11,553,1214,9,1223,0,1223,32,914,277,22.04.2019 01:45,146,14,Poltava
1280,1281,16,426,841,13,854,0,854,22,664,168,22.04.2019 00:07,146,14,Poltava
736,740,5,246,485,5,490,0,490,22,389,79,22.04.2019 00:30,146,14,Poltava
1536,1516,9,505,1024,7,1031,0,1031,27,791,213,22.04.2019 00:01,146,14,Poltava
800,804,11,299,491,10,501,0,501,11,403,87,22.04.2019 00:05,146,14,Poltava
1984,1952,33,786,1174,24,1198,0,1198,29,947,222,22.04.2019 00:22,146,14,Poltava
960,956,11,357,597,6,603,0,603,20,462,121,21.04.2019 23:30,146,14,Poltava
624,614,8,222,396,6,402,0,402,14,332,56,22.04.2019 00:24,146,14,Poltava
1680,1671,14,606,1061,13,1074,0,1074,26,840,208,22.04.2019 00:35,146,14,Poltava
1648,1637,11,554,1085,9,1094,0,1094,32,862,200,21.04.2019 21:15,146,14,Poltava
2000,1987,5,673,1323,4,1327,0,1327,27,1079,221,22.04.2019 00:05,146,14,Poltava
2368,2346,18,730,1629,9,1638,0,1638,24,1304,310,22.04.2019 00:09,146,14,Poltava
2144,2159,6,658,1480,6,1486,0,1486,37,1143,306,22.04.2019 00:25,146,14,Poltava
2176,2155,7,682,1492,2,1494,0,1494,31,1183,280,22.04.2019 00:15,146,14,Poltava
1728,1738,21,572,1143,13,1156,0,1156,23,902,231,22.04.2019 00:40,146,14,Poltava
2304,2288,24,705,1581,18,1599,0,1599,35,1275,289,22.04.2019 00:15,146,14,Poltava
2176,2154,6,733,1440,3,1443,0,1443,30,1151,262,22.04.2019 01:40,146,14,Poltava
2320,2299,13,792,1516,12,1528,0,1528,19,1249,260,22.04.2019 00:30,146,14,Poltava
2208,2173,18,710,1483,15,1498,0,1498,35,1184,279,22.04.2019 00:59,146,14,Poltava
2000,2004,15,612,1377,11,1388,0,1388,35,1076,277,22.04.2019 00:26,146,14,Poltava
1984,1924,13,747,1228,9,1237,0,1237,34,964,239,22.04.2019 00:20,146,14,Poltava
2000,1965,20,729,1258,13,1271,0,1271,32,998,241,22.04.2019 00:05,146,14,Poltava
1968,1935,31,654,1290,24,1314,0,1314,33,1026,255,22.04.2019 00:02,146,14,Poltava
1840,1835,18,564,1259,17,1276,0,1276,25,960,291,22.04.2019 00:30,146,14,Poltava
2064,2046,18,829,1227,8,1235,0,1235,26,1029,180,22.04.2019 00:17,146,14,Poltava
2416,2396,24,848,1549,19,1568,0,1568,51,1268,249,22.04.2019 00:05,146,14,Poltava
1920,1914,8,715,1199,6,1205,0,1205,25,979,201,22.04.2019 00:42,146,14,Poltava
1888,1862,9,739,1143,6,1149,0,1149,25,936,188,22.04.2019 00:30,146,14,Poltava
1808,1793,18,626,1168,14,1182,0,1182,35,930,217,22.04.2019 00:30,146,14,Poltava
1120,1109,4,435,681,4,685,0,685,18,559,108,21.04.2019 23:06,146,14,Poltava
1840,1826,12,617,1216,7,1223,0,1223,30,988,205,22.04.2019 00:22,146,14,Poltava
1456,1458,10,503,947,6,953,0,953,21,721,211,22.04.2019 00:30,146,14,Poltava
2048,2020,14,874,1164,10,1174,0,1174,19,978,177,21.04.2019 23:01,146,14,Poltava
1744,1716,10,636,1100,8,1108,0,1108,27,870,211,22.04.2019 00:05,146,14,Poltava
1360,1349,11,458,892,10,902,0,902,27,725,150,22.04.2019 00:09,146,14,Poltava
2256,2245,11,820,1427,9,1436,0,1436,36,1179,221,22.04.2019 00:05,146,14,Poltava
1984,1959,11,717,1259,8,1267,0,1267,28,1031,208,22.04.2019 00:30,146,14,Poltava
2144,2119,7,655,1483,6,1489,0,1489,39,1202,248,22.04.2019 00:05,146,14,Poltava
2288,2257,7,785,1499,4,1503,0,1503,31,1205,267,22.04.2019 00:45,146,14,Poltava
2176,2139,13,680,1486,10,1496,0,1496,40,1177,279,22.04.2019 00:20,146,14,Poltava
2144,2128,12,715,1418,11,1429,0,1429,27,1134,268,22.04.2019 00:40,146,14,Poltava
240,66,0,187,53,0,53,0,53,0,47,6,21.04.2019 22:25,146,14,Poltava
48,31,0,17,31,0,31,0,31,2,24,5,21.04.2019 20:21,146,14,Poltava
1088,1067,11,357,722,9,731,0,731,17,558,156,22.04.2019 00:07,146,14,Poltava
1088,1063,13,397,684,7,691,0,691,13,543,135,21.04.2019 22:05,146,14,Poltava
1872,1855,21,664,1189,19,1208,0,1208,23,955,230,22.04.2019 00:10,146,14,Poltava
1152,1123,12,460,684,8,692,0,692,23,534,135,22.04.2019 00:10,146,14,Poltava
992,992,12,337,643,12,655,0,655,17,506,132,22.04.2019 00:12,146,14,Poltava
1136,1122,14,399,728,9,737,0,737,25,549,163,22.04.2019 00:26,146,14,Poltava
1648,1646,6,531,1112,5,1117,0,1117,36,852,229,21.04.2019 22:12,146,14,Poltava
1536,1510,22,538,978,20,998,0,998,34,738,226,22.04.2019 00:30,146,14,Poltava
1472,1441,11,540,922,10,932,0,932,13,759,160,22.04.2019 00:35,146,14,Poltava
1952,1928,12,647,1295,10,1305,0,1305,30,1053,222,22.04.2019 00:10,146,14,Poltava
1568,1540,4,553,1013,2,1015,0,1015,27,824,164,21.04.2019 22:00,146,14,Poltava
2048,2010,11,667,1373,8,1381,0,1381,38,1083,260,22.04.2019 00:05,146,14,Poltava
2032,2004,9,662,1363,7,1370,0,1370,25,1133,212,22.04.2019 00:50,146,14,Poltava
672,662,6,264,402,6,408,0,408,9,335,64,21.04.2019 23:47,146,14,Poltava
1024,989,6,473,547,4,551,0,551,4,481,66,22.04.2019 00:05,146,14,Poltava
1984,1958,21,719,1251,14,1265,0,1265,27,1051,187,22.04.2019 00:05,146,14,Poltava
1776,1730,20,661,1105,10,1115,0,1115,27,927,161,21.04.2019 23:45,146,14,Poltava
1392,1364,7,547,840,5,845,0,845,26,682,137,22.04.2019 00:05,146,14,Poltava
1536,1523,13,595,928,13,941,0,941,28,780,133,22.04.2019 00:10,146,14,Poltava
1456,1445,10,634,815,7,822,0,822,25,692,105,22.04.2019 00:30,146,14,Poltava
1440,1418,15,650,777,13,790,0,790,21,658,111,22.04.2019 00:10,146,14,Poltava
1392,1382,13,550,833,9,842,0,842,15,702,125,22.04.2019 00:11,146,14,Poltava
1488,1462,13,610,869,9,878,0,878,18,706,154,22.04.2019 00:22,146,14,Poltava
1600,1572,16,626,961,13,974,0,974,25,810,139,22.04.2019 00:09,146,14,Poltava
1392,1365,15,594,788,10,798,0,798,18,673,107,22.04.2019 00:16,146,14,Poltava
1440,1419,13,591,842,7,849,0,849,25,678,146,22.04.2019 00:10,146,14,Poltava
1600,1571,14,526,1060,14,1074,0,1074,31,859,184,22.04.2019 00:15,146,14,Poltava
2144,2116,15,736,1396,12,1408,0,1408,38,1133,237,22.04.2019 00:35,146,14,Poltava
2256,2207,12,750,1501,5,1506,0,1506,44,1190,272,22.04.2019 00:10,146,14,Poltava
1472,1443,6,482,986,4,990,0,990,18,795,177,22.04.2019 00:49,146,14,Poltava
1312,1284,13,476,823,13,836,0,836,29,669,138,22.04.2019 00:20,146,14,Poltava
1472,1439,19,575,881,16,897,0,897,28,745,124,22.04.2019 00:03,146,14,Poltava
1472,1450,14,547,915,10,925,0,925,24,758,143,21.04.2019 21:30,146,14,Poltava
1536,1518,11,501,1029,6,1035,0,1035,26,864,145,22.04.2019 00:30,146,14,Poltava
1824,1800,14,655,1157,12,1169,0,1169,33,936,200,22.04.2019 01:20,146,14,Poltava
1232,113,0,1119,113,0,113,0,113,7,102,4,21.04.2019 22:30,146,14,Poltava
1456,1432,46,493,925,38,963,0,963,23,799,141,22.04.2019 00:40,147,14,Poltava
1488,1462,48,518,933,37,970,0,970,24,796,150,22.04.2019 00:05,147,14,Poltava
1728,1695,37,603,1090,35,1125,0,1125,17,961,147,22.04.2019 00:30,147,14,Poltava
2032,2006,64,719,1257,56,1313,0,1313,20,1135,158,22.04.2019 00:39,147,14,Poltava
176,163,14,74,90,12,102,0,102,6,83,13,22.04.2019 00:20,147,14,Poltava
304,294,18,106,183,15,198,0,198,4,160,34,21.04.2019 20:35,147,14,Poltava
320,315,32,110,183,27,210,0,210,0,186,24,22.04.2019 00:40,147,14,Poltava
432,415,30,163,242,27,269,0,269,3,229,37,22.04.2019 00:10,147,14,Poltava
816,806,47,295,477,44,521,0,521,3,413,105,21.04.2019 23:20,147,14,Poltava
864,845,74,243,559,62,621,0,621,14,533,74,22.04.2019 00:20,147,14,Poltava
224,213,26,84,118,22,140,0,140,0,126,14,22.04.2019 02:54,147,14,Poltava
208,204,9,82,118,8,126,0,126,7,106,13,22.04.2019 00:15,147,14,Poltava
736,727,27,314,399,23,422,0,422,8,354,60,22.04.2019 00:15,147,14,Poltava
704,697,58,240,410,54,464,0,464,9,415,40,21.04.2019 22:45,147,14,Poltava
288,282,33,113,145,30,175,0,175,2,147,26,21.04.2019 20:40,147,14,Poltava
256,258,11,78,167,11,178,0,178,3,148,27,21.04.2019 21:45,147,14,Poltava
736,716,77,275,394,67,461,0,461,10,425,26,22.04.2019 00:05,147,14,Poltava
432,425,47,143,248,41,289,0,289,2,257,30,22.04.2019 00:30,147,14,Poltava
1840,1813,23,697,1124,19,1143,0,1143,26,961,156,22.04.2019 00:50,147,14,Poltava
176,177,6,71,100,5,105,0,105,0,92,13,22.04.2019 00:10,147,14,Poltava
544,539,41,164,343,37,380,0,380,6,334,40,21.04.2019 21:55,147,14,Poltava
1936,1948,51,644,1244,48,1292,0,1292,23,1088,181,22.04.2019 02:20,147,14,Poltava
1888,1848,78,625,1204,59,1263,0,1263,31,1042,190,22.04.2019 00:10,147,14,Poltava
1696,1656,74,618,1014,64,1078,0,1078,32,905,141,22.04.2019 00:20,147,14,Poltava
1504,1471,73,523,921,60,981,0,981,14,850,117,22.04.2019 00:20,147,14,Poltava
608,596,31,214,365,29,394,0,394,9,341,44,22.04.2019 00:16,147,14,Poltava
192,183,13,45,136,11,147,0,147,2,119,26,21.04.2019 23:50,147,14,Poltava
304,289,28,130,151,23,174,0,174,5,143,26,22.04.2019 00:30,147,14,Poltava
1104,1089,54,361,692,51,743,0,743,14,641,88,22.04.2019 00:50,147,14,Poltava
1184,1160,72,386,728,70,798,0,798,20,692,86,22.04.2019 00:15,147,14,Poltava
1120,1097,83,408,645,67,712,0,712,25,621,66,22.04.2019 00:15,147,14,Poltava
928,921,28,327,575,26,601,0,601,13,517,71,22.04.2019 00:30,147,14,Poltava
272,266,44,111,121,40,161,0,161,1,140,20,22.04.2019 00:10,147,14,Poltava
256,244,31,94,136,26,162,0,162,2,144,16,22.04.2019 00:11,147,14,Poltava
432,417,40,144,258,30,288,0,288,4,254,30,21.04.2019 20:55,147,14,Poltava
736,715,42,245,452,39,491,0,491,13,426,52,21.04.2019 23:45,147,14,Poltava
464,452,21,165,279,20,299,0,299,2,264,33,21.04.2019 20:32,147,14,Poltava
192,181,25,61,108,23,131,0,131,1,109,21,21.04.2019 20:30,147,14,Poltava
1184,1164,140,347,702,135,837,0,837,8,767,62,22.04.2019 01:00,147,14,Poltava
320,306,49,84,193,43,236,0,236,0,214,22,22.04.2019 00:08,147,14,Poltava
640,644,98,155,390,95,485,0,485,6,444,35,22.04.2019 00:35,147,14,Poltava
144,136,22,64,63,17,80,0,80,0,68,12,22.04.2019 00:20,147,14,Poltava
400,393,68,140,195,65,260,0,260,9,229,22,21.04.2019 21:00,147,14,Poltava
448,436,50,154,247,47,294,0,294,2,267,25,22.04.2019 00:10,147,14,Poltava
848,838,107,293,463,92,555,0,555,15,492,48,22.04.2019 00:20,147,14,Poltava
384,379,28,150,216,18,234,0,234,4,204,26,22.04.2019 00:42,147,14,Poltava
144,135,20,65,60,19,79,0,79,0,75,4,22.04.2019 00:25,147,14,Poltava
384,371,46,110,237,37,274,0,274,3,232,39,21.04.2019 23:00,147,14,Poltava
336,323,46,105,189,42,231,0,231,2,208,21,22.04.2019 00:30,147,14,Poltava
256,237,27,83,149,24,173,0,173,11,150,12,22.04.2019 00:20,147,14,Poltava
384,367,27,180,184,20,204,0,204,2,178,24,22.04.2019 00:15,147,14,Poltava
96,89,14,34,50,12,62,0,62,0,51,11,22.04.2019 00:51,147,14,Poltava
416,408,59,112,253,51,304,0,304,6,259,39,21.04.2019 21:35,147,14,Poltava
128,125,30,36,70,22,92,0,92,1,82,9,21.04.2019 22:00,147,14,Poltava
640,625,53,226,367,47,414,0,414,6,364,44,22.04.2019 00:05,147,14,Poltava
224,219,26,71,128,25,153,0,153,3,140,10,22.04.2019 00:35,147,14,Poltava
624,608,90,193,352,79,431,0,431,10,355,66,22.04.2019 00:07,147,14,Poltava
288,267,32,124,137,27,164,0,164,1,130,33,22.04.2019 01:15,147,14,Poltava
624,621,76,231,324,69,393,0,393,4,346,43,22.04.2019 00:01,147,14,Poltava
736,723,31,281,427,28,455,0,455,15,373,67,22.04.2019 01:02,147,14,Poltava
864,853,55,238,574,52,626,0,626,13,568,45,22.04.2019 00:10,147,14,Poltava
416,403,55,126,242,48,290,0,290,9,256,25,22.04.2019 00:15,147,14,Poltava
480,455,70,170,246,64,310,0,310,4,271,35,21.04.2019 23:45,147,14,Poltava
576,556,36,202,342,32,374,0,374,9,336,29,22.04.2019 00:15,147,14,Poltava
560,549,53,215,303,42,345,0,345,4,290,51,22.04.2019 00:55,147,14,Poltava
224,218,38,58,130,36,166,0,166,4,148,14,22.04.2019 00:15,147,14,Poltava
720,702,30,261,429,30,459,0,459,8,402,49,21.04.2019 20:23,147,14,Poltava
432,435,56,133,254,45,299,0,299,3,244,52,22.04.2019 00:05,147,14,Poltava
704,685,65,239,404,61,465,0,465,7,386,72,21.04.2019 20:40,147,14,Poltava
1280,1255,54,496,730,54,784,0,784,8,665,111,21.04.2019 21:00,147,14,Poltava
1408,1390,49,604,760,44,804,0,804,11,674,119,21.04.2019 21:50,147,14,Poltava
320,307,18,118,186,16,202,0,202,0,177,25,21.04.2019 20:51,147,14,Poltava
1200,1173,28,482,696,22,718,0,718,13,604,101,21.04.2019 22:00,147,14,Poltava
1008,985,53,414,542,52,594,0,594,10,512,72,21.04.2019 21:15,147,14,Poltava
704,702,58,300,352,52,404,0,404,14,314,76,21.04.2019 21:00,147,14,Poltava
128,116,8,51,71,6,77,0,77,1,66,10,21.04.2019 20:28,147,14,Poltava
624,611,54,188,384,52,436,0,436,10,345,81,22.04.2019 00:03,147,14,Poltava
832,825,74,332,430,70,500,0,500,6,435,59,21.04.2019 20:45,147,14,Poltava
528,509,53,203,282,43,325,0,325,10,260,55,21.04.2019 20:50,147,14,Poltava
240,220,30,100,115,25,140,0,140,3,121,16,21.04.2019 21:15,147,14,Poltava
832,813,33,333,467,32,499,0,499,9,432,58,21.04.2019 23:21,147,14,Poltava
816,802,43,333,442,41,483,0,483,6,430,47,22.04.2019 00:20,147,14,Poltava
144,144,18,56,72,16,88,0,88,0,79,9,21.04.2019 20:55,147,14,Poltava
464,445,42,166,256,42,298,0,298,3,249,46,21.04.2019 20:52,147,14,Poltava
144,139,19,28,97,19,116,0,116,2,83,31,21.04.2019 21:05,147,14,Poltava
1200,1199,54,419,728,53,781,0,781,9,673,99,21.04.2019 21:10,147,14,Poltava
464,459,54,151,263,50,313,0,313,3,280,30,21.04.2019 20:45,147,14,Poltava
1296,1274,86,505,710,81,791,0,791,6,689,96,22.04.2019 00:15,147,14,Poltava
2000,1968,74,918,1020,62,1082,0,1082,29,896,157,21.04.2019 23:20,147,14,Poltava
320,308,9,112,202,6,208,0,208,3,151,54,22.04.2019 00:20,147,14,Poltava
705,697,70,133,505,67,572,0,572,36,458,78,22.04.2019 00:09,147,14,Poltava
176,163,17,40,121,15,136,0,136,5,102,29,21.04.2019 20:40,147,14,Poltava
80,66,3,19,58,3,61,0,61,0,40,21,21.04.2019 20:52,147,14,Poltava
96,80,6,21,69,6,75,0,75,3,48,24,21.04.2019 20:50,147,14,Poltava
320,312,23,111,189,20,209,0,209,7,178,24,21.04.2019 23:45,147,14,Poltava
160,152,27,51,82,27,109,0,109,1,94,14,21.04.2019 21:05,147,14,Poltava
288,283,23,112,153,23,176,0,176,3,154,19,21.04.2019 20:40,147,14,Poltava
112,106,5,37,71,4,75,0,75,1,58,16,21.04.2019 20:40,147,14,Poltava
1376,1358,56,650,673,53,726,0,726,15,580,131,21.04.2019 22:00,147,14,Poltava
160,163,20,47,93,20,113,0,113,2,91,20,21.04.2019 21:15,147,14,Poltava
320,318,26,110,184,26,210,0,210,2,161,47,21.04.2019 21:04,147,14,Poltava
352,343,39,121,194,37,231,0,231,8,171,52,21.04.2019 22:20,147,14,Poltava
272,274,42,68,167,37,204,0,204,1,151,52,21.04.2019 22:05,147,14,Poltava
448,439,32,206,215,27,242,0,242,2,213,27,22.04.2019 00:01,147,14,Poltava
112,111,8,37,68,7,75,0,75,0,62,13,21.04.2019 20:40,147,14,Poltava
560,556,56,254,251,55,306,0,306,8,260,38,21.04.2019 21:00,147,14,Poltava
816,795,20,365,432,19,451,0,451,7,384,60,22.04.2019 00:10,147,14,Poltava
272,257,22,92,163,17,180,0,180,3,152,25,21.04.2019 22:35,147,14,Poltava
288,286,25,87,176,25,201,0,201,2,179,20,21.04.2019 20:40,147,14,Poltava
1664,1649,26,598,1043,23,1066,0,1066,28,878,160,22.04.2019 00:06,147,14,Poltava
1296,1284,21,453,824,19,843,0,843,17,681,145,22.04.2019 00:03,147,14,Poltava
1504,1483,34,516,960,28,988,0,988,26,818,144,22.04.2019 01:05,147,14,Poltava
1072,1047,37,389,655,28,683,0,683,15,576,92,21.04.2019 21:34,147,14,Poltava
1168,1150,19,395,756,17,773,0,773,12,657,104,22.04.2019 00:05,147,14,Poltava
320,311,11,120,189,11,200,0,200,4,181,15,21.04.2019 21:30,147,14,Poltava
848,821,32,294,522,32,554,0,554,15,453,86,21.04.2019 21:30,147,14,Poltava
320,309,10,90,220,10,230,0,230,5,201,24,21.04.2019 23:20,147,14,Poltava
208,198,4,82,122,4,126,0,126,0,98,28,22.04.2019 00:09,147,14,Poltava
624,610,28,250,350,24,374,0,374,4,337,33,22.04.2019 00:15,147,14,Poltava
288,287,10,140,138,10,148,0,148,1,126,21,21.04.2019 20:42,147,14,Poltava
992,975,52,358,585,49,634,0,634,14,553,67,21.04.2019 21:30,147,14,Poltava
832,829,59,255,526,51,577,0,577,7,525,45,21.04.2019 20:30,147,14,Poltava
240,222,21,94,127,19,146,0,146,1,131,14,22.04.2019 00:05,147,14,Poltava
384,370,41,121,227,36,263,0,263,3,221,39,22.04.2019 00:09,147,14,Poltava
160,147,15,54,93,13,106,0,106,6,78,22,22.04.2019 00:03,147,14,Poltava
496,486,35,208,259,29,288,0,288,1,244,43,21.04.2019 21:15,147,14,Poltava
384,387,40,138,217,29,246,0,246,1,209,36,21.04.2019 22:20,147,14,Poltava
368,365,31,106,233,29,262,0,262,7,232,23,22.04.2019 00:10,147,14,Poltava
400,399,41,114,249,37,286,0,286,3,238,45,22.04.2019 00:20,147,14,Poltava
400,380,44,134,225,41,266,0,266,6,226,34,22.04.2019 00:25,147,14,Poltava
208,195,30,73,108,27,135,0,135,2,101,32,22.04.2019 00:05,147,14,Poltava
320,313,44,83,197,40,237,0,237,6,206,25,22.04.2019 00:12,147,14,Poltava
192,188,15,47,131,14,145,0,145,2,136,7,22.04.2019 00:25,147,14,Poltava
400,391,43,132,225,43,268,0,268,7,214,47,22.04.2019 00:50,147,14,Poltava
272,262,19,78,175,19,194,0,194,5,159,30,22.04.2019 00:05,147,14,Poltava
512,502,28,209,280,23,303,0,303,3,251,49,21.04.2019 20:45,147,14,Poltava
784,775,46,347,396,41,437,0,437,5,360,72,22.04.2019 00:02,147,14,Poltava
400,378,21,150,230,20,250,0,250,4,221,25,22.04.2019 00:25,147,14,Poltava
576,570,34,225,321,30,351,0,351,4,310,37,22.04.2019 00:30,147,14,Poltava
512,505,40,190,287,35,322,0,322,8,266,48,22.04.2019 00:05,147,14,Poltava
704,696,64,259,386,59,445,0,445,1,366,78,22.04.2019 00:45,147,14,Poltava
496,483,34,195,267,34,301,0,301,3,273,25,22.04.2019 01:55,147,14,Poltava
240,222,25,83,134,23,157,0,157,2,130,25,22.04.2019 00:10,147,14,Poltava
368,362,31,105,233,30,263,0,263,5,219,39,22.04.2019 00:10,147,14,Poltava
320,298,9,98,214,8,222,0,222,2,188,32,22.04.2019 00:05,147,14,Poltava
320,307,33,91,199,30,229,0,229,4,208,17,22.04.2019 00:05,147,14,Poltava
256,242,34,82,141,33,174,0,174,7,143,24,22.04.2019 00:05,147,14,Poltava
1968,1951,101,674,1206,88,1294,0,1294,21,1094,179,22.04.2019 00:16,147,14,Poltava
1968,1935,87,666,1230,72,1302,0,1302,19,1080,203,22.04.2019 00:20,147,14,Poltava
272,261,19,78,179,15,194,0,194,2,170,22,21.04.2019 20:23,147,14,Poltava
288,276,40,73,177,38,215,0,215,6,180,29,21.04.2019 20:50,147,14,Poltava
416,404,41,135,243,38,281,0,281,1,263,17,22.04.2019 00:05,147,14,Poltava
368,356,43,124,203,41,244,0,244,3,222,19,21.04.2019 21:00,147,14,Poltava
464,456,45,153,271,40,311,0,311,3,285,23,22.04.2019 00:08,147,14,Poltava
624,607,37,208,388,28,416,0,416,3,364,49,21.04.2019 22:00,147,14,Poltava
272,258,18,103,152,17,169,0,169,1,149,19,21.04.2019 21:00,147,14,Poltava
736,721,45,242,453,41,494,0,494,7,428,59,21.04.2019 23:55,147,14,Poltava
768,765,72,269,433,66,499,0,499,8,438,53,22.04.2019 02:45,147,14,Poltava
496,476,53,171,275,50,325,0,325,6,284,35,21.04.2019 20:45,147,14,Poltava
544,530,34,162,349,33,382,0,382,1,336,45,21.04.2019 20:50,147,14,Poltava
464,452,35,193,240,31,271,0,271,7,235,29,22.04.2019 00:35,147,14,Poltava
384,385,38,125,222,37,259,0,259,4,217,38,22.04.2019 00:02,147,14,Poltava
784,778,50,282,458,44,502,0,502,8,432,62,22.04.2019 00:12,147,14,Poltava
560,549,59,219,291,50,341,0,341,6,302,33,21.04.2019 20:50,147,14,Poltava
1040,1023,79,374,591,75,666,0,666,18,566,82,22.04.2019 00:15,147,14,Poltava
432,427,52,148,236,48,284,0,284,10,240,34,21.04.2019 23:20,147,14,Poltava
1824,1795,99,676,1062,86,1148,0,1148,28,988,132,21.04.2019 20:40,147,14,Poltava
1504,1489,53,516,938,50,988,0,988,14,853,121,21.04.2019 21:50,147,14,Poltava
2000,1967,17,697,1286,17,1303,0,1303,20,1104,179,21.04.2019 21:25,147,14,Poltava
1424,1404,16,510,903,11,914,0,914,22,766,126,22.04.2019 00:01,147,14,Poltava
1840,1809,65,636,1148,56,1204,0,1204,39,1053,112,22.04.2019 00:10,147,14,Poltava
1824,1810,19,712,1098,14,1112,0,1112,26,928,158,21.04.2019 20:40,147,14,Poltava
1760,1847,24,525,1214,21,1235,0,1235,42,993,200,21.04.2019 20:23,147,14,Poltava
1632,1678,25,548,1063,21,1084,0,1084,30,854,200,22.04.2019 00:05,147,14,Poltava
1776,1759,22,629,1129,18,1147,0,1147,35,940,172,22.04.2019 00:05,147,14,Poltava
1840,1805,10,728,1104,8,1112,0,1112,25,941,146,22.04.2019 00:03,147,14,Poltava
1840,1832,7,700,1135,5,1140,0,1140,26,934,180,21.04.2019 20:45,147,14,Poltava
1920,1953,21,639,1262,19,1281,0,1281,34,1064,183,21.04.2019 22:30,147,14,Poltava
1264,1302,19,391,854,19,873,0,873,30,706,137,22.04.2019 00:30,147,14,Poltava
1712,1685,33,696,983,33,1016,0,1016,28,896,92,22.04.2019 00:01,147,14,Poltava
1872,1891,25,574,1276,22,1298,0,1298,28,1055,215,22.04.2019 00:05,147,14,Poltava
1680,1677,8,615,1057,8,1065,0,1065,16,893,156,22.04.2019 00:03,147,14,Poltava
1840,1825,22,709,1112,19,1131,0,1131,24,954,153,22.04.2019 00:05,147,14,Poltava
1424,1418,11,557,859,8,867,0,867,21,724,122,21.04.2019 20:47,147,14,Poltava
1920,1877,11,722,1189,9,1198,0,1198,43,962,193,22.04.2019 00:06,147,14,Poltava
2016,1975,15,793,1208,15,1223,0,1223,35,994,194,22.04.2019 00:20,147,14,Poltava
2208,2205,36,820,1356,32,1388,0,1388,38,1171,179,22.04.2019 01:10,148,14,Poltava
2064,2032,29,837,1200,27,1227,0,1227,22,1043,162,22.04.2019 01:30,148,14,Poltava
320,315,13,136,171,13,184,0,184,2,170,12,21.04.2019 20:56,148,14,Poltava
352,333,27,139,186,27,213,0,213,3,181,29,21.04.2019 21:18,148,14,Poltava
288,282,15,93,180,15,195,0,195,3,164,28,21.04.2019 23:58,148,14,Poltava
160,162,8,56,97,7,104,0,104,2,80,22,22.04.2019 00:30,148,14,Poltava
304,288,41,115,150,39,189,0,189,1,143,45,22.04.2019 00:25,148,14,Poltava
135,133,16,43,77,15,92,0,92,4,73,15,22.04.2019 01:00,148,14,Poltava
217,196,26,87,104,26,130,0,130,1,93,36,22.04.2019 01:15,148,14,Poltava
1904,1870,63,724,1128,52,1180,0,1180,29,1008,143,22.04.2019 01:30,148,14,Poltava
432,425,36,142,257,33,290,0,290,6,238,46,21.04.2019 20:45,148,14,Poltava
640,643,41,227,376,37,413,0,413,9,345,59,21.04.2019 21:10,148,14,Poltava
736,723,56,217,468,51,519,0,519,8,407,104,22.04.2019 01:15,148,14,Poltava
208,195,25,55,131,22,153,0,153,2,126,25,22.04.2019 00:07,148,14,Poltava
400,383,29,128,243,29,272,0,272,9,227,36,22.04.2019 01:25,148,14,Poltava
544,538,41,185,318,41,359,0,359,4,305,50,21.04.2019 22:15,148,14,Poltava
272,259,19,84,169,19,188,0,188,7,150,31,22.04.2019 00:25,148,14,Poltava
304,300,20,65,219,20,239,0,239,4,199,36,22.04.2019 00:30,148,14,Poltava
240,233,26,65,151,24,175,0,175,2,144,29,22.04.2019 01:00,148,14,Poltava
560,543,26,210,326,24,350,0,350,4,302,44,22.04.2019 05:10,148,14,Poltava
352,339,22,143,187,22,209,0,209,8,185,16,22.04.2019 00:02,148,14,Poltava
128,122,6,56,66,6,72,0,72,0,59,13,22.04.2019 00:15,148,14,Poltava
960,932,77,354,533,73,606,0,606,8,514,84,22.04.2019 00:10,148,14,Poltava
432,416,56,123,256,53,309,0,309,7,256,46,22.04.2019 00:10,148,14,Poltava
224,221,28,63,135,26,161,0,161,5,125,31,22.04.2019 00:35,148,14,Poltava
1008,983,48,453,511,44,555,0,555,4,496,55,22.04.2019 00:45,148,14,Poltava
144,137,13,77,54,13,67,0,67,2,54,11,22.04.2019 00:46,148,14,Poltava
624,620,53,194,377,53,430,0,430,6,367,57,22.04.2019 00:15,148,14,Poltava
400,396,28,155,217,28,245,0,245,7,206,32,21.04.2019 22:30,148,14,Poltava
1440,1430,71,568,801,71,872,0,872,18,744,110,22.04.2019 00:35,148,14,Poltava
144,136,7,36,101,7,108,0,108,2,89,17,22.04.2019 00:30,148,14,Poltava
272,252,30,70,172,30,202,0,202,0,185,17,22.04.2019 00:05,148,14,Poltava
128,121,19,21,88,19,107,0,107,3,91,13,22.04.2019 00:13,148,14,Poltava
496,488,42,156,299,41,340,0,340,8,294,38,22.04.2019 00:22,148,14,Poltava
256,246,23,95,138,23,161,0,161,5,134,22,22.04.2019 01:40,148,14,Poltava
1696,1673,29,582,1091,23,1114,0,1114,32,950,132,22.04.2019 00:10,148,14,Poltava
1552,1525,27,625,905,22,927,0,927,19,759,149,22.04.2019 01:25,148,14,Poltava
1136,1122,16,439,681,16,697,0,697,17,589,91,22.04.2019 00:25,148,14,Poltava
880,861,44,297,539,44,583,0,583,15,480,88,22.04.2019 00:25,148,14,Poltava
240,239,7,116,122,2,124,0,124,1,107,16,22.04.2019 00:25,148,14,Poltava
496,486,1,159,337,0,337,0,337,7,290,40,22.04.2019 00:10,148,14,Poltava
592,575,38,210,348,34,382,0,382,9,297,76,22.04.2019 00:25,148,14,Poltava
384,373,44,122,222,40,262,0,262,7,228,27,22.04.2019 00:10,148,14,Poltava
464,447,59,175,235,54,289,0,289,2,230,57,22.04.2019 00:15,148,14,Poltava
1216,1191,68,591,568,57,625,0,625,8,519,98,22.04.2019 02:05,148,14,Poltava
432,418,37,169,227,36,263,0,263,4,204,55,21.04.2019 21:25,148,14,Poltava
1024,1002,76,475,479,70,549,0,549,9,482,58,22.04.2019 00:55,148,14,Poltava
224,216,18,95,113,16,129,0,129,1,108,20,22.04.2019 00:15,148,14,Poltava
128,127,11,41,78,9,87,0,87,4,65,18,22.04.2019 00:25,148,14,Poltava
704,686,36,296,372,36,408,0,408,13,308,87,22.04.2019 00:15,148,14,Poltava
432,415,25,176,232,24,256,0,256,8,197,51,22.04.2019 00:30,148,14,Poltava
1088,1074,62,407,622,59,681,0,681,18,546,117,22.04.2019 00:30,148,14,Poltava
160,153,19,66,77,17,94,0,94,3,71,20,22.04.2019 00:20,148,14,Poltava
496,484,24,157,318,21,339,0,339,6,298,35,22.04.2019 00:45,148,14,Poltava
176,168,30,77,70,29,99,0,99,1,72,26,22.04.2019 00:30,148,14,Poltava
320,319,19,107,196,17,213,0,213,4,180,29,22.04.2019 00:20,148,14,Poltava
192,187,16,68,109,15,124,0,124,2,95,27,22.04.2019 00:10,148,14,Poltava
368,359,35,134,200,34,234,0,234,4,191,39,22.04.2019 00:15,148,14,Poltava
928,907,25,377,529,22,551,0,551,4,453,94,22.04.2019 02:05,148,14,Poltava
672,652,7,289,376,7,383,0,383,13,324,46,22.04.2019 00:05,148,14,Poltava
208,206,16,75,117,16,133,0,133,4,103,26,22.04.2019 00:45,148,14,Poltava
608,590,36,241,333,34,367,0,367,9,298,60,22.04.2019 01:30,148,14,Poltava
208,206,9,84,115,9,124,0,124,6,99,19,22.04.2019 00:15,148,14,Poltava
608,586,43,197,371,40,411,0,411,17,314,80,22.04.2019 00:02,148,14,Poltava
144,138,15,41,92,11,103,0,103,6,65,32,22.04.2019 01:30,148,14,Poltava
384,366,34,76,281,27,308,0,308,5,263,40,22.04.2019 00:02,148,14,Poltava
352,350,38,136,183,33,216,0,216,4,180,32,22.04.2019 01:25,148,14,Poltava
368,353,17,132,219,17,236,0,236,6,189,41,22.04.2019 00:45,148,14,Poltava
1904,1872,31,740,1137,27,1164,0,1164,31,951,182,22.04.2019 00:42,148,14,Poltava
1168,1159,16,475,680,13,693,0,693,26,522,145,22.04.2019 00:05,148,14,Poltava
224,224,6,54,166,4,170,0,170,1,124,45,22.04.2019 00:02,148,14,Poltava
1408,1391,40,551,830,27,857,0,857,20,654,183,22.04.2019 02:25,148,14,Poltava
800,779,108,281,424,95,519,0,519,9,402,108,21.04.2019 21:50,148,14,Poltava
688,666,49,271,372,45,417,0,417,11,319,87,22.04.2019 00:07,148,14,Poltava
1024,1001,44,397,588,39,627,0,627,15,519,93,22.04.2019 02:43,148,14,Poltava
320,307,15,110,195,15,210,0,210,2,161,47,22.04.2019 01:00,148,14,Poltava
448,439,11,183,255,10,265,0,265,4,219,42,22.04.2019 00:10,148,14,Poltava
640,629,102,166,373,101,474,0,474,12,362,100,22.04.2019 00:45,148,14,Poltava
976,963,55,384,539,53,592,0,592,8,448,136,22.04.2019 00:30,148,14,Poltava
240,221,18,107,119,14,133,0,133,2,98,33,22.04.2019 00:25,148,14,Poltava
144,136,11,52,82,10,92,0,92,4,72,16,22.04.2019 01:30,148,14,Poltava
160,159,10,52,99,9,108,0,108,1,86,21,22.04.2019 00:05,148,14,Poltava
80,66,4,39,37,4,41,0,41,0,26,15,22.04.2019 01:15,148,14,Poltava
1008,994,43,382,585,41,626,0,626,21,512,93,22.04.2019 01:05,148,14,Poltava
880,864,63,368,450,62,512,0,512,9,447,56,22.04.2019 01:50,148,14,Poltava
384,379,25,114,248,22,270,0,270,3,203,64,22.04.2019 01:00,148,14,Poltava
160,154,8,58,94,8,102,0,102,0,78,24,22.04.2019 00:10,148,14,Poltava
640,623,18,249,374,17,391,0,391,4,322,65,22.04.2019 01:50,148,14,Poltava
496,477,28,191,281,24,305,0,305,7,247,51,22.04.2019 00:05,148,14,Poltava
240,229,10,87,145,8,153,0,153,3,137,13,22.04.2019 00:01,148,14,Poltava
416,408,32,165,222,29,251,0,251,3,185,63,22.04.2019 00:20,148,14,Poltava
560,546,24,154,382,24,406,0,406,6,318,82,22.04.2019 00:20,148,14,Poltava
624,602,59,177,389,58,447,0,447,10,350,87,22.04.2019 00:30,148,14,Poltava
544,536,49,171,324,49,373,0,373,8,332,33,22.04.2019 02:15,148,14,Poltava
464,450,22,189,255,20,275,0,275,4,206,65,22.04.2019 00:20,148,14,Poltava
528,518,25,124,381,23,404,0,404,4,332,68,22.04.2019 02:40,148,14,Poltava
528,516,45,181,305,42,347,0,347,2,256,89,22.04.2019 00:30,148,14,Poltava
176,174,18,48,111,17,128,0,128,1,114,13,22.04.2019 00:12,148,14,Poltava
192,187,10,52,132,8,140,0,140,0,126,14,22.04.2019 00:02,148,14,Poltava
736,721,75,259,403,74,477,0,477,9,393,75,22.04.2019 01:05,148,14,Poltava
256,234,5,98,153,5,158,0,158,5,122,31,21.04.2019 20:40,148,14,Poltava
512,504,64,176,273,63,336,0,336,10,264,62,22.04.2019 00:40,148,14,Poltava
688,678,70,246,372,70,442,0,442,12,337,93,22.04.2019 00:05,148,14,Poltava
448,431,31,190,231,27,258,0,258,5,197,56,22.04.2019 01:10,148,14,Poltava
512,494,55,198,264,50,314,0,314,6,223,85,22.04.2019 00:20,148,14,Poltava
352,337,37,131,185,36,221,0,221,5,168,48,22.04.2019 01:20,148,14,Poltava
752,733,55,345,361,46,407,0,407,11,336,60,22.04.2019 00:15,148,14,Poltava
816,790,67,298,454,64,518,0,518,21,414,83,22.04.2019 02:38,148,14,Poltava
464,457,47,188,230,46,276,0,276,10,211,55,22.04.2019 00:03,148,14,Poltava
80,76,0,31,49,0,49,0,49,3,36,10,22.04.2019 00:14,148,14,Poltava
96,93,8,44,44,8,52,0,52,1,44,7,22.04.2019 00:10,148,14,Poltava
352,342,15,74,265,13,278,0,278,3,235,40,22.04.2019 01:45,148,14,Poltava
128,116,4,35,90,3,93,0,93,0,79,14,22.04.2019 00:18,148,14,Poltava
448,439,35,196,220,32,252,0,252,5,182,65,22.04.2019 00:30,148,14,Poltava
160,154,13,36,113,11,124,0,124,3,104,17,22.04.2019 00:15,148,14,Poltava
432,425,45,176,212,44,256,0,256,4,176,76,22.04.2019 00:30,148,14,Poltava
704,692,67,269,368,67,435,0,435,6,356,73,22.04.2019 00:01,148,14,Poltava
240,224,21,73,146,21,167,0,167,5,109,53,22.04.2019 01:00,148,14,Poltava
208,198,7,78,124,6,130,0,130,4,102,24,22.04.2019 00:40,148,14,Poltava
320,313,19,115,188,17,205,0,205,12,150,43,22.04.2019 00:32,148,14,Poltava
112,111,16,36,61,15,76,0,76,5,56,15,22.04.2019 00:50,148,14,Poltava
976,946,99,391,486,99,585,0,585,7,434,144,22.04.2019 01:15,148,14,Poltava
528,510,46,217,267,44,311,0,311,4,216,91,22.04.2019 03:05,148,14,Poltava
192,178,15,82,99,11,110,0,110,1,77,32,22.04.2019 00:05,148,14,Poltava
528,521,40,183,307,38,345,0,345,3,277,65,22.04.2019 00:20,148,14,Poltava
192,178,3,79,111,2,113,0,113,0,84,29,21.04.2019 23:15,148,14,Poltava
464,454,43,187,235,42,277,0,277,11,206,60,22.04.2019 00:25,148,14,Poltava
160,149,27,57,78,25,103,0,103,2,86,15,21.04.2019 23:45,148,14,Poltava
304,296,17,118,170,16,186,0,186,2,137,47,22.04.2019 00:30,148,14,Poltava
320,313,30,99,199,22,221,0,221,3,196,22,22.04.2019 00:15,148,14,Poltava
128,120,9,31,88,9,97,0,97,0,88,9,22.04.2019 01:25,148,14,Poltava
528,518,57,216,256,56,312,0,312,7,221,84,22.04.2019 00:10,148,14,Poltava
192,190,19,66,111,15,126,0,126,4,100,22,22.04.2019 00:30,148,14,Poltava
176,178,20,22,134,20,154,0,154,6,108,40,22.04.2019 00:24,148,14,Poltava
272,265,21,112,141,19,160,0,160,2,115,43,22.04.2019 00:15,148,14,Poltava
464,451,30,189,248,27,275,0,275,2,220,53,22.04.2019 00:12,148,14,Poltava
336,314,15,138,184,14,198,0,198,6,154,38,22.04.2019 01:15,148,14,Poltava
144,142,4,70,70,4,74,0,74,2,46,26,22.04.2019 00:50,148,14,Poltava
240,229,11,103,126,11,137,0,137,0,111,26,22.04.2019 00:45,148,14,Poltava
144,133,1,40,103,1,104,0,104,1,72,31,22.04.2019 01:30,148,14,Poltava
272,261,29,82,162,28,190,0,190,3,149,38,22.04.2019 00:45,148,14,Poltava
1456,1428,18,537,902,17,919,0,919,25,765,129,22.04.2019 00:35,148,14,Poltava
2208,2175,43,908,1261,39,1300,0,1300,27,1079,194,22.04.2019 00:45,148,14,Poltava
1776,1729,45,643,1090,43,1133,0,1133,28,925,180,22.04.2019 00:25,148,14,Poltava
128,25,7,106,15,7,22,0,22,0,18,4,21.04.2019 21:20,148,14,Poltava
1680,1667,97,542,1044,94,1138,0,1138,22,923,193,22.04.2019 00:15,148,14,Poltava
1760,1735,28,617,1116,27,1143,0,1143,28,950,165,22.04.2019 02:13,148,14,Poltava
1904,1887,27,660,1225,19,1244,0,1244,32,1065,147,22.04.2019 00:15,148,14,Poltava
1248,1217,16,479,755,14,769,0,769,14,639,116,22.04.2019 00:15,148,14,Poltava
1872,1847,17,658,1200,14,1214,0,1214,26,992,196,22.04.2019 02:45,148,14,Poltava
1280,1255,16,479,785,16,801,0,801,8,660,133,22.04.2019 03:00,148,14,Poltava
1120,1099,8,460,655,5,660,0,660,20,548,92,22.04.2019 01:15,148,14,Poltava
560,559,23,226,311,23,334,0,334,6,280,48,22.04.2019 01:30,148,14,Poltava
208,206,15,41,152,15,167,0,167,4,134,29,22.04.2019 00:50,148,14,Poltava
304,302,24,98,182,24,206,0,206,2,164,40,22.04.2019 00:15,148,14,Poltava
496,481,56,167,280,49,329,0,329,3,271,55,22.04.2019 00:25,148,14,Poltava
1600,1567,169,559,891,150,1041,0,1041,33,841,167,22.04.2019 00:45,148,14,Poltava
96,79,4,22,70,4,74,0,74,1,60,13,22.04.2019 00:10,148,14,Poltava
96,83,11,44,41,11,52,0,52,3,37,12,21.04.2019 21:40,148,14,Poltava
128,127,10,27,92,9,101,0,101,0,81,20,22.04.2019 00:05,148,14,Poltava
320,321,15,126,185,9,194,0,194,4,176,14,22.04.2019 00:15,148,14,Poltava
704,682,60,267,380,57,437,0,437,4,371,62,21.04.2019 21:10,148,14,Poltava
368,361,24,137,210,21,231,0,231,2,199,30,21.04.2019 23:00,148,14,Poltava
528,511,49,151,331,46,377,0,377,6,310,61,22.04.2019 00:20,148,14,Poltava
272,265,24,82,169,21,190,0,190,3,168,19,22.04.2019 00:15,148,14,Poltava
704,679,72,253,382,69,451,0,451,6,385,60,22.04.2019 00:40,148,14,Poltava
432,430,48,155,235,42,277,0,277,4,232,41,21.04.2019 22:50,148,14,Poltava
736,723,47,243,454,39,493,0,493,7,398,88,22.04.2019 01:20,148,14,Poltava
384,377,45,101,239,44,283,0,283,2,236,45,22.04.2019 00:40,148,14,Poltava
288,280,16,89,183,16,199,0,199,5,173,21,22.04.2019 01:15,148,14,Poltava
160,158,12,38,110,12,122,0,122,1,106,15,22.04.2019 01:20,148,14,Poltava
336,323,34,103,202,31,233,0,233,2,195,36,22.04.2019 00:50,148,14,Poltava
416,408,35,102,279,35,314,0,314,9,270,35,22.04.2019 01:03,148,14,Poltava
320,318,32,62,226,32,258,0,258,2,227,29,22.04.2019 00:15,148,14,Poltava
944,938,92,339,515,90,605,0,605,19,491,95,22.04.2019 00:05,148,14,Poltava
368,355,18,115,239,14,253,0,253,4,210,39,22.04.2019 00:05,148,14,Poltava
336,329,27,103,208,25,233,0,233,5,180,48,22.04.2019 00:11,148,14,Poltava
80,74,7,15,58,7,65,0,65,1,45,19,22.04.2019 00:05,148,14,Poltava
208,193,11,52,145,11,156,0,156,0,123,33,22.04.2019 00:20,148,14,Poltava
272,256,4,143,125,4,129,0,129,2,107,20,22.04.2019 00:10,148,14,Poltava
384,371,11,135,239,10,249,0,249,3,198,48,22.04.2019 02:23,148,14,Poltava
160,145,8,42,111,7,118,0,118,0,104,14,22.04.2019 00:20,148,14,Poltava
496,481,64,169,271,56,327,0,327,3,252,72,21.04.2019 22:45,148,14,Poltava
160,157,5,73,82,5,87,0,87,0,69,18,22.04.2019 00:40,148,14,Poltava
464,451,32,163,272,29,301,0,301,5,255,41,22.04.2019 00:20,148,14,Poltava
560,552,55,199,308,53,361,0,361,6,292,63,22.04.2019 00:05,148,14,Poltava
176,163,12,34,130,12,142,0,142,1,107,34,22.04.2019 00:25,148,14,Poltava
960,947,42,406,512,42,554,0,554,9,472,73,22.04.2019 00:35,148,14,Poltava
176,173,8,49,119,8,127,0,127,3,89,35,22.04.2019 00:10,148,14,Poltava
112,105,5,40,68,4,72,0,72,1,56,15,21.04.2019 21:20,148,14,Poltava
480,467,25,171,284,25,309,0,309,7,260,42,22.04.2019 00:25,148,14,Poltava
304,295,23,134,149,21,170,0,170,3,121,46,21.04.2019 22:50,148,14,Poltava
224,210,11,81,132,11,143,0,143,3,121,19,22.04.2019 00:15,148,14,Poltava
160,158,16,78,72,10,82,0,82,2,68,12,22.04.2019 00:45,148,14,Poltava
384,382,56,116,219,49,268,0,268,7,225,36,22.04.2019 02:00,148,14,Poltava
1968,1931,12,647,1313,8,1321,0,1321,44,1048,228,22.04.2019 00:05,148,14,Poltava
1888,1893,13,646,1232,10,1242,0,1242,30,1046,166,22.04.2019 00:07,148,14,Poltava
1792,1762,14,654,1125,13,1138,0,1138,29,925,184,22.04.2019 00:40,148,14,Poltava
1984,1978,23,657,1308,19,1327,0,1327,51,1067,209,22.04.2019 00:07,148,14,Poltava
1808,1801,33,661,1122,25,1147,0,1147,28,919,200,22.04.2019 01:20,148,14,Poltava
1904,1901,21,741,1143,20,1163,0,1163,36,925,202,22.04.2019 00:20,148,14,Poltava
1904,1873,15,701,1190,13,1203,0,1203,32,946,225,22.04.2019 00:30,148,14,Poltava
1808,1784,13,700,1099,9,1108,0,1108,37,872,199,22.04.2019 00:30,148,14,Poltava
1856,1816,18,642,1201,13,1214,0,1214,23,957,234,22.04.2019 00:10,148,14,Poltava
2000,1962,28,750,1226,24,1250,0,1250,36,993,221,22.04.2019 00:40,148,14,Poltava
2112,2070,23,760,1333,19,1352,0,1352,32,1101,219,22.04.2019 00:12,148,14,Poltava
1872,1863,12,682,1180,10,1190,0,1190,37,949,204,22.04.2019 00:30,148,14,Poltava
1808,1788,58,672,1086,50,1136,0,1136,30,916,190,22.04.2019 00:30,148,14,Poltava
1808,1789,12,720,1077,11,1088,0,1088,18,909,161,22.04.2019 01:30,148,14,Poltava
1984,1958,15,785,1187,12,1199,0,1199,28,1001,170,22.04.2019 00:45,148,14,Poltava
1840,1805,8,710,1124,6,1130,0,1130,30,922,178,22.04.2019 00:10,148,14,Poltava
1968,1946,13,735,1222,11,1233,0,1233,29,1017,187,22.04.2019 00:50,148,14,Poltava
1856,1821,16,678,1167,11,1178,0,1178,42,932,204,22.04.2019 00:09,148,14,Poltava
1968,1967,25,774,1172,22,1194,0,1194,27,964,203,22.04.2019 00:50,148,14,Poltava
2000,1926,17,797,1187,16,1203,0,1203,24,1028,151,22.04.2019 00:30,148,14,Poltava
2096,2083,20,813,1265,18,1283,0,1283,29,1063,191,22.04.2019 00:15,149,14,Poltava
1824,1790,28,726,1073,25,1098,0,1098,20,929,149,22.04.2019 00:38,149,14,Poltava
2048,2022,18,863,1169,16,1185,0,1185,29,992,164,22.04.2019 00:10,149,14,Poltava
1936,1900,13,908,1018,10,1028,0,1028,28,863,137,22.04.2019 00:10,149,14,Poltava
2400,2365,17,1063,1321,16,1337,0,1337,30,1163,144,22.04.2019 00:15,149,14,Poltava
1584,1558,11,765,809,10,819,0,819,11,722,86,22.04.2019 00:30,149,14,Poltava
1968,1938,13,833,1122,13,1135,0,1135,24,996,115,21.04.2019 21:30,149,14,Poltava
944,921,82,371,497,76,573,0,573,7,501,65,22.04.2019 00:20,149,14,Poltava
928,922,32,461,439,28,467,0,467,11,405,51,21.04.2019 21:55,149,14,Poltava
1136,1126,46,482,608,46,654,0,654,5,593,56,21.04.2019 22:10,149,14,Poltava
608,592,45,210,357,41,398,0,398,2,332,64,22.04.2019 00:35,149,14,Poltava
2288,2264,76,976,1247,65,1312,0,1312,18,1205,89,22.04.2019 00:10,149,14,Poltava
368,355,15,126,227,15,242,0,242,1,182,59,22.04.2019 00:30,149,14,Poltava
592,577,30,218,345,29,374,0,374,5,333,36,22.04.2019 00:30,149,14,Poltava
1472,1455,51,624,806,42,848,0,848,11,738,99,22.04.2019 00:50,149,14,Poltava
864,849,31,346,491,27,518,0,518,7,457,54,22.04.2019 00:15,149,14,Poltava
864,843,68,349,455,60,515,0,515,10,451,54,22.04.2019 00:04,149,14,Poltava
1056,1024,33,496,528,32,560,0,560,10,483,67,22.04.2019 00:28,149,14,Poltava
688,658,53,271,366,51,417,0,417,6,365,46,22.04.2019 00:10,149,14,Poltava
912,889,49,405,460,47,507,0,507,3,460,44,22.04.2019 00:05,149,14,Poltava
400,381,10,133,257,10,267,0,267,5,222,40,22.04.2019 02:10,149,14,Poltava
1152,1122,61,495,600,57,657,0,657,7,617,33,22.04.2019 00:15,149,14,Poltava
448,426,1,242,205,1,206,0,206,5,187,14,22.04.2019 01:10,149,14,Poltava
576,574,41,220,316,40,356,0,356,11,296,49,21.04.2019 22:50,149,14,Poltava
720,702,38,307,379,34,413,0,413,7,353,53,22.04.2019 00:30,149,14,Poltava
1424,1412,44,544,845,35,880,0,880,17,780,83,21.04.2019 21:34,149,14,Poltava
784,777,53,330,411,43,454,0,454,5,402,47,22.04.2019 00:05,149,14,Poltava
480,476,26,178,280,22,302,0,302,4,267,31,21.04.2019 22:04,149,14,Poltava
272,255,14,77,181,14,195,0,195,2,155,38,22.04.2019 02:00,149,14,Poltava
464,452,17,199,248,17,265,0,265,5,232,28,21.04.2019 22:00,149,14,Poltava
576,563,42,182,352,42,394,0,394,3,345,46,21.04.2019 20:50,149,14,Poltava
1120,1111,84,338,704,78,782,0,782,6,701,75,22.04.2019 01:20,149,14,Poltava
736,727,75,276,385,75,460,0,460,4,391,65,21.04.2019 20:42,149,14,Poltava
224,218,28,73,123,28,151,0,151,3,131,17,21.04.2019 20:40,149,14,Poltava
208,195,19,90,101,17,118,0,118,2,97,19,22.04.2019 00:05,149,14,Poltava
352,341,32,150,172,30,202,0,202,0,179,23,21.04.2019 21:05,149,14,Poltava
272,263,12,108,152,12,164,0,164,3,135,26,21.04.2019 20:45,149,14,Poltava
512,494,35,172,305,35,340,0,340,9,279,52,21.04.2019 21:15,149,14,Poltava
320,316,33,98,189,33,222,0,222,3,187,32,21.04.2019 21:40,149,14,Poltava
224,219,28,53,146,25,171,0,171,1,151,19,22.04.2019 01:20,149,14,Poltava
512,497,43,200,270,42,312,0,312,1,270,41,21.04.2019 20:40,149,14,Poltava
512,504,22,181,309,22,331,0,331,5,295,31,21.04.2019 21:05,149,14,Poltava
304,295,27,90,191,23,214,0,214,1,187,26,21.04.2019 20:39,149,14,Poltava
304,302,20,96,191,17,208,0,208,5,178,25,22.04.2019 00:05,149,14,Poltava
128,114,10,45,73,10,83,0,83,0,74,9,21.04.2019 20:50,149,14,Poltava
448,441,57,128,266,54,320,0,320,12,274,34,21.04.2019 20:40,149,14,Poltava
560,544,58,229,277,54,331,0,331,5,294,32,21.04.2019 22:00,149,14,Poltava
480,468,52,208,225,47,272,0,272,3,208,61,22.04.2019 00:05,149,14,Poltava
704,686,53,285,373,46,419,0,419,8,358,53,21.04.2019 20:55,149,14,Poltava
448,442,45,146,265,37,302,0,302,5,263,34,22.04.2019 00:10,149,14,Poltava
320,314,22,94,206,20,226,0,226,3,183,40,22.04.2019 00:40,149,14,Poltava
240,222,17,67,157,16,173,0,173,11,143,19,21.04.2019 20:52,149,14,Poltava
192,178,10,59,123,10,133,0,133,2,109,22,21.04.2019 20:30,149,14,Poltava
1616,1580,21,549,1047,20,1067,0,1067,7,884,176,22.04.2019 01:15,149,14,Poltava
1248,1240,23,459,775,14,789,0,789,12,684,93,22.04.2019 01:25,149,14,Poltava
1456,1445,32,472,956,28,984,0,984,15,815,154,21.04.2019 21:50,149,14,Poltava
1456,1436,28,476,959,21,980,0,980,23,822,135,22.04.2019 00:15,149,14,Poltava
1840,1816,33,645,1163,32,1195,0,1195,17,1005,173,22.04.2019 00:35,149,14,Poltava
1360,1338,20,490,856,14,870,0,870,24,699,147,22.04.2019 01:45,149,14,Poltava
432,418,57,123,255,54,309,0,309,17,247,45,21.04.2019 21:05,149,14,Poltava
224,218,21,28,175,21,196,0,196,3,155,38,22.04.2019 02:30,149,14,Poltava
208,200,20,22,166,20,186,0,186,0,134,52,21.04.2019 20:45,149,14,Poltava
720,697,85,238,403,79,482,0,482,11,391,80,22.04.2019 00:02,149,14,Poltava
720,698,72,316,337,67,404,0,404,9,358,37,22.04.2019 01:30,149,14,Poltava
336,323,26,124,193,19,212,0,212,3,177,32,21.04.2019 23:05,149,14,Poltava
96,87,8,37,53,6,59,0,59,1,48,10,21.04.2019 20:49,149,14,Poltava
416,412,28,117,275,24,299,0,299,3,276,20,22.04.2019 00:10,149,14,Poltava
432,425,27,171,237,24,261,0,261,4,214,43,22.04.2019 00:05,149,14,Poltava
864,847,60,380,428,56,484,0,484,12,401,71,21.04.2019 21:30,149,14,Poltava
320,310,39,165,120,35,155,0,155,5,116,34,22.04.2019 00:10,149,14,Poltava
1136,1111,70,423,651,62,713,0,713,21,625,67,22.04.2019 00:25,149,14,Poltava
528,509,53,204,278,46,324,0,324,3,286,35,22.04.2019 03:00,149,14,Poltava
1184,1164,43,490,661,33,694,0,694,9,607,78,22.04.2019 00:05,149,14,Poltava
2080,2038,114,915,1054,111,1165,0,1165,34,989,142,21.04.2019 22:00,149,14,Poltava
112,107,13,42,57,13,70,0,70,0,52,18,21.04.2019 21:15,149,14,Poltava
224,217,34,82,111,31,142,0,142,2,107,33,22.04.2019 00:45,149,14,Poltava
464,462,56,197,216,51,267,0,267,20,202,45,22.04.2019 00:15,149,14,Poltava
352,344,52,125,183,44,227,0,227,7,193,27,21.04.2019 21:06,149,14,Poltava
480,467,63,154,263,63,326,0,326,7,291,28,22.04.2019 00:05,149,14,Poltava
464,460,54,179,247,38,285,0,285,4,198,83,22.04.2019 00:05,149,14,Poltava
528,519,31,179,318,31,349,0,349,3,317,29,22.04.2019 00:10,149,14,Poltava
160,149,16,54,91,15,106,0,106,0,91,15,21.04.2019 20:45,149,14,Poltava
256,47,28,226,15,15,30,0,30,1,26,3,22.04.2019 00:10,149,14,Poltava
1968,1954,29,747,1192,29,1221,0,1221,30,957,234,22.04.2019 01:15,149,14,Poltava
1328,1312,44,571,713,44,757,0,757,9,621,127,22.04.2019 00:20,149,14,Poltava
336,334,8,147,181,8,189,0,189,5,156,28,22.04.2019 04:00,149,14,Poltava
1216,1202,30,519,670,27,697,0,697,8,543,146,22.04.2019 00:45,149,14,Poltava
1072,1063,11,463,598,11,609,0,609,9,495,105,22.04.2019 00:30,149,14,Poltava
880,870,58,402,420,58,478,0,478,13,385,80,21.04.2019 23:20,149,14,Poltava
352,334,23,131,199,22,221,0,221,3,189,29,22.04.2019 00:10,149,14,Poltava
192,189,9,79,104,9,113,0,113,1,85,27,21.04.2019 21:30,149,14,Poltava
368,360,22,134,212,22,234,0,234,3,192,39,21.04.2019 22:04,149,14,Poltava
224,213,15,77,132,15,147,0,147,3,126,18,22.04.2019 00:25,149,14,Poltava
128,110,5,58,65,5,70,0,70,2,55,13,21.04.2019 21:00,149,14,Poltava
304,286,14,113,177,14,191,0,191,3,155,33,21.04.2019 21:25,149,14,Poltava
1360,1360,31,527,802,31,833,0,833,16,691,126,22.04.2019 00:45,149,14,Poltava
320,314,43,120,157,43,200,0,200,5,147,48,21.04.2019 21:20,149,14,Poltava
528,517,53,197,278,53,331,0,331,4,249,78,22.04.2019 00:30,149,14,Poltava
272,262,15,117,140,15,155,0,155,1,115,39,21.04.2019 22:00,149,14,Poltava
400,390,44,125,233,42,275,0,275,7,213,55,21.04.2019 23:50,149,14,Poltava
176,161,18,78,81,17,98,0,98,3,85,10,21.04.2019 23:15,149,14,Poltava
512,501,38,206,271,35,306,0,306,2,215,89,21.04.2019 21:10,149,14,Poltava
480,474,32,200,248,32,280,0,280,5,196,79,21.04.2019 21:25,149,14,Poltava
560,552,43,224,295,41,336,0,336,9,278,49,22.04.2019 01:10,149,14,Poltava
480,465,25,163,292,25,317,0,317,4,276,37,22.04.2019 00:50,149,14,Poltava
272,267,16,81,176,15,191,0,191,4,116,71,22.04.2019 02:20,149,14,Poltava
304,295,24,140,147,17,164,0,164,2,142,20,22.04.2019 00:35,149,14,Poltava
704,701,28,318,360,26,386,0,386,2,318,66,22.04.2019 00:05,149,14,Poltava
576,582,43,210,324,42,366,0,366,12,256,98,21.04.2019 22:00,149,14,Poltava
96,93,9,36,51,9,60,0,60,4,38,18,21.04.2019 21:00,149,14,Poltava
480,475,15,199,266,15,281,0,281,4,226,51,21.04.2019 20:45,149,14,Poltava
1392,1369,27,526,845,21,866,0,866,13,698,155,22.04.2019 00:25,149,14,Poltava
1680,1659,24,574,1083,23,1106,0,1106,28,881,197,22.04.2019 00:20,149,14,Poltava
288,281,4,112,172,4,176,0,176,3,148,25,21.04.2019 20:52,149,14,Poltava
400,382,17,172,211,17,228,0,228,4,166,58,22.04.2019 00:10,149,14,Poltava
128,123,2,57,69,2,71,0,71,0,52,19,22.04.2019 00:15,149,14,Poltava
656,649,21,214,421,21,442,0,442,8,373,61,22.04.2019 00:30,149,14,Poltava
448,435,34,178,236,34,270,0,270,3,208,59,22.04.2019 00:05,149,14,Poltava
224,212,11,97,116,11,127,0,127,0,104,23,22.04.2019 00:15,149,14,Poltava
448,429,24,178,246,24,270,0,270,5,236,29,21.04.2019 22:10,149,14,Poltava
1504,1480,67,514,928,62,990,0,990,14,891,85,22.04.2019 00:10,149,14,Poltava
192,188,18,69,107,16,123,0,123,3,103,17,21.04.2019 20:50,149,14,Poltava
1008,988,31,438,542,28,570,0,570,3,516,51,22.04.2019 00:10,149,14,Poltava
384,369,21,109,254,21,275,0,275,3,249,23,21.04.2019 23:05,149,14,Poltava
864,849,21,290,554,20,574,0,574,6,501,67,22.04.2019 00:15,149,14,Poltava
128,118,6,42,80,6,86,0,86,0,75,11,22.04.2019 00:12,149,14,Poltava
144,132,11,45,88,11,99,0,99,2,78,19,22.04.2019 00:30,149,14,Poltava
144,139,11,33,100,11,111,0,111,0,90,21,22.04.2019 00:04,149,14,Poltava
400,385,30,144,227,29,256,0,256,2,228,26,22.04.2019 00:15,149,14,Poltava
208,194,25,94,93,21,114,0,114,2,102,10,22.04.2019 00:15,149,14,Poltava
352,340,39,100,213,39,252,0,252,2,222,28,22.04.2019 00:25,149,14,Poltava
704,691,34,258,419,27,446,0,446,4,392,50,22.04.2019 01:27,149,14,Poltava
496,488,37,245,218,33,251,0,251,10,189,52,22.04.2019 00:05,149,14,Poltava
1728,1709,50,657,1025,46,1071,0,1071,22,919,130,22.04.2019 00:18,149,14,Poltava
800,795,18,288,495,17,512,0,512,6,451,55,22.04.2019 00:03,149,14,Poltava
208,199,5,83,120,5,125,0,125,1,112,12,22.04.2019 00:10,149,14,Poltava
224,210,11,103,110,11,121,0,121,3,94,24,22.04.2019 00:30,149,14,Poltava
240,224,19,102,123,15,138,0,138,0,117,21,22.04.2019 00:05,149,14,Poltava
144,121,0,27,117,0,117,0,117,5,107,5,22.04.2019 00:05,149,14,Poltava
1616,1595,46,577,1000,39,1039,0,1039,21,854,164,22.04.2019 01:13,149,14,Poltava
800,798,26,286,491,23,514,0,514,7,420,87,22.04.2019 00:19,149,14,Poltava
1632,1608,26,588,1022,22,1044,0,1044,18,880,146,22.04.2019 00:30,149,14,Poltava
1360,1340,31,492,839,29,868,0,868,18,723,127,22.04.2019 04:10,149,14,Poltava
624,620,17,255,354,15,369,0,369,7,302,60,22.04.2019 00:15,149,14,Poltava
176,167,22,42,115,19,134,0,134,0,118,16,22.04.2019 00:15,149,14,Poltava
144,129,15,58,74,12,86,0,86,0,82,4,22.04.2019 01:20,149,14,Poltava
432,422,35,172,227,33,260,0,260,6,219,35,22.04.2019 02:48,149,14,Poltava
288,284,48,105,145,38,183,0,183,2,138,43,22.04.2019 00:50,149,14,Poltava
352,333,23,146,185,21,206,0,206,3,190,13,21.04.2019 23:50,149,14,Poltava
192,186,19,40,133,19,152,0,152,4,122,26,22.04.2019 00:05,149,14,Poltava
256,252,18,69,173,14,187,0,187,5,163,19,22.04.2019 00:29,149,14,Poltava
176,171,19,44,115,17,132,0,132,1,117,14,22.04.2019 00:02,149,14,Poltava
848,832,86,214,554,80,634,0,634,11,562,61,22.04.2019 01:15,149,14,Poltava
96,87,8,28,60,8,68,0,68,2,60,6,22.04.2019 00:05,149,14,Poltava
48,39,3,14,32,2,34,0,34,4,28,2,22.04.2019 00:05,149,14,Poltava
688,684,32,291,367,30,397,0,397,5,357,35,22.04.2019 00:05,149,14,Poltava
384,376,34,149,205,30,235,0,235,3,186,46,22.04.2019 00:03,149,14,Poltava
560,552,86,198,283,79,362,0,362,8,310,44,22.04.2019 00:51,149,14,Poltava
576,560,39,214,331,31,362,0,362,1,322,39,22.04.2019 00:30,149,14,Poltava
96,94,7,24,66,6,72,0,72,3,67,2,22.04.2019 00:23,149,14,Poltava
128,121,22,23,85,20,105,0,105,0,102,3,22.04.2019 00:15,149,14,Poltava
224,214,14,74,137,13,150,0,150,1,131,18,22.04.2019 00:05,149,14,Poltava
128,112,16,51,62,15,77,0,77,0,68,9,22.04.2019 00:45,149,14,Poltava
1136,1128,72,403,687,46,733,0,733,17,633,83,22.04.2019 01:30,149,14,Poltava
336,330,34,106,196,34,230,0,230,3,192,35,22.04.2019 00:05,149,14,Poltava
368,370,51,132,190,46,236,0,236,3,199,34,22.04.2019 01:15,149,14,Poltava
800,780,60,250,497,53,550,0,550,7,481,62,22.04.2019 00:15,149,14,Poltava
1344,1324,50,575,725,44,769,0,769,8,692,69,22.04.2019 00:15,149,14,Poltava
576,560,32,208,340,28,368,0,368,5,320,43,22.04.2019 00:07,149,14,Poltava
528,524,59,198,281,49,330,0,330,5,283,42,22.04.2019 00:15,149,14,Poltava
1600,1565,41,605,955,40,995,0,995,15,886,94,22.04.2019 00:21,149,14,Poltava
432,427,38,151,246,35,281,0,281,7,222,52,21.04.2019 21:00,149,14,Poltava
384,370,25,159,201,24,225,0,225,2,198,25,22.04.2019 00:15,149,14,Poltava
496,485,46,177,276,43,319,0,319,3,259,57,21.04.2019 22:00,149,14,Poltava
224,218,21,96,113,15,128,0,128,1,109,18,22.04.2019 00:05,149,14,Poltava
1824,1797,65,712,1058,54,1112,0,1112,21,1006,85,22.04.2019 00:05,149,14,Poltava
432,415,31,173,233,26,259,0,259,8,207,44,22.04.2019 00:02,149,14,Poltava
192,181,15,89,90,13,103,0,103,2,81,20,22.04.2019 00:30,149,14,Poltava
720,710,31,227,467,26,493,0,493,4,419,70,22.04.2019 00:30,149,14,Poltava
400,389,21,123,257,20,277,0,277,4,210,63,22.04.2019 00:04,149,14,Poltava
432,417,32,192,213,27,240,0,240,1,208,31,22.04.2019 00:10,149,14,Poltava
432,413,16,181,238,13,251,0,251,6,215,30,21.04.2019 23:50,149,14,Poltava
544,539,58,199,291,54,345,0,345,7,281,57,22.04.2019 00:05,149,14,Poltava
352,352,25,116,211,25,236,0,236,5,195,36,22.04.2019 00:35,149,14,Poltava
192,189,16,71,106,15,121,0,121,3,101,17,21.04.2019 23:30,149,14,Poltava
128,127,11,47,71,10,81,0,81,2,76,3,22.04.2019 00:15,149,14,Poltava
544,540,60,165,323,56,379,0,379,2,333,44,22.04.2019 00:10,149,14,Poltava
352,342,37,123,194,35,229,0,229,10,193,26,22.04.2019 00:18,149,14,Poltava
1600,1582,48,675,885,40,925,0,925,16,810,99,22.04.2019 00:35,149,14,Poltava
1296,1283,23,539,735,22,757,0,757,14,665,78,22.04.2019 00:20,149,14,Poltava
448,434,57,162,232,54,286,0,286,4,245,37,22.04.2019 01:00,149,14,Poltava
880,861,48,324,516,40,556,0,556,12,491,53,22.04.2019 00:05,149,14,Poltava
1488,1463,25,564,902,22,924,0,924,17,785,122,22.04.2019 00:05,149,14,Poltava
1536,1521,65,576,903,57,960,0,960,15,831,114,22.04.2019 00:10,149,14,Poltava
912,902,53,374,496,42,538,0,538,5,468,65,22.04.2019 00:25,149,14,Poltava
304,285,21,110,173,21,194,0,194,0,161,33,22.04.2019 00:10,149,14,Poltava
336,320,35,152,150,34,184,0,184,1,161,22,22.04.2019 00:05,149,14,Poltava
752,735,72,265,423,64,487,0,487,10,397,80,21.04.2019 21:30,149,14,Poltava
176,167,5,76,96,4,100,0,100,4,86,10,21.04.2019 20:30,149,14,Poltava
448,436,60,134,256,58,314,0,314,4,267,43,22.04.2019 00:20,149,14,Poltava
496,487,57,175,267,54,321,0,321,1,271,49,22.04.2019 00:01,149,14,Poltava
384,364,26,104,257,23,280,0,280,4,250,26,22.04.2019 00:15,149,14,Poltava
288,280,37,83,169,36,205,0,205,3,178,24,22.04.2019 00:15,149,14,Poltava
512,497,49,189,282,41,323,0,323,2,278,43,22.04.2019 00:15,149,14,Poltava
336,322,38,111,193,32,225,0,225,4,194,27,22.04.2019 00:10,149,14,Poltava
304,301,38,99,169,36,205,0,205,2,168,35,22.04.2019 00:05,149,14,Poltava
336,321,41,82,215,39,254,0,254,5,221,28,21.04.2019 23:45,149,14,Poltava
624,604,44,269,314,41,355,0,355,1,315,39,22.04.2019 00:17,149,14,Poltava
192,176,25,68,102,22,124,0,124,3,110,11,22.04.2019 00:05,149,14,Poltava
208,200,17,72,120,16,136,0,136,0,125,11,22.04.2019 00:05,149,14,Poltava
624,614,65,234,329,61,390,0,390,4,334,52,22.04.2019 00:05,149,14,Poltava
848,832,84,284,490,74,564,0,564,9,515,40,22.04.2019 00:10,149,14,Poltava
1168,1155,48,482,644,42,686,0,686,11,610,65,22.04.2019 00:15,149,14,Poltava
640,627,56,233,355,52,407,0,407,5,363,39,22.04.2019 00:05,149,14,Poltava
624,612,41,235,348,41,389,0,389,9,343,37,22.04.2019 00:30,149,14,Poltava
96,96,5,43,48,5,53,0,53,0,46,7,21.04.2019 20:50,149,14,Poltava
1808,1772,18,766,1027,15,1042,0,1042,16,881,145,21.04.2019 22:55,150,14,Poltava
1728,1708,13,707,1010,11,1021,0,1021,24,836,161,22.04.2019 03:25,150,14,Poltava
1968,1928,18,767,1184,17,1201,0,1201,25,935,241,21.04.2019 23:25,150,14,Poltava
2272,2244,32,828,1421,23,1444,0,1444,35,1106,303,21.04.2019 21:15,150,14,Poltava
1792,1776,20,759,1014,19,1033,0,1033,19,862,152,22.04.2019 00:20,150,14,Poltava
368,365,13,135,220,13,233,0,233,2,176,55,21.04.2019 20:40,150,14,Poltava
480,470,26,228,226,26,252,0,252,2,200,50,21.04.2019 20:58,150,14,Poltava
1728,1711,36,852,845,31,876,0,876,18,731,127,21.04.2019 21:15,150,14,Poltava
2144,2115,60,1011,1083,50,1133,0,1133,23,946,164,21.04.2019 22:00,150,14,Poltava
2304,2280,49,929,1330,45,1375,0,1375,33,1117,225,21.04.2019 20:40,150,14,Poltava
592,586,24,219,349,24,373,0,373,8,289,76,21.04.2019 21:40,150,14,Poltava
528,506,43,210,275,43,318,0,318,6,248,64,21.04.2019 21:50,150,14,Poltava
368,362,32,136,205,27,232,0,232,11,177,44,21.04.2019 20:39,150,14,Poltava
1120,1098,72,424,625,71,696,0,696,18,531,147,21.04.2019 20:50,150,14,Poltava
224,217,21,61,142,21,163,0,163,0,128,35,21.04.2019 22:00,150,14,Poltava
224,203,17,109,101,14,115,0,115,3,78,34,21.04.2019 21:00,150,14,Poltava
1104,1085,49,452,605,47,652,0,652,7,561,84,21.04.2019 23:00,150,14,Poltava
576,566,62,209,305,62,367,0,367,6,305,56,21.04.2019 21:00,150,14,Poltava
608,589,47,193,370,45,415,0,415,4,358,53,22.04.2019 02:15,150,14,Poltava
688,672,53,278,358,52,410,0,410,6,321,83,21.04.2019 22:10,150,14,Poltava
416,393,47,106,263,47,310,0,310,2,285,23,21.04.2019 20:45,150,14,Poltava
368,367,24,112,232,24,256,0,256,2,208,46,21.04.2019 22:40,150,14,Poltava
160,143,13,59,89,12,101,0,101,2,80,19,21.04.2019 20:31,150,14,Poltava
352,354,22,111,220,21,241,0,241,4,157,80,21.04.2019 20:33,150,14,Poltava
352,340,22,113,218,21,239,0,239,7,190,42,22.04.2019 02:50,150,14,Poltava
256,236,33,80,147,29,176,0,176,5,144,27,21.04.2019 21:00,150,14,Poltava
480,472,30,171,281,28,309,0,309,3,265,41,21.04.2019 22:20,150,14,Poltava
640,618,32,260,348,32,380,0,380,7,338,35,21.04.2019 21:58,150,14,Poltava
1344,1325,54,517,775,52,827,0,827,24,717,86,21.04.2019 21:30,150,14,Poltava
496,477,29,171,296,29,325,0,325,2,289,34,21.04.2019 21:00,150,14,Poltava
288,276,4,133,151,4,155,0,155,4,134,17,21.04.2019 20:34,150,14,Poltava
176,164,15,61,100,15,115,0,115,0,99,16,21.04.2019 20:30,150,14,Poltava
432,415,31,193,211,28,239,0,239,3,201,35,21.04.2019 20:35,150,14,Poltava
112,102,9,49,56,7,63,0,63,1,55,7,21.04.2019 20:30,150,14,Poltava
736,718,42,283,421,32,453,0,453,15,375,63,21.04.2019 20:46,150,14,Poltava
192,174,14,68,112,12,124,0,124,1,114,9,21.04.2019 21:10,150,14,Poltava
656,651,31,244,385,27,412,0,412,9,372,31,21.04.2019 21:35,150,14,Poltava
560,551,29,208,326,26,352,0,352,11,270,71,21.04.2019 21:00,150,14,Poltava
496,478,36,169,292,35,327,0,327,5,251,71,21.04.2019 23:07,150,14,Poltava
112,108,9,39,64,9,73,0,73,0,59,14,21.04.2019 20:20,150,14,Poltava
624,615,28,283,315,26,341,0,341,8,279,54,22.04.2019 00:30,150,14,Poltava
304,290,10,89,206,9,215,0,215,2,188,25,22.04.2019 02:25,150,14,Poltava
880,865,79,302,499,79,578,0,577,14,432,131,22.04.2019 03:01,150,14,Poltava
640,630,54,229,357,54,411,0,411,12,323,76,21.04.2019 20:50,150,14,Poltava
528,518,40,203,288,37,325,0,325,7,283,35,22.04.2019 01:36,150,14,Poltava
592,574,42,193,361,38,399,0,399,5,351,43,22.04.2019 01:09,150,14,Poltava
528,512,58,187,288,53,341,0,341,3,298,40,21.04.2019 23:30,150,14,Poltava
144,134,5,78,61,5,66,0,66,2,59,5,21.04.2019 20:44,150,14,Poltava
528,514,17,215,296,17,313,0,313,6,258,49,21.04.2019 21:10,150,14,Poltava
1072,1048,21,470,584,18,602,0,602,11,524,67,21.04.2019 23:50,150,14,Poltava
1040,1008,80,440,521,79,600,0,600,13,488,99,21.04.2019 22:45,150,14,Poltava
272,268,5,93,174,5,179,0,179,5,141,33,21.04.2019 22:00,150,14,Poltava
384,373,31,133,220,31,251,0,251,4,227,20,22.04.2019 00:10,150,14,Poltava
112,105,11,36,65,11,76,0,76,0,71,5,22.04.2019 00:10,150,14,Poltava
576,565,50,155,373,48,421,0,421,7,362,52,21.04.2019 21:15,150,14,Poltava
192,186,19,68,105,19,124,0,124,0,110,14,21.04.2019 20:49,150,14,Poltava
256,30,12,227,17,12,29,0,29,1,21,7,21.04.2019 21:00,150,14,Poltava
1920,1899,21,810,1090,20,1110,0,1110,24,944,142,21.04.2019 22:15,150,14,Poltava
208,194,6,115,87,6,93,0,93,2,74,17,21.04.2019 21:10,150,14,Poltava
800,793,32,300,468,32,500,0,500,14,439,47,21.04.2019 21:40,150,14,Poltava
1552,1530,40,631,883,38,921,0,921,17,761,143,21.04.2019 22:00,150,14,Poltava
608,589,47,306,261,41,302,0,302,5,237,60,21.04.2019 21:25,150,14,Poltava
784,769,40,314,430,40,470,0,470,9,369,92,21.04.2019 20:54,150,14,Poltava
384,366,19,161,205,18,223,0,223,4,186,33,21.04.2019 20:49,150,14,Poltava
256,240,30,100,132,24,156,0,156,0,134,22,21.04.2019 21:00,150,14,Poltava
512,504,24,222,270,20,290,0,290,7,237,46,21.04.2019 20:50,150,14,Poltava
1680,1650,10,745,927,8,935,0,935,26,788,121,21.04.2019 21:40,150,14,Poltava
624,609,29,214,382,28,410,0,410,16,322,72,22.04.2019 03:30,150,14,Poltava
1712,1687,17,763,934,15,949,0,949,15,825,109,21.04.2019 22:30,150,14,Poltava
1008,990,6,484,518,6,524,0,524,6,423,95,21.04.2019 21:40,150,14,Poltava
304,294,2,142,160,2,162,0,162,4,124,34,21.04.2019 20:37,150,14,Poltava
336,318,30,116,192,28,220,0,220,6,184,30,21.04.2019 21:00,150,14,Poltava
480,465,38,156,289,35,324,0,324,2,272,50,22.04.2019 00:20,150,14,Poltava
672,651,28,295,349,28,377,0,377,9,325,43,21.04.2019 20:49,150,14,Poltava
160,149,19,54,87,19,106,0,106,2,82,22,21.04.2019 22:10,150,14,Poltava
1584,1559,47,702,835,47,882,0,882,21,717,144,21.04.2019 21:25,150,14,Poltava
1376,1351,43,565,771,40,811,0,811,15,640,156,22.04.2019 01:40,150,14,Poltava
144,145,10,33,101,10,111,0,111,0,85,26,21.04.2019 22:35,150,14,Poltava
1424,1405,65,503,857,64,921,0,921,28,707,186,21.04.2019 21:48,150,14,Poltava
256,253,17,119,122,15,137,0,137,1,101,35,21.04.2019 21:00,150,14,Poltava
2240,2213,48,819,1379,42,1421,0,1421,33,1097,291,21.04.2019 21:20,150,14,Poltava
1856,1828,29,678,1153,25,1178,0,1178,35,926,217,21.04.2019 21:21,150,14,Poltava
1536,1523,15,634,889,13,902,0,902,19,723,160,21.04.2019 21:35,150,14,Poltava
1408,1391,35,549,824,35,859,0,859,22,698,139,21.04.2019 21:06,150,14,Poltava
1056,1021,37,464,556,36,592,0,592,8,500,84,21.04.2019 21:15,150,14,Poltava
352,342,9,137,206,9,215,0,215,3,178,34,21.04.2019 21:20,150,14,Poltava
752,744,54,264,441,47,488,0,488,10,392,86,21.04.2019 22:30,150,14,Poltava
144,136,6,63,75,6,81,0,81,0,69,12,21.04.2019 20:33,150,14,Poltava
1184,1171,63,460,661,63,724,0,724,16,616,92,21.04.2019 21:10,150,14,Poltava
368,350,17,106,245,17,262,0,262,5,231,26,21.04.2019 20:49,150,14,Poltava
1952,1912,34,819,1102,31,1133,0,1133,24,910,199,21.04.2019 21:01,150,14,Poltava
1376,1364,42,502,832,42,874,0,874,29,761,84,21.04.2019 21:55,150,14,Poltava
928,909,58,296,580,52,632,0,632,9,549,74,21.04.2019 20:55,150,14,Poltava
704,689,35,236,438,30,468,0,468,10,367,91,21.04.2019 21:20,150,14,Poltava
256,254,13,114,133,9,142,0,142,1,115,26,21.04.2019 21:20,150,14,Poltava
2496,2478,111,790,1617,89,1706,0,1706,30,1459,217,22.04.2019 00:05,150,14,Poltava
1792,1750,32,692,1073,27,1100,0,1100,33,949,118,22.04.2019 00:07,150,14,Poltava
1936,1937,46,626,1278,32,1310,0,1310,32,1115,163,21.04.2019 22:40,150,14,Poltava
2064,2028,54,621,1398,45,1443,0,1443,25,1245,173,21.04.2019 21:59,150,14,Poltava
1824,1791,49,523,1272,29,1301,0,1301,25,1074,202,22.04.2019 00:02,150,14,Poltava
1904,1901,54,569,1295,40,1335,0,1335,22,1151,162,22.04.2019 00:01,150,14,Poltava
2160,2146,31,658,1482,20,1502,0,1502,35,1255,212,22.04.2019 00:11,150,14,Poltava
2192,2171,24,641,1536,15,1551,0,1551,21,1332,198,22.04.2019 00:05,150,14,Poltava
2048,2056,24,620,1413,15,1428,0,1428,21,1220,187,22.04.2019 00:20,150,14,Poltava
2032,2007,66,605,1374,53,1427,0,1427,38,1207,182,22.04.2019 00:30,150,14,Poltava
2080,2054,54,617,1420,43,1463,0,1463,21,1257,185,22.04.2019 00:15,150,14,Poltava
1824,1800,45,588,1205,31,1236,0,1236,19,1059,158,21.04.2019 23:50,150,14,Poltava
1904,1899,44,585,1284,35,1319,0,1319,29,1148,142,21.04.2019 22:05,150,14,Poltava
1968,1963,15,728,1227,13,1240,0,1240,24,1074,142,21.04.2019 21:10,150,14,Poltava
1984,1979,40,573,1384,27,1411,0,1411,30,1203,178,22.04.2019 00:10,150,14,Poltava
2112,2122,46,607,1465,40,1505,0,1505,31,1283,191,21.04.2019 22:00,150,14,Poltava
1696,1703,50,446,1215,35,1250,0,1250,31,1040,179,21.04.2019 21:55,150,14,Poltava
2144,2108,113,913,1130,101,1231,0,1231,27,1029,175,21.04.2019 21:40,150,14,Poltava
2224,2195,19,717,1493,14,1507,0,1507,37,1228,242,22.04.2019 00:30,150,14,Poltava
2128,2100,13,752,1366,10,1376,0,1376,28,1090,258,22.04.2019 02:10,150,14,Poltava
1840,1813,10,619,1213,8,1221,0,1221,37,972,212,22.04.2019 00:30,150,14,Poltava
2064,2029,7,651,1407,6,1413,0,1413,38,1157,218,22.04.2019 00:35,150,14,Poltava
2048,2014,13,667,1369,12,1381,0,1381,30,1121,230,22.04.2019 00:45,150,14,Poltava
2256,2309,19,604,1640,12,1652,0,1652,45,1338,269,22.04.2019 00:20,150,14,Poltava
2304,2259,7,769,1531,4,1535,0,1535,27,1263,245,22.04.2019 00:20,150,14,Poltava
2288,2238,11,785,1496,7,1503,0,1503,29,1250,224,22.04.2019 03:45,150,14,Poltava
2272,2265,24,856,1396,20,1416,0,1416,40,1163,213,21.04.2019 23:01,150,14,Poltava
2384,2344,16,882,1491,11,1502,0,1502,35,1257,210,22.04.2019 00:05,150,14,Poltava
1664,1651,15,594,1060,10,1070,0,1070,20,878,172,22.04.2019 02:20,150,14,Poltava
1856,1838,13,605,1240,11,1251,0,1251,25,1048,178,22.04.2019 00:20,150,14,Poltava
2224,2220,19,723,1489,12,1501,0,1501,40,1231,230,22.04.2019 00:30,150,14,Poltava
2080,2047,35,647,1409,24,1433,0,1433,29,1190,214,22.04.2019 03:40,150,14,Poltava
1856,1860,48,531,1286,39,1325,0,1325,12,1165,148,22.04.2019 00:40,150,14,Poltava
1600,1574,15,555,1033,12,1045,0,1045,22,861,162,22.04.2019 00:20,151,14,Poltava
1056,1032,22,438,598,20,618,0,618,11,514,93,22.04.2019 00:59,151,14,Poltava
1632,1593,14,605,1014,13,1027,0,1027,24,871,132,22.04.2019 05:45,151,14,Poltava
1680,1639,12,615,1054,11,1065,0,1065,34,916,115,22.04.2019 00:30,151,14,Poltava
1664,1648,10,630,1025,9,1034,0,1034,25,846,163,22.04.2019 01:10,151,14,Poltava
960,928,15,401,550,9,559,0,559,18,465,76,22.04.2019 00:10,151,14,Poltava
1184,1158,17,444,723,17,740,0,740,21,645,74,22.04.2019 01:15,151,14,Poltava
1040,1011,10,348,682,10,692,0,692,13,585,94,22.04.2019 00:45,151,14,Poltava
880,879,30,280,574,26,600,0,600,10,543,47,22.04.2019 01:45,151,14,Poltava
256,241,40,17,199,40,239,0,239,2,211,26,22.04.2019 00:45,151,14,Poltava
496,497,37,128,336,32,368,0,368,10,297,61,22.04.2019 01:10,151,14,Poltava
640,628,33,228,384,28,412,0,412,5,359,48,22.04.2019 00:20,151,14,Poltava
960,954,25,355,580,25,605,0,605,9,545,51,21.04.2019 23:40,151,14,Poltava
1808,1782,32,778,1003,27,1030,0,1030,33,922,75,22.04.2019 05:30,151,14,Poltava
336,324,19,122,196,18,214,0,214,2,185,27,22.04.2019 02:00,151,14,Poltava
688,676,55,307,329,52,381,0,381,2,295,84,22.04.2019 01:50,151,14,Poltava
880,865,40,294,552,34,586,0,586,19,488,79,22.04.2019 00:35,151,14,Poltava
768,754,52,282,441,45,486,0,486,18,412,56,21.04.2019 21:09,151,14,Poltava
176,164,28,76,78,22,100,0,100,3,85,12,22.04.2019 00:05,151,14,Poltava
608,590,33,218,361,29,390,0,390,3,336,51,22.04.2019 00:14,151,14,Poltava
272,266,22,98,153,21,174,0,174,2,146,26,22.04.2019 01:12,151,14,Poltava
384,370,11,158,218,8,226,0,226,4,188,34,22.04.2019 01:30,151,14,Poltava
80,72,3,33,45,2,47,0,47,1,43,3,22.04.2019 00:17,151,14,Poltava
80,76,7,25,50,5,55,0,55,3,47,5,21.04.2019 22:20,151,14,Poltava
1104,1083,14,475,617,12,629,0,629,14,580,35,22.04.2019 00:55,151,14,Poltava
368,360,20,146,206,16,222,0,222,3,200,19,22.04.2019 00:10,151,14,Poltava
784,778,47,303,438,43,481,0,481,12,388,81,22.04.2019 05:25,151,14,Poltava
1104,1089,43,465,603,36,639,0,639,13,574,52,22.04.2019 00:45,151,14,Poltava
624,608,74,231,326,67,393,0,393,8,329,56,22.04.2019 00:35,151,14,Poltava
752,742,33,310,415,27,442,0,442,7,355,80,22.04.2019 06:50,151,14,Poltava
512,496,26,225,266,21,287,0,287,5,253,29,21.04.2019 20:20,151,14,Poltava
992,972,24,382,587,23,610,0,610,14,554,42,22.04.2019 00:26,151,14,Poltava
640,616,11,281,349,10,359,0,359,8,308,43,22.04.2019 00:32,151,14,Poltava
336,332,5,139,194,3,197,0,197,4,181,12,22.04.2019 00:15,151,14,Poltava
176,174,2,69,105,2,107,0,107,1,82,24,22.04.2019 00:05,151,14,Poltava
304,288,7,114,183,7,190,0,190,2,149,39,21.04.2019 23:10,151,14,Poltava
208,204,12,70,126,12,138,0,138,1,106,31,22.04.2019 01:30,151,14,Poltava
656,662,38,243,382,31,413,0,413,2,343,68,22.04.2019 00:25,151,14,Poltava
416,413,20,153,249,14,263,0,263,5,212,46,22.04.2019 00:40,151,14,Poltava
144,139,5,54,85,5,90,0,90,0,70,20,22.04.2019 00:15,151,14,Poltava
816,804,12,297,507,12,519,0,519,12,406,101,22.04.2019 00:25,151,14,Poltava
1440,1417,29,669,746,25,771,0,771,18,651,102,22.04.2019 00:07,151,14,Poltava
272,259,15,136,123,13,136,0,136,2,110,24,21.04.2019 20:40,151,14,Poltava
400,392,19,160,223,17,240,0,240,6,188,46,22.04.2019 00:50,151,14,Poltava
528,517,33,201,294,33,327,0,327,5,253,69,21.04.2019 21:05,151,14,Poltava
560,537,36,196,330,34,364,0,364,7,291,66,21.04.2019 21:00,151,14,Poltava
144,135,12,26,106,12,118,0,118,1,91,26,22.04.2019 00:05,151,14,Poltava
272,268,22,107,144,21,165,0,165,3,120,42,22.04.2019 01:56,151,14,Poltava
800,792,44,369,388,43,431,0,431,3,342,86,22.04.2019 02:17,151,14,Poltava
1408,1377,80,551,793,64,857,0,857,25,687,145,22.04.2019 00:40,151,14,Poltava
1872,1848,43,705,1129,38,1167,0,1167,21,931,215,22.04.2019 00:25,151,14,Poltava
2352,2268,57,889,1414,49,1463,0,1463,41,1165,257,22.04.2019 00:40,151,14,Poltava
1920,1899,55,744,1125,51,1176,0,1176,21,968,187,22.04.2019 01:25,151,14,Poltava
1328,1298,11,512,807,9,816,0,816,19,640,157,22.04.2019 01:10,151,14,Poltava
336,325,21,110,207,19,226,0,226,3,192,31,22.04.2019 00:10,151,14,Poltava
1920,1903,53,748,1119,53,1172,0,1172,20,954,198,22.04.2019 00:03,151,14,Poltava
1696,1677,48,658,998,40,1038,0,1038,27,860,151,22.04.2019 00:10,151,14,Poltava
2080,2053,53,848,1188,44,1232,0,1232,32,991,209,22.04.2019 00:50,151,14,Poltava
544,527,20,199,330,15,345,0,345,10,283,52,22.04.2019 00:20,151,14,Poltava
512,504,32,204,278,30,308,0,308,4,237,67,22.04.2019 00:15,151,14,Poltava
160,143,1,71,89,0,89,0,89,2,60,27,22.04.2019 00:10,151,14,Poltava
256,241,28,108,126,22,148,0,148,3,115,30,22.04.2019 01:20,151,14,Poltava
304,297,24,127,156,21,177,0,177,4,112,61,21.04.2019 21:50,151,14,Poltava
704,686,66,323,322,59,381,0,381,8,273,100,22.04.2019 00:15,151,14,Poltava
208,199,27,75,109,24,133,0,133,0,110,23,22.04.2019 00:05,151,14,Poltava
272,254,33,107,139,26,165,0,165,5,143,17,22.04.2019 00:05,151,14,Poltava
240,230,40,82,122,36,158,0,158,2,133,23,22.04.2019 00:02,151,14,Poltava
272,256,22,116,138,18,156,0,156,7,127,22,22.04.2019 00:15,151,14,Poltava
96,95,8,36,52,8,60,0,60,3,38,19,22.04.2019 00:30,151,14,Poltava
816,803,57,354,410,52,462,0,462,5,408,49,22.04.2019 00:30,151,14,Poltava
784,759,58,331,398,55,453,0,453,10,368,75,22.04.2019 01:15,151,14,Poltava
240,233,30,108,111,21,132,0,132,2,97,33,21.04.2019 23:50,151,14,Poltava
256,240,27,111,124,21,145,0,145,1,116,28,22.04.2019 01:20,151,14,Poltava
704,680,42,256,409,39,448,0,448,7,377,64,22.04.2019 00:15,151,14,Poltava
464,451,24,182,261,21,282,0,282,3,225,54,22.04.2019 00:16,151,14,Poltava
128,119,11,55,63,10,73,0,73,2,60,11,22.04.2019 00:05,151,14,Poltava
464,444,47,187,240,37,277,0,277,7,227,43,22.04.2019 00:30,151,14,Poltava
224,220,39,65,124,35,159,0,159,0,139,20,22.04.2019 00:05,151,14,Poltava
144,133,12,65,70,9,79,0,79,2,59,18,22.04.2019 00:40,151,14,Poltava
512,497,39,224,258,30,288,0,288,4,245,39,22.04.2019 06:15,151,14,Poltava
352,347,25,153,176,23,199,0,199,3,160,36,22.04.2019 00:15,151,14,Poltava
528,529,22,222,287,19,306,0,306,3,238,65,22.04.2019 00:15,151,14,Poltava
368,368,22,137,209,22,231,0,231,6,179,46,22.04.2019 00:15,151,14,Poltava
288,282,17,100,174,14,188,0,188,3,143,42,22.04.2019 00:15,151,14,Poltava
800,781,41,324,445,31,476,1,476,7,397,71,22.04.2019 00:20,151,14,Poltava
848,829,47,401,406,41,447,0,447,8,384,55,22.04.2019 00:20,151,14,Poltava
208,194,9,120,81,7,88,0,88,1,55,32,22.04.2019 00:30,151,14,Poltava
608,592,42,222,347,39,386,0,386,4,296,86,22.04.2019 00:10,151,14,Poltava
416,408,27,146,249,21,270,0,270,7,216,47,22.04.2019 00:05,151,14,Poltava
368,358,38,131,201,36,237,0,237,5,205,27,22.04.2019 00:15,151,14,Poltava
64,62,8,15,41,8,49,0,49,0,34,15,22.04.2019 00:05,151,14,Poltava
176,161,10,76,90,10,100,0,100,4,79,17,22.04.2019 00:05,151,14,Poltava
896,873,59,345,497,54,551,0,551,10,464,77,22.04.2019 01:25,151,14,Poltava
688,679,47,261,380,47,427,0,427,7,360,60,22.04.2019 00:05,151,14,Poltava
448,434,36,159,256,33,289,0,289,10,230,49,22.04.2019 00:10,151,14,Poltava
176,161,16,63,98,15,113,0,113,2,90,21,21.04.2019 21:30,151,14,Poltava
992,968,117,314,577,101,678,0,678,8,560,110,22.04.2019 01:40,151,14,Poltava
336,331,35,104,197,35,232,0,232,8,196,28,22.04.2019 00:25,151,14,Poltava
368,358,26,150,195,23,218,0,218,6,168,44,22.04.2019 00:22,151,14,Poltava
192,173,10,80,102,10,112,0,112,2,92,18,22.04.2019 00:15,151,14,Poltava
784,767,70,251,469,64,533,0,533,3,462,68,22.04.2019 00:07,151,14,Poltava
96,93,11,25,61,10,71,0,71,0,62,9,22.04.2019 00:05,151,14,Poltava
608,589,32,256,320,32,352,0,352,5,284,63,22.04.2019 00:50,151,14,Poltava
656,590,51,219,390,47,437,0,437,8,361,68,22.04.2019 01:10,151,14,Poltava
112,106,6,43,63,6,69,0,69,6,49,14,22.04.2019 00:25,151,14,Poltava
224,207,16,82,127,15,142,0,142,4,110,28,22.04.2019 00:30,151,14,Poltava
144,132,12,62,72,10,82,0,82,1,69,12,22.04.2019 00:10,151,14,Poltava
336,326,16,169,156,11,167,0,167,3,120,44,22.04.2019 00:15,151,14,Poltava
192,184,13,69,112,11,123,0,123,3,93,27,22.04.2019 00:25,151,14,Poltava
128,114,12,49,67,12,79,0,79,3,61,15,22.04.2019 00:20,151,14,Poltava
752,741,67,271,419,62,481,0,481,8,373,100,21.04.2019 23:40,151,14,Poltava
432,419,45,134,253,45,298,0,298,4,257,37,22.04.2019 01:20,151,14,Poltava
128,117,27,75,34,19,53,0,53,1,46,6,22.04.2019 00:15,151,14,Poltava
112,105,13,44,57,11,68,0,68,1,48,19,22.04.2019 00:20,151,14,Poltava
848,839,38,268,542,38,580,0,580,9,460,111,22.04.2019 00:30,151,14,Poltava
528,524,20,208,304,16,320,0,320,5,258,57,22.04.2019 00:15,151,14,Poltava
320,305,19,139,165,16,181,0,181,2,149,30,22.04.2019 00:10,151,14,Poltava
192,185,10,70,113,9,122,0,122,4,100,18,22.04.2019 03:20,151,14,Poltava
256,253,29,111,123,22,145,0,145,1,116,28,22.04.2019 01:15,151,14,Poltava
224,212,21,78,125,21,146,0,146,3,105,38,22.04.2019 00:10,151,14,Poltava
368,370,33,143,192,33,225,0,225,5,179,41,22.04.2019 00:05,151,14,Poltava
224,227,23,59,144,21,165,0,165,2,119,44,21.04.2019 23:45,151,14,Poltava
272,258,24,83,166,23,189,0,189,4,161,24,22.04.2019 00:45,151,14,Poltava
224,212,13,77,134,13,147,0,147,2,109,36,22.04.2019 01:15,151,14,Poltava
944,927,75,348,528,68,596,0,596,14,450,132,22.04.2019 01:10,151,14,Poltava
336,331,32,94,211,31,242,0,242,1,219,22,22.04.2019 00:05,151,14,Poltava
208,199,12,49,147,12,159,0,159,2,120,37,22.04.2019 00:20,151,14,Poltava
192,177,24,92,81,19,100,0,100,1,78,21,22.04.2019 03:50,151,14,Poltava
256,237,31,83,147,26,173,0,173,0,152,21,22.04.2019 00:09,151,14,Poltava
1392,1379,87,560,763,69,832,0,832,21,680,131,22.04.2019 00:30,151,14,Poltava
496,487,34,211,253,32,285,0,285,8,247,30,22.04.2019 00:35,151,14,Poltava
176,172,15,68,96,12,108,0,108,4,67,37,22.04.2019 02:00,151,14,Poltava
288,290,32,98,162,28,190,0,190,0,142,48,22.04.2019 00:01,151,14,Poltava
144,136,16,32,96,16,112,0,112,1,79,32,22.04.2019 01:25,151,14,Poltava
512,504,56,204,255,53,308,0,308,8,231,69,22.04.2019 01:30,151,14,Poltava
128,111,10,58,61,9,70,0,70,2,47,21,22.04.2019 00:15,151,14,Poltava
96,96,0,33,63,0,63,0,63,2,47,14,22.04.2019 00:35,151,14,Poltava
720,715,48,285,392,43,435,0,435,7,351,77,22.04.2019 02:10,151,14,Poltava
448,437,27,195,235,18,253,0,253,3,210,40,22.04.2019 00:06,151,14,Poltava
400,404,31,151,223,26,249,0,249,3,213,33,22.04.2019 00:10,151,14,Poltava
320,303,33,131,156,33,189,0,189,3,162,24,22.04.2019 02:30,151,14,Poltava
272,257,25,108,141,23,164,0,164,1,125,38,22.04.2019 00:55,151,14,Poltava
736,718,64,283,394,59,453,0,453,12,362,79,22.04.2019 00:30,151,14,Poltava
176,171,26,65,90,21,111,0,111,2,94,15,22.04.2019 00:05,151,14,Poltava
272,256,34,96,142,34,176,0,176,2,148,26,22.04.2019 00:05,151,14,Poltava
640,618,44,308,294,38,332,0,332,4,261,67,22.04.2019 00:10,151,14,Poltava
336,322,18,122,200,14,214,0,214,3,179,32,22.04.2019 00:55,151,14,Poltava
576,562,27,231,324,21,345,0,345,1,291,53,22.04.2019 00:20,151,14,Poltava
592,577,48,261,285,46,331,0,331,6,270,55,22.04.2019 00:01,151,14,Poltava
320,313,45,124,151,45,196,0,196,1,154,41,22.04.2019 00:09,151,14,Poltava
384,375,31,177,180,27,207,0,207,2,177,28,22.04.2019 00:15,151,14,Poltava
256,245,27,105,124,27,151,0,151,2,123,26,22.04.2019 00:05,151,14,Poltava
448,439,53,164,231,53,284,0,284,9,211,64,22.04.2019 00:05,151,14,Poltava
320,300,28,128,171,21,192,0,192,1,159,32,22.04.2019 00:30,151,14,Poltava
256,259,47,80,138,38,176,0,176,5,102,69,22.04.2019 02:20,151,14,Poltava
192,180,35,80,83,29,112,0,112,0,81,31,22.04.2019 00:10,151,14,Poltava
704,703,52,292,369,43,412,0,412,11,329,72,22.04.2019 00:15,151,14,Poltava
336,332,21,125,191,20,211,0,211,3,165,43,22.04.2019 00:15,151,14,Poltava
1248,1218,36,548,667,33,700,0,700,16,570,114,22.04.2019 00:30,151,14,Poltava
176,163,23,73,84,19,103,0,103,1,79,23,22.04.2019 00:40,151,14,Poltava
368,331,1,37,330,1,331,0,331,33,266,32,21.04.2019 20:20,152,15,Rovno
2144,2120,7,743,1396,5,1401,0,1401,43,815,543,22.04.2019 00:20,152,15,Rovno
2096,2070,5,787,1305,4,1309,0,1309,35,806,468,21.04.2019 23:01,152,15,Rovno
2112,2097,6,715,1394,3,1397,0,1397,41,746,610,21.04.2019 22:55,152,15,Rovno
2048,2015,5,924,1119,5,1124,0,1124,26,755,343,22.04.2019 00:05,152,15,Rovno
1712,1690,11,581,1122,9,1131,0,1131,31,699,401,21.04.2019 22:10,152,15,Rovno
1600,1592,12,538,1052,10,1062,0,1062,30,594,438,21.04.2019 22:15,152,15,Rovno
2224,2202,16,838,1374,12,1386,0,1386,39,846,501,22.04.2019 03:15,152,15,Rovno
1856,1826,13,652,1194,10,1204,0,1204,41,692,471,22.04.2019 00:17,152,15,Rovno
2224,2189,6,836,1384,4,1388,0,1388,34,806,548,22.04.2019 00:23,152,15,Rovno
1888,1889,8,611,1271,6,1277,0,1277,38,768,471,21.04.2019 22:20,152,15,Rovno
1264,1241,3,549,712,3,715,0,715,21,437,257,21.04.2019 21:45,152,15,Rovno
2096,2068,9,797,1291,8,1299,0,1299,40,745,514,22.04.2019 00:10,152,15,Rovno
2048,2037,7,833,1212,3,1215,0,1215,31,715,469,22.04.2019 00:08,152,15,Rovno
2096,2082,7,693,1398,5,1403,0,1403,42,799,562,22.04.2019 03:25,152,15,Rovno
1968,1940,12,766,1190,12,1202,0,1202,42,750,410,21.04.2019 21:20,152,15,Rovno
2032,2006,8,734,1293,5,1298,0,1298,29,779,490,22.04.2019 01:05,152,15,Rovno
2336,2286,4,880,1455,1,1456,0,1456,40,877,539,22.04.2019 00:05,152,15,Rovno
2096,2067,5,809,1284,3,1287,0,1287,39,745,503,22.04.2019 00:17,152,15,Rovno
2240,2208,8,852,1383,5,1388,0,1388,45,776,567,22.04.2019 02:20,152,15,Rovno
1744,1719,12,610,1126,8,1134,0,1134,35,656,443,22.04.2019 00:17,152,15,Rovno
1904,1877,9,693,1202,9,1211,0,1211,27,755,429,22.04.2019 02:30,152,15,Rovno
2064,2034,14,736,1321,7,1328,0,1328,34,809,485,21.04.2019 22:02,152,15,Rovno
1648,1585,1,666,981,1,982,0,982,20,534,428,21.04.2019 22:30,152,15,Rovno
1904,1880,12,757,1140,7,1147,0,1147,23,727,397,21.04.2019 23:45,152,15,Rovno
1056,1036,6,350,702,4,706,0,706,38,410,258,21.04.2019 20:30,152,15,Rovno
1616,1594,10,620,987,9,996,0,996,32,591,373,22.04.2019 00:09,152,15,Rovno
2240,2196,11,1113,1121,6,1127,0,1127,33,656,438,22.04.2019 00:05,152,15,Rovno
1808,1806,19,581,1213,14,1227,0,1227,44,727,456,22.04.2019 00:10,152,15,Rovno
1664,1695,17,502,1149,13,1162,0,1162,35,666,461,21.04.2019 23:50,152,15,Rovno
704,695,7,234,463,7,470,0,470,13,292,165,21.04.2019 22:32,152,15,Rovno
1488,1478,11,545,933,10,943,0,943,28,512,403,21.04.2019 22:58,152,15,Rovno
2240,2193,19,778,1447,15,1462,0,1462,50,851,561,22.04.2019 01:55,152,15,Rovno
2048,2048,9,602,1438,8,1446,0,1446,53,782,611,22.04.2019 00:05,152,15,Rovno
1568,1568,19,544,1011,13,1024,0,1024,19,634,371,22.04.2019 00:10,152,15,Rovno
1328,1331,5,387,936,5,941,0,941,34,532,375,21.04.2019 22:02,152,15,Rovno
672,651,6,240,426,6,432,0,432,17,259,156,21.04.2019 20:45,152,15,Rovno
1152,1132,6,418,729,5,734,0,734,16,438,280,21.04.2019 22:00,152,15,Rovno
2224,2206,8,774,1445,5,1450,0,1450,49,863,538,22.04.2019 00:15,152,15,Rovno
1728,1699,16,521,1194,13,1207,0,1207,48,646,513,21.04.2019 22:10,152,15,Rovno
1552,1556,6,514,1032,6,1038,0,1038,19,620,399,22.04.2019 00:14,152,15,Rovno
1088,1071,3,427,659,2,661,0,661,9,364,288,21.04.2019 21:15,152,15,Rovno
2352,2330,13,897,1443,12,1455,0,1455,53,792,610,21.04.2019 22:30,152,15,Rovno
1904,1886,1,1092,811,1,812,0,812,21,547,244,21.04.2019 21:40,152,15,Rovno
2064,2022,6,1015,1045,4,1049,0,1049,25,598,426,21.04.2019 21:40,152,15,Rovno
1487,1457,7,508,972,7,979,0,979,36,590,353,22.04.2019 00:20,152,15,Rovno
2000,1964,15,702,1285,13,1298,0,1298,41,767,490,21.04.2019 22:05,152,15,Rovno
832,832,7,332,494,6,500,0,500,16,312,172,21.04.2019 21:40,152,15,Rovno
1952,1915,15,650,1289,13,1302,0,1302,41,770,491,21.04.2019 22:00,152,15,Rovno
2336,2286,2,1231,1104,1,1105,0,1105,38,675,392,21.04.2019 21:05,152,15,Rovno
2480,2453,7,902,1572,6,1578,0,1578,67,809,702,22.04.2019 00:10,152,15,Rovno
1952,1943,5,650,1297,5,1302,0,1302,31,755,516,21.04.2019 21:45,152,15,Rovno
1888,1859,14,711,1168,9,1177,0,1177,34,706,437,22.04.2019 01:05,152,15,Rovno
1648,1621,6,728,914,6,920,0,920,25,570,325,21.04.2019 22:24,152,15,Rovno
1840,1815,5,695,1140,5,1145,0,1145,17,662,466,21.04.2019 21:25,152,15,Rovno
2240,2231,7,796,1438,6,1444,0,1444,48,835,561,22.04.2019 00:37,152,15,Rovno
1968,1946,13,777,1182,9,1191,0,1191,34,696,461,21.04.2019 21:54,152,15,Rovno
992,976,5,321,666,5,671,0,671,20,409,242,21.04.2019 21:42,152,15,Rovno
672,662,2,282,388,2,390,0,390,13,234,143,22.04.2019 00:17,152,15,Rovno
1792,1765,1,735,1056,1,1057,0,1057,31,673,353,22.04.2019 00:35,152,15,Rovno
2128,2110,4,719,1405,4,1409,0,1409,40,838,531,22.04.2019 00:02,152,15,Rovno
2416,2387,10,807,1602,7,1609,0,1609,28,914,667,22.04.2019 00:20,152,15,Rovno
2160,2147,8,741,1412,7,1419,0,1419,39,881,499,22.04.2019 00:05,152,15,Rovno
1648,1630,5,680,963,5,968,0,968,40,528,400,22.04.2019 00:10,152,15,Rovno
1904,1866,5,729,1171,4,1175,0,1175,40,696,439,22.04.2019 00:05,152,15,Rovno
1824,1835,5,585,1235,4,1239,0,1239,34,698,507,21.04.2019 21:30,152,15,Rovno
2272,2230,7,801,1466,5,1471,0,1471,48,766,657,21.04.2019 21:30,152,15,Rovno
1648,1613,4,498,1147,3,1150,0,1150,39,619,492,22.04.2019 00:06,152,15,Rovno
1376,1339,1,839,537,0,537,0,537,18,344,175,22.04.2019 00:16,152,15,Rovno
960,909,4,550,406,4,410,0,410,12,227,171,22.04.2019 03:17,152,15,Rovno
2080,2044,9,724,1350,6,1356,0,1356,55,712,589,21.04.2019 22:20,152,15,Rovno
1552,1512,6,559,987,6,993,0,993,27,541,425,21.04.2019 21:35,152,15,Rovno
2112,2084,9,641,1462,9,1471,0,1471,36,832,603,21.04.2019 22:45,152,15,Rovno
2224,2195,13,798,1416,10,1426,0,1426,47,799,580,21.04.2019 23:00,152,15,Rovno
2112,2090,5,738,1371,3,1374,0,1374,34,866,474,22.04.2019 00:10,152,15,Rovno
1376,1361,0,526,850,0,850,0,850,38,508,304,21.04.2019 20:50,152,15,Rovno
2128,2085,5,768,1357,3,1360,0,1360,36,816,508,21.04.2019 23:55,152,15,Rovno
2096,2078,3,727,1366,3,1369,0,1369,37,828,504,21.04.2019 23:01,152,15,Rovno
1888,1871,15,724,1151,13,1164,0,1164,41,687,436,22.04.2019 00:05,152,15,Rovno
2144,2105,10,784,1351,9,1360,0,1360,41,740,579,22.04.2019 00:07,152,15,Rovno
1024,1003,8,367,650,7,657,0,657,11,378,268,22.04.2019 00:28,152,15,Rovno
2000,1980,101,689,1300,11,1311,0,1311,43,740,528,22.04.2019 00:05,152,15,Rovno
2032,2018,8,788,1237,7,1244,0,1244,39,725,480,21.04.2019 22:46,152,15,Rovno
2288,2270,9,777,1506,5,1511,0,1511,50,848,613,22.04.2019 00:13,152,15,Rovno
2448,2414,12,1058,1382,8,1390,0,1390,39,814,537,22.04.2019 01:20,152,15,Rovno
128,19,3,110,15,3,18,0,18,0,9,9,21.04.2019 21:15,152,15,Rovno
336,49,19,291,27,18,45,0,45,1,24,20,22.04.2019 00:10,152,15,Rovno
256,74,29,190,39,27,66,0,66,4,38,24,21.04.2019 22:32,152,15,Rovno
144,56,5,89,50,5,55,0,55,3,34,18,21.04.2019 20:28,152,15,Rovno
208,18,0,191,17,0,17,0,17,1,12,4,21.04.2019 20:44,152,15,Rovno
768,164,120,619,41,108,149,0,149,6,82,61,21.04.2019 21:32,152,15,Rovno
384,41,0,344,40,0,40,0,40,1,27,12,21.04.2019 21:10,152,15,Rovno
704,167,93,539,73,92,165,0,165,9,103,53,21.04.2019 20:22,152,15,Rovno
1184,1169,5,481,700,3,703,0,703,16,439,248,21.04.2019 21:30,152,15,Rovno
1632,1614,4,586,1042,4,1046,0,1046,37,586,423,22.04.2019 01:15,152,15,Rovno
1632,1597,8,546,1079,7,1086,0,1086,22,658,406,21.04.2019 22:00,152,15,Rovno
1600,1585,5,544,1051,5,1056,0,1056,31,641,384,22.04.2019 00:30,152,15,Rovno
1088,1066,11,376,704,8,712,0,712,24,376,312,21.04.2019 21:26,152,15,Rovno
1568,1562,6,498,1065,5,1070,0,1070,35,540,495,21.04.2019 22:20,152,15,Rovno
784,787,6,254,526,4,530,0,530,17,307,206,21.04.2019 23:30,152,15,Rovno
2096,2075,34,811,1255,30,1285,0,1285,25,702,558,22.04.2019 00:15,153,15,Rovno
1824,1785,28,750,1046,28,1074,0,1074,33,607,434,21.04.2019 22:13,153,15,Rovno
1792,1762,58,766,974,52,1026,0,1026,28,593,405,21.04.2019 22:45,153,15,Rovno
224,210,16,100,110,14,124,0,124,0,89,35,21.04.2019 23:05,153,15,Rovno
752,739,27,378,354,20,374,0,374,8,234,132,21.04.2019 21:55,153,15,Rovno
1376,1352,25,672,680,24,704,0,704,15,396,293,21.04.2019 21:15,153,15,Rovno
304,298,28,97,180,27,207,0,207,3,97,107,21.04.2019 20:40,153,15,Rovno
336,320,21,162,157,17,174,0,174,2,123,49,21.04.2019 20:35,153,15,Rovno
528,522,35,215,280,33,313,0,313,5,118,190,21.04.2019 21:35,153,15,Rovno
512,503,30,167,319,26,345,0,345,11,174,160,21.04.2019 20:45,153,15,Rovno
1456,1447,38,654,774,28,802,0,802,15,542,245,21.04.2019 21:50,153,15,Rovno
496,485,29,198,275,23,298,0,298,5,171,122,21.04.2019 21:40,153,15,Rovno
400,386,20,109,272,19,291,0,291,10,118,163,22.04.2019 00:02,153,15,Rovno
400,382,35,124,243,33,276,0,276,12,141,123,21.04.2019 21:30,153,15,Rovno
128,121,15,38,76,14,90,0,90,7,36,47,21.04.2019 20:55,153,15,Rovno
368,373,14,136,219,13,232,0,232,6,112,114,21.04.2019 21:05,153,15,Rovno
304,293,14,79,211,14,225,0,225,4,139,82,21.04.2019 21:45,153,15,Rovno
240,236,21,71,148,21,169,0,169,3,83,83,21.04.2019 22:00,153,15,Rovno
160,161,17,35,110,15,125,0,125,0,66,59,21.04.2019 21:45,153,15,Rovno
176,166,20,53,104,19,123,0,123,4,65,54,21.04.2019 21:00,153,15,Rovno
480,469,13,142,327,11,338,0,338,12,191,135,21.04.2019 22:00,153,15,Rovno
256,242,10,106,140,10,150,0,150,6,76,68,21.04.2019 20:42,153,15,Rovno
384,368,11,151,222,11,233,0,233,1,132,100,22.04.2019 00:05,153,15,Rovno
432,424,22,159,259,14,273,0,273,5,172,96,21.04.2019 21:10,153,15,Rovno
160,154,16,48,96,16,112,0,112,2,73,37,21.04.2019 21:40,153,15,Rovno
368,357,30,142,198,28,226,0,226,1,154,71,21.04.2019 21:45,153,15,Rovno
848,840,38,311,504,33,537,0,537,3,281,253,21.04.2019 21:30,153,15,Rovno
400,388,21,203,179,18,197,0,197,1,117,79,21.04.2019 21:05,153,15,Rovno
240,236,23,85,135,20,155,0,155,3,56,96,21.04.2019 21:30,153,15,Rovno
304,291,28,139,141,24,165,0,165,1,79,85,21.04.2019 21:00,153,15,Rovno
400,385,39,165,200,35,235,0,235,6,105,124,21.04.2019 21:10,153,15,Rovno
448,433,18,185,247,16,263,0,263,4,86,173,21.04.2019 22:00,153,15,Rovno
128,116,19,42,71,15,86,0,86,4,49,33,21.04.2019 20:55,153,15,Rovno
320,302,21,148,152,20,172,0,172,5,101,66,21.04.2019 21:10,153,15,Rovno
128,119,24,41,64,23,87,0,87,0,50,37,22.04.2019 00:05,153,15,Rovno
256,255,33,75,149,32,181,0,181,3,71,107,22.04.2019 00:25,153,15,Rovno
224,216,20,82,122,20,142,0,142,0,75,67,21.04.2019 20:34,153,15,Rovno
336,323,9,149,181,6,187,0,187,3,108,76,21.04.2019 21:40,153,15,Rovno
224,209,17,95,114,15,129,0,129,0,68,61,21.04.2019 20:45,153,15,Rovno
464,451,38,192,235,37,272,0,272,9,143,120,21.04.2019 21:30,153,15,Rovno
144,129,13,62,69,13,82,0,82,1,47,34,21.04.2019 20:50,153,15,Rovno
528,515,32,198,301,29,330,0,330,11,188,131,21.04.2019 21:30,153,15,Rovno
288,273,17,103,174,11,185,0,185,0,98,87,21.04.2019 20:40,153,15,Rovno
368,349,26,174,172,22,194,0,194,6,127,61,22.04.2019 00:30,153,15,Rovno
128,121,21,58,50,20,70,0,70,1,48,21,22.04.2019 00:10,153,15,Rovno
928,918,72,325,543,60,603,0,603,13,363,227,21.04.2019 21:15,153,15,Rovno
752,742,37,272,447,33,480,0,480,18,277,185,22.04.2019 00:20,153,15,Rovno
624,609,17,284,325,15,340,0,340,13,177,150,21.04.2019 21:45,153,15,Rovno
288,275,21,107,162,19,181,0,181,3,85,93,21.04.2019 22:15,153,15,Rovno
1744,1707,93,785,894,65,959,0,959,41,552,366,21.04.2019 21:00,153,15,Rovno
192,196,16,54,123,15,138,0,138,1,73,64,21.04.2019 21:00,153,15,Rovno
480,466,35,157,291,32,323,0,323,5,175,143,22.04.2019 00:05,153,15,Rovno
2224,2197,39,988,1204,32,1236,0,1236,48,823,365,22.04.2019 00:10,153,15,Rovno
1968,1943,31,807,1146,15,1161,0,1161,31,736,394,22.04.2019 00:10,153,15,Rovno
1904,1887,37,899,977,28,1005,0,1005,26,626,353,22.04.2019 01:30,153,15,Rovno
304,299,19,126,161,17,178,0,178,2,137,39,21.04.2019 20:45,153,15,Rovno
448,429,22,154,273,21,294,0,294,5,185,104,21.04.2019 21:37,153,15,Rovno
400,393,29,168,208,24,232,0,232,9,132,91,21.04.2019 21:40,153,15,Rovno
624,612,38,255,336,33,369,0,369,16,225,128,22.04.2019 00:10,153,15,Rovno
400,380,33,180,196,24,220,0,220,5,150,65,22.04.2019 01:15,153,15,Rovno
112,110,10,25,77,10,87,0,87,1,50,36,21.04.2019 22:40,153,15,Rovno
1488,1456,63,645,781,62,843,0,843,16,559,268,22.04.2019 00:30,153,15,Rovno
368,353,21,141,207,20,227,0,227,10,138,79,21.04.2019 20:50,153,15,Rovno
320,304,33,137,154,29,183,0,183,4,111,68,21.04.2019 22:01,153,15,Rovno
176,172,18,50,109,17,126,0,126,2,84,40,21.04.2019 22:47,153,15,Rovno
832,820,16,395,424,13,437,0,437,4,297,136,22.04.2019 00:55,153,15,Rovno
864,854,54,330,487,47,534,0,534,12,323,199,22.04.2019 02:00,153,15,Rovno
384,380,38,180,172,32,204,0,204,2,108,94,21.04.2019 22:05,153,15,Rovno
496,487,31,199,270,27,297,0,297,8,188,101,21.04.2019 21:31,153,15,Rovno
640,626,16,275,351,14,365,0,365,9,253,103,21.04.2019 21:50,153,15,Rovno
336,320,20,143,173,20,193,0,193,2,88,103,21.04.2019 20:45,153,15,Rovno
496,487,31,234,239,23,262,0,262,5,220,37,21.04.2019 21:10,153,15,Rovno
352,336,46,114,194,44,238,0,238,11,128,99,21.04.2019 21:30,153,15,Rovno
1040,1022,65,474,512,54,566,0,566,6,390,170,22.04.2019 01:30,153,15,Rovno
1056,1042,63,393,603,60,663,0,663,11,379,273,22.04.2019 00:15,153,15,Rovno
944,924,38,462,448,34,482,0,482,4,369,109,22.04.2019 00:50,153,15,Rovno
656,643,73,292,303,61,364,0,364,2,211,151,21.04.2019 20:55,153,15,Rovno
128,123,24,43,61,24,85,0,85,0,34,51,21.04.2019 21:20,153,15,Rovno
1776,1760,37,798,944,34,978,0,978,14,663,301,22.04.2019 00:20,153,15,Rovno
608,588,43,263,308,37,345,0,345,13,178,154,22.04.2019 00:10,153,15,Rovno
448,431,44,178,226,44,270,0,270,3,147,120,22.04.2019 00:15,153,15,Rovno
320,300,10,171,141,8,149,0,149,2,95,52,21.04.2019 21:30,153,15,Rovno
256,245,19,129,111,16,127,0,127,4,97,26,21.04.2019 21:50,153,15,Rovno
432,418,34,116,282,34,316,0,316,5,194,117,21.04.2019 21:25,153,15,Rovno
528,519,36,223,272,33,305,0,305,10,215,80,21.04.2019 21:35,153,15,Rovno
128,115,17,54,57,17,74,0,74,0,53,21,21.04.2019 20:25,153,15,Rovno
400,397,33,182,188,30,218,0,218,4,134,80,21.04.2019 20:40,153,15,Rovno
416,417,40,134,246,36,282,0,282,7,150,125,22.04.2019 01:30,153,15,Rovno
480,471,29,207,244,29,273,0,273,3,114,156,22.04.2019 05:10,153,15,Rovno
96,94,11,26,59,11,70,0,70,0,27,43,22.04.2019 01:10,153,15,Rovno
128,120,3,73,52,3,55,0,55,3,30,22,22.04.2019 00:13,153,15,Rovno
256,250,21,85,152,19,171,0,171,3,92,76,21.04.2019 21:10,153,15,Rovno
544,523,25,273,252,19,271,0,271,3,175,93,21.04.2019 22:18,153,15,Rovno
304,286,24,148,139,17,156,0,156,5,95,56,21.04.2019 20:47,153,15,Rovno
496,476,23,236,240,20,260,0,260,4,154,102,22.04.2019 00:01,153,15,Rovno
208,199,3,82,123,3,126,0,126,0,78,48,22.04.2019 00:07,153,15,Rovno
288,283,28,105,155,28,183,0,183,3,95,85,21.04.2019 21:30,153,15,Rovno
128,128,9,49,70,9,79,0,79,0,34,45,21.04.2019 22:30,153,15,Rovno
1232,1218,37,503,693,36,729,0,729,16,478,235,21.04.2019 21:30,153,15,Rovno
256,248,17,79,162,15,177,0,177,2,85,90,22.04.2019 00:10,153,15,Rovno
400,394,13,158,229,13,242,0,242,4,142,96,21.04.2019 21:30,153,15,Rovno
512,498,10,212,292,8,300,0,300,4,157,139,22.04.2019 00:04,153,15,Rovno
800,784,18,358,425,17,442,0,442,12,235,195,21.04.2019 22:30,153,15,Rovno
560,544,12,236,314,10,324,0,324,12,178,134,22.04.2019 00:24,153,15,Rovno
336,329,13,116,207,13,220,0,220,7,85,128,22.04.2019 00:20,153,15,Rovno
368,354,24,141,204,23,227,0,227,6,112,109,22.04.2019 00:20,153,15,Rovno
128,126,10,44,74,10,84,0,84,1,40,43,22.04.2019 00:15,153,15,Rovno
1168,1141,17,520,631,17,648,0,648,16,398,234,22.04.2019 00:10,153,15,Rovno
416,403,17,191,208,17,225,0,225,6,154,65,22.04.2019 00:19,153,15,Rovno
432,417,42,165,230,37,267,0,267,7,152,108,22.04.2019 00:10,153,15,Rovno
1264,1239,76,601,595,68,663,0,663,15,296,352,22.04.2019 00:19,153,15,Rovno
800,782,34,333,433,34,467,0,467,8,230,229,22.04.2019 00:25,153,15,Rovno
272,260,18,100,154,18,172,0,172,0,80,92,21.04.2019 22:30,153,15,Rovno
256,245,12,107,137,12,149,0,149,4,69,76,22.04.2019 00:05,153,15,Rovno
464,448,46,190,229,45,274,0,274,4,156,114,22.04.2019 00:10,153,15,Rovno
304,294,9,128,167,9,176,0,176,1,137,38,21.04.2019 22:05,153,15,Rovno
208,194,16,80,114,14,128,0,128,1,88,39,21.04.2019 22:00,153,15,Rovno
256,244,13,110,133,13,146,0,146,5,85,56,21.04.2019 22:00,153,15,Rovno
1536,1501,23,726,788,22,810,0,810,18,425,367,22.04.2019 00:10,153,15,Rovno
672,651,20,315,341,16,357,0,357,5,223,129,22.04.2019 00:12,153,15,Rovno
992,982,14,430,548,14,562,0,562,12,338,212,22.04.2019 00:10,153,15,Rovno
256,247,6,115,135,6,141,0,141,1,81,59,21.04.2019 21:00,153,15,Rovno
368,356,12,180,177,11,188,0,188,8,125,55,22.04.2019 00:10,153,15,Rovno
432,425,18,163,253,16,269,0,269,6,97,166,22.04.2019 03:05,153,15,Rovno
912,890,67,432,418,62,480,0,480,11,186,283,21.04.2019 22:30,153,15,Rovno
368,357,41,131,196,41,237,0,237,2,136,99,21.04.2019 22:15,153,15,Rovno
848,833,17,318,513,17,530,0,530,9,304,217,21.04.2019 20:40,153,15,Rovno
432,414,32,145,258,29,287,0,287,7,166,114,22.04.2019 00:05,153,15,Rovno
192,187,26,69,102,21,123,0,123,1,30,92,22.04.2019 00:30,153,15,Rovno
272,256,23,124,128,20,148,0,148,5,70,73,21.04.2019 21:30,153,15,Rovno
112,111,5,25,83,4,87,0,87,2,51,34,21.04.2019 21:40,153,15,Rovno
800,785,71,360,374,66,440,0,440,10,271,159,22.04.2019 00:01,153,15,Rovno
992,974,17,475,505,12,517,0,517,8,349,160,22.04.2019 00:20,153,15,Rovno
672,654,13,312,351,9,360,0,360,6,211,143,22.04.2019 00:10,153,15,Rovno
2431,2398,14,976,1441,14,1455,0,1455,30,871,554,21.04.2019 21:55,153,15,Rovno
656,635,9,245,402,9,411,0,411,5,225,181,22.04.2019 01:03,153,15,Rovno
304,291,5,134,165,5,170,0,170,3,102,65,21.04.2019 23:25,153,15,Rovno
752,736,14,360,380,12,392,0,392,7,236,149,22.04.2019 00:10,153,15,Rovno
272,267,3,109,160,3,163,0,163,4,95,64,21.04.2019 23:45,153,15,Rovno
1248,1232,42,460,746,42,788,0,788,13,489,286,22.04.2019 00:15,153,15,Rovno
432,428,13,158,261,13,274,0,274,7,156,111,21.04.2019 20:41,153,15,Rovno
1024,992,13,300,711,13,724,0,724,15,354,355,21.04.2019 21:00,153,15,Rovno
1824,1805,16,796,1012,16,1028,0,1028,29,588,411,22.04.2019 00:10,153,15,Rovno
864,859,4,229,631,4,635,0,635,19,356,260,22.04.2019 00:15,153,15,Rovno
912,888,11,404,498,10,508,0,508,12,352,144,22.04.2019 00:45,153,15,Rovno
176,170,23,65,88,23,111,0,111,0,42,69,22.04.2019 00:37,153,15,Rovno
80,75,4,31,46,3,49,0,49,1,24,24,22.04.2019 03:25,153,15,Rovno
1840,1822,38,648,1155,37,1192,0,1192,31,646,515,22.04.2019 01:15,153,15,Rovno
1408,1378,26,502,880,26,906,0,906,17,505,384,22.04.2019 01:53,153,15,Rovno
64,60,3,21,40,3,43,0,43,0,24,19,21.04.2019 21:10,153,15,Rovno
176,175,8,52,116,8,124,0,124,4,82,38,22.04.2019 00:23,153,15,Rovno
208,204,13,70,125,13,138,0,138,1,93,44,22.04.2019 00:20,153,15,Rovno
752,738,31,305,420,27,447,0,447,9,266,172,21.04.2019 20:45,153,15,Rovno
192,189,15,68,110,14,124,0,124,6,64,54,21.04.2019 20:30,153,15,Rovno
176,167,28,96,63,17,80,0,80,1,49,30,21.04.2019 22:00,153,15,Rovno
1088,1092,50,344,704,40,744,0,744,17,403,324,22.04.2019 06:45,153,15,Rovno
272,256,21,90,163,19,182,0,182,4,130,48,22.04.2019 00:10,153,15,Rovno
448,438,23,177,251,20,271,0,271,7,127,137,21.04.2019 21:30,153,15,Rovno
1088,1077,84,405,608,75,683,0,683,23,405,255,22.04.2019 00:24,153,15,Rovno
448,430,20,186,245,17,262,0,262,5,171,86,22.04.2019 00:10,153,15,Rovno
1024,993,25,428,573,23,596,0,596,13,379,204,21.04.2019 21:39,153,15,Rovno
944,915,32,359,556,29,585,0,585,15,323,247,22.04.2019 00:15,153,15,Rovno
576,562,39,230,307,39,346,0,346,9,197,140,22.04.2019 00:32,153,15,Rovno
2304,2267,22,894,1393,17,1410,0,1410,38,891,481,21.04.2019 22:22,153,15,Rovno
768,757,12,333,424,11,435,0,435,16,279,140,22.04.2019 00:10,153,15,Rovno
288,275,21,107,160,21,181,0,181,6,93,82,21.04.2019 22:00,153,15,Rovno
2112,2085,30,846,1237,29,1266,0,1266,36,691,539,22.04.2019 00:40,153,15,Rovno
1776,1758,27,704,1047,25,1072,0,1072,41,502,529,21.04.2019 22:30,153,15,Rovno
1328,1313,7,441,880,7,887,0,887,20,450,417,22.04.2019 00:05,153,15,Rovno
400,389,28,145,229,26,255,0,255,12,158,85,22.04.2019 01:10,153,15,Rovno
1152,1124,23,521,609,22,631,0,631,16,359,256,22.04.2019 00:40,153,15,Rovno
864,842,17,394,456,14,470,0,470,6,264,200,22.04.2019 00:16,153,15,Rovno
272,260,29,116,127,29,156,0,156,1,103,52,22.04.2019 00:15,153,15,Rovno
448,441,49,165,241,42,283,0,283,8,178,97,21.04.2019 22:10,153,15,Rovno
96,84,5,47,46,3,49,0,49,1,27,21,22.04.2019 00:20,153,15,Rovno
768,759,19,255,494,19,513,0,513,9,300,204,21.04.2019 22:40,153,15,Rovno
752,748,9,312,432,8,440,0,440,32,264,144,22.04.2019 01:10,153,15,Rovno
192,183,11,61,120,11,131,0,131,2,89,40,21.04.2019 22:30,153,15,Rovno
1952,1928,13,778,1164,10,1174,0,1174,32,722,420,22.04.2019 00:32,153,15,Rovno
480,466,8,196,277,7,284,0,284,5,156,123,22.04.2019 00:24,153,15,Rovno
1168,1147,24,554,595,19,614,0,614,16,387,211,22.04.2019 00:10,153,15,Rovno
272,266,15,82,175,15,190,0,190,3,102,85,22.04.2019 00:10,153,15,Rovno
352,341,7,171,176,5,181,0,181,1,109,71,21.04.2019 23:00,153,15,Rovno
272,269,9,90,174,8,182,0,182,1,115,66,22.04.2019 00:08,153,15,Rovno
432,413,8,201,223,8,231,0,231,3,125,103,22.04.2019 00:20,153,15,Rovno
96,95,2,16,78,2,80,0,80,1,47,32,21.04.2019 22:23,153,15,Rovno
720,708,19,328,376,16,392,0,392,7,237,148,21.04.2019 22:30,153,15,Rovno
1440,1409,22,594,827,19,846,0,846,25,463,358,22.04.2019 02:20,153,15,Rovno
352,347,44,109,199,44,243,0,243,8,153,82,21.04.2019 20:50,153,15,Rovno
208,208,12,69,127,12,139,0,139,1,83,55,21.04.2019 21:45,153,15,Rovno
192,175,9,81,102,9,111,0,111,1,73,37,21.04.2019 21:00,153,15,Rovno
528,512,3,213,313,2,315,0,315,8,195,112,21.04.2019 21:30,153,15,Rovno
2416,2376,21,1084,1318,14,1332,0,1332,35,801,496,21.04.2019 21:35,153,15,Rovno
864,844,7,329,528,7,535,0,535,11,278,246,22.04.2019 00:15,153,15,Rovno
2064,2033,26,845,1196,23,1219,0,1219,18,702,499,21.04.2019 23:59,153,15,Rovno
736,728,46,309,386,41,427,0,427,8,232,187,21.04.2019 21:00,153,15,Rovno
2096,2062,9,911,1178,7,1185,0,1185,21,842,322,22.04.2019 00:20,153,15,Rovno
2256,2222,12,928,1319,9,1328,0,1328,28,867,433,22.04.2019 00:08,153,15,Rovno
1648,1621,11,738,900,10,910,0,910,20,572,318,22.04.2019 00:05,153,15,Rovno
2112,2079,10,759,1345,8,1353,0,1353,37,824,492,22.04.2019 00:30,153,15,Rovno
1664,1639,8,631,1025,8,1033,0,1033,29,631,373,22.04.2019 00:45,153,15,Rovno
1888,1857,20,661,1210,17,1227,0,1227,23,732,472,22.04.2019 01:15,153,15,Rovno
1472,1459,15,579,880,13,893,0,893,17,502,373,22.04.2019 00:45,153,15,Rovno
1888,1855,13,786,1090,12,1102,0,1102,16,596,490,21.04.2019 22:40,153,15,Rovno
256,108,32,155,70,31,101,0,101,3,54,44,21.04.2019 20:30,153,15,Rovno
304,22,13,282,9,13,22,0,22,0,13,9,21.04.2019 20:40,153,15,Rovno
704,408,29,297,378,29,407,0,407,34,333,40,22.04.2019 00:25,153,15,Rovno
480,272,0,208,272,0,272,0,272,12,234,26,22.04.2019 01:20,153,15,Rovno
1696,1667,32,668,1001,27,1028,0,1028,24,606,398,21.04.2019 22:20,153,15,Rovno
1712,1702,24,707,982,23,1005,0,1005,34,597,374,21.04.2019 23:05,153,15,Rovno
1728,1698,26,780,930,18,948,0,948,28,532,388,21.04.2019 21:35,153,15,Rovno
1776,1740,15,727,1035,14,1049,0,1049,33,566,450,22.04.2019 03:25,153,15,Rovno
1328,1302,16,533,780,15,795,0,795,25,521,249,22.04.2019 00:15,153,15,Rovno
1728,1717,31,702,998,28,1026,0,1026,18,706,302,21.04.2019 22:10,153,15,Rovno
384,163,0,232,152,0,152,0,152,10,84,58,22.04.2019 00:05,153,15,Rovno
2208,2172,4,757,1447,4,1451,0,1451,56,808,587,22.04.2019 00:20,153,15,Rovno
2032,2011,17,670,1347,15,1362,0,1362,49,784,529,22.04.2019 01:30,153,15,Rovno
1936,1903,11,660,1269,7,1276,0,1276,42,732,502,22.04.2019 00:20,153,15,Rovno
2032,2006,17,749,1272,11,1283,0,1283,43,726,514,22.04.2019 00:20,153,15,Rovno
1520,1509,9,579,935,6,941,0,941,36,588,317,22.04.2019 00:20,153,15,Rovno
1600,1563,6,604,991,5,996,0,996,29,584,383,22.04.2019 01:00,153,15,Rovno
1840,1836,13,720,1109,11,1120,0,1120,36,679,405,22.04.2019 00:50,153,15,Rovno
1312,1282,9,585,722,5,727,0,727,19,465,243,22.04.2019 00:10,153,15,Rovno
688,675,4,267,418,3,421,0,421,5,281,135,22.04.2019 03:40,153,15,Rovno
496,479,0,168,328,0,328,0,328,7,198,123,22.04.2019 00:02,153,15,Rovno
704,680,37,262,410,32,442,0,442,7,248,187,22.04.2019 00:30,154,15,Rovno
592,570,29,245,319,28,347,0,347,2,239,106,22.04.2019 00:20,154,15,Rovno
1312,1292,74,471,773,68,841,0,841,32,466,343,22.04.2019 02:10,154,15,Rovno
736,716,20,251,466,19,485,0,485,13,309,163,22.04.2019 00:30,154,15,Rovno
416,403,40,146,235,35,270,0,270,5,135,130,22.04.2019 00:15,154,15,Rovno
256,247,18,105,133,18,151,0,151,5,73,73,22.04.2019 00:30,154,15,Rovno
944,934,82,358,507,79,586,0,586,9,374,203,22.04.2019 01:30,154,15,Rovno
544,524,56,156,334,54,388,0,388,7,177,204,22.04.2019 01:00,154,15,Rovno
256,253,26,104,130,22,152,0,152,3,72,77,22.04.2019 00:06,154,15,Rovno
736,714,58,253,430,53,483,0,483,8,247,228,22.04.2019 00:09,154,15,Rovno
224,213,37,69,119,36,155,0,155,1,71,83,22.04.2019 00:10,154,15,Rovno
592,576,35,191,369,32,401,0,401,5,247,149,22.04.2019 00:10,154,15,Rovno
112,102,12,47,57,8,65,0,65,2,39,24,22.04.2019 00:20,154,15,Rovno
128,124,21,43,66,19,85,0,85,2,40,43,22.04.2019 00:05,154,15,Rovno
320,318,37,128,158,34,192,0,192,3,81,108,21.04.2019 21:20,154,15,Rovno
768,746,48,285,444,39,483,0,483,10,276,197,22.04.2019 00:30,154,15,Rovno
288,283,24,88,181,19,200,0,200,2,117,81,22.04.2019 01:00,154,15,Rovno
304,296,30,116,162,26,188,0,188,2,93,93,22.04.2019 00:05,154,15,Rovno
336,330,20,110,209,17,226,0,226,2,142,82,22.04.2019 00:40,154,15,Rovno
736,726,67,256,428,52,480,0,480,9,271,200,22.04.2019 00:42,154,15,Rovno
240,225,20,106,117,17,134,0,134,1,73,60,22.04.2019 00:30,154,15,Rovno
608,587,44,300,271,37,308,0,308,17,189,102,22.04.2019 00:00,154,15,Rovno
288,280,23,106,164,18,182,0,182,7,100,75,22.04.2019 00:05,154,15,Rovno
656,644,31,188,437,31,468,0,468,9,262,197,22.04.2019 00:20,154,15,Rovno
640,622,40,182,420,38,458,0,458,10,283,165,22.04.2019 00:01,154,15,Rovno
1680,1650,53,654,976,50,1026,0,1026,22,634,370,21.04.2019 22:50,154,15,Rovno
1280,1250,67,470,750,60,810,0,810,19,560,231,22.04.2019 00:30,154,15,Rovno
832,821,29,304,499,29,528,0,528,9,367,152,22.04.2019 00:20,154,15,Rovno
528,513,32,178,318,32,350,0,350,11,226,113,22.04.2019 00:10,154,15,Rovno
128,125,9,26,93,9,102,0,102,2,59,41,22.04.2019 00:10,154,15,Rovno
656,642,23,270,363,23,386,0,386,11,228,147,22.04.2019 00:15,154,15,Rovno
128,124,13,52,66,10,76,0,76,1,44,31,22.04.2019 00:10,154,15,Rovno
288,277,8,90,190,8,198,0,198,2,140,56,22.04.2019 00:30,154,15,Rovno
896,880,54,351,493,52,545,0,545,12,336,197,22.04.2019 00:35,154,15,Rovno
240,231,11,90,140,10,150,0,150,4,99,47,22.04.2019 00:02,154,15,Rovno
192,180,16,81,100,11,111,0,111,2,40,69,22.04.2019 00:25,154,15,Rovno
304,292,21,109,179,16,195,0,195,4,85,106,21.04.2019 21:15,154,15,Rovno
784,760,30,390,364,30,394,0,394,4,244,146,22.04.2019 00:15,154,15,Rovno
416,409,11,133,274,9,283,0,283,6,146,131,22.04.2019 00:10,154,15,Rovno
176,175,5,65,107,4,111,0,111,0,38,73,22.04.2019 00:50,154,15,Rovno
352,340,23,149,180,23,203,0,203,1,135,67,22.04.2019 00:05,154,15,Rovno
256,251,25,66,165,25,190,0,190,11,71,108,22.04.2019 00:05,154,15,Rovno
128,119,13,47,68,13,81,0,81,3,53,25,22.04.2019 00:15,154,15,Rovno
384,366,9,171,205,8,213,0,213,1,129,83,21.04.2019 22:58,154,15,Rovno
192,177,8,69,115,8,123,0,123,3,85,35,21.04.2019 21:30,154,15,Rovno
464,457,23,149,294,21,315,0,315,7,195,113,22.04.2019 00:10,154,15,Rovno
288,273,18,105,169,14,183,0,183,4,127,52,22.04.2019 00:10,154,15,Rovno
304,286,22,74,208,22,230,0,230,7,155,68,22.04.2019 00:15,154,15,Rovno
368,351,15,107,246,15,261,0,261,8,123,130,22.04.2019 00:10,154,15,Rovno
1920,1890,85,728,1110,82,1192,0,1192,29,705,458,22.04.2019 00:30,154,15,Rovno
176,173,13,40,123,13,136,0,136,2,82,52,22.04.2019 02:20,154,15,Rovno
224,212,4,63,157,4,161,0,161,2,105,54,22.04.2019 00:40,154,15,Rovno
544,527,35,212,297,35,332,0,332,6,204,122,22.04.2019 00:25,154,15,Rovno
448,432,22,162,264,22,286,0,286,12,141,133,22.04.2019 00:17,154,15,Rovno
288,273,31,105,152,31,183,0,183,2,93,88,22.04.2019 00:18,154,15,Rovno
480,458,34,179,268,33,301,0,301,4,163,134,22.04.2019 00:15,154,15,Rovno
448,443,12,185,252,11,263,0,263,4,133,126,22.04.2019 00:20,154,15,Rovno
240,224,6,75,159,6,165,0,165,9,72,84,22.04.2019 00:15,154,15,Rovno
480,462,23,176,281,23,304,0,304,17,190,97,22.04.2019 01:35,154,15,Rovno
320,311,20,85,215,20,235,0,235,3,114,118,22.04.2019 00:10,154,15,Rovno
688,676,34,225,429,34,463,0,463,8,288,167,22.04.2019 00:05,154,15,Rovno
352,340,15,148,189,15,204,0,204,6,112,86,22.04.2019 00:05,154,15,Rovno
1216,1182,23,496,699,21,720,0,720,10,419,291,22.04.2019 00:40,154,15,Rovno
112,103,9,48,55,9,64,0,64,3,22,39,21.04.2019 21:12,154,15,Rovno
208,199,2,54,152,2,154,0,154,2,57,95,22.04.2019 00:15,154,15,Rovno
368,358,39,95,234,39,273,0,273,6,180,87,22.04.2019 00:10,154,15,Rovno
464,447,23,168,273,23,296,0,296,5,206,85,22.04.2019 00:05,154,15,Rovno
288,284,11,107,172,9,181,0,181,3,102,76,22.04.2019 00:15,154,15,Rovno
768,752,43,174,551,43,594,0,594,5,289,300,22.04.2019 00:05,154,15,Rovno
1360,1332,45,443,874,43,917,0,917,15,516,386,22.04.2019 00:08,154,15,Rovno
128,114,8,63,57,8,65,0,65,0,47,18,22.04.2019 01:08,154,15,Rovno
336,330,27,141,170,25,195,0,195,0,110,85,22.04.2019 00:10,154,15,Rovno
176,159,11,52,113,11,124,0,124,0,62,62,22.04.2019 00:15,154,15,Rovno
560,550,38,210,312,38,350,0,350,6,211,133,22.04.2019 00:15,154,15,Rovno
256,247,16,67,175,14,189,0,189,3,123,63,22.04.2019 00:10,154,15,Rovno
288,270,15,109,164,15,179,0,179,3,115,61,22.04.2019 00:01,154,15,Rovno
144,141,16,43,85,16,101,0,101,5,68,28,22.04.2019 00:15,154,15,Rovno
576,557,23,225,328,23,351,0,351,9,165,177,22.04.2019 00:18,154,15,Rovno
240,252,23,85,136,19,155,0,155,8,77,70,22.04.2019 00:17,154,15,Rovno
2224,2184,73,894,1266,64,1330,0,1330,39,692,599,22.04.2019 00:45,154,15,Rovno
160,152,19,62,85,13,98,0,98,3,43,52,22.04.2019 00:05,154,15,Rovno
400,389,41,133,230,37,267,0,267,5,135,127,22.04.2019 00:10,154,15,Rovno
128,124,4,51,73,4,77,0,77,3,45,29,21.04.2019 21:11,154,15,Rovno
704,683,43,244,417,43,460,0,460,13,310,137,22.04.2019 00:15,154,15,Rovno
176,172,14,57,105,14,119,0,119,2,80,37,22.04.2019 00:30,154,15,Rovno
1312,1293,59,495,758,59,817,0,817,11,492,314,22.04.2019 00:10,154,15,Rovno
448,444,33,176,239,33,272,0,272,7,162,103,22.04.2019 00:30,154,15,Rovno
832,816,29,340,463,29,492,0,492,46,234,212,22.04.2019 00:30,154,15,Rovno
736,715,27,246,463,27,490,0,490,11,307,172,22.04.2019 00:15,154,15,Rovno
544,527,34,240,271,33,304,0,304,6,150,148,22.04.2019 01:00,154,15,Rovno
272,34,18,241,13,18,31,0,31,1,16,14,22.04.2019 00:13,154,15,Rovno
1984,1967,7,722,1255,7,1262,0,1262,39,759,464,22.04.2019 00:40,154,15,Rovno
1840,1802,4,735,1101,4,1105,0,1105,34,646,425,22.04.2019 00:40,154,15,Rovno
2080,2072,8,800,1272,8,1280,0,1280,37,783,460,22.04.2019 00:30,154,15,Rovno
1952,1922,89,811,1069,72,1141,0,1141,39,634,468,22.04.2019 00:49,154,15,Rovno
2256,2248,22,879,1361,16,1377,0,1377,52,842,483,22.04.2019 00:53,154,15,Rovno
1296,1277,11,602,686,8,694,0,694,17,467,210,22.04.2019 01:10,154,15,Rovno
1264,1252,11,480,773,11,784,0,784,19,494,271,22.04.2019 00:55,154,15,Rovno
1712,1689,11,664,1037,11,1048,0,1048,20,704,324,22.04.2019 00:25,154,15,Rovno
1104,1074,4,429,671,4,675,0,675,30,380,265,22.04.2019 01:10,154,15,Rovno
1232,1222,8,466,758,8,766,0,766,20,412,334,22.04.2019 01:20,154,15,Rovno
2272,2246,16,903,1354,15,1369,0,1369,40,781,548,22.04.2019 00:10,154,15,Rovno
1440,1411,27,687,730,23,753,0,753,25,507,221,22.04.2019 00:16,154,15,Rovno
1344,1322,24,595,728,21,749,0,749,12,476,261,22.04.2019 00:05,154,15,Rovno
288,277,21,137,132,19,151,0,151,1,98,52,21.04.2019 22:15,154,15,Rovno
864,845,14,453,398,13,411,0,411,17,266,128,22.04.2019 00:05,154,15,Rovno
1040,1025,8,425,610,5,615,0,615,14,353,248,22.04.2019 00:20,154,15,Rovno
1184,1162,6,490,688,6,694,0,694,20,428,246,21.04.2019 23:30,154,15,Rovno
368,347,3,165,202,1,203,0,203,6,118,79,22.04.2019 01:47,154,15,Rovno
496,485,53,190,254,52,306,0,306,4,188,114,22.04.2019 00:10,154,15,Rovno
80,76,18,30,35,15,50,0,50,1,20,29,22.04.2019 00:30,154,15,Rovno
144,128,12,72,63,9,72,0,72,1,39,32,22.04.2019 00:15,154,15,Rovno
592,582,36,223,336,33,369,0,369,9,183,177,22.04.2019 00:16,154,15,Rovno
128,128,11,46,71,11,82,0,82,1,53,28,22.04.2019 02:20,154,15,Rovno
1392,1368,30,627,737,28,765,0,765,15,515,235,22.04.2019 01:10,154,15,Rovno
720,690,62,310,348,62,410,0,410,4,197,209,22.04.2019 00:20,154,15,Rovno
608,599,58,214,339,55,394,0,394,12,209,173,22.04.2019 01:30,154,15,Rovno
1280,1258,25,521,737,22,759,0,759,16,444,299,22.04.2019 00:30,154,15,Rovno
1312,1299,24,543,745,24,769,0,769,14,419,336,22.04.2019 00:35,154,15,Rovno
1504,1490,20,665,820,19,839,0,839,11,487,341,22.04.2019 00:30,154,15,Rovno
624,606,42,247,335,42,377,0,377,6,237,134,22.04.2019 00:30,154,15,Rovno
720,713,28,276,417,27,444,0,444,10,284,150,22.04.2019 00:10,154,15,Rovno
144,137,5,53,86,5,91,0,91,0,48,43,22.04.2019 00:10,154,15,Rovno
400,399,7,57,336,7,343,0,343,4,161,178,22.04.2019 00:16,154,15,Rovno
80,75,0,10,70,0,70,0,70,0,26,44,22.04.2019 00:15,154,15,Rovno
400,387,3,138,259,3,262,0,262,7,164,91,22.04.2019 00:20,154,15,Rovno
256,248,12,124,120,12,132,0,132,4,78,50,22.04.2019 00:02,154,15,Rovno
224,218,0,113,111,0,111,0,111,7,83,21,22.04.2019 00:05,154,15,Rovno
768,751,61,300,407,61,468,0,468,9,261,198,22.04.2019 01:15,154,15,Rovno
512,497,24,159,329,24,353,0,353,5,194,154,22.04.2019 00:30,154,15,Rovno
368,347,22,143,203,22,225,0,225,9,106,110,22.04.2019 00:30,154,15,Rovno
256,250,21,109,130,17,147,0,147,2,83,62,22.04.2019 00:15,154,15,Rovno
256,245,27,101,129,26,155,0,155,4,78,73,22.04.2019 00:43,154,15,Rovno
464,453,6,148,311,5,316,0,316,9,171,136,22.04.2019 00:48,154,15,Rovno
528,510,24,242,263,23,286,0,286,0,168,118,21.04.2019 22:20,154,15,Rovno
368,365,14,168,186,14,200,0,200,3,121,76,22.04.2019 00:10,154,15,Rovno
288,269,20,133,135,20,155,0,155,2,84,69,22.04.2019 00:05,154,15,Rovno
304,286,34,117,157,30,187,0,187,2,112,73,22.04.2019 00:30,154,15,Rovno
592,572,68,161,366,65,431,0,431,6,253,172,22.04.2019 00:20,154,15,Rovno
864,843,13,434,419,11,430,0,430,8,245,177,22.04.2019 00:45,154,15,Rovno
640,625,10,291,340,9,349,0,349,4,179,166,21.04.2019 21:00,154,15,Rovno
352,341,25,145,182,25,207,0,207,3,125,79,22.04.2019 00:20,154,15,Rovno
784,767,50,392,350,42,392,0,392,14,219,159,22.04.2019 00:20,154,15,Rovno
112,110,10,54,48,10,58,0,58,0,39,19,22.04.2019 00:08,154,15,Rovno
208,202,7,71,130,7,137,0,137,3,95,39,22.04.2019 00:45,154,15,Rovno
240,37,14,205,21,14,35,0,35,0,23,12,22.04.2019 00:45,154,15,Rovno
2096,2054,68,847,1192,57,1249,0,1249,32,757,460,22.04.2019 02:30,154,15,Rovno
2048,2022,42,778,1234,36,1270,0,1270,38,721,511,22.04.2019 00:10,154,15,Rovno
2288,2262,46,867,1379,42,1421,0,1421,41,818,562,22.04.2019 00:15,154,15,Rovno
624,613,34,256,339,29,368,0,368,13,187,168,22.04.2019 00:29,154,15,Rovno
320,319,23,89,208,23,231,0,231,2,168,61,22.04.2019 00:30,154,15,Rovno
1136,1120,58,442,644,50,694,0,694,12,409,273,22.04.2019 00:34,154,15,Rovno
528,515,35,200,295,33,328,0,328,1,202,125,22.04.2019 00:30,154,15,Rovno
640,626,40,182,419,39,458,0,458,8,296,154,22.04.2019 00:02,154,15,Rovno
448,444,38,150,263,35,298,0,298,10,198,90,22.04.2019 00:05,154,15,Rovno
512,495,37,255,226,31,257,0,257,2,114,141,22.04.2019 00:30,154,15,Rovno
192,192,13,83,98,11,109,0,109,1,67,41,22.04.2019 00:40,154,15,Rovno
416,397,33,157,228,31,259,0,259,8,181,70,22.04.2019 00:05,154,15,Rovno
208,203,18,69,122,17,139,0,139,3,52,84,22.04.2019 00:12,154,15,Rovno
736,729,70,319,352,65,417,0,417,17,215,185,22.04.2019 00:15,154,15,Rovno
400,396,33,166,202,32,234,0,234,5,139,90,21.04.2019 20:40,154,15,Rovno
304,291,13,141,150,13,163,0,163,3,95,65,22.04.2019 00:03,154,15,Rovno
640,624,32,246,364,30,394,0,394,9,222,163,21.04.2019 20:30,154,15,Rovno
240,228,20,85,136,19,155,0,155,1,98,56,22.04.2019 00:30,154,15,Rovno
432,420,29,155,254,23,277,0,277,7,185,85,21.04.2019 21:00,154,15,Rovno
128,123,16,48,67,13,80,0,80,1,44,35,22.04.2019 00:40,154,15,Rovno
480,471,25,169,289,22,311,0,311,4,191,116,22.04.2019 00:05,154,15,Rovno
128,119,13,53,64,11,75,0,75,0,37,38,22.04.2019 00:15,154,15,Rovno
144,141,7,52,85,7,92,0,92,3,47,42,22.04.2019 00:15,154,15,Rovno
320,311,45,115,165,40,205,0,205,3,118,84,22.04.2019 00:10,154,15,Rovno
800,788,76,327,412,61,473,0,473,4,250,219,22.04.2019 01:15,154,15,Rovno
1184,1173,41,455,688,41,729,0,729,16,414,299,22.04.2019 00:15,154,15,Rovno
1232,1211,34,493,705,34,739,0,739,16,412,311,21.04.2019 22:00,154,15,Rovno
256,243,58,89,114,53,167,0,167,0,72,95,22.04.2019 00:30,154,15,Rovno
416,409,25,179,212,25,237,0,237,1,143,93,22.04.2019 00:05,154,15,Rovno
816,802,50,321,456,39,495,0,495,12,281,202,22.04.2019 00:05,154,15,Rovno
320,309,19,110,191,19,210,0,210,4,131,75,21.04.2019 22:15,154,15,Rovno
1120,1104,88,493,546,81,627,0,627,19,359,249,22.04.2019 00:15,154,15,Rovno
400,394,41,132,229,39,268,0,268,4,133,131,22.04.2019 00:20,154,15,Rovno
144,139,23,48,75,21,96,0,96,2,50,44,22.04.2019 00:30,154,15,Rovno
528,508,57,181,291,56,347,0,347,14,158,175,21.04.2019 21:30,154,15,Rovno
400,399,55,150,203,47,250,0,250,9,93,148,21.04.2019 21:30,154,15,Rovno
784,756,37,299,450,35,485,0,485,12,298,175,22.04.2019 00:02,154,15,Rovno
176,171,13,78,87,11,98,0,98,2,61,35,22.04.2019 00:15,154,15,Rovno
352,334,39,150,170,32,202,0,202,6,109,87,22.04.2019 00:20,154,15,Rovno
864,846,61,333,475,56,531,0,531,12,329,190,22.04.2019 00:10,154,15,Rovno
384,375,31,155,205,24,229,0,229,6,116,107,22.04.2019 00:30,154,15,Rovno
480,467,32,195,258,27,285,0,285,5,128,152,22.04.2019 01:10,154,15,Rovno
608,594,24,268,319,21,340,0,340,11,100,229,22.04.2019 00:20,154,15,Rovno
560,555,38,175,350,35,385,0,385,4,197,184,21.04.2019 21:20,154,15,Rovno
240,226,28,107,108,25,133,0,133,3,68,62,22.04.2019 00:40,154,15,Rovno
304,287,36,120,152,32,184,0,184,2,97,85,22.04.2019 00:15,154,15,Rovno
384,376,34,113,242,29,271,0,271,7,175,89,22.04.2019 00:15,154,15,Rovno
512,491,40,184,291,37,328,0,328,6,192,130,22.04.2019 00:02,154,15,Rovno
208,200,28,67,115,26,141,0,141,0,73,68,22.04.2019 00:20,154,15,Rovno
272,262,23,116,136,20,156,0,156,2,78,76,22.04.2019 00:30,154,15,Rovno
2000,1971,13,853,1135,12,1147,0,1147,30,712,405,22.04.2019 02:15,154,15,Rovno
2080,2039,12,891,1177,12,1189,0,1189,27,730,432,22.04.2019 00:20,154,15,Rovno
2096,2039,10,874,1215,7,1222,0,1222,30,792,400,22.04.2019 02:55,154,15,Rovno
1520,1501,16,628,878,14,892,0,892,25,544,323,22.04.2019 00:20,154,15,Rovno
528,522,28,244,257,27,284,0,284,6,122,156,22.04.2019 00:10,154,15,Rovno
416,397,12,178,226,12,238,0,238,6,136,96,22.04.2019 00:10,154,15,Rovno
656,629,34,249,373,34,407,0,407,4,239,164,22.04.2019 00:10,154,15,Rovno
272,259,21,85,166,21,187,0,187,5,80,102,22.04.2019 00:25,154,15,Rovno
176,159,3,72,102,2,104,0,104,0,65,39,22.04.2019 00:20,154,15,Rovno
240,224,7,100,133,7,140,0,140,3,64,73,22.04.2019 00:30,154,15,Rovno
1088,1082,14,466,609,13,622,0,622,12,387,223,21.04.2019 22:00,154,15,Rovno
1056,1045,18,443,596,17,613,0,613,11,383,219,22.04.2019 00:20,154,15,Rovno
192,184,14,62,116,14,130,0,130,3,53,74,22.04.2019 00:15,154,15,Rovno
192,185,15,62,115,15,130,0,130,2,78,50,22.04.2019 00:10,154,15,Rovno
880,861,54,357,481,42,523,0,523,15,334,174,21.04.2019 21:50,154,15,Rovno
400,390,23,178,201,21,222,0,222,3,100,119,22.04.2019 00:20,154,15,Rovno
288,275,10,103,177,8,185,0,185,4,68,113,22.04.2019 00:05,154,15,Rovno
560,545,50,202,310,48,358,0,358,1,155,202,22.04.2019 00:17,154,15,Rovno
528,511,30,204,295,29,324,0,324,6,232,86,22.04.2019 00:30,154,15,Rovno
1088,1068,16,471,601,16,617,0,617,11,334,272,22.04.2019 00:32,154,15,Rovno
352,348,9,149,194,9,203,0,203,3,110,90,22.04.2019 00:10,154,15,Rovno
256,251,4,115,137,4,141,0,141,8,72,61,22.04.2019 00:10,154,15,Rovno
256,247,3,101,152,3,155,0,155,2,88,65,22.04.2019 00:23,154,15,Rovno
1200,1179,41,503,659,38,697,0,697,23,370,304,22.04.2019 00:55,154,15,Rovno
288,287,15,98,175,15,190,0,190,8,82,100,22.04.2019 00:20,154,15,Rovno
800,789,41,289,472,39,511,0,511,7,299,205,22.04.2019 00:05,154,15,Rovno
512,506,16,184,312,16,328,0,328,7,168,153,22.04.2019 00:20,154,15,Rovno
976,968,28,379,572,25,597,0,597,11,307,279,22.04.2019 00:10,154,15,Rovno
256,252,16,75,165,16,181,0,181,3,93,85,22.04.2019 00:45,154,15,Rovno
1056,1030,13,469,574,13,587,0,587,9,352,226,22.04.2019 01:16,154,15,Rovno
320,311,9,120,191,9,200,0,200,5,90,105,22.04.2019 00:30,154,15,Rovno
656,640,45,265,346,45,391,0,391,2,199,190,22.04.2019 00:20,154,15,Rovno
320,306,30,131,163,26,189,0,189,3,103,83,22.04.2019 00:02,154,15,Rovno
560,550,42,188,330,42,372,0,372,5,244,123,22.04.2019 00:30,154,15,Rovno
288,270,12,102,177,9,186,0,186,0,116,70,22.04.2019 01:12,154,15,Rovno
352,337,24,120,208,24,232,0,232,4,108,120,22.04.2019 00:25,154,15,Rovno
336,325,35,88,215,33,248,0,248,4,107,137,22.04.2019 00:35,154,15,Rovno
608,604,49,240,319,49,368,0,368,12,151,205,22.04.2019 00:10,154,15,Rovno
432,412,24,150,258,24,282,0,282,8,168,106,22.04.2019 00:38,154,15,Rovno
336,326,13,88,235,13,248,0,248,10,135,103,22.04.2019 00:15,154,15,Rovno
272,260,14,96,162,14,176,0,176,5,90,81,22.04.2019 00:20,154,15,Rovno
704,694,40,181,483,40,523,0,523,11,298,214,22.04.2019 00:15,154,15,Rovno
528,518,38,168,322,38,360,0,360,10,176,174,22.04.2019 01:05,154,15,Rovno
656,638,57,317,282,57,339,0,339,16,210,113,22.04.2019 01:10,154,15,Rovno
1472,1431,15,651,810,11,821,0,821,20,504,297,22.04.2019 00:30,154,15,Rovno
1472,1458,15,611,849,12,861,0,861,22,522,317,22.04.2019 00:05,154,15,Rovno
1472,1461,6,560,907,5,912,0,912,42,541,329,22.04.2019 00:03,154,15,Rovno
1568,1538,10,589,969,10,979,0,979,35,553,391,22.04.2019 00:15,154,15,Rovno
1536,1508,7,628,902,6,908,0,908,28,586,294,22.04.2019 01:45,154,15,Rovno
1840,1790,9,769,1064,7,1071,0,1071,28,626,417,22.04.2019 00:20,154,15,Rovno
1584,1561,17,592,977,15,992,0,992,29,599,364,22.04.2019 00:15,154,15,Rovno
1744,1726,14,731,1000,13,1013,0,1013,26,656,331,22.04.2019 00:05,154,15,Rovno
1920,1872,12,779,1132,9,1141,0,1141,56,699,386,22.04.2019 00:25,154,15,Rovno
1472,1442,12,604,857,11,868,0,868,22,560,286,22.04.2019 00:15,154,15,Rovno
1504,1483,19,532,961,11,972,0,972,39,553,380,22.04.2019 00:15,154,15,Rovno
1152,1141,13,481,660,11,671,0,671,18,403,250,22.04.2019 00:10,154,15,Rovno
1584,1575,14,647,926,11,937,0,937,30,543,364,22.04.2019 00:20,154,15,Rovno
1888,1863,11,690,1187,11,1198,0,1198,38,716,444,22.04.2019 00:10,154,15,Rovno
1376,1359,13,602,763,11,774,0,774,20,450,304,22.04.2019 00:25,154,15,Rovno
1600,1577,9,676,915,9,924,0,924,27,548,349,22.04.2019 00:05,154,15,Rovno
1392,1368,96,540,773,79,852,0,852,30,524,298,22.04.2019 00:20,154,15,Rovno
1199,1184,10,429,762,8,770,0,770,16,431,323,22.04.2019 00:10,154,15,Rovno
96,15,0,81,15,0,15,0,15,0,9,6,22.04.2019 00:10,154,15,Rovno
48,42,29,9,13,26,39,0,39,2,22,15,21.04.2019 20:30,154,15,Rovno
2448,2417,7,1089,1353,6,1359,0,1359,34,720,605,22.04.2019 00:12,155,15,Rovno
2368,2332,8,1113,1248,7,1255,0,1255,32,667,556,22.04.2019 00:30,155,15,Rovno
2320,2288,8,967,1345,8,1353,0,1353,27,790,536,22.04.2019 00:30,155,15,Rovno
2432,2390,23,1036,1373,23,1396,0,1396,33,834,529,22.04.2019 00:18,155,15,Rovno
1024,1004,48,477,501,46,547,0,547,12,329,206,22.04.2019 00:30,155,15,Rovno
384,372,20,145,222,17,239,0,239,11,131,97,22.04.2019 00:40,155,15,Rovno
704,692,31,328,348,28,376,0,376,5,231,140,21.04.2019 22:21,155,15,Rovno
656,643,8,352,298,6,304,0,304,15,136,153,22.04.2019 00:35,155,15,Rovno
288,284,8,108,174,6,180,0,180,2,115,63,22.04.2019 00:05,155,15,Rovno
496,487,21,217,259,20,279,0,279,5,168,106,22.04.2019 00:10,155,15,Rovno
368,355,12,201,157,10,167,0,167,3,64,100,22.04.2019 00:15,155,15,Rovno
1504,1468,16,880,615,9,624,0,624,13,315,296,22.04.2019 00:55,155,15,Rovno
128,124,5,63,62,3,65,0,65,1,30,34,22.04.2019 04:30,155,15,Rovno
848,838,31,426,391,31,422,0,422,8,235,179,22.04.2019 01:05,155,15,Rovno
640,634,17,331,293,16,309,0,309,6,145,158,22.04.2019 00:40,155,15,Rovno
432,427,19,202,211,19,230,0,230,4,103,123,22.04.2019 05:57,155,15,Rovno
2080,2059,53,927,1101,52,1153,0,1153,22,652,479,22.04.2019 00:15,155,15,Rovno
352,347,8,149,195,8,203,0,203,5,104,94,22.04.2019 00:10,155,15,Rovno
1152,1136,4,600,550,2,552,0,552,5,322,225,22.04.2019 00:05,155,15,Rovno
256,245,1,143,112,1,113,0,113,3,52,58,22.04.2019 00:05,155,15,Rovno
1456,1432,61,662,738,56,794,0,794,10,451,333,22.04.2019 00:15,155,15,Rovno
480,461,7,210,263,7,270,0,270,16,129,125,22.04.2019 00:08,155,15,Rovno
528,515,23,210,295,23,318,0,318,19,143,156,22.04.2019 00:30,155,15,Rovno
1440,1412,9,713,719,8,727,0,727,14,413,300,22.04.2019 00:15,155,15,Rovno
656,646,31,294,336,26,362,0,362,8,189,165,22.04.2019 00:35,155,15,Rovno
880,865,51,265,565,50,615,0,615,13,362,240,22.04.2019 00:10,155,15,Rovno
656,635,36,231,391,34,425,0,425,9,217,199,22.04.2019 00:10,155,15,Rovno
544,532,24,218,304,22,326,0,326,6,203,117,22.04.2019 00:15,155,15,Rovno
1456,1449,38,673,746,37,783,0,783,16,178,589,22.04.2019 00:40,155,15,Rovno
384,383,12,109,263,12,275,0,275,1,95,179,22.04.2019 00:40,155,15,Rovno
608,596,26,237,345,26,371,0,371,10,194,167,22.04.2019 00:20,155,15,Rovno
176,168,6,67,103,6,109,0,109,4,41,64,22.04.2019 01:38,155,15,Rovno
768,760,36,348,389,31,420,0,420,2,251,167,22.04.2019 00:04,155,15,Rovno
240,231,19,89,133,18,151,0,151,0,84,67,22.04.2019 00:20,155,15,Rovno
448,444,16,191,241,16,257,0,257,7,153,97,22.04.2019 00:30,155,15,Rovno
192,183,4,93,96,3,99,0,99,0,53,46,22.04.2019 00:05,155,15,Rovno
1440,1419,21,719,701,20,721,0,721,25,428,268,21.04.2019 22:35,155,15,Rovno
128,122,7,64,57,7,64,0,64,0,29,35,22.04.2019 00:30,155,15,Rovno
448,442,19,157,273,18,291,0,291,8,135,148,22.04.2019 00:10,155,15,Rovno
736,735,44,383,318,35,353,0,353,8,204,141,22.04.2019 00:30,155,15,Rovno
1072,1054,29,421,622,29,651,0,651,8,366,277,22.04.2019 00:15,155,15,Rovno
1232,1203,10,537,687,8,695,0,695,21,432,242,22.04.2019 00:05,155,15,Rovno
672,665,16,304,354,14,368,0,368,4,263,101,22.04.2019 00:30,155,15,Rovno
352,338,2,135,215,2,217,0,217,2,175,40,22.04.2019 00:30,155,15,Rovno
816,793,30,453,342,21,363,0,363,13,191,159,22.04.2019 00:21,155,15,Rovno
784,769,28,360,396,28,424,0,424,15,219,190,22.04.2019 00:05,155,15,Rovno
640,634,7,345,288,7,295,0,295,6,167,122,22.04.2019 06:15,155,15,Rovno
768,751,11,394,363,11,374,0,374,7,140,227,22.04.2019 02:00,155,15,Rovno
368,365,1,231,136,1,137,0,137,2,63,72,22.04.2019 00:30,155,15,Rovno
800,776,19,308,475,17,492,0,492,3,293,196,22.04.2019 00:10,155,15,Rovno
1440,1424,28,762,650,28,678,0,678,19,398,261,22.04.2019 00:33,155,15,Rovno
688,669,32,322,340,26,366,0,366,12,267,87,22.04.2019 00:15,155,15,Rovno
208,205,9,76,123,9,132,0,132,1,77,54,22.04.2019 00:10,155,15,Rovno
176,142,0,34,142,0,142,0,142,7,112,23,22.04.2019 00:15,155,15,Rovno
1984,1940,7,785,1192,7,1199,0,1199,30,709,460,22.04.2019 00:20,155,15,Rovno
1760,1728,4,719,1037,4,1041,0,1041,23,623,395,22.04.2019 01:46,155,15,Rovno
1536,1493,0,732,804,0,804,0,804,20,524,260,22.04.2019 00:40,155,15,Rovno
1840,1780,4,811,1026,3,1029,0,1029,18,645,366,22.04.2019 00:14,155,15,Rovno
464,425,0,224,240,0,240,0,240,2,144,94,22.04.2019 00:15,155,15,Rovno
1248,1222,4,507,737,4,741,0,741,18,481,242,22.04.2019 00:01,155,15,Rovno
224,216,0,80,144,0,144,0,144,2,108,34,22.04.2019 00:21,155,15,Rovno
448,441,7,149,292,7,299,0,299,3,193,103,22.04.2019 00:45,155,15,Rovno
320,317,18,103,199,18,217,0,217,3,132,82,22.04.2019 00:08,155,15,Rovno
2016,1974,6,778,1232,6,1238,0,1238,23,683,532,22.04.2019 01:30,155,15,Rovno
656,643,2,311,343,2,345,0,345,3,264,78,22.04.2019 00:25,155,15,Rovno
112,101,0,42,70,0,70,0,70,10,26,34,22.04.2019 00:40,155,15,Rovno
560,548,32,203,326,31,357,0,357,6,168,183,22.04.2019 00:40,155,15,Rovno
1472,1481,47,687,741,44,785,0,785,13,482,290,22.04.2019 00:15,155,15,Rovno
352,349,7,131,214,7,221,0,221,4,128,89,22.04.2019 00:10,155,15,Rovno
720,700,25,310,385,25,410,0,410,6,233,171,22.04.2019 00:20,155,15,Rovno
1280,1257,10,652,619,9,628,0,628,15,408,205,22.04.2019 00:20,155,15,Rovno
1632,1603,32,701,899,32,931,0,931,12,587,332,22.04.2019 00:15,155,15,Rovno
624,603,20,300,304,20,324,0,324,3,214,107,22.04.2019 00:50,155,15,Rovno
336,318,16,94,226,16,242,0,242,5,170,67,22.04.2019 00:10,155,15,Rovno
416,391,7,174,235,7,242,0,242,1,145,96,22.04.2019 00:03,155,15,Rovno
512,491,7,203,303,6,309,0,309,9,152,148,22.04.2019 00:15,155,15,Rovno
384,374,12,158,214,12,226,0,226,6,147,73,22.04.2019 00:05,155,15,Rovno
160,147,6,35,119,6,125,0,125,3,52,70,22.04.2019 00:10,155,15,Rovno
464,457,27,142,297,25,322,0,322,6,211,105,22.04.2019 00:10,155,15,Rovno
880,858,2,429,449,2,451,0,451,8,297,146,22.04.2019 00:15,155,15,Rovno
784,757,5,244,537,3,540,0,540,7,276,257,22.04.2019 00:10,155,15,Rovno
384,380,6,184,194,6,200,0,200,3,104,93,22.04.2019 00:10,155,15,Rovno
208,197,3,82,124,2,126,0,126,3,56,67,22.04.2019 00:04,155,15,Rovno
608,598,12,222,375,11,386,0,386,6,240,140,22.04.2019 00:03,155,15,Rovno
576,558,20,161,396,19,415,0,415,6,263,146,22.04.2019 00:05,155,15,Rovno
416,405,2,216,198,2,200,0,200,3,116,81,22.04.2019 00:05,155,15,Rovno
736,732,26,275,435,26,461,0,461,6,219,236,22.04.2019 00:20,155,15,Rovno
1088,1074,1,583,504,1,505,0,505,9,321,175,22.04.2019 00:50,155,15,Rovno
480,468,3,187,290,3,293,0,293,5,81,207,22.04.2019 00:03,155,15,Rovno
1552,1529,13,626,915,11,926,0,926,10,665,251,22.04.2019 00:35,155,15,Rovno
496,494,3,155,338,3,341,0,341,9,258,74,22.04.2019 00:02,155,15,Rovno
1440,1407,33,642,765,33,798,0,798,16,428,354,22.04.2019 00:55,155,15,Rovno
384,375,8,168,208,8,216,0,216,6,137,73,22.04.2019 00:15,155,15,Rovno
400,385,17,145,238,17,255,0,255,3,112,140,22.04.2019 00:05,155,15,Rovno
208,200,20,54,134,20,154,0,154,7,58,89,22.04.2019 00:04,155,15,Rovno
1472,1431,30,617,825,30,855,0,855,15,479,361,22.04.2019 00:30,155,15,Rovno
528,518,32,166,330,32,362,0,362,6,250,106,22.04.2019 00:25,155,15,Rovno
240,233,14,73,153,14,167,0,167,6,100,61,22.04.2019 01:55,155,15,Rovno
224,203,17,84,124,16,140,0,140,4,57,79,22.04.2019 00:45,155,15,Rovno
320,315,4,133,185,2,187,0,187,3,107,77,22.04.2019 00:35,155,15,Rovno
416,400,6,145,266,5,271,0,271,2,189,80,22.04.2019 00:10,155,15,Rovno
176,160,12,58,106,12,118,0,118,1,84,33,22.04.2019 00:35,155,15,Rovno
688,671,49,159,480,49,529,0,529,7,286,236,22.04.2019 00:32,155,15,Rovno
416,400,36,154,227,35,262,0,262,6,157,99,22.04.2019 05:55,155,15,Rovno
240,29,11,212,18,10,28,0,28,1,16,11,22.04.2019 00:35,155,15,Rovno
1392,1368,16,581,796,15,811,0,811,8,612,191,22.04.2019 00:04,155,15,Rovno
1456,1428,10,615,833,8,841,0,841,19,589,233,22.04.2019 01:10,155,15,Rovno
1504,1480,2,656,847,1,848,0,848,12,617,219,22.04.2019 00:35,155,15,Rovno
704,683,1,349,354,1,355,0,355,4,278,73,22.04.2019 00:20,155,15,Rovno
560,547,10,198,353,9,362,0,362,2,288,72,21.04.2019 22:05,155,15,Rovno
160,164,3,51,106,3,109,0,109,0,76,33,22.04.2019 00:05,155,15,Rovno
1744,1725,15,1029,704,11,715,0,715,25,485,205,22.04.2019 01:30,155,15,Rovno
544,536,7,260,279,5,284,0,284,5,176,103,22.04.2019 00:25,155,15,Rovno
128,120,1,61,67,0,67,0,67,4,48,15,22.04.2019 00:05,155,15,Rovno
992,987,71,419,506,67,573,0,573,2,413,158,22.04.2019 01:30,155,15,Rovno
352,341,29,126,197,29,226,0,226,0,118,108,22.04.2019 00:10,155,15,Rovno
1328,1296,3,634,692,2,694,0,694,16,480,198,22.04.2019 00:10,155,15,Rovno
368,365,16,133,221,14,235,0,235,2,150,83,22.04.2019 02:45,155,15,Rovno
64,58,2,22,42,0,42,0,42,0,21,21,22.04.2019 05:08,155,15,Rovno
128,117,6,44,78,6,84,0,84,0,72,12,22.04.2019 00:15,155,15,Rovno
464,454,52,171,245,48,293,0,293,2,178,113,22.04.2019 00:30,155,15,Rovno
224,208,14,63,147,14,161,0,161,6,97,58,22.04.2019 00:07,155,15,Rovno
240,233,12,75,155,10,165,0,165,2,90,73,22.04.2019 01:30,155,15,Rovno
512,509,22,154,337,21,358,0,358,1,303,54,22.04.2019 01:30,155,15,Rovno
336,323,18,127,191,18,209,0,209,4,163,42,22.04.2019 00:10,155,15,Rovno
688,685,41,249,404,35,439,0,439,4,299,136,22.04.2019 00:10,155,15,Rovno
480,477,23,188,271,21,292,0,292,8,133,151,22.04.2019 00:05,155,15,Rovno
736,726,56,255,431,50,481,0,481,3,332,146,22.04.2019 00:25,155,15,Rovno
288,273,15,79,195,14,209,0,209,0,141,68,22.04.2019 00:40,155,15,Rovno
448,437,27,151,271,26,297,0,297,4,191,102,22.04.2019 00:40,155,15,Rovno
384,377,24,179,181,24,205,0,205,0,156,49,22.04.2019 00:25,155,15,Rovno
416,405,8,132,276,8,284,0,284,4,162,118,22.04.2019 00:20,155,15,Rovno
752,726,44,281,433,38,471,0,471,14,379,78,22.04.2019 01:20,155,15,Rovno
48,46,8,11,30,7,37,0,37,0,29,8,22.04.2019 00:17,155,15,Rovno
448,434,76,177,205,66,271,0,271,6,203,62,22.04.2019 05:40,155,15,Rovno
800,775,21,354,430,16,446,0,446,11,258,177,22.04.2019 00:15,155,15,Rovno
80,72,13,33,34,13,47,0,47,0,34,13,22.04.2019 00:05,155,15,Rovno
48,45,8,20,21,7,28,0,28,0,22,6,22.04.2019 00:35,155,15,Rovno
592,586,48,242,307,43,350,0,350,8,252,90,22.04.2019 00:50,155,15,Rovno
288,285,9,120,161,7,168,0,168,2,139,27,22.04.2019 00:37,155,15,Rovno
400,395,37,150,217,33,250,0,250,13,151,86,22.04.2019 02:10,155,15,Rovno
384,371,24,153,209,22,231,0,231,7,150,74,22.04.2019 01:35,155,15,Rovno
112,105,8,38,67,7,74,0,74,0,47,27,22.04.2019 00:45,155,15,Rovno
96,86,6,32,58,6,64,0,64,0,45,19,22.04.2019 00:05,155,15,Rovno
144,141,9,50,85,9,94,0,94,3,58,33,22.04.2019 01:10,155,15,Rovno
1408,1371,25,611,774,23,797,0,797,13,625,159,22.04.2019 00:45,155,15,Rovno
512,503,5,261,247,4,251,0,251,0,197,54,22.04.2019 02:10,155,15,Rovno
352,353,2,144,206,2,208,0,208,2,159,47,22.04.2019 00:05,155,15,Rovno
192,176,9,39,144,9,153,0,153,3,99,51,22.04.2019 00:30,155,15,Rovno
64,56,8,28,31,5,36,0,36,1,19,16,22.04.2019 00:05,155,15,Rovno
1440,1418,42,676,731,33,764,0,764,20,557,187,22.04.2019 00:45,155,15,Rovno
1872,1824,25,789,1072,11,1083,0,1083,26,810,247,22.04.2019 00:55,155,15,Rovno
1968,1927,25,864,1086,18,1104,0,1104,24,803,277,22.04.2019 00:15,155,15,Rovno
1520,1504,24,750,746,24,770,0,770,22,565,183,22.04.2019 02:30,155,15,Rovno
432,428,5,222,207,3,210,0,210,8,145,57,22.04.2019 00:05,155,15,Rovno
2096,2066,84,790,1230,76,1306,0,1306,24,882,400,22.04.2019 01:35,155,15,Rovno
368,351,7,168,193,7,200,0,200,5,144,51,22.04.2019 00:15,155,15,Rovno
240,229,7,94,141,5,146,0,146,2,108,36,22.04.2019 00:05,155,15,Rovno
720,700,42,315,367,38,405,0,405,8,264,133,22.04.2019 00:11,155,15,Rovno
288,276,7,105,176,7,183,0,183,12,124,47,22.04.2019 01:00,155,15,Rovno
224,212,7,62,155,7,162,0,162,4,103,55,22.04.2019 00:10,155,15,Rovno
1072,1050,45,497,532,43,575,0,575,14,401,160,22.04.2019 00:15,155,15,Rovno
544,531,26,225,293,26,319,0,319,10,199,110,22.04.2019 00:15,155,15,Rovno
496,480,32,184,281,31,312,0,312,3,214,95,22.04.2019 00:05,155,15,Rovno
384,370,12,147,229,8,237,0,237,3,144,90,22.04.2019 00:15,155,15,Rovno
704,697,54,256,396,52,448,0,448,10,251,187,22.04.2019 00:10,155,15,Rovno
368,358,12,104,254,10,264,0,264,4,201,59,22.04.2019 00:25,155,15,Rovno
1888,1876,15,972,903,13,916,0,916,22,635,259,21.04.2019 22:50,155,15,Rovno
720,714,11,276,434,10,444,0,444,15,366,63,22.04.2019 01:30,155,15,Rovno
2000,1978,32,948,1021,31,1052,0,1052,17,574,461,22.04.2019 00:26,155,15,Rovno
944,925,40,459,448,37,485,0,485,13,318,154,22.04.2019 00:30,155,15,Rovno
480,475,14,193,273,14,287,0,287,9,188,90,22.04.2019 01:50,155,15,Rovno
368,360,29,169,172,27,199,0,199,4,119,76,22.04.2019 01:05,155,15,Rovno
1408,1392,22,542,844,22,866,0,866,27,623,216,22.04.2019 04:50,155,15,Rovno
832,806,11,397,425,10,435,0,435,8,298,129,22.04.2019 01:55,155,15,Rovno
416,408,11,113,292,11,303,0,303,16,217,70,22.04.2019 00:55,155,15,Rovno
2048,2012,43,871,1141,36,1177,0,1177,28,956,193,22.04.2019 00:10,155,15,Rovno
208,205,8,66,135,7,142,0,142,0,100,42,22.04.2019 01:25,155,15,Rovno
624,619,11,247,366,11,377,0,377,5,296,76,22.04.2019 00:10,155,15,Rovno
752,731,44,288,423,41,464,0,464,2,354,108,22.04.2019 00:40,155,15,Rovno
160,158,3,41,116,3,119,0,119,2,64,53,22.04.2019 00:15,155,15,Rovno
848,829,60,311,481,56,537,0,537,7,312,218,22.04.2019 00:20,155,15,Rovno
2400,2385,38,1154,1210,36,1246,0,1246,24,801,421,22.04.2019 00:10,155,15,Rovno
1200,1178,32,580,592,28,620,0,620,10,469,141,22.04.2019 00:17,155,15,Rovno
512,509,21,79,416,17,433,0,433,5,291,137,22.04.2019 00:30,155,15,Rovno
1584,1544,14,640,933,11,944,0,944,24,594,326,22.04.2019 01:10,155,15,Rovno
1696,1701,22,636,1044,16,1060,0,1060,24,634,402,22.04.2019 00:22,155,15,Rovno
1616,1584,14,618,986,12,998,0,998,37,559,402,22.04.2019 00:05,155,15,Rovno
1840,1808,18,682,1142,16,1158,0,1158,20,697,441,22.04.2019 00:20,155,15,Rovno
1744,1703,14,646,1087,11,1098,0,1098,26,616,456,22.04.2019 00:09,155,15,Rovno
1696,1658,13,608,1078,10,1088,0,1088,24,660,404,22.04.2019 00:15,155,15,Rovno
2352,2283,18,865,1477,10,1487,0,1487,31,856,600,22.04.2019 01:11,155,15,Rovno
2368,2324,13,861,1497,10,1507,0,1507,27,847,633,22.04.2019 02:30,155,15,Rovno
2352,2296,12,912,1434,6,1440,0,1440,34,842,564,22.04.2019 01:10,155,15,Rovno
2304,2239,17,847,1443,14,1457,0,1457,35,841,581,22.04.2019 00:10,155,15,Rovno
2160,2113,22,712,1433,15,1448,0,1448,39,792,617,22.04.2019 00:05,155,15,Rovno
2000,1970,21,677,1307,16,1323,0,1323,31,750,542,22.04.2019 00:20,155,15,Rovno
2160,2089,16,795,1354,11,1365,0,1365,44,792,529,22.04.2019 00:30,155,15,Rovno
1248,1243,2,328,919,1,920,0,920,13,493,414,22.04.2019 00:10,155,15,Rovno
1360,1347,7,563,790,7,797,0,797,36,496,265,22.04.2019 00:45,156,15,Rovno
1872,1842,9,769,1094,9,1103,0,1103,43,656,404,22.04.2019 01:30,156,15,Rovno
1392,1363,12,697,683,12,695,0,695,10,496,189,22.04.2019 00:01,156,15,Rovno
576,564,2,292,283,1,284,0,284,5,203,76,22.04.2019 00:30,156,15,Rovno
528,521,2,214,313,1,314,0,314,6,220,88,21.04.2019 23:50,156,15,Rovno
880,868,4,335,541,4,545,0,545,13,358,174,22.04.2019 00:45,156,15,Rovno
2016,1991,46,990,984,42,1026,0,1026,24,685,317,22.04.2019 00:40,156,15,Rovno
656,645,18,249,390,17,407,0,407,5,250,152,22.04.2019 00:10,156,15,Rovno
448,435,6,177,266,5,271,0,271,3,96,172,21.04.2019 23:30,156,15,Rovno
320,309,20,118,182,20,202,0,202,4,131,67,22.04.2019 00:40,156,15,Rovno
1600,1585,39,623,938,39,977,0,977,16,523,438,22.04.2019 00:25,156,15,Rovno
464,446,13,212,239,13,252,0,252,3,145,104,22.04.2019 00:20,156,15,Rovno
2144,2119,41,864,1239,41,1280,0,1280,32,898,350,22.04.2019 00:35,156,15,Rovno
800,792,29,411,363,26,389,0,389,6,141,242,22.04.2019 01:20,156,15,Rovno
640,618,4,319,317,4,321,0,321,12,208,101,22.04.2019 00:05,156,15,Rovno
2096,2065,46,805,1245,46,1291,0,1291,24,885,382,21.04.2019 20:55,156,15,Rovno
880,872,28,368,484,28,512,0,512,11,350,151,21.04.2019 21:40,156,15,Rovno
256,248,16,89,151,16,167,0,167,2,112,53,22.04.2019 00:17,156,15,Rovno
416,400,27,171,218,27,245,0,245,1,144,100,22.04.2019 00:03,156,15,Rovno
1232,1218,22,579,632,21,653,0,653,14,414,225,22.04.2019 00:10,156,15,Rovno
496,478,15,256,226,14,240,0,240,13,141,86,21.04.2019 21:30,156,15,Rovno
208,201,18,81,109,18,127,0,127,2,88,37,21.04.2019 20:56,156,15,Rovno
384,370,19,144,222,18,240,0,240,7,163,70,22.04.2019 01:15,156,15,Rovno
1856,1824,30,882,946,28,974,0,974,15,626,333,22.04.2019 01:15,156,15,Rovno
1232,1206,24,613,595,24,619,0,619,10,291,318,22.04.2019 00:15,156,15,Rovno
1008,1002,37,305,666,37,703,0,703,17,388,298,22.04.2019 00:40,156,15,Rovno
1024,1018,9,511,504,9,513,0,513,4,346,163,22.04.2019 00:20,156,15,Rovno
1088,1069,4,571,514,3,517,0,517,12,321,184,22.04.2019 00:30,156,15,Rovno
256,243,21,105,131,20,151,0,151,2,96,53,22.04.2019 01:40,156,15,Rovno
144,135,8,37,99,8,107,0,107,5,65,37,22.04.2019 01:35,156,15,Rovno
976,962,31,421,524,31,555,0,555,17,327,211,22.04.2019 00:50,156,15,Rovno
672,655,22,251,399,22,421,0,421,22,284,115,22.04.2019 00:35,156,15,Rovno
624,609,36,209,379,36,415,0,415,6,268,141,22.04.2019 00:50,156,15,Rovno
832,818,9,479,344,9,353,0,353,6,249,98,21.04.2019 23:05,156,15,Rovno
256,42,20,219,18,19,37,0,37,0,18,19,22.04.2019 00:40,156,15,Rovno
640,622,50,243,349,48,397,0,397,5,256,136,22.04.2019 00:15,156,15,Rovno
448,440,27,198,224,26,250,0,250,6,178,66,21.04.2019 21:05,156,15,Rovno
384,367,22,118,245,21,266,0,266,4,136,126,21.04.2019 20:35,156,15,Rovno
560,544,20,192,349,19,368,0,368,6,231,131,21.04.2019 21:45,156,15,Rovno
720,696,30,269,424,27,451,0,451,5,272,174,22.04.2019 00:15,156,15,Rovno
416,398,15,158,243,15,258,0,258,4,152,102,22.04.2019 00:10,156,15,Rovno
192,183,10,70,113,9,122,0,122,1,80,41,21.04.2019 20:40,156,15,Rovno
512,506,14,227,273,12,285,0,285,7,174,104,22.04.2019 00:38,156,15,Rovno
528,511,18,180,330,18,348,0,348,6,163,179,21.04.2019 23:00,156,15,Rovno
1568,1543,82,435,1053,80,1133,0,1133,17,504,612,22.04.2019 01:03,156,15,Rovno
848,843,18,241,589,18,607,0,607,17,268,322,22.04.2019 00:05,156,15,Rovno
160,145,0,68,92,0,92,0,92,0,34,58,21.04.2019 22:20,156,15,Rovno
240,236,3,83,154,3,157,0,157,3,83,71,22.04.2019 00:05,156,15,Rovno
624,602,14,274,336,14,350,0,350,10,124,216,22.04.2019 00:10,156,15,Rovno
272,261,7,122,143,7,150,0,150,11,46,93,21.04.2019 22:05,156,15,Rovno
720,707,21,261,438,21,459,0,459,8,244,207,22.04.2019 00:15,156,15,Rovno
160,151,1,45,114,1,115,0,115,2,38,75,22.04.2019 00:15,156,15,Rovno
288,277,4,130,154,4,158,0,158,0,73,85,21.04.2019 22:30,156,15,Rovno
1168,1153,40,444,684,40,724,0,724,10,359,355,21.04.2019 23:50,156,15,Rovno
256,254,0,75,181,0,181,0,181,3,65,113,21.04.2019 22:45,156,15,Rovno
128,124,2,51,75,2,77,0,77,0,45,32,21.04.2019 23:30,156,15,Rovno
160,158,14,57,90,13,103,0,103,3,28,72,21.04.2019 21:10,156,15,Rovno
624,615,15,280,329,15,344,0,344,2,222,120,21.04.2019 23:55,156,15,Rovno
720,707,22,280,419,21,440,0,440,7,317,116,22.04.2019 00:50,156,15,Rovno
1056,1181,12,326,721,9,730,0,730,13,425,292,22.04.2019 00:35,156,15,Rovno
64,64,6,31,28,5,33,0,33,0,20,13,22.04.2019 00:07,156,15,Rovno
496,476,28,196,272,28,300,0,300,4,175,121,22.04.2019 00:10,156,15,Rovno
144,132,3,57,87,0,87,0,87,5,40,42,22.04.2019 00:15,156,15,Rovno
208,205,20,79,110,19,129,0,129,4,78,47,21.04.2019 20:40,156,15,Rovno
144,135,6,50,88,6,94,0,94,0,61,33,21.04.2019 22:40,156,15,Rovno
528,518,52,125,353,50,403,0,403,7,184,212,22.04.2019 03:45,156,15,Rovno
160,158,17,44,99,17,116,0,116,3,47,66,21.04.2019 22:05,156,15,Rovno
208,196,12,86,110,12,122,0,122,2,70,50,21.04.2019 22:20,156,15,Rovno
496,486,16,229,251,16,267,0,267,4,186,77,21.04.2019 23:20,156,15,Rovno
192,185,5,74,113,5,118,0,118,3,72,43,22.04.2019 00:45,156,15,Rovno
416,409,11,186,219,11,230,0,230,4,161,65,22.04.2019 00:05,156,15,Rovno
1008,1002,21,415,572,21,593,0,593,10,350,233,22.04.2019 00:50,156,15,Rovno
144,132,3,41,100,3,103,0,103,0,59,44,22.04.2019 00:20,156,15,Rovno
192,185,9,82,101,9,110,0,110,4,82,24,22.04.2019 00:20,156,15,Rovno
112,106,5,44,64,4,68,0,68,1,46,21,21.04.2019 21:00,156,15,Rovno
336,311,22,181,134,21,155,0,155,2,83,70,21.04.2019 21:50,156,15,Rovno
688,677,9,323,358,7,365,0,365,8,187,170,22.04.2019 00:50,156,15,Rovno
560,538,4,243,313,4,317,0,317,4,217,96,22.04.2019 00:30,156,15,Rovno
176,161,3,92,81,3,84,0,84,1,58,25,21.04.2019 21:40,156,15,Rovno
608,592,18,275,320,13,333,0,333,8,193,132,21.04.2019 21:56,156,15,Rovno
288,275,15,148,125,15,140,0,140,3,98,39,22.04.2019 00:10,156,15,Rovno
240,235,16,100,125,15,140,0,140,3,91,46,21.04.2019 20:48,156,15,Rovno
880,863,47,364,474,42,516,0,516,6,271,239,21.04.2019 23:45,156,15,Rovno
480,462,23,214,244,22,266,0,266,7,151,108,21.04.2019 23:10,156,15,Rovno
96,88,2,41,53,2,55,0,55,0,26,29,21.04.2019 22:00,156,15,Rovno
1440,1429,33,681,726,33,759,0,759,17,453,289,21.04.2019 21:50,156,15,Rovno
160,144,8,39,113,8,121,0,121,0,58,63,22.04.2019 00:50,156,15,Rovno
464,460,46,168,250,46,296,0,296,7,148,141,21.04.2019 22:10,156,15,Rovno
320,316,6,138,176,6,182,0,182,3,100,79,21.04.2019 20:28,156,15,Rovno
592,593,8,255,329,8,337,0,337,7,213,117,22.04.2019 00:15,156,15,Rovno
2176,2140,12,934,1231,11,1242,0,1242,36,750,456,22.04.2019 00:45,156,15,Rovno
1200,1173,7,516,680,4,684,0,684,16,435,233,21.04.2019 21:10,156,15,Rovno
1856,1827,14,713,1133,10,1143,0,1143,22,651,470,22.04.2019 00:40,156,15,Rovno
1632,1611,7,697,931,4,935,0,935,23,608,304,22.04.2019 00:31,156,15,Rovno
2016,1957,28,880,1115,21,1136,0,1136,24,755,357,21.04.2019 21:25,156,15,Rovno
768,753,1,345,422,1,423,0,423,5,299,119,21.04.2019 20:50,156,15,Rovno
1904,1873,18,806,1086,12,1098,0,1098,30,685,383,22.04.2019 00:30,156,15,Rovno
2176,2145,8,917,1251,8,1259,0,1259,45,728,486,22.04.2019 00:08,156,15,Rovno
2048,2024,12,885,1153,10,1163,0,1163,35,660,468,22.04.2019 00:20,156,15,Rovno
2112,2055,15,941,1156,15,1171,0,1171,22,670,479,22.04.2019 00:30,156,15,Rovno
2240,2230,13,927,1302,11,1313,0,1313,27,772,514,22.04.2019 00:30,156,15,Rovno
144,34,22,115,12,17,29,0,29,0,16,13,21.04.2019 20:30,156,15,Rovno
464,446,2,219,243,2,245,0,245,5,165,75,22.04.2019 00:15,156,15,Rovno
1136,1133,9,459,669,8,677,0,677,22,475,180,21.04.2019 21:10,156,15,Rovno
1152,1129,16,477,660,15,675,0,675,16,454,205,22.04.2019 00:35,156,15,Rovno
960,935,6,426,528,6,534,0,534,11,391,132,22.04.2019 01:30,156,15,Rovno
1104,1076,16,456,638,10,648,0,648,13,475,160,22.04.2019 00:30,156,15,Rovno
1040,1005,9,446,586,8,594,0,594,16,398,180,21.04.2019 21:02,156,15,Rovno
1328,1299,6,664,659,5,664,0,664,24,435,205,22.04.2019 00:04,156,15,Rovno
1200,1177,8,443,750,7,757,0,757,17,558,182,22.04.2019 00:35,156,15,Rovno
1392,1350,18,603,775,14,789,0,789,14,594,181,22.04.2019 00:45,156,15,Rovno
1072,1073,13,411,652,9,661,0,661,11,472,178,22.04.2019 00:10,156,15,Rovno
928,922,9,372,547,9,556,0,556,20,407,129,21.04.2019 21:00,156,15,Rovno
1424,1387,9,582,835,7,842,0,842,20,608,214,22.04.2019 00:08,156,15,Rovno
1392,1360,5,590,798,4,802,0,802,12,591,199,22.04.2019 01:40,156,15,Rovno
1344,1320,6,578,761,5,766,0,766,11,566,189,22.04.2019 03:45,156,15,Rovno
1280,1243,9,557,715,8,723,0,723,18,520,185,22.04.2019 00:25,156,15,Rovno
1552,1552,9,725,818,9,827,0,827,20,571,236,22.04.2019 00:36,156,15,Rovno
2144,2106,11,981,1153,10,1163,0,1163,22,899,242,22.04.2019 00:15,156,15,Rovno
1136,1113,15,547,576,13,589,0,589,16,469,104,22.04.2019 01:10,156,15,Rovno
2400,2363,41,1034,1340,26,1366,0,1366,29,1089,248,22.04.2019 01:40,156,15,Rovno
1568,1547,36,831,705,32,737,0,737,19,629,89,22.04.2019 00:45,156,15,Rovno
1344,1329,55,497,801,46,847,0,847,23,505,319,22.04.2019 01:45,156,15,Rovno
1568,1543,56,719,803,46,849,0,849,33,494,322,22.04.2019 01:15,156,15,Rovno
512,504,11,261,242,9,251,0,251,11,176,64,22.04.2019 00:35,156,15,Rovno
224,218,6,77,141,6,147,0,147,2,74,71,22.04.2019 00:20,156,15,Rovno
144,145,9,56,79,9,88,0,88,2,60,26,22.04.2019 00:20,156,15,Rovno
128,114,6,59,65,4,69,0,69,0,34,35,22.04.2019 00:35,156,15,Rovno
96,89,1,45,50,1,51,0,51,1,29,21,22.04.2019 00:30,156,15,Rovno
1856,1813,73,608,1175,73,1248,0,1248,25,740,483,22.04.2019 02:30,156,15,Rovno
512,497,20,198,295,19,314,0,314,4,146,164,22.04.2019 00:20,156,15,Rovno
224,215,10,66,148,10,158,0,158,5,95,58,22.04.2019 00:30,156,15,Rovno
1424,1405,28,789,611,24,635,0,635,18,407,210,22.04.2019 00:10,156,15,Rovno
368,365,6,137,226,5,231,0,231,5,157,69,21.04.2019 21:30,156,15,Rovno
224,215,10,87,127,10,137,0,137,1,115,21,21.04.2019 21:50,156,15,Rovno
480,466,15,280,185,15,200,0,200,1,151,48,21.04.2019 22:00,156,15,Rovno
1632,1604,17,658,958,16,974,0,974,21,720,233,22.04.2019 02:50,156,15,Rovno
960,938,13,437,512,11,523,0,523,13,462,48,22.04.2019 03:00,156,15,Rovno
400,387,21,172,207,21,228,0,228,6,110,112,22.04.2019 00:30,156,15,Rovno
368,352,12,197,159,12,171,0,171,7,93,71,22.04.2019 00:17,156,15,Rovno
1552,1535,35,609,908,35,943,0,943,11,633,299,22.04.2019 00:15,156,15,Rovno
736,719,19,253,466,17,483,0,483,7,367,109,22.04.2019 01:30,156,15,Rovno
480,460,3,189,289,2,291,0,291,5,201,85,22.04.2019 00:10,156,15,Rovno
1024,1011,42,571,420,33,453,0,453,6,342,105,22.04.2019 00:03,156,15,Rovno
464,455,5,213,246,5,251,0,251,3,200,48,22.04.2019 00:15,156,15,Rovno
1904,1872,21,1012,874,18,892,0,892,12,604,276,22.04.2019 00:30,156,15,Rovno
304,298,7,156,142,6,148,0,148,4,71,73,22.04.2019 00:20,156,15,Rovno
192,189,1,68,123,1,124,0,124,0,88,36,21.04.2019 21:20,156,15,Rovno
480,457,29,205,247,28,275,0,275,8,187,80,21.04.2019 23:00,156,15,Rovno
176,171,13,69,95,12,107,0,107,1,51,55,22.04.2019 00:10,156,15,Rovno
288,279,17,126,147,15,162,0,162,6,108,48,22.04.2019 00:15,156,15,Rovno
224,219,7,88,131,5,136,0,136,2,97,37,22.04.2019 00:05,156,15,Rovno
1728,1704,23,761,946,21,967,0,967,13,684,270,21.04.2019 22:50,156,15,Rovno
880,862,20,458,406,16,422,0,422,12,312,98,22.04.2019 01:52,156,15,Rovno
368,364,5,154,210,4,214,0,214,3,167,44,22.04.2019 00:15,156,15,Rovno
144,140,3,50,91,3,94,0,94,0,52,42,22.04.2019 00:15,156,15,Rovno
2384,2361,9,1101,1274,9,1283,0,1283,23,974,286,22.04.2019 00:20,156,15,Rovno
560,548,6,235,319,6,325,0,325,6,246,73,22.04.2019 00:30,156,15,Rovno
112,95,13,50,49,13,62,0,62,2,44,16,22.04.2019 00:05,156,15,Rovno
656,628,33,356,267,33,300,0,300,1,199,100,22.04.2019 00:20,156,15,Rovno
1184,1165,24,697,463,24,487,0,487,3,294,190,21.04.2019 21:40,156,15,Rovno
656,634,22,297,337,22,359,0,359,7,243,109,22.04.2019 00:15,156,15,Rovno
816,808,8,475,334,7,341,0,341,17,169,155,22.04.2019 00:15,156,15,Rovno
1664,1639,53,753,862,49,911,0,911,19,675,217,22.04.2019 00:20,156,15,Rovno
96,85,1,51,44,1,45,0,45,2,34,9,22.04.2019 01:10,156,15,Rovno
2416,2399,39,1155,1228,33,1261,0,1261,38,784,439,22.04.2019 00:20,156,15,Rovno
816,796,15,359,442,15,457,0,457,15,250,192,22.04.2019 00:20,156,15,Rovno
848,833,30,356,462,30,492,0,492,13,275,204,22.04.2019 00:30,156,15,Rovno
720,702,9,402,311,7,318,0,318,5,180,133,22.04.2019 00:20,156,15,Rovno
1696,1679,13,972,711,13,724,0,724,9,273,442,22.04.2019 00:10,156,15,Rovno
448,27,15,424,12,12,24,0,24,0,16,8,22.04.2019 00:12,156,15,Rovno
128,31,0,97,31,0,31,0,31,0,19,12,21.04.2019 23:00,156,15,Rovno
96,32,0,67,29,0,29,0,29,0,23,6,22.04.2019 00:25,156,15,Rovno
544,473,0,71,473,0,473,0,473,39,399,35,22.04.2019 00:25,156,15,Rovno
336,329,0,159,177,0,177,0,177,6,60,111,22.04.2019 00:25,156,15,Rovno
1952,1928,6,853,1093,6,1099,0,1099,20,706,373,22.04.2019 00:15,156,15,Rovno
496,482,0,14,482,0,482,0,482,57,404,21,22.04.2019 00:26,157,16,Sumy
1456,1437,43,548,881,27,908,0,908,26,670,212,22.04.2019 00:08,157,16,Sumy
2384,2373,48,752,1597,35,1632,0,1632,36,1164,432,22.04.2019 00:20,157,16,Sumy
1504,1484,20,503,985,16,1001,0,1001,39,716,246,22.04.2019 00:20,157,16,Sumy
2208,2174,60,709,1458,41,1499,0,1499,32,1137,330,22.04.2019 00:30,157,16,Sumy
2304,2263,54,762,1505,37,1542,0,1542,45,1083,414,22.04.2019 00:17,157,16,Sumy
2128,2102,66,788,1283,57,1340,0,1340,33,1029,278,22.04.2019 00:35,157,16,Sumy
1680,1627,35,590,1064,26,1090,0,1090,32,811,247,22.04.2019 00:25,157,16,Sumy
1584,1500,11,603,971,10,981,0,981,27,759,195,22.04.2019 02:25,157,16,Sumy
2176,2133,43,723,1412,41,1453,0,1453,37,1071,345,22.04.2019 00:10,157,16,Sumy
1632,1593,1,740,892,0,892,0,892,14,711,167,22.04.2019 00:15,157,16,Sumy
2320,2283,29,826,1470,24,1494,0,1494,35,1173,286,22.04.2019 00:45,157,16,Sumy
2256,2244,52,815,1401,40,1441,0,1441,36,1124,281,22.04.2019 04:09,157,16,Sumy
752,747,4,227,521,4,525,0,525,16,388,121,22.04.2019 00:12,157,16,Sumy
2224,2183,22,725,1483,16,1499,0,1499,34,1125,340,22.04.2019 00:45,157,16,Sumy
2175,2149,14,655,1509,11,1520,0,1520,32,1187,301,22.04.2019 00:30,157,16,Sumy
2064,2039,25,678,1376,10,1386,0,1386,31,1089,266,22.04.2019 00:35,157,16,Sumy
2192,2167,7,796,1391,5,1396,0,1396,27,1078,291,22.04.2019 00:20,157,16,Sumy
2256,2227,15,812,1434,10,1444,0,1444,28,1104,312,22.04.2019 00:15,157,16,Sumy
1968,1957,10,657,1305,6,1311,0,1311,33,1046,232,22.04.2019 00:35,157,16,Sumy
2320,2277,35,778,1517,25,1542,0,1542,30,1202,310,22.04.2019 00:20,157,16,Sumy
2192,2158,22,682,1492,18,1510,0,1510,39,1155,316,22.04.2019 00:10,157,16,Sumy
1840,1819,14,648,1180,12,1192,0,1192,37,948,207,22.04.2019 00:30,157,16,Sumy
1760,1737,10,584,1167,9,1176,0,1176,33,894,249,22.04.2019 00:32,157,16,Sumy
2080,2045,15,683,1387,10,1397,0,1397,43,1054,300,22.04.2019 00:21,157,16,Sumy
1968,1931,28,666,1277,25,1302,0,1302,44,979,279,22.04.2019 00:10,157,16,Sumy
2304,2291,14,784,1508,12,1520,0,1520,36,1144,340,22.04.2019 00:40,157,16,Sumy
1488,1475,3,433,1053,2,1055,0,1055,15,817,223,22.04.2019 00:05,157,16,Sumy
80,9,0,71,9,0,9,0,9,0,8,1,22.04.2019 00:07,157,16,Sumy
384,40,20,344,20,20,40,0,40,0,37,3,21.04.2019 20:50,157,16,Sumy
128,20,15,109,5,14,19,0,19,1,14,4,22.04.2019 00:05,157,16,Sumy
1616,1603,7,878,731,7,738,0,738,14,559,165,22.04.2019 00:09,157,16,Sumy
1392,1371,13,539,840,13,853,0,853,29,598,226,22.04.2019 00:05,157,16,Sumy
1792,1760,15,540,1242,10,1252,0,1252,31,916,305,22.04.2019 00:10,157,16,Sumy
1520,1507,15,568,940,12,952,0,952,20,762,170,22.04.2019 00:21,157,16,Sumy
1840,1814,8,655,1181,4,1185,0,1185,26,960,199,22.04.2019 00:55,157,16,Sumy
1968,1929,18,892,1060,16,1076,0,1076,18,859,199,22.04.2019 00:15,157,16,Sumy
1920,1932,16,750,1156,14,1170,0,1170,25,944,201,21.04.2019 22:00,157,16,Sumy
2224,2194,8,695,1523,6,1529,0,1529,48,1130,351,22.04.2019 00:05,157,16,Sumy
2016,1981,12,670,1334,12,1346,0,1346,40,968,338,22.04.2019 01:10,157,16,Sumy
2176,2130,16,793,1368,15,1383,0,1383,33,1093,257,22.04.2019 00:25,157,16,Sumy
2304,2266,20,816,1469,19,1488,0,1488,53,1113,322,22.04.2019 00:10,157,16,Sumy
2176,2142,10,712,1457,7,1464,0,1464,45,1106,313,22.04.2019 00:15,157,16,Sumy
2160,2141,19,702,1444,14,1458,0,1458,37,1103,318,22.04.2019 00:20,157,16,Sumy
2224,2192,9,731,1485,8,1493,0,1493,26,1170,297,22.04.2019 00:30,157,16,Sumy
2288,2269,18,776,1499,13,1512,0,1512,41,1169,302,22.04.2019 00:20,157,16,Sumy
2352,2306,14,821,1519,12,1531,0,1531,36,1157,338,22.04.2019 00:45,157,16,Sumy
2352,2304,15,777,1564,11,1575,0,1575,51,1190,334,22.04.2019 00:05,157,16,Sumy
2432,2407,19,828,1586,18,1604,0,1604,39,1276,289,22.04.2019 01:25,157,16,Sumy
2336,2303,5,830,1504,2,1506,0,1506,28,1155,323,22.04.2019 00:02,157,16,Sumy
2304,2267,4,810,1490,4,1494,0,1494,31,1158,305,22.04.2019 01:05,157,16,Sumy
1936,1908,14,689,1233,14,1247,0,1247,25,1003,219,22.04.2019 00:08,157,16,Sumy
1536,1510,23,512,1001,23,1024,0,1024,21,836,167,22.04.2019 00:05,157,16,Sumy
1984,1960,16,669,1304,11,1315,0,1315,39,1003,273,22.04.2019 00:05,157,16,Sumy
2256,2247,20,754,1490,12,1502,0,1502,37,1152,313,22.04.2019 00:02,157,16,Sumy
2432,2402,32,813,1591,28,1619,0,1619,40,1254,325,22.04.2019 00:05,157,16,Sumy
2080,2041,16,735,1332,13,1345,0,1345,22,1116,207,22.04.2019 00:30,157,16,Sumy
1968,1946,13,682,1282,4,1286,0,1286,52,973,261,22.04.2019 00:15,157,16,Sumy
1920,1891,20,618,1287,15,1302,0,1302,32,993,277,22.04.2019 00:10,157,16,Sumy
1904,1882,19,662,1229,13,1242,0,1242,34,953,255,22.04.2019 00:15,157,16,Sumy
1728,1696,26,558,1150,20,1170,0,1170,33,883,254,22.04.2019 00:20,157,16,Sumy
2240,2229,22,768,1453,19,1472,0,1472,28,1146,298,22.04.2019 00:05,157,16,Sumy
2464,2431,18,874,1578,12,1590,0,1590,33,1243,314,22.04.2019 00:45,157,16,Sumy
2426,2390,12,939,1476,11,1487,0,1487,24,1212,251,22.04.2019 00:05,157,16,Sumy
2304,2264,12,817,1477,10,1487,0,1487,40,1183,264,22.04.2019 00:15,157,16,Sumy
1840,1872,10,610,1222,8,1230,0,1230,47,1005,178,22.04.2019 00:15,157,16,Sumy
2128,2092,17,743,1373,12,1385,0,1385,34,1093,258,22.04.2019 00:42,157,16,Sumy
2288,2255,23,803,1464,21,1485,0,1485,37,1184,264,22.04.2019 00:05,157,16,Sumy
1600,1552,15,536,1051,13,1064,0,1064,27,847,190,22.04.2019 00:07,157,16,Sumy
1696,1678,2,719,975,2,977,0,977,25,834,118,22.04.2019 00:04,157,16,Sumy
2256,2237,17,867,1374,15,1389,0,1389,52,1090,247,22.04.2019 00:07,157,16,Sumy
2080,2035,4,745,1331,4,1335,0,1335,40,1042,253,22.04.2019 00:07,157,16,Sumy
2176,2158,15,761,1403,12,1415,0,1415,26,1044,345,22.04.2019 00:15,157,16,Sumy
2368,2338,20,965,1388,15,1403,0,1403,30,1159,214,22.04.2019 00:05,157,16,Sumy
2256,2225,9,866,1382,8,1390,0,1390,22,1140,228,22.04.2019 00:59,157,16,Sumy
2256,2221,21,768,1473,15,1488,0,1488,33,1192,263,22.04.2019 00:30,157,16,Sumy
2144,2101,6,744,1395,5,1400,0,1400,35,1158,207,22.04.2019 00:45,157,16,Sumy
2432,2377,7,766,1661,5,1666,0,1666,31,1290,345,22.04.2019 00:40,157,16,Sumy
464,461,4,141,319,4,323,0,323,10,247,66,22.04.2019 00:07,157,16,Sumy
2160,2148,21,620,1524,16,1540,0,1540,25,1182,333,21.04.2019 23:30,157,16,Sumy
192,192,93,12,92,88,180,0,180,5,111,64,21.04.2019 21:04,157,16,Sumy
2304,2283,20,836,1449,19,1468,0,1468,40,1168,260,22.04.2019 00:20,157,16,Sumy
2096,2062,5,978,1113,5,1118,0,1118,23,913,182,22.04.2019 00:03,157,16,Sumy
1984,1957,14,672,1300,12,1312,0,1312,17,1075,219,22.04.2019 00:20,157,16,Sumy
1728,1698,16,692,1025,11,1036,0,1036,17,871,148,22.04.2019 00:25,157,16,Sumy
1552,1530,18,616,919,17,936,0,936,14,764,158,22.04.2019 00:10,157,16,Sumy
864,856,2,309,554,1,555,0,555,12,428,115,22.04.2019 00:10,157,16,Sumy
192,29,0,163,29,0,29,0,29,0,26,3,22.04.2019 00:15,157,16,Sumy
320,17,0,303,17,0,17,0,17,0,11,6,22.04.2019 00:10,157,16,Sumy
672,102,59,571,43,58,101,0,101,1,89,11,22.04.2019 00:50,157,16,Sumy
352,91,7,262,83,7,90,0,90,3,77,10,22.04.2019 00:10,157,16,Sumy
64,8,1,57,7,0,7,0,7,0,5,2,22.04.2019 00:20,157,16,Sumy
176,51,3,126,47,3,50,0,50,2,34,14,22.04.2019 00:15,157,16,Sumy
240,18,0,222,18,0,18,0,18,0,13,5,21.04.2019 21:30,157,16,Sumy
96,60,5,39,53,4,57,0,57,0,48,9,22.04.2019 00:10,157,16,Sumy
224,32,0,193,31,0,31,0,31,0,24,7,22.04.2019 00:06,157,16,Sumy
64,39,0,26,38,0,38,0,38,1,30,7,22.04.2019 00:10,157,16,Sumy
896,388,27,511,358,27,385,0,385,24,335,26,22.04.2019 00:15,157,16,Sumy
2304,2283,21,833,1457,14,1471,0,1471,39,1199,233,22.04.2019 00:05,157,16,Sumy
1760,1736,14,687,1065,8,1073,0,1073,29,815,229,22.04.2019 00:15,157,16,Sumy
1360,1337,21,647,697,16,713,0,713,15,617,81,22.04.2019 00:25,158,16,Sumy
1424,1405,26,607,798,19,817,0,817,19,736,62,22.04.2019 00:10,158,16,Sumy
2336,2294,40,942,1370,24,1394,0,1394,27,1159,208,22.04.2019 00:10,158,16,Sumy
2320,2282,33,972,1320,28,1348,0,1348,37,1111,200,22.04.2019 00:15,158,16,Sumy
2320,2290,36,939,1356,25,1381,0,1381,30,1133,218,22.04.2019 00:10,158,16,Sumy
2336,2294,40,1150,1152,34,1186,0,1186,22,1029,135,22.04.2019 00:30,158,16,Sumy
1216,1200,32,546,643,27,670,0,670,12,587,71,22.04.2019 00:05,158,16,Sumy
896,878,43,371,485,40,525,0,525,10,470,45,22.04.2019 01:57,158,16,Sumy
1040,1022,36,527,484,29,513,0,513,7,444,62,22.04.2019 00:15,158,16,Sumy
736,718,18,338,383,15,398,0,398,5,355,38,21.04.2019 21:05,158,16,Sumy
400,392,42,149,212,39,251,0,251,5,203,43,22.04.2019 00:30,158,16,Sumy
224,210,23,112,91,21,112,0,112,2,97,13,21.04.2019 20:50,158,16,Sumy
1104,1081,47,432,626,46,672,0,672,10,570,92,22.04.2019 00:10,158,16,Sumy
1360,1348,40,514,808,38,846,0,846,11,758,77,21.04.2019 22:20,158,16,Sumy
944,919,59,364,524,56,580,0,580,7,514,59,21.04.2019 21:30,158,16,Sumy
288,278,33,95,164,29,193,0,193,4,162,27,21.04.2019 21:08,158,16,Sumy
256,243,10,77,170,9,179,0,179,3,137,39,21.04.2019 22:15,158,16,Sumy
240,225,22,86,132,22,154,0,154,0,141,13,21.04.2019 22:10,158,16,Sumy
880,863,98,264,522,94,616,0,616,12,522,82,21.04.2019 23:57,158,16,Sumy
896,883,101,284,527,85,612,0,612,4,516,92,21.04.2019 23:45,158,16,Sumy
336,321,57,94,189,53,242,0,242,3,200,39,21.04.2019 20:45,158,16,Sumy
384,376,63,105,221,58,279,0,279,0,228,51,22.04.2019 00:40,158,16,Sumy
112,102,25,29,62,21,83,0,83,0,69,14,21.04.2019 22:10,158,16,Sumy
80,72,4,29,48,3,51,0,51,0,39,12,21.04.2019 21:45,158,16,Sumy
1120,1099,123,509,497,114,611,0,611,6,532,73,21.04.2019 21:05,158,16,Sumy
560,543,44,233,290,37,327,0,327,12,275,40,21.04.2019 20:30,158,16,Sumy
624,602,58,285,286,53,339,0,339,6,274,59,21.04.2019 21:10,158,16,Sumy
320,315,39,135,149,36,185,0,185,7,137,41,21.04.2019 20:40,158,16,Sumy
448,436,41,162,247,39,286,0,286,4,233,49,21.04.2019 21:59,158,16,Sumy
128,116,20,47,65,16,81,0,81,0,63,18,21.04.2019 21:35,158,16,Sumy
256,251,43,105,118,33,151,0,151,1,128,22,22.04.2019 00:05,158,16,Sumy
272,264,50,109,114,49,163,0,163,1,152,10,22.04.2019 00:20,158,16,Sumy
96,93,20,35,43,18,61,0,61,0,38,23,21.04.2019 23:05,158,16,Sumy
448,430,39,221,200,27,227,0,227,5,194,28,21.04.2019 20:57,158,16,Sumy
208,199,18,107,86,15,101,0,101,1,71,29,21.04.2019 23:55,158,16,Sumy
176,159,26,66,85,25,110,0,110,3,70,37,21.04.2019 21:05,158,16,Sumy
432,423,44,189,203,40,243,0,243,6,193,44,22.04.2019 00:10,158,16,Sumy
672,652,60,236,379,57,436,0,436,4,358,74,22.04.2019 00:02,158,16,Sumy
128,114,21,66,45,17,62,0,62,2,38,22,21.04.2019 20:45,158,16,Sumy
336,323,47,120,173,43,216,0,216,4,175,37,21.04.2019 20:34,158,16,Sumy
592,575,89,209,300,83,383,0,383,4,347,32,21.04.2019 21:30,158,16,Sumy
336,330,44,113,187,36,223,0,223,2,199,22,21.04.2019 21:30,158,16,Sumy
352,340,45,137,171,44,215,0,215,1,183,31,22.04.2019 00:25,158,16,Sumy
432,422,55,184,201,47,248,0,248,0,201,47,22.04.2019 00:30,158,16,Sumy
432,423,63,222,155,55,210,0,210,4,173,33,22.04.2019 00:20,158,16,Sumy
608,589,100,160,354,94,448,0,448,5,378,65,21.04.2019 21:30,158,16,Sumy
544,530,77,160,314,70,384,0,384,6,317,61,22.04.2019 00:10,158,16,Sumy
608,599,76,286,257,65,322,0,322,7,301,14,22.04.2019 00:30,158,16,Sumy
224,218,29,86,117,21,138,0,138,3,92,43,21.04.2019 20:16,158,16,Sumy
272,263,25,114,137,21,158,0,158,1,120,37,21.04.2019 21:00,158,16,Sumy
112,100,9,50,53,9,62,0,62,1,46,15,22.04.2019 00:10,158,16,Sumy
176,161,27,69,82,25,107,0,107,1,79,27,21.04.2019 20:55,158,16,Sumy
528,517,81,157,296,75,371,0,371,9,275,87,21.04.2019 21:35,158,16,Sumy
144,143,19,41,88,15,103,0,103,1,90,12,22.04.2019 00:10,158,16,Sumy
400,392,50,79,274,47,321,0,321,0,264,57,21.04.2019 21:00,158,16,Sumy
80,73,8,18,55,7,62,0,62,0,41,21,21.04.2019 20:50,158,16,Sumy
304,299,42,98,167,39,206,0,206,2,174,30,22.04.2019 00:15,158,16,Sumy
192,178,28,82,84,26,110,0,110,1,79,30,22.04.2019 00:15,158,16,Sumy
192,30,18,162,12,18,30,0,30,0,25,5,22.04.2019 00:15,158,16,Sumy
1104,1101,20,362,722,20,742,0,742,19,601,122,22.04.2019 00:25,158,16,Sumy
1968,1947,66,692,1222,54,1276,0,1276,18,1025,233,22.04.2019 00:08,158,16,Sumy
432,409,33,191,214,27,241,0,241,1,196,44,22.04.2019 02:40,158,16,Sumy
1344,1315,63,538,757,49,806,0,806,22,643,141,22.04.2019 00:10,158,16,Sumy
464,450,39,161,270,33,303,0,303,10,251,42,22.04.2019 00:40,158,16,Sumy
1280,1256,50,469,769,42,811,0,811,17,676,118,22.04.2019 00:25,158,16,Sumy
128,118,22,47,60,21,81,0,81,4,47,30,22.04.2019 00:20,158,16,Sumy
368,359,28,148,195,25,220,0,220,3,187,30,22.04.2019 02:31,158,16,Sumy
800,795,67,351,386,63,449,0,449,2,398,49,22.04.2019 00:15,158,16,Sumy
720,700,80,308,336,76,412,0,412,5,369,38,21.04.2019 21:45,158,16,Sumy
288,276,18,112,159,17,176,0,176,2,148,26,22.04.2019 03:00,158,16,Sumy
320,305,26,106,192,22,214,0,214,12,155,47,21.04.2019 23:17,158,16,Sumy
1136,1100,71,494,583,59,642,0,642,10,544,88,22.04.2019 01:00,158,16,Sumy
240,238,21,99,121,20,141,0,141,2,116,23,22.04.2019 00:10,158,16,Sumy
464,456,39,145,282,37,319,0,319,4,293,22,21.04.2019 21:20,158,16,Sumy
416,405,15,200,204,12,216,0,216,5,182,29,21.04.2019 23:00,158,16,Sumy
416,409,15,183,219,14,233,0,233,3,203,27,21.04.2019 21:40,158,16,Sumy
320,302,2,167,151,2,153,0,153,5,126,22,22.04.2019 00:30,158,16,Sumy
96,85,10,22,64,10,74,0,74,0,66,8,22.04.2019 00:10,158,16,Sumy
816,797,76,309,437,70,507,0,507,7,447,53,22.04.2019 00:15,158,16,Sumy
96,80,13,33,51,12,63,0,63,0,38,25,22.04.2019 00:10,158,16,Sumy
1184,1162,16,587,583,14,597,0,597,10,527,60,22.04.2019 00:40,158,16,Sumy
432,427,5,225,202,5,207,0,207,1,190,16,22.04.2019 00:15,158,16,Sumy
416,413,47,144,228,44,272,0,272,3,221,48,22.04.2019 00:40,158,16,Sumy
432,419,43,189,203,40,243,0,243,1,212,30,22.04.2019 00:10,158,16,Sumy
480,458,40,180,267,33,300,0,300,3,248,49,22.04.2019 00:20,158,16,Sumy
528,517,49,180,299,49,348,0,348,8,310,30,21.04.2019 21:30,158,16,Sumy
208,207,25,37,146,25,171,0,171,0,143,28,21.04.2019 22:30,158,16,Sumy
1056,1048,94,395,574,87,661,0,661,9,540,112,21.04.2019 23:50,158,16,Sumy
336,314,30,118,188,30,218,0,218,3,174,41,22.04.2019 00:35,158,16,Sumy
336,326,23,175,142,19,161,0,161,0,147,14,22.04.2019 00:50,158,16,Sumy
160,155,34,57,70,33,103,0,103,1,76,26,22.04.2019 01:00,158,16,Sumy
592,595,53,214,332,46,378,0,378,6,332,40,22.04.2019 01:25,158,16,Sumy
320,307,37,101,185,34,219,0,219,3,208,8,22.04.2019 00:20,158,16,Sumy
144,133,10,55,79,10,89,0,89,3,79,7,22.04.2019 00:10,158,16,Sumy
400,382,18,212,174,14,188,0,188,3,166,19,22.04.2019 00:40,158,16,Sumy
432,421,34,135,266,31,297,0,297,1,262,34,21.04.2019 21:10,158,16,Sumy
128,120,33,60,39,29,68,0,68,1,60,7,22.04.2019 01:55,158,16,Sumy
704,686,53,333,326,45,371,0,371,10,272,89,21.04.2019 22:02,158,16,Sumy
128,117,6,73,49,6,55,0,55,0,40,15,21.04.2019 20:50,158,16,Sumy
144,15,14,130,1,13,14,0,14,0,10,4,22.04.2019 00:35,158,16,Sumy
416,403,19,191,206,19,225,0,225,4,184,37,21.04.2019 23:03,158,16,Sumy
240,230,20,82,138,20,158,0,158,1,135,22,21.04.2019 21:00,158,16,Sumy
1520,1508,79,535,908,77,985,0,985,23,790,172,22.04.2019 01:45,158,16,Sumy
384,377,19,158,207,19,226,0,226,6,176,44,21.04.2019 20:42,158,16,Sumy
384,372,24,180,181,23,204,0,204,6,151,47,22.04.2019 04:10,158,16,Sumy
368,351,41,185,147,36,183,0,183,2,148,33,22.04.2019 00:10,158,16,Sumy
112,105,11,40,62,10,72,0,72,0,60,12,22.04.2019 00:05,158,16,Sumy
656,640,33,229,396,31,427,0,427,2,342,83,22.04.2019 00:07,158,16,Sumy
2368,2340,58,901,1410,57,1467,0,1467,20,1159,288,22.04.2019 01:35,158,16,Sumy
1696,1696,13,666,1019,11,1030,0,1030,21,875,134,22.04.2019 00:05,158,16,Sumy
1392,1379,12,582,801,9,810,0,809,11,687,111,22.04.2019 00:45,158,16,Sumy
384,347,25,177,182,25,207,0,207,4,174,29,22.04.2019 00:20,158,16,Sumy
368,356,20,139,214,15,229,0,229,7,191,31,22.04.2019 00:05,158,16,Sumy
352,338,46,139,167,46,213,0,213,3,178,32,21.04.2019 22:10,158,16,Sumy
688,670,59,264,369,55,424,0,424,5,376,43,22.04.2019 00:05,158,16,Sumy
240,231,25,81,137,22,159,0,159,3,123,33,22.04.2019 00:05,158,16,Sumy
208,203,24,81,105,22,127,0,127,3,86,38,21.04.2019 21:30,158,16,Sumy
400,390,43,169,192,39,231,0,231,3,183,45,21.04.2019 21:40,158,16,Sumy
624,612,54,163,408,53,461,0,461,4,375,82,21.04.2019 21:25,158,16,Sumy
160,150,7,57,96,7,103,0,103,0,80,23,21.04.2019 21:00,158,16,Sumy
176,162,13,61,102,13,115,0,115,2,101,12,22.04.2019 00:25,158,16,Sumy
2400,2369,78,902,1439,59,1498,0,1498,23,1154,321,21.04.2019 22:25,158,16,Sumy
432,412,22,140,270,22,292,0,292,5,260,27,21.04.2019 22:30,158,16,Sumy
736,729,71,250,415,71,486,0,486,7,409,70,22.04.2019 00:25,158,16,Sumy
256,244,17,111,130,15,145,0,145,2,92,51,21.04.2019 21:00,158,16,Sumy
864,775,77,311,484,69,553,0,553,2,435,116,22.04.2019 00:20,158,16,Sumy
576,574,48,277,257,42,299,0,299,5,237,57,21.04.2019 21:05,158,16,Sumy
1120,1089,91,491,549,80,629,0,629,7,522,100,22.04.2019 02:40,158,16,Sumy
1120,1100,89,475,579,66,645,0,645,13,530,102,22.04.2019 00:48,158,16,Sumy
1936,1923,65,857,1023,56,1079,0,1079,18,932,129,21.04.2019 21:00,158,16,Sumy
928,922,62,380,492,56,548,0,548,4,446,98,22.04.2019 00:50,158,16,Sumy
576,570,7,242,327,7,334,0,334,3,280,51,21.04.2019 23:50,158,16,Sumy
608,587,56,298,262,48,310,0,310,3,277,30,21.04.2019 20:48,158,16,Sumy
1008,995,94,453,467,88,555,0,555,8,451,96,22.04.2019 00:25,158,16,Sumy
368,355,17,134,219,15,234,0,234,2,163,69,21.04.2019 21:20,158,16,Sumy
384,388,37,173,177,34,211,0,211,2,191,18,21.04.2019 23:50,158,16,Sumy
1472,1445,37,478,966,28,994,0,994,25,739,230,22.04.2019 01:05,158,16,Sumy
480,467,39,192,255,33,288,0,288,2,237,49,21.04.2019 22:00,158,16,Sumy
800,776,101,281,430,89,519,0,519,5,397,117,22.04.2019 00:15,158,16,Sumy
320,313,20,141,160,19,179,0,179,2,156,21,22.04.2019 00:05,158,16,Sumy
272,263,18,93,161,18,179,0,179,4,149,26,21.04.2019 20:40,158,16,Sumy
1520,1485,55,606,865,49,914,0,914,10,761,143,22.04.2019 00:15,158,16,Sumy
1424,1407,60,575,793,56,849,0,849,17,661,171,22.04.2019 01:25,158,16,Sumy
1200,1180,48,442,723,35,758,0,758,14,630,114,21.04.2019 21:00,158,16,Sumy
1584,1559,54,619,921,44,965,0,965,13,814,138,22.04.2019 00:10,158,16,Sumy
1744,2029,53,476,1228,40,1268,0,1268,37,976,255,22.04.2019 00:15,158,16,Sumy
224,212,31,90,105,29,134,0,134,1,108,25,21.04.2019 20:55,158,16,Sumy
416,401,23,160,233,23,256,0,256,6,218,32,22.04.2019 00:05,158,16,Sumy
736,726,68,284,394,58,452,0,452,8,351,93,22.04.2019 00:30,158,16,Sumy
1552,1526,96,536,932,84,1016,0,1016,19,832,165,22.04.2019 00:29,158,16,Sumy
1808,1799,42,815,958,35,993,0,993,17,764,212,22.04.2019 00:15,158,16,Sumy
592,579,27,259,306,27,333,0,333,2,302,29,21.04.2019 21:40,158,16,Sumy
1872,1861,101,717,1073,82,1155,0,1155,22,900,233,21.04.2019 22:00,158,16,Sumy
592,582,32,286,278,28,306,0,306,3,249,54,21.04.2019 21:55,158,16,Sumy
1072,1058,72,476,524,72,596,0,596,14,491,91,22.04.2019 00:15,158,16,Sumy
720,714,126,278,325,117,442,0,442,9,368,65,21.04.2019 21:55,158,16,Sumy
224,93,29,132,64,28,92,0,92,3,76,13,21.04.2019 21:00,158,16,Sumy
2352,2324,55,724,1585,43,1628,0,1628,39,1197,391,22.04.2019 00:15,158,16,Sumy
2112,2086,59,732,1342,38,1380,0,1380,45,1031,304,22.04.2019 00:15,158,16,Sumy
2208,2182,63,776,1391,41,1432,0,1432,27,1100,305,22.04.2019 00:06,158,16,Sumy
2288,2252,37,775,1494,19,1513,0,1513,34,1170,309,22.04.2019 06:30,158,16,Sumy
2208,2201,35,760,1423,25,1448,0,1448,33,1133,282,22.04.2019 01:05,158,16,Sumy
1984,1959,22,634,1336,14,1350,0,1350,38,1007,305,22.04.2019 00:40,158,16,Sumy
2272,2252,24,665,1590,17,1607,0,1607,39,1279,289,22.04.2019 03:10,158,16,Sumy
2128,2088,22,709,1400,19,1419,0,1418,40,1130,248,22.04.2019 00:30,158,16,Sumy
2032,2001,19,627,1387,18,1405,0,1405,48,1049,308,22.04.2019 01:30,158,16,Sumy
2496,2495,11,838,1653,5,1658,0,1658,31,1289,338,22.04.2019 00:35,158,16,Sumy
2176,2153,35,768,1382,26,1408,0,1407,39,1127,241,21.04.2019 23:30,158,16,Sumy
1952,1920,15,701,1241,10,1251,0,1251,26,938,287,22.04.2019 00:15,158,16,Sumy
1872,1837,25,689,1164,19,1183,0,1183,31,950,202,22.04.2019 00:30,158,16,Sumy
1472,1442,20,508,949,15,964,0,964,20,791,153,22.04.2019 00:10,158,16,Sumy
1984,1957,38,706,1248,30,1278,0,1278,50,990,238,22.04.2019 00:05,158,16,Sumy
2000,1974,25,705,1275,20,1295,0,1295,32,1025,238,21.04.2019 21:20,158,16,Sumy
1520,1509,59,522,961,37,998,0,998,18,794,186,21.04.2019 21:25,158,16,Sumy
1568,1539,35,522,1021,25,1046,0,1046,17,824,205,22.04.2019 00:10,158,16,Sumy
2208,2191,12,747,1454,7,1461,0,1461,29,1194,238,22.04.2019 00:40,158,16,Sumy
2240,2204,37,866,1352,22,1374,0,1374,33,1111,230,22.04.2019 00:15,158,16,Sumy
1856,1822,22,674,1168,14,1182,0,1182,32,923,227,22.04.2019 01:05,158,16,Sumy
1936,1907,14,779,1145,12,1157,0,1157,33,948,176,22.04.2019 00:20,158,16,Sumy
2208,2178,24,897,1297,14,1311,0,1311,38,1090,183,22.04.2019 00:30,158,16,Sumy
2256,2216,31,817,1417,22,1439,0,1439,32,1129,278,22.04.2019 01:35,158,16,Sumy
2192,2158,15,806,1376,10,1386,0,1386,31,1095,260,22.04.2019 00:35,158,16,Sumy
1904,1870,35,739,1142,23,1165,0,1165,32,938,195,22.04.2019 00:05,158,16,Sumy
1920,1884,17,680,1230,10,1240,0,1240,27,933,280,22.04.2019 03:05,158,16,Sumy
1184,1164,4,350,831,3,834,0,834,29,638,167,22.04.2019 00:33,158,16,Sumy
2288,2263,8,845,1437,6,1443,0,1443,24,1134,285,22.04.2019 02:50,158,16,Sumy
2096,2057,12,699,1388,9,1397,0,1397,21,1081,295,22.04.2019 00:45,158,16,Sumy
368,14,11,354,3,11,14,0,14,0,13,1,22.04.2019 00:10,158,16,Sumy
272,37,2,237,33,2,35,0,35,0,29,6,22.04.2019 00:07,158,16,Sumy
160,8,2,152,6,2,8,0,8,0,5,3,22.04.2019 00:10,158,16,Sumy
1200,1173,18,455,731,14,745,0,745,18,596,131,21.04.2019 22:10,158,16,Sumy
288,280,29,136,126,26,152,0,152,1,141,10,22.04.2019 00:15,159,16,Sumy
416,402,16,176,225,15,240,0,240,6,212,22,22.04.2019 00:30,159,16,Sumy
1168,1156,43,563,564,41,605,0,605,5,562,38,22.04.2019 02:15,159,16,Sumy
144,130,15,78,57,9,66,0,66,2,59,5,22.04.2019 00:15,159,16,Sumy
592,578,67,290,246,56,302,0,302,8,267,27,21.04.2019 22:10,159,16,Sumy
512,507,36,197,279,36,315,0,315,2,275,38,22.04.2019 00:10,159,16,Sumy
576,566,28,220,330,26,356,0,356,7,322,27,21.04.2019 22:45,159,16,Sumy
224,211,9,105,113,6,119,0,119,0,96,23,22.04.2019 00:20,159,16,Sumy
816,792,27,378,416,22,438,0,438,6,389,43,22.04.2019 00:45,159,16,Sumy
1088,1057,65,442,586,60,646,0,646,14,551,81,22.04.2019 00:30,159,16,Sumy
432,406,64,207,165,60,225,0,225,0,201,24,22.04.2019 00:26,159,16,Sumy
864,844,123,351,402,111,513,0,513,9,423,81,21.04.2019 21:40,159,16,Sumy
384,381,39,159,191,34,225,0,225,1,201,23,22.04.2019 00:10,159,16,Sumy
656,641,76,237,350,69,419,0,419,7,361,51,22.04.2019 01:30,159,16,Sumy
880,856,35,384,468,28,496,0,496,4,463,29,21.04.2019 23:00,159,16,Sumy
496,481,53,151,294,51,345,0,345,4,262,79,22.04.2019 04:00,159,16,Sumy
720,694,100,275,355,90,445,0,445,5,351,89,21.04.2019 22:20,159,16,Sumy
272,267,46,119,109,44,153,0,153,5,122,26,21.04.2019 20:50,159,16,Sumy
1072,1052,85,375,626,71,697,0,697,16,588,93,22.04.2019 00:20,159,16,Sumy
1088,1095,53,442,601,45,646,0,646,14,568,64,22.04.2019 00:30,159,16,Sumy
208,192,9,109,92,7,99,0,99,2,83,14,22.04.2019 00:15,159,16,Sumy
240,228,27,81,138,21,159,0,159,1,144,14,22.04.2019 00:30,159,16,Sumy
432,412,36,190,210,32,242,0,242,2,200,40,22.04.2019 00:15,159,16,Sumy
1152,1127,88,515,552,85,637,0,637,4,593,40,21.04.2019 21:55,159,16,Sumy
256,239,26,113,120,23,143,0,143,0,130,13,22.04.2019 00:05,159,16,Sumy
192,184,12,89,93,10,103,0,103,0,88,15,22.04.2019 01:35,159,16,Sumy
480,485,9,240,234,6,240,0,240,0,211,29,21.04.2019 22:00,159,16,Sumy
304,301,34,149,129,26,155,0,155,3,142,10,21.04.2019 21:59,159,16,Sumy
208,198,3,96,110,2,112,0,112,3,94,15,21.04.2019 23:00,159,16,Sumy
320,306,12,112,199,9,208,0,208,2,184,22,21.04.2019 21:10,159,16,Sumy
160,146,10,81,73,6,79,0,79,0,71,8,21.04.2019 21:30,159,16,Sumy
480,469,37,149,297,34,331,0,331,6,303,22,22.04.2019 00:10,159,16,Sumy
192,184,16,73,104,15,119,0,119,3,105,11,21.04.2019 22:20,159,16,Sumy
416,399,23,182,211,23,234,0,234,4,210,20,22.04.2019 00:10,159,16,Sumy
480,457,19,228,236,16,252,0,252,2,236,14,21.04.2019 21:30,159,16,Sumy
352,350,42,164,153,35,188,0,188,2,161,25,22.04.2019 00:45,159,16,Sumy
464,457,35,178,255,31,286,0,286,1,253,32,21.04.2019 22:00,159,16,Sumy
528,517,46,243,246,39,285,0,285,7,228,50,22.04.2019 00:30,159,16,Sumy
352,335,41,155,158,39,197,0,197,2,179,16,22.04.2019 01:30,159,16,Sumy
176,168,18,84,75,17,92,0,92,0,80,12,21.04.2019 22:30,159,16,Sumy
256,239,21,130,109,17,126,0,126,1,97,28,21.04.2019 20:45,159,16,Sumy
592,571,39,277,282,33,315,0,315,8,237,70,22.04.2019 00:30,159,16,Sumy
240,231,48,79,116,45,161,0,161,5,128,28,22.04.2019 01:20,159,16,Sumy
1424,1387,30,571,828,25,853,0,853,12,708,133,22.04.2019 03:00,159,16,Sumy
1328,1292,8,555,767,6,773,0,773,14,618,141,21.04.2019 23:00,159,16,Sumy
1408,1378,14,584,816,8,824,0,824,22,653,149,21.04.2019 22:30,159,16,Sumy
1072,1050,16,468,595,9,604,0,604,16,497,91,21.04.2019 22:00,159,16,Sumy
720,711,8,316,398,6,404,0,404,5,344,55,22.04.2019 00:10,159,16,Sumy
1632,1607,102,617,929,86,1015,0,1015,40,803,172,21.04.2019 23:40,159,16,Sumy
720,704,8,335,379,6,385,0,385,8,314,63,22.04.2019 01:30,159,16,Sumy
1408,1392,35,597,779,32,811,0,811,16,658,137,22.04.2019 00:10,159,16,Sumy
1504,1463,9,635,861,8,869,0,869,21,711,137,21.04.2019 22:50,159,16,Sumy
1280,1256,23,537,723,20,743,0,743,17,586,140,22.04.2019 00:20,159,16,Sumy
704,683,8,293,403,8,411,0,411,8,311,92,21.04.2019 23:30,159,16,Sumy
1552,1516,15,656,885,11,896,0,896,13,769,114,22.04.2019 01:10,159,16,Sumy
1248,1221,13,525,711,12,723,0,723,17,584,122,22.04.2019 01:30,159,16,Sumy
1424,1378,11,620,794,10,804,0,804,15,656,133,22.04.2019 00:05,159,16,Sumy
576,563,7,246,325,5,330,0,330,7,293,30,22.04.2019 00:32,159,16,Sumy
640,635,45,310,286,44,330,0,330,8,271,51,22.04.2019 02:20,159,16,Sumy
320,310,24,167,131,22,153,0,153,3,108,42,22.04.2019 00:10,159,16,Sumy
352,342,26,99,231,22,253,0,253,6,191,56,21.04.2019 23:15,159,16,Sumy
576,564,39,284,260,32,292,0,292,6,239,47,22.04.2019 01:15,159,16,Sumy
704,693,66,322,331,51,382,0,382,5,307,70,22.04.2019 00:20,159,16,Sumy
288,280,43,153,103,32,135,0,135,3,94,38,22.04.2019 01:10,159,16,Sumy
512,490,34,270,213,29,242,0,242,7,198,37,22.04.2019 01:10,159,16,Sumy
432,421,49,184,207,41,248,0,248,4,206,38,22.04.2019 00:25,159,16,Sumy
320,311,27,120,174,26,200,0,200,2,145,53,22.04.2019 00:05,159,16,Sumy
832,803,63,374,400,58,458,0,458,5,380,73,22.04.2019 01:45,159,16,Sumy
864,844,61,258,552,54,606,0,606,3,499,104,22.04.2019 01:30,159,16,Sumy
464,447,50,211,214,39,253,0,253,2,211,40,21.04.2019 22:10,159,16,Sumy
224,217,25,102,97,25,122,0,122,3,97,22,21.04.2019 20:50,159,16,Sumy
592,581,15,184,399,9,408,0,408,3,360,45,21.04.2019 23:50,159,16,Sumy
176,35,9,147,21,8,29,0,29,0,20,9,22.04.2019 00:25,159,16,Sumy
1792,1762,9,712,1071,9,1080,0,1080,12,989,79,22.04.2019 01:30,159,16,Sumy
1920,1892,32,766,1123,31,1154,0,1154,19,1055,80,22.04.2019 01:40,159,16,Sumy
1888,1841,19,810,1062,16,1078,0,1078,14,978,86,22.04.2019 00:30,159,16,Sumy
1968,1939,24,868,1078,22,1100,0,1100,15,978,107,22.04.2019 00:10,159,16,Sumy
2112,2067,61,934,1126,52,1178,0,1178,19,1080,79,22.04.2019 01:20,159,16,Sumy
2048,2026,21,894,1135,19,1154,0,1154,24,1056,74,21.04.2019 23:00,159,16,Sumy
400,381,17,165,219,16,235,0,235,1,219,15,21.04.2019 22:10,159,16,Sumy
304,299,45,112,148,44,192,0,192,0,173,19,21.04.2019 21:30,159,16,Sumy
400,389,34,177,193,30,223,0,223,5,206,12,22.04.2019 01:45,159,16,Sumy
304,300,29,115,166,23,189,0,189,1,176,12,22.04.2019 01:10,159,16,Sumy
320,309,21,166,135,19,154,0,154,2,132,20,22.04.2019 00:30,159,16,Sumy
192,190,20,73,99,20,119,0,119,4,107,8,21.04.2019 22:00,159,16,Sumy
304,293,29,131,148,25,173,0,173,2,154,17,22.04.2019 00:10,159,16,Sumy
96,84,22,53,26,17,43,0,43,0,39,4,22.04.2019 00:00,159,16,Sumy
368,354,29,122,218,28,246,0,246,5,228,13,21.04.2019 23:15,159,16,Sumy
144,134,14,61,71,12,83,0,83,2,72,9,21.04.2019 23:50,159,16,Sumy
160,145,13,84,67,9,76,0,76,0,57,19,21.04.2019 22:00,159,16,Sumy
352,341,28,87,244,21,265,0,265,2,254,9,21.04.2019 20:45,159,16,Sumy
576,557,34,248,298,30,328,0,328,4,297,27,21.04.2019 20:50,159,16,Sumy
256,248,13,97,149,10,159,0,159,0,148,11,22.04.2019 00:25,159,16,Sumy
176,163,5,80,92,4,96,0,96,0,76,20,21.04.2019 23:50,159,16,Sumy
896,870,38,442,429,25,454,0,454,13,425,16,22.04.2019 01:30,159,16,Sumy
336,330,23,130,186,20,206,0,206,6,175,25,21.04.2019 20:58,159,16,Sumy
208,203,14,100,94,14,108,0,108,4,90,14,21.04.2019 20:45,159,16,Sumy
240,228,21,93,131,16,147,0,147,2,138,7,21.04.2019 23:45,159,16,Sumy
512,493,38,214,269,29,298,0,298,4,268,26,22.04.2019 01:30,159,16,Sumy
272,260,13,122,141,9,150,0,150,2,123,25,22.04.2019 05:00,159,16,Sumy
256,240,26,104,128,24,152,0,152,2,130,20,22.04.2019 00:05,159,16,Sumy
208,206,12,75,121,12,133,0,133,1,118,14,21.04.2019 21:45,159,16,Sumy
112,107,7,55,51,6,57,0,57,0,48,9,22.04.2019 00:45,159,16,Sumy
128,128,8,64,56,8,64,0,64,0,55,9,21.04.2019 22:00,159,16,Sumy
144,136,11,67,68,9,77,0,77,0,62,15,21.04.2019 21:25,159,16,Sumy
256,240,16,133,109,14,123,0,123,1,102,20,21.04.2019 21:50,159,16,Sumy
128,122,6,67,55,6,61,0,61,1,52,8,21.04.2019 23:00,159,16,Sumy
304,294,22,114,168,22,190,0,190,0,175,15,21.04.2019 22:00,159,16,Sumy
160,147,4,77,79,4,83,0,83,2,73,8,21.04.2019 22:15,159,16,Sumy
304,287,34,118,157,29,186,0,186,1,160,25,22.04.2019 00:10,159,16,Sumy
160,40,0,126,34,0,34,0,34,1,25,8,22.04.2019 00:30,159,16,Sumy
1376,1352,12,705,663,8,671,0,671,12,617,42,22.04.2019 00:25,159,16,Sumy
816,797,11,378,430,8,438,0,438,2,405,31,22.04.2019 00:10,159,16,Sumy
672,658,5,303,365,4,369,0,369,10,335,24,21.04.2019 22:55,159,16,Sumy
800,776,9,381,410,9,419,0,419,3,399,17,22.04.2019 00:03,159,16,Sumy
176,163,17,84,75,17,92,0,92,0,85,7,21.04.2019 22:05,159,16,Sumy
96,96,8,40,50,6,56,0,56,2,45,9,21.04.2019 22:10,159,16,Sumy
192,188,12,87,96,9,105,0,105,0,98,7,21.04.2019 22:25,159,16,Sumy
144,140,6,57,82,5,87,0,87,2,80,5,21.04.2019 23:50,159,16,Sumy
208,194,12,69,127,12,139,0,139,0,126,13,21.04.2019 20:58,159,16,Sumy
224,212,29,94,104,26,130,0,130,2,118,10,21.04.2019 23:20,159,16,Sumy
432,425,34,148,251,33,284,0,284,4,260,20,21.04.2019 21:50,159,16,Sumy
272,262,19,116,139,17,156,0,156,6,137,13,21.04.2019 21:18,159,16,Sumy
128,119,11,63,56,9,65,0,65,0,58,7,21.04.2019 22:00,159,16,Sumy
64,51,5,26,34,4,38,0,38,0,37,1,21.04.2019 21:30,159,16,Sumy
160,144,13,56,91,13,104,0,104,1,86,17,22.04.2019 00:20,159,16,Sumy
192,184,19,44,129,19,148,0,148,0,129,19,21.04.2019 21:30,159,16,Sumy
48,39,3,18,27,3,30,0,30,2,23,5,21.04.2019 23:50,159,16,Sumy
272,257,23,98,153,21,174,0,174,2,150,22,21.04.2019 22:00,159,16,Sumy
192,189,16,83,93,16,109,0,109,0,92,17,22.04.2019 00:40,159,16,Sumy
224,215,11,109,107,8,115,0,115,3,97,15,22.04.2019 01:10,159,16,Sumy
304,298,18,135,151,18,169,0,169,4,152,13,21.04.2019 21:30,159,16,Sumy
784,761,15,367,405,12,417,0,417,5,377,35,22.04.2019 02:17,159,16,Sumy
688,663,14,302,376,10,386,0,386,5,352,29,21.04.2019 21:30,159,16,Sumy
96,93,4,22,70,4,74,0,74,1,63,10,21.04.2019 23:00,159,16,Sumy
160,147,6,70,84,6,90,0,90,0,85,5,21.04.2019 23:30,159,16,Sumy
208,200,8,87,117,4,121,0,121,4,101,16,22.04.2019 00:10,159,16,Sumy
112,28,7,88,18,6,24,0,24,0,19,5,21.04.2019 22:30,159,16,Sumy
672,654,55,286,341,45,386,0,386,10,339,37,22.04.2019 01:00,159,16,Sumy
384,375,35,157,193,34,227,0,227,6,200,21,22.04.2019 00:15,159,16,Sumy
288,279,22,140,130,18,148,0,148,3,121,24,21.04.2019 23:00,159,16,Sumy
144,134,22,56,72,16,88,0,88,0,62,26,21.04.2019 20:50,159,16,Sumy
416,416,14,183,220,13,233,0,233,2,207,24,22.04.2019 00:07,159,16,Sumy
96,97,3,41,52,3,55,0,55,1,45,9,22.04.2019 02:30,159,16,Sumy
240,235,28,99,118,23,141,0,141,0,112,29,21.04.2019 23:40,159,16,Sumy
624,608,44,289,303,32,335,0,335,5,293,37,21.04.2019 20:52,159,16,Sumy
176,161,12,105,62,9,71,0,71,1,58,12,21.04.2019 22:30,159,16,Sumy
576,569,37,328,213,35,248,0,248,2,216,30,21.04.2019 21:30,159,16,Sumy
400,390,14,151,235,14,249,0,249,8,216,25,21.04.2019 22:10,159,16,Sumy
640,632,39,249,356,35,391,0,391,6,356,29,22.04.2019 00:15,159,16,Sumy
624,610,49,234,345,45,390,0,390,4,332,54,21.04.2019 23:50,159,16,Sumy
1008,991,28,485,500,23,523,0,523,12,455,56,22.04.2019 01:00,159,16,Sumy
912,895,85,461,382,69,451,0,451,4,407,40,22.04.2019 00:20,159,16,Sumy
480,464,21,230,230,20,250,0,250,3,218,29,22.04.2019 01:00,159,16,Sumy
1376,1345,61,633,686,57,743,0,743,10,666,67,22.04.2019 00:05,159,16,Sumy
1120,1105,23,464,640,16,656,0,656,11,545,100,21.04.2019 21:50,159,16,Sumy
1360,1309,33,635,702,23,725,0,725,19,643,63,22.04.2019 00:10,159,16,Sumy
1200,1166,24,631,546,23,569,0,569,13,503,53,21.04.2019 21:07,159,16,Sumy
480,456,45,196,247,37,284,0,284,9,245,30,22.04.2019 00:20,159,16,Sumy
240,227,29,113,100,27,127,0,127,1,110,16,22.04.2019 01:00,159,16,Sumy
352,341,26,162,167,23,190,0,190,0,179,11,21.04.2019 21:45,159,16,Sumy
656,632,52,274,337,45,382,0,382,7,341,34,21.04.2019 21:10,159,16,Sumy
288,289,33,142,122,24,146,0,146,1,129,16,21.04.2019 22:30,159,16,Sumy
816,803,84,364,381,71,452,0,452,11,386,55,21.04.2019 22:00,159,16,Sumy
416,404,37,178,209,29,238,0,238,5,198,35,21.04.2019 22:00,159,16,Sumy
304,287,33,123,150,31,181,0,181,4,136,41,21.04.2019 22:00,159,16,Sumy
592,583,43,241,320,31,351,0,351,2,328,21,22.04.2019 00:30,159,16,Sumy
960,934,74,356,546,58,604,0,604,7,569,28,22.04.2019 00:30,159,16,Sumy
224,220,19,78,132,14,146,0,146,3,132,11,22.04.2019 00:30,159,16,Sumy
704,687,60,343,311,50,361,0,361,2,341,18,22.04.2019 00:30,159,16,Sumy
1136,1122,57,516,573,47,620,0,620,6,581,33,22.04.2019 00:30,159,16,Sumy
1136,1110,50,459,636,41,677,0,677,10,582,85,21.04.2019 21:40,159,16,Sumy
1408,1368,29,510,879,19,898,0,898,21,775,102,22.04.2019 00:15,159,16,Sumy
1312,1273,66,609,663,40,703,0,703,16,599,88,22.04.2019 00:20,159,16,Sumy
224,217,13,109,104,11,115,0,115,4,95,16,22.04.2019 00:30,159,16,Sumy
208,201,4,95,109,4,113,0,113,1,104,8,22.04.2019 00:15,159,16,Sumy
288,272,16,81,192,15,207,0,207,3,138,66,22.04.2019 01:40,159,16,Sumy
160,156,8,62,91,7,98,0,98,2,84,12,21.04.2019 23:00,159,16,Sumy
192,188,10,76,106,10,116,0,116,1,105,10,21.04.2019 21:05,159,16,Sumy
192,182,21,87,90,15,105,0,105,1,90,14,21.04.2019 20:55,159,16,Sumy
464,451,47,216,213,35,248,0,248,1,224,23,21.04.2019 21:00,159,16,Sumy
416,407,51,170,195,51,246,0,246,2,236,8,21.04.2019 22:40,159,16,Sumy
576,556,57,285,238,53,291,0,291,4,254,33,21.04.2019 21:50,159,16,Sumy
112,21,8,92,13,7,20,0,20,0,13,7,21.04.2019 21:40,159,16,Sumy
1872,1815,13,733,1130,9,1139,0,1139,23,1007,109,22.04.2019 00:05,159,16,Sumy
1904,1850,21,662,1225,17,1242,0,1242,21,1079,142,22.04.2019 00:30,159,16,Sumy
1376,1350,15,552,812,12,824,0,824,12,734,78,22.04.2019 00:30,159,16,Sumy
2016,1976,27,693,1305,18,1323,0,1323,32,1124,167,22.04.2019 00:15,159,16,Sumy
1472,1428,16,571,886,15,901,0,901,18,770,113,22.04.2019 00:20,159,16,Sumy
1120,1122,8,434,678,8,686,0,686,19,583,84,22.04.2019 00:05,159,16,Sumy
1264,1248,36,432,806,26,832,0,832,26,721,85,22.04.2019 00:40,159,16,Sumy
1248,1213,9,495,747,6,753,0,753,17,626,110,22.04.2019 00:05,159,16,Sumy
1248,1222,18,466,765,17,782,0,782,13,666,103,22.04.2019 00:05,159,16,Sumy
1680,1955,29,370,1287,23,1310,0,1310,19,1050,241,22.04.2019 00:10,159,16,Sumy
192,186,8,42,143,7,150,0,150,5,136,9,22.04.2019 00:10,159,16,Sumy
1360,1339,27,525,812,23,835,0,835,15,740,80,22.04.2019 00:15,159,16,Sumy
1904,1859,18,794,1093,17,1110,0,1110,20,978,112,21.04.2019 21:00,159,16,Sumy
1472,1450,26,551,900,21,921,0,921,6,841,74,22.04.2019 00:30,159,16,Sumy
1392,1354,15,550,829,13,842,0,842,27,702,113,22.04.2019 00:15,159,16,Sumy
1696,1660,41,646,1011,39,1050,0,1050,15,931,104,22.04.2019 00:25,159,16,Sumy
288,25,7,264,18,6,24,0,24,0,19,5,22.04.2019 00:20,159,16,Sumy
192,101,0,92,100,0,100,0,100,9,80,11,21.04.2019 23:10,159,16,Sumy
1072,1059,41,440,597,35,632,0,632,15,521,96,22.04.2019 00:15,160,16,Sumy
992,974,23,418,555,19,574,0,574,9,498,67,22.04.2019 01:00,160,16,Sumy
256,241,26,111,122,23,145,0,145,1,116,28,22.04.2019 00:25,160,16,Sumy
176,163,32,56,90,30,120,0,120,5,88,27,21.04.2019 23:45,160,16,Sumy
400,381,29,171,202,27,229,0,229,6,171,52,22.04.2019 00:10,160,16,Sumy
992,974,18,519,455,18,473,0,473,13,388,72,22.04.2019 00:03,160,16,Sumy
224,206,20,148,62,14,76,0,76,0,55,21,22.04.2019 00:25,160,16,Sumy
416,400,30,212,180,24,204,0,204,5,157,42,22.04.2019 00:10,160,16,Sumy
176,174,16,71,89,16,105,0,105,1,71,33,22.04.2019 00:25,160,16,Sumy
624,606,44,263,318,43,361,0,361,6,264,91,22.04.2019 00:10,160,16,Sumy
112,111,15,39,59,14,73,0,73,0,58,15,22.04.2019 00:00,160,16,Sumy
160,149,11,79,71,10,81,0,81,1,57,23,22.04.2019 00:54,160,16,Sumy
496,487,43,166,289,41,330,0,330,5,249,76,22.04.2019 00:20,160,16,Sumy
464,442,51,227,191,46,237,0,237,7,176,54,22.04.2019 00:35,160,16,Sumy
672,647,28,322,326,24,350,0,350,6,297,47,21.04.2019 21:55,160,16,Sumy
1808,1766,147,879,800,129,929,0,929,15,802,112,22.04.2019 00:35,160,16,Sumy
1328,1291,58,596,675,57,732,0,732,9,642,81,22.04.2019 00:15,160,16,Sumy
1856,1945,30,749,1081,26,1107,0,1107,17,930,160,22.04.2019 00:30,160,16,Sumy
592,582,35,250,310,32,342,0,342,1,298,43,21.04.2019 22:00,160,16,Sumy
288,280,27,71,194,23,217,0,217,0,187,30,22.04.2019 00:05,160,16,Sumy
560,528,48,283,233,44,277,0,277,3,240,34,21.04.2019 21:50,160,16,Sumy
640,614,75,275,295,70,365,0,365,3,314,48,22.04.2019 00:10,160,16,Sumy
128,131,31,54,52,22,74,0,74,0,64,10,22.04.2019 00:30,160,16,Sumy
560,545,25,227,309,24,333,0,333,2,275,56,22.04.2019 00:31,160,16,Sumy
224,219,21,90,114,20,134,0,134,1,114,19,22.04.2019 00:05,160,16,Sumy
288,278,32,102,156,30,186,0,186,4,157,25,22.04.2019 00:05,160,16,Sumy
864,829,90,361,419,84,503,0,503,2,439,62,22.04.2019 00:40,160,16,Sumy
1520,1502,14,650,856,14,870,0,870,17,771,82,22.04.2019 00:50,160,16,Sumy
1920,1909,17,840,1064,16,1080,0,1080,27,953,100,22.04.2019 00:40,160,16,Sumy
1888,1848,17,822,1053,13,1066,0,1066,20,911,135,22.04.2019 01:16,160,16,Sumy
1536,1518,17,558,964,14,978,0,978,29,832,117,22.04.2019 01:40,160,16,Sumy
1488,1473,44,561,891,36,927,0,927,21,776,130,22.04.2019 01:20,160,16,Sumy
1904,2153,31,455,1426,23,1449,0,1449,45,1063,341,22.04.2019 00:01,160,16,Sumy
2560,2425,21,997,1547,16,1563,0,1563,41,1291,231,22.04.2019 00:25,160,16,Sumy
1904,1896,32,691,1186,27,1213,0,1213,24,1033,156,22.04.2019 00:06,160,16,Sumy
1888,1862,24,755,1114,19,1133,0,1133,25,934,174,22.04.2019 00:15,160,16,Sumy
2032,1994,28,797,1211,24,1235,0,1235,25,1062,148,22.04.2019 01:20,160,16,Sumy
2032,1996,24,755,1261,16,1277,0,1277,28,1044,205,22.04.2019 00:10,160,16,Sumy
1888,1858,18,764,1116,8,1124,0,1124,23,938,163,22.04.2019 00:30,160,16,Sumy
1344,1329,30,514,803,27,830,0,830,17,711,102,22.04.2019 00:40,160,16,Sumy
2096,2058,42,821,1248,27,1275,0,1275,29,1078,168,22.04.2019 00:24,160,16,Sumy
2176,2137,21,822,1339,15,1354,0,1354,30,1141,183,22.04.2019 01:30,160,16,Sumy
1776,1763,23,690,1068,18,1086,0,1086,33,913,140,22.04.2019 00:35,160,16,Sumy
1904,1880,29,769,1111,24,1135,0,1135,22,939,174,22.04.2019 01:16,160,16,Sumy
1968,1929,22,740,1211,17,1228,0,1228,34,1022,172,22.04.2019 00:35,160,16,Sumy
1856,1853,17,660,1182,14,1196,0,1196,23,985,188,22.04.2019 00:20,160,16,Sumy
2032,1991,31,838,1169,25,1194,0,1194,28,1024,142,22.04.2019 01:40,160,16,Sumy
2032,1989,30,823,1183,26,1209,0,1209,22,1001,186,22.04.2019 01:02,160,16,Sumy
2080,2060,31,874,1180,26,1206,0,1206,42,1017,147,22.04.2019 01:10,160,16,Sumy
2096,2058,26,823,1257,16,1273,0,1273,40,1069,164,22.04.2019 01:30,160,16,Sumy
1952,1924,12,762,1178,12,1190,0,1190,22,1033,135,22.04.2019 00:30,160,16,Sumy
1568,1555,21,608,940,20,960,0,960,23,819,118,22.04.2019 00:21,160,16,Sumy
1968,1944,8,832,1128,8,1136,0,1136,29,988,119,22.04.2019 00:05,160,16,Sumy
2080,2044,65,922,1101,57,1158,0,1158,30,988,140,22.04.2019 00:15,160,16,Sumy
2048,2019,24,885,1141,22,1163,0,1163,34,962,167,22.04.2019 00:30,160,16,Sumy
2032,2011,27,865,1148,19,1167,0,1167,27,985,155,22.04.2019 00:08,160,16,Sumy
1456,1430,20,659,778,19,797,0,797,24,683,90,22.04.2019 02:30,160,16,Sumy
1552,1539,18,787,751,14,765,0,765,11,650,104,22.04.2019 00:13,160,16,Sumy
1776,1757,32,879,870,27,897,0,897,5,806,86,22.04.2019 00:17,160,16,Sumy
1984,1954,17,757,1212,15,1227,0,1227,27,1031,169,22.04.2019 00:15,160,16,Sumy
128,24,10,104,14,10,24,0,24,0,20,4,22.04.2019 00:05,160,16,Sumy
544,135,91,429,34,81,115,0,115,5,96,14,22.04.2019 00:10,160,16,Sumy
160,142,0,18,142,0,142,0,142,7,132,3,22.04.2019 00:05,160,16,Sumy
736,719,5,321,413,2,415,0,415,8,360,47,22.04.2019 00:37,160,16,Sumy
2112,2061,21,842,1256,14,1270,0,1270,37,1111,122,22.04.2019 00:05,160,16,Sumy
2176,2127,10,882,1284,10,1294,0,1294,26,1125,143,22.04.2019 00:15,160,16,Sumy
2016,2004,14,781,1228,7,1235,0,1235,19,1081,135,22.04.2019 00:50,160,16,Sumy
2288,2226,16,1002,1273,13,1286,0,1286,34,1094,158,22.04.2019 00:29,160,16,Sumy
2160,2122,9,834,1321,5,1326,0,1326,26,1143,157,22.04.2019 00:09,160,16,Sumy
2096,2055,23,859,1219,18,1237,0,1237,25,1074,138,22.04.2019 01:00,160,16,Sumy
1792,1758,17,659,1121,12,1133,0,1133,17,949,167,21.04.2019 22:00,160,16,Sumy
1008,978,8,366,635,7,642,0,642,15,534,93,22.04.2019 00:15,160,16,Sumy
1616,1586,20,640,960,16,976,0,976,28,828,120,22.04.2019 00:05,160,16,Sumy
2224,2194,22,923,1288,13,1301,0,1301,28,1100,173,22.04.2019 00:10,160,16,Sumy
1184,1157,12,422,754,8,762,0,762,20,643,99,22.04.2019 00:55,160,16,Sumy
1920,1880,18,792,1113,15,1128,0,1128,26,970,132,22.04.2019 00:02,160,16,Sumy
2208,2154,12,908,1291,9,1300,0,1300,31,1128,141,21.04.2019 21:30,160,16,Sumy
1456,1435,14,629,820,7,827,0,827,12,732,83,22.04.2019 00:10,160,16,Sumy
1664,1641,13,654,999,11,1010,0,1010,13,884,113,22.04.2019 00:09,160,16,Sumy
1776,1734,13,664,1101,11,1112,0,1112,13,977,122,22.04.2019 00:32,160,16,Sumy
2137,2089,15,979,1147,11,1158,0,1158,18,1001,139,22.04.2019 00:30,160,16,Sumy
1632,1569,18,656,966,10,976,0,976,19,825,132,22.04.2019 00:35,160,16,Sumy
1344,1366,15,509,825,10,835,0,835,16,722,97,22.04.2019 00:15,160,16,Sumy
1664,1655,16,591,1058,15,1073,0,1073,15,920,138,22.04.2019 00:20,160,16,Sumy
2096,2053,21,831,1251,14,1265,0,1265,27,1102,136,21.04.2019 21:40,160,16,Sumy
2080,2025,11,800,1273,7,1280,0,1280,34,1096,150,22.04.2019 00:10,160,16,Sumy
2192,2134,15,837,1344,11,1355,0,1355,28,1149,178,22.04.2019 00:07,160,16,Sumy
2224,2177,11,847,1367,10,1377,0,1377,35,1193,149,22.04.2019 00:10,160,16,Sumy
1696,1653,6,719,972,5,977,0,977,20,821,136,22.04.2019 00:15,160,16,Sumy
2208,2161,25,873,1318,17,1335,0,1335,34,1175,126,22.04.2019 00:15,160,16,Sumy
1808,1767,14,726,1074,8,1082,0,1082,22,972,88,22.04.2019 00:30,160,16,Sumy
1520,1483,15,598,909,13,922,0,922,8,828,86,22.04.2019 00:52,160,16,Sumy
1344,1313,12,584,753,7,760,0,760,13,670,77,22.04.2019 00:35,160,16,Sumy
2224,2165,20,837,1376,11,1387,0,1387,29,1211,147,22.04.2019 01:30,160,16,Sumy
448,62,49,388,13,47,60,0,60,0,58,2,22.04.2019 00:10,160,16,Sumy
384,376,45,119,225,40,265,0,265,8,200,57,22.04.2019 00:10,161,16,Sumy
64,62,9,16,39,9,48,0,48,0,34,14,22.04.2019 00:05,161,16,Sumy
160,144,14,56,90,14,104,0,104,3,79,22,22.04.2019 00:10,161,16,Sumy
128,124,35,44,54,30,84,0,84,0,66,18,22.04.2019 00:20,161,16,Sumy
368,355,45,106,222,40,262,0,262,2,204,56,22.04.2019 00:20,161,16,Sumy
624,608,109,242,286,96,382,0,382,6,313,63,22.04.2019 00:40,161,16,Sumy
432,426,57,144,235,53,288,0,288,0,250,38,22.04.2019 00:20,161,16,Sumy
464,457,44,193,234,37,271,0,271,7,199,65,22.04.2019 00:40,161,16,Sumy
352,336,9,66,277,9,286,0,286,3,258,25,22.04.2019 00:35,161,16,Sumy
192,187,0,44,148,0,148,0,148,1,119,28,22.04.2019 00:40,161,16,Sumy
368,355,45,119,212,37,249,0,249,6,162,81,22.04.2019 00:10,161,16,Sumy
464,458,29,193,242,29,271,0,271,4,221,46,22.04.2019 01:10,161,16,Sumy
1184,1156,84,493,610,81,691,0,691,9,569,113,22.04.2019 01:10,161,16,Sumy
416,411,46,153,226,37,263,0,263,3,222,38,22.04.2019 00:20,161,16,Sumy
96,81,11,32,54,10,64,0,64,0,46,18,22.04.2019 00:45,161,16,Sumy
96,96,12,30,57,9,66,0,66,1,46,19,22.04.2019 00:40,161,16,Sumy
160,155,13,61,89,10,99,0,99,0,80,19,22.04.2019 01:40,161,16,Sumy
1216,1203,79,530,614,72,686,0,686,13,596,77,22.04.2019 00:40,161,16,Sumy
896,870,49,374,477,45,522,0,522,9,443,70,22.04.2019 00:50,161,16,Sumy
608,587,64,222,327,59,386,0,386,5,308,73,22.04.2019 00:20,161,16,Sumy
128,119,6,50,72,6,78,0,78,0,63,15,22.04.2019 00:15,161,16,Sumy
464,446,48,157,259,48,307,0,307,0,253,54,22.04.2019 00:05,161,16,Sumy
288,283,24,115,155,18,173,0,173,0,128,45,22.04.2019 01:43,161,16,Sumy
224,216,36,76,113,35,148,0,148,2,125,21,22.04.2019 00:30,161,16,Sumy
208,193,23,66,119,23,142,0,142,1,111,30,22.04.2019 01:30,161,16,Sumy
176,167,29,89,68,19,87,0,87,1,59,27,22.04.2019 00:30,161,16,Sumy
384,374,50,107,228,49,277,0,277,3,221,53,22.04.2019 00:15,161,16,Sumy
976,949,14,463,499,14,513,0,513,16,446,51,22.04.2019 00:20,161,16,Sumy
1072,1042,53,465,556,51,607,0,607,15,496,96,22.04.2019 00:05,161,16,Sumy
416,406,27,178,215,23,238,0,238,2,199,37,22.04.2019 01:15,161,16,Sumy
368,347,29,158,183,27,210,0,210,3,155,52,22.04.2019 01:30,161,16,Sumy
160,152,21,58,83,19,102,0,102,2,67,33,22.04.2019 00:10,161,16,Sumy
528,511,49,172,310,46,356,0,356,4,259,93,22.04.2019 00:20,161,16,Sumy
608,583,61,208,343,57,400,0,400,3,305,92,22.04.2019 00:25,161,16,Sumy
560,549,41,109,412,39,451,0,451,6,243,202,21.04.2019 23:50,161,16,Sumy
656,634,88,282,290,84,374,0,374,6,310,58,22.04.2019 00:30,161,16,Sumy
592,568,64,204,330,58,388,0,388,7,334,47,22.04.2019 00:10,161,16,Sumy
304,283,28,78,201,25,226,0,226,4,153,69,22.04.2019 00:10,161,16,Sumy
144,131,18,35,91,18,109,0,109,0,88,21,22.04.2019 00:15,161,16,Sumy
1136,1110,46,396,704,36,740,0,740,22,631,87,22.04.2019 00:20,161,16,Sumy
1392,1364,57,536,808,48,856,0,856,14,715,127,22.04.2019 02:10,161,16,Sumy
544,520,81,152,325,67,392,0,392,1,299,92,22.04.2019 00:10,161,16,Sumy
496,483,53,129,316,51,367,0,367,6,292,69,21.04.2019 23:00,161,16,Sumy
160,161,14,38,111,11,122,0,122,0,104,18,21.04.2019 20:30,161,16,Sumy
432,412,59,172,208,52,260,0,260,6,209,45,22.04.2019 00:30,161,16,Sumy
512,503,50,156,313,43,356,0,356,6,320,30,22.04.2019 01:00,161,16,Sumy
656,641,73,183,407,66,473,0,473,3,394,76,22.04.2019 00:40,161,16,Sumy
928,914,154,313,476,139,615,0,615,11,484,120,22.04.2019 01:00,161,16,Sumy
352,341,62,108,183,61,244,0,244,6,194,44,22.04.2019 00:03,161,16,Sumy
480,466,80,149,254,77,331,0,331,8,270,53,22.04.2019 00:15,161,16,Sumy
128,27,4,101,23,4,27,0,27,1,19,7,22.04.2019 00:25,161,16,Sumy
416,401,27,133,257,26,283,0,283,1,228,54,22.04.2019 00:30,161,16,Sumy
656,647,87,201,375,80,455,0,455,8,367,80,22.04.2019 00:12,161,16,Sumy
480,462,78,175,237,68,305,0,305,3,229,73,21.04.2019 23:50,161,16,Sumy
448,435,67,157,231,60,291,0,291,3,225,63,22.04.2019 00:50,161,16,Sumy
1024,1008,137,351,548,125,673,0,673,9,552,112,22.04.2019 01:00,161,16,Sumy
240,233,33,79,133,28,161,0,161,6,123,32,22.04.2019 00:10,161,16,Sumy
400,385,44,123,238,39,277,0,277,13,224,40,22.04.2019 00:15,161,16,Sumy
716,693,60,226,436,54,490,0,490,10,413,67,22.04.2019 00:45,161,16,Sumy
180,174,19,60,105,15,120,0,120,2,100,18,22.04.2019 00:30,161,16,Sumy
224,210,24,62,140,22,162,0,162,0,151,11,22.04.2019 00:55,161,16,Sumy
400,390,87,93,231,76,307,0,307,7,218,82,22.04.2019 01:07,161,16,Sumy
384,367,46,129,210,45,255,0,255,0,198,57,22.04.2019 00:10,161,16,Sumy
272,262,29,79,166,27,193,0,193,2,144,47,22.04.2019 00:30,161,16,Sumy
384,369,53,118,218,48,266,0,266,4,222,40,22.04.2019 00:45,161,16,Sumy
192,184,26,51,116,25,141,0,141,3,108,30,22.04.2019 00:15,161,16,Sumy
192,174,29,61,106,25,131,0,131,2,101,28,21.04.2019 21:20,161,16,Sumy
1152,1138,91,411,657,84,741,0,741,13,582,146,22.04.2019 00:20,161,16,Sumy
880,867,57,346,484,50,534,0,534,8,435,91,22.04.2019 00:04,161,16,Sumy
96,90,19,34,52,10,62,0,62,0,44,18,22.04.2019 00:50,161,16,Sumy
112,105,7,43,62,7,69,0,69,2,52,15,22.04.2019 00:20,161,16,Sumy
272,264,51,95,131,46,177,0,177,4,122,51,22.04.2019 00:40,161,16,Sumy
432,428,36,128,268,36,304,0,304,6,233,65,22.04.2019 00:30,161,16,Sumy
304,304,20,88,197,19,216,0,216,3,176,37,22.04.2019 00:40,161,16,Sumy
272,268,41,58,182,32,214,0,214,4,167,43,22.04.2019 00:40,161,16,Sumy
176,169,17,57,103,16,119,0,119,1,62,56,22.04.2019 00:10,161,16,Sumy
288,278,36,77,180,31,211,0,211,1,163,47,22.04.2019 00:50,161,16,Sumy
128,117,24,49,58,21,79,0,79,0,45,34,22.04.2019 00:30,161,16,Sumy
240,229,22,85,139,16,155,0,155,1,79,75,22.04.2019 00:15,161,16,Sumy
80,66,13,35,35,10,45,0,45,1,36,8,22.04.2019 00:20,161,16,Sumy
80,65,10,27,44,9,53,0,53,2,25,26,22.04.2019 00:40,161,16,Sumy
720,697,99,231,402,87,489,0,489,3,406,80,22.04.2019 00:16,161,16,Sumy
272,260,28,91,158,23,181,0,181,2,146,33,22.04.2019 01:15,161,16,Sumy
112,106,7,38,68,6,74,0,74,0,53,21,22.04.2019 00:30,161,16,Sumy
128,35,14,98,17,13,30,0,30,2,25,3,22.04.2019 02:15,161,16,Sumy
272,255,23,106,147,19,166,0,166,5,129,32,22.04.2019 01:10,161,16,Sumy
128,117,16,48,64,16,80,0,80,1,54,25,22.04.2019 01:15,161,16,Sumy
288,272,37,86,168,34,202,0,202,5,152,45,22.04.2019 00:40,161,16,Sumy
736,724,66,266,409,61,470,0,470,12,345,113,22.04.2019 00:40,161,16,Sumy
432,413,42,139,258,35,293,0,293,6,244,43,22.04.2019 00:10,161,16,Sumy
240,238,29,93,122,25,147,0,147,4,113,30,22.04.2019 00:15,161,16,Sumy
416,400,10,184,227,5,232,0,232,2,182,48,22.04.2019 00:10,161,16,Sumy
400,388,25,130,245,25,270,0,270,10,223,37,22.04.2019 00:30,161,16,Sumy
208,197,14,101,95,12,107,0,107,0,81,26,22.04.2019 00:20,161,16,Sumy
112,108,7,49,56,7,63,0,63,0,46,17,22.04.2019 00:10,161,16,Sumy
1424,1409,91,525,823,76,899,0,899,17,744,138,22.04.2019 00:15,161,16,Sumy
464,453,42,157,267,40,307,0,307,3,191,113,21.04.2019 20:45,161,16,Sumy
944,912,60,364,524,56,580,0,580,11,436,133,22.04.2019 00:15,161,16,Sumy
112,103,8,38,66,8,74,0,74,0,61,13,22.04.2019 00:45,161,16,Sumy
192,180,24,77,93,22,115,0,115,2,91,22,22.04.2019 00:35,161,16,Sumy
352,345,42,107,203,42,245,0,245,3,208,34,21.04.2019 21:30,161,16,Sumy
256,240,15,98,145,13,158,0,158,0,114,44,22.04.2019 00:10,161,16,Sumy
144,133,10,34,100,10,110,0,110,0,90,20,21.04.2019 23:25,161,16,Sumy
368,351,29,165,179,24,203,0,203,7,163,33,22.04.2019 00:35,161,16,Sumy
208,200,14,75,120,13,133,0,133,2,103,28,22.04.2019 01:25,161,16,Sumy
96,95,13,31,56,9,65,0,65,0,47,18,22.04.2019 00:20,161,16,Sumy
240,228,13,91,137,12,149,0,149,2,127,20,22.04.2019 00:10,161,16,Sumy
128,114,4,53,72,3,75,0,75,0,60,15,22.04.2019 00:10,161,16,Sumy
112,104,7,33,72,7,79,0,79,0,65,14,22.04.2019 00:15,161,16,Sumy
208,207,10,62,136,10,146,0,146,5,122,19,22.04.2019 00:10,161,16,Sumy
64,52,5,33,26,5,31,0,31,0,23,8,22.04.2019 00:10,161,16,Sumy
224,204,10,95,121,8,129,0,129,4,109,16,22.04.2019 00:15,161,16,Sumy
144,135,5,57,82,5,87,0,87,1,59,27,22.04.2019 00:15,161,16,Sumy
1008,986,46,301,661,46,707,0,707,14,574,119,22.04.2019 00:30,161,16,Sumy
320,317,48,111,166,43,209,0,209,2,152,55,21.04.2019 20:30,161,16,Sumy
544,535,35,238,273,33,306,0,306,9,241,56,22.04.2019 00:50,161,16,Sumy
208,196,11,88,109,11,120,0,120,2,83,35,22.04.2019 00:45,161,16,Sumy
80,74,4,22,54,4,58,0,58,0,46,12,22.04.2019 00:10,161,16,Sumy
256,249,13,98,152,6,158,0,158,3,131,24,22.04.2019 00:15,161,16,Sumy
368,362,26,141,208,19,227,0,227,3,186,38,22.04.2019 00:15,161,16,Sumy
512,505,30,210,276,26,302,0,302,0,262,40,22.04.2019 00:50,161,16,Sumy
528,523,41,188,300,40,340,0,340,7,280,53,22.04.2019 00:10,161,16,Sumy
336,322,34,117,185,34,219,0,219,4,181,34,22.04.2019 00:15,161,16,Sumy
208,197,10,78,122,8,130,0,130,1,84,45,22.04.2019 01:40,161,16,Sumy
224,214,28,91,112,21,133,0,133,3,110,20,22.04.2019 00:15,161,16,Sumy
992,981,78,395,530,67,597,0,597,8,469,120,22.04.2019 02:20,161,16,Sumy
1056,1038,53,327,677,52,729,0,729,8,563,158,22.04.2019 00:40,161,16,Sumy
368,357,25,166,178,24,202,0,202,4,164,34,22.04.2019 00:30,161,16,Sumy
160,151,1,51,108,1,109,0,109,3,80,26,22.04.2019 00:05,161,16,Sumy
912,908,22,338,553,21,574,0,574,11,491,72,22.04.2019 00:15,161,16,Sumy
288,270,13,109,166,13,179,0,179,3,156,20,22.04.2019 00:20,161,16,Sumy
144,139,9,54,82,8,90,0,90,0,61,29,22.04.2019 00:10,161,16,Sumy
448,427,25,173,252,23,275,0,275,4,240,31,22.04.2019 00:10,161,16,Sumy
880,864,40,338,503,39,542,0,542,10,462,70,22.04.2019 00:55,161,16,Sumy
272,260,28,111,137,24,161,0,161,4,131,26,22.04.2019 02:10,161,16,Sumy
960,949,42,330,593,37,630,0,630,16,516,98,22.04.2019 00:10,161,16,Sumy
208,199,24,62,123,23,146,0,146,1,113,32,22.04.2019 00:05,161,16,Sumy
224,219,16,79,131,14,145,0,145,0,119,26,22.04.2019 00:25,161,16,Sumy
928,910,41,428,461,39,500,0,500,13,389,98,22.04.2019 00:20,161,16,Sumy
288,277,22,110,156,22,178,0,178,4,137,37,22.04.2019 00:15,161,16,Sumy
608,584,53,229,334,45,379,0,379,10,282,87,22.04.2019 00:30,161,16,Sumy
256,246,15,95,149,12,161,0,161,3,126,32,22.04.2019 00:20,161,16,Sumy
144,139,7,53,86,5,91,0,91,3,62,26,22.04.2019 00:20,161,16,Sumy
608,583,19,221,371,16,387,0,387,4,322,61,22.04.2019 00:20,161,16,Sumy
368,360,16,129,226,13,239,0,239,3,203,33,22.04.2019 00:10,161,16,Sumy
288,276,32,100,157,31,188,0,188,5,157,26,22.04.2019 00:30,161,16,Sumy
208,194,19,88,105,15,120,0,120,4,96,20,22.04.2019 00:20,161,16,Sumy
352,334,44,105,208,39,247,0,247,5,200,42,22.04.2019 00:30,161,16,Sumy
656,557,0,100,556,0,556,0,556,24,508,24,22.04.2019 00:10,161,16,Sumy
1552,1578,40,494,1028,30,1058,0,1058,19,861,178,22.04.2019 00:10,161,16,Sumy
1680,1665,18,611,1054,15,1069,0,1069,31,864,174,22.04.2019 00:40,161,16,Sumy
1632,1627,38,551,1051,30,1081,0,1081,33,845,203,22.04.2019 00:20,161,16,Sumy
1712,1684,29,626,1061,25,1086,0,1086,33,870,183,22.04.2019 00:10,161,16,Sumy
1616,1587,39,546,1038,32,1070,0,1070,20,859,191,22.04.2019 00:50,161,16,Sumy
1584,1561,26,592,975,17,992,0,992,22,753,217,22.04.2019 00:30,161,16,Sumy
1456,1422,20,538,907,11,918,0,918,15,738,165,22.04.2019 01:20,161,16,Sumy
1440,1415,25,500,919,21,940,0,940,14,768,158,22.04.2019 00:20,161,16,Sumy
1424,1388,14,555,857,12,869,0,869,17,724,128,22.04.2019 00:10,161,16,Sumy
1360,1335,24,495,846,19,865,0,865,18,747,100,22.04.2019 00:05,161,16,Sumy
1552,1524,43,563,959,30,989,0,989,23,790,176,22.04.2019 00:50,161,16,Sumy
1472,1457,31,529,921,22,943,0,943,21,769,153,22.04.2019 00:50,161,16,Sumy
1360,1334,19,553,792,15,807,0,807,20,656,131,22.04.2019 00:20,161,16,Sumy
1488,1460,24,608,860,20,880,0,880,26,710,144,22.04.2019 00:30,161,16,Sumy
1728,1713,32,661,1042,25,1067,0,1067,19,894,154,22.04.2019 00:45,161,16,Sumy
1776,1705,27,621,1132,23,1155,0,1155,22,948,185,22.04.2019 01:30,161,16,Sumy
1792,1769,28,665,1102,25,1127,0,1127,22,953,152,22.04.2019 00:50,161,16,Sumy
1840,1796,28,711,1103,26,1129,0,1129,14,979,136,22.04.2019 00:15,161,16,Sumy
1840,1806,22,728,1095,17,1112,0,1112,23,932,157,22.04.2019 00:10,161,16,Sumy
384,28,28,357,0,27,27,0,27,1,23,3,22.04.2019 00:55,161,16,Sumy
736,68,0,670,66,0,66,0,66,2,59,5,22.04.2019 00:10,161,16,Sumy
848,831,14,343,493,12,505,0,505,5,436,64,22.04.2019 01:30,162,16,Sumy
992,949,16,408,570,14,584,0,584,9,504,71,22.04.2019 03:10,162,16,Sumy
784,778,64,318,405,61,466,0,466,1,403,62,22.04.2019 00:35,162,16,Sumy
624,595,49,273,312,39,351,0,351,2,299,50,22.04.2019 00:10,162,16,Sumy
480,460,34,136,320,24,344,0,344,3,319,22,22.04.2019 00:05,162,16,Sumy
688,671,43,238,407,43,450,0,450,2,397,51,22.04.2019 00:15,162,16,Sumy
336,319,24,148,169,19,188,0,188,2,150,36,22.04.2019 00:05,162,16,Sumy
192,178,14,95,85,12,97,0,97,0,79,18,22.04.2019 00:30,162,16,Sumy
560,540,81,204,277,79,356,0,356,4,320,32,22.04.2019 01:30,162,16,Sumy
128,123,14,62,53,13,66,0,66,2,50,14,22.04.2019 00:40,162,16,Sumy
144,125,19,61,65,18,83,0,83,0,74,9,21.04.2019 22:20,162,16,Sumy
176,167,10,66,101,9,110,0,110,1,93,16,22.04.2019 01:15,162,16,Sumy
240,239,24,80,139,21,160,0,160,1,128,31,22.04.2019 00:20,162,16,Sumy
208,213,31,78,106,24,130,0,130,0,116,14,22.04.2019 00:30,162,16,Sumy
592,584,44,251,301,40,341,0,341,7,313,21,22.04.2019 00:31,162,16,Sumy
224,212,21,66,137,21,158,0,158,2,133,23,22.04.2019 00:05,162,16,Sumy
816,794,65,318,446,52,498,0,498,7,446,45,22.04.2019 00:15,162,16,Sumy
240,229,23,107,113,20,133,0,133,2,112,19,22.04.2019 00:10,162,16,Sumy
48,47,5,14,29,5,34,0,34,0,26,8,22.04.2019 00:05,162,16,Sumy
576,553,51,221,315,40,355,0,355,6,275,74,22.04.2019 01:30,162,16,Sumy
272,268,24,81,168,23,191,0,191,1,149,41,22.04.2019 01:25,162,16,Sumy
80,64,9,38,36,6,42,0,42,0,36,6,22.04.2019 00:10,162,16,Sumy
352,345,41,143,171,38,209,0,209,0,188,21,22.04.2019 00:01,162,16,Sumy
496,480,52,200,244,52,296,0,296,5,248,43,22.04.2019 00:28,162,16,Sumy
448,430,36,176,242,30,272,0,272,5,237,30,22.04.2019 00:04,162,16,Sumy
208,199,26,52,137,19,156,0,156,1,134,21,22.04.2019 00:10,162,16,Sumy
752,726,93,302,372,78,450,0,450,8,356,86,22.04.2019 00:35,162,16,Sumy
384,380,19,142,223,19,242,0,242,3,188,51,22.04.2019 01:15,162,16,Sumy
176,162,3,73,100,3,103,0,103,1,73,29,22.04.2019 00:20,162,16,Sumy
112,20,8,94,10,8,18,0,18,0,12,6,22.04.2019 00:25,162,16,Sumy
672,654,49,295,331,46,377,0,377,3,284,90,22.04.2019 00:45,162,16,Sumy
384,377,43,138,204,42,246,0,246,3,207,36,22.04.2019 00:20,162,16,Sumy
800,780,39,376,388,36,424,0,424,6,361,57,22.04.2019 00:27,162,16,Sumy
864,835,35,374,460,30,490,0,490,3,411,76,22.04.2019 00:51,162,16,Sumy
160,154,10,61,89,10,99,0,99,0,84,15,22.04.2019 02:00,162,16,Sumy
288,268,31,125,134,29,163,0,163,1,134,28,22.04.2019 00:10,162,16,Sumy
592,577,102,205,291,96,387,0,387,6,312,69,22.04.2019 01:05,162,16,Sumy
432,404,39,179,220,33,253,0,253,2,222,29,22.04.2019 00:25,162,16,Sumy
416,401,43,164,213,39,252,0,252,3,203,46,22.04.2019 00:05,162,16,Sumy
64,58,5,26,35,3,38,0,38,0,29,9,22.04.2019 00:05,162,16,Sumy
784,772,38,252,497,35,532,0,532,10,426,96,22.04.2019 01:00,162,16,Sumy
688,678,75,228,387,73,460,0,460,5,392,63,22.04.2019 00:50,162,16,Sumy
1744,1703,127,756,875,113,988,0,988,18,865,105,22.04.2019 00:35,162,16,Sumy
352,345,37,135,187,30,217,0,217,2,193,22,21.04.2019 23:05,162,16,Sumy
304,279,7,147,153,4,157,0,157,5,111,41,22.04.2019 00:08,162,16,Sumy
192,185,17,69,107,16,123,0,123,3,77,43,22.04.2019 00:15,162,16,Sumy
480,464,60,173,247,60,307,0,307,1,266,40,22.04.2019 00:20,162,16,Sumy
176,169,29,74,76,26,102,0,102,0,79,23,22.04.2019 00:05,162,16,Sumy
256,241,31,119,109,28,137,0,137,1,121,15,22.04.2019 00:05,162,16,Sumy
400,390,48,130,225,45,270,0,270,10,234,26,22.04.2019 00:05,162,16,Sumy
1456,1427,170,556,736,164,900,0,900,17,778,105,22.04.2019 00:05,162,16,Sumy
576,565,87,206,290,80,370,0,370,6,323,41,22.04.2019 00:03,162,16,Sumy
288,278,50,89,155,44,199,0,199,1,166,32,22.04.2019 00:20,162,16,Sumy
992,982,102,249,644,99,743,0,743,10,584,149,22.04.2019 01:10,162,16,Sumy
624,607,60,257,308,59,367,0,367,8,310,49,22.04.2019 01:12,162,16,Sumy
304,283,20,100,185,19,204,0,204,2,144,58,22.04.2019 00:25,162,16,Sumy
160,154,16,65,81,14,95,0,95,1,86,8,22.04.2019 00:15,162,16,Sumy
272,264,14,98,163,11,174,0,174,2,134,38,22.04.2019 00:02,162,16,Sumy
144,128,6,65,73,6,79,0,79,1,58,20,22.04.2019 00:05,162,16,Sumy
1008,997,54,379,575,54,629,0,629,18,537,74,22.04.2019 01:05,162,16,Sumy
368,355,41,132,196,40,236,0,236,4,186,46,22.04.2019 00:20,162,16,Sumy
656,629,87,277,296,83,379,0,379,6,332,41,22.04.2019 00:15,162,16,Sumy
176,169,33,75,71,30,101,0,101,1,94,6,21.04.2019 23:40,162,16,Sumy
752,733,32,297,424,31,455,0,455,7,376,72,22.04.2019 00:46,162,16,Sumy
624,618,62,182,387,55,442,0,442,4,398,40,22.04.2019 00:05,162,16,Sumy
352,337,37,178,140,34,174,0,174,2,133,39,21.04.2019 23:55,162,16,Sumy
464,472,39,147,281,36,317,0,317,5,255,57,22.04.2019 00:10,162,16,Sumy
1472,1453,89,544,849,79,928,0,928,24,803,101,22.04.2019 00:10,162,16,Sumy
1536,1508,141,534,871,131,1002,0,1002,22,837,143,22.04.2019 00:30,162,16,Sumy
256,248,27,64,168,24,192,0,192,6,151,35,22.04.2019 01:15,162,16,Sumy
2336,2310,23,845,1472,19,1491,0,1491,29,1203,259,22.04.2019 01:00,162,16,Sumy
2240,2206,23,833,1389,18,1407,0,1407,27,1133,247,22.04.2019 00:23,162,16,Sumy
2240,2210,37,935,1283,22,1305,0,1305,18,1096,191,22.04.2019 02:30,162,16,Sumy
1792,1764,22,755,1016,21,1037,0,1037,19,866,152,22.04.2019 00:40,162,16,Sumy
800,792,7,329,466,5,471,0,471,10,428,33,22.04.2019 00:20,162,16,Sumy
304,289,6,97,201,6,207,0,207,2,154,51,22.04.2019 01:05,162,16,Sumy
176,169,15,57,105,14,119,0,119,0,96,23,22.04.2019 00:20,162,16,Sumy
176,174,7,64,105,7,112,0,112,2,87,23,22.04.2019 00:20,162,16,Sumy
1168,1154,50,535,585,48,633,0,633,21,521,91,22.04.2019 00:15,162,16,Sumy
864,855,28,330,509,25,534,0,534,7,458,69,22.04.2019 00:25,162,16,Sumy
400,389,34,145,221,34,255,0,255,2,220,33,22.04.2019 00:45,162,16,Sumy
96,89,2,38,56,2,58,0,58,0,50,8,22.04.2019 03:15,162,16,Sumy
144,128,1,55,88,1,89,0,89,0,73,16,22.04.2019 00:40,162,16,Sumy
688,673,78,262,352,74,426,0,426,5,331,90,21.04.2019 21:57,162,16,Sumy
112,105,15,40,57,15,72,0,72,1,50,21,21.04.2019 20:45,162,16,Sumy
288,284,18,125,151,12,163,0,163,8,130,25,22.04.2019 00:10,162,16,Sumy
320,313,23,104,193,23,216,0,216,2,201,13,22.04.2019 00:10,162,16,Sumy
144,137,13,64,68,12,80,0,80,1,73,6,22.04.2019 01:20,162,16,Sumy
224,212,27,69,131,24,155,0,155,0,130,25,22.04.2019 00:20,162,16,Sumy
176,164,9,66,104,6,110,0,110,0,96,14,22.04.2019 00:40,162,16,Sumy
352,346,31,127,197,28,225,0,225,2,208,15,21.04.2019 23:20,162,16,Sumy
160,154,9,68,86,6,92,0,92,0,77,15,22.04.2019 01:00,162,16,Sumy
288,272,12,125,154,9,163,0,163,2,149,12,22.04.2019 00:15,162,16,Sumy
560,561,34,205,325,30,355,0,355,7,301,47,22.04.2019 01:10,162,16,Sumy
192,45,16,149,28,15,43,0,43,2,38,3,22.04.2019 00:15,162,16,Sumy
1648,1612,18,595,1036,17,1053,0,1053,30,925,98,22.04.2019 01:05,162,16,Sumy
1792,1760,48,766,984,42,1026,0,1026,28,889,109,22.04.2019 00:40,162,16,Sumy
1040,1014,22,452,570,18,588,0,588,16,513,59,22.04.2019 01:55,162,16,Sumy
1616,1589,26,661,933,22,955,0,955,16,818,121,22.04.2019 01:55,162,16,Sumy
240,239,8,110,122,8,130,0,130,8,103,19,22.04.2019 00:59,162,16,Sumy
2320,2288,34,871,1419,30,1449,0,1449,22,1224,203,22.04.2019 00:42,162,16,Sumy
2304,2256,34,812,1461,31,1492,0,1492,33,1264,195,22.04.2019 00:10,162,16,Sumy
2144,2127,20,732,1395,17,1412,0,1412,27,1208,177,22.04.2019 00:20,162,16,Sumy
1904,1864,20,756,1131,17,1148,0,1148,19,972,157,22.04.2019 00:40,162,16,Sumy
2080,2064,139,604,1341,135,1476,0,1476,30,1232,214,22.04.2019 00:12,162,16,Sumy
2240,2210,37,775,1432,33,1465,0,1465,26,1223,216,22.04.2019 00:38,162,16,Sumy
1536,1505,22,536,980,20,1000,0,1000,11,864,125,22.04.2019 01:18,162,16,Sumy
2320,2278,41,845,1437,38,1475,0,1475,34,1264,177,22.04.2019 00:40,162,16,Sumy
1968,1944,23,675,1273,20,1293,0,1293,15,1105,173,22.04.2019 00:10,162,16,Sumy
1312,1287,13,512,788,12,800,0,800,17,672,111,22.04.2019 00:10,162,16,Sumy
2192,2150,35,792,1371,29,1400,0,1400,25,1183,192,22.04.2019 00:40,162,16,Sumy
2288,2257,32,838,1425,25,1450,0,1450,28,1236,186,22.04.2019 01:08,162,16,Sumy
1904,1906,20,647,1244,13,1257,0,1257,34,1072,151,22.04.2019 01:05,162,16,Sumy
1760,1729,19,631,1113,16,1129,0,1129,16,968,144,22.04.2019 00:05,162,16,Sumy
1600,1569,8,599,995,6,1001,0,1001,25,858,118,22.04.2019 00:17,162,16,Sumy
352,47,35,309,12,31,43,0,43,2,32,9,22.04.2019 00:14,162,16,Sumy
2336,2316,13,1010,1314,12,1326,0,1326,54,645,627,21.04.2019 23:33,163,17,Ternopol
2352,2299,3,1054,1295,3,1298,0,1298,46,638,614,22.04.2019 00:30,163,17,Ternopol
2496,2419,3,993,1501,2,1503,0,1503,65,681,757,22.04.2019 00:45,163,17,Ternopol
2448,2401,12,933,1505,10,1515,0,1515,62,706,747,22.04.2019 00:05,163,17,Ternopol
2384,2331,2,1077,1306,1,1307,0,1307,52,672,583,21.04.2019 22:38,163,17,Ternopol
2464,2468,5,920,1540,4,1544,0,1544,55,754,735,22.04.2019 00:07,163,17,Ternopol
2480,2427,10,889,1582,9,1591,0,1591,59,729,803,22.04.2019 00:10,163,17,Ternopol
2432,2400,14,954,1466,12,1478,0,1478,53,725,700,22.04.2019 00:05,163,17,Ternopol
2208,2184,16,841,1355,12,1367,0,1367,64,627,676,22.04.2019 00:15,163,17,Ternopol
2144,2116,11,801,1332,11,1343,0,1343,60,606,677,22.04.2019 00:38,163,17,Ternopol
2480,2439,9,982,1492,6,1498,0,1498,65,742,691,22.04.2019 00:35,163,17,Ternopol
2512,2483,12,1043,1458,11,1469,0,1469,57,666,746,22.04.2019 00:50,163,17,Ternopol
2448,2430,25,1000,1430,18,1448,0,1448,57,666,725,22.04.2019 00:01,163,17,Ternopol
1568,1567,11,567,991,10,1001,0,1001,38,501,462,22.04.2019 00:10,163,17,Ternopol
1664,1672,17,561,1091,12,1103,0,1103,67,545,491,22.04.2019 00:10,163,17,Ternopol
1776,1791,26,636,1118,22,1140,0,1140,33,575,532,22.04.2019 00:10,163,17,Ternopol
1888,1877,18,688,1186,14,1200,0,1200,42,580,578,22.04.2019 00:17,163,17,Ternopol
2160,2154,12,805,1348,7,1355,0,1355,51,606,698,22.04.2019 00:07,163,17,Ternopol
2528,2483,12,984,1533,11,1544,0,1544,33,663,848,22.04.2019 00:01,163,17,Ternopol
1952,1908,10,782,1162,8,1170,0,1170,38,547,585,22.04.2019 00:20,163,17,Ternopol
1696,1667,10,671,1016,9,1025,0,1025,46,499,480,22.04.2019 00:15,163,17,Ternopol
1216,1211,12,400,806,10,816,0,816,38,372,406,22.04.2019 00:15,163,17,Ternopol
2416,2394,16,914,1487,15,1502,0,1500,62,673,765,22.04.2019 00:45,163,17,Ternopol
1552,1520,18,591,946,15,961,0,961,31,425,505,22.04.2019 01:15,163,17,Ternopol
1680,1671,15,574,1091,15,1106,0,1106,40,484,582,21.04.2019 22:07,163,17,Ternopol
1632,1600,13,604,1017,11,1028,0,1028,33,492,503,22.04.2019 00:20,163,17,Ternopol
2112,2072,14,738,1362,12,1374,0,1374,63,609,702,22.04.2019 00:45,163,17,Ternopol
2480,2459,15,911,1558,11,1569,0,1569,64,764,741,22.04.2019 00:15,163,17,Ternopol
2448,2411,11,967,1470,11,1481,0,1481,48,700,733,22.04.2019 04:30,163,17,Ternopol
1824,1736,5,796,1023,5,1028,0,1028,47,505,476,22.04.2019 00:10,163,17,Ternopol
2288,2268,11,847,1431,10,1441,0,1441,52,676,713,22.04.2019 00:05,163,17,Ternopol
2320,2284,15,890,1417,13,1430,0,1430,54,641,735,22.04.2019 00:49,163,17,Ternopol
2224,2200,16,850,1365,9,1374,0,1374,46,571,757,22.04.2019 00:36,163,17,Ternopol
2352,2311,16,850,1489,13,1502,0,1502,75,624,803,22.04.2019 00:33,163,17,Ternopol
2320,2294,9,791,1520,9,1529,0,1529,61,688,780,22.04.2019 00:09,163,17,Ternopol
2416,2397,23,884,1512,20,1532,0,1532,60,681,791,22.04.2019 00:15,163,17,Ternopol
2192,2166,7,818,1367,7,1374,0,1374,39,641,694,21.04.2019 22:56,163,17,Ternopol
2352,2324,25,969,1361,22,1383,0,1383,53,698,632,22.04.2019 00:05,163,17,Ternopol
2000,1960,15,768,1221,11,1232,0,1232,70,566,596,22.04.2019 00:20,163,17,Ternopol
2272,2239,11,891,1370,11,1381,0,1381,42,654,685,21.04.2019 23:15,163,17,Ternopol
2224,2173,20,828,1378,18,1396,0,1396,53,665,678,22.04.2019 00:45,163,17,Ternopol
2191,2169,7,791,1394,6,1400,0,1400,54,685,661,22.04.2019 00:46,163,17,Ternopol
1937,1904,2,791,1144,2,1146,0,1146,52,519,575,22.04.2019 00:05,163,17,Ternopol
2352,2336,6,795,1551,6,1557,0,1557,64,675,818,22.04.2019 00:40,163,17,Ternopol
2288,2261,13,876,1401,11,1412,0,1412,56,678,678,22.04.2019 00:10,163,17,Ternopol
2432,2419,9,918,1509,5,1514,0,1514,57,710,747,22.04.2019 00:29,163,17,Ternopol
2112,2069,11,762,1341,9,1350,0,1350,56,608,686,22.04.2019 00:15,163,17,Ternopol
2000,1982,8,743,1250,7,1257,0,1257,47,598,612,22.04.2019 00:15,163,17,Ternopol
1632,1610,6,572,1054,6,1060,0,1060,42,482,536,22.04.2019 00:20,163,17,Ternopol
2208,2174,17,814,1379,15,1394,0,1394,51,675,668,22.04.2019 00:30,163,17,Ternopol
2272,2244,8,772,1494,6,1500,0,1500,59,685,756,22.04.2019 00:53,163,17,Ternopol
2384,2346,21,940,1428,16,1444,0,1444,56,686,702,22.04.2019 00:05,163,17,Ternopol
2144,2103,3,825,1316,3,1319,0,1319,49,610,660,22.04.2019 02:25,163,17,Ternopol
2144,2092,16,917,1213,14,1227,0,1227,46,545,636,22.04.2019 00:01,163,17,Ternopol
2416,2379,12,962,1445,9,1454,0,1454,40,664,750,21.04.2019 22:05,163,17,Ternopol
2128,2099,16,768,1346,14,1360,0,1360,43,677,640,22.04.2019 00:12,163,17,Ternopol
2432,2397,12,973,1451,8,1459,0,1459,51,748,660,22.04.2019 06:30,163,17,Ternopol
2192,2165,11,788,1396,8,1404,0,1404,55,623,726,22.04.2019 00:51,163,17,Ternopol
2544,2503,5,930,1609,5,1614,0,1614,58,763,793,22.04.2019 00:41,163,17,Ternopol
2288,2264,13,801,1474,13,1487,0,1487,52,678,757,22.04.2019 00:45,163,17,Ternopol
2480,2447,9,918,1557,5,1562,0,1561,64,677,820,22.04.2019 00:50,163,17,Ternopol
2352,2335,11,859,1485,8,1493,0,1493,49,663,781,22.04.2019 00:05,163,17,Ternopol
2224,2192,4,1165,1059,0,1059,0,1059,28,566,465,22.04.2019 00:10,163,17,Ternopol
2416,2353,13,997,1407,12,1419,0,1419,49,714,656,21.04.2019 22:05,163,17,Ternopol
2352,2271,13,1192,1149,11,1160,0,1160,36,634,490,22.04.2019 00:05,163,17,Ternopol
2368,2340,9,1030,1333,5,1338,0,1338,49,638,651,22.04.2019 00:17,163,17,Ternopol
2288,2260,16,899,1375,14,1389,0,1389,58,596,735,22.04.2019 06:10,163,17,Ternopol
1840,1794,6,865,971,4,975,0,975,37,448,490,21.04.2019 22:30,163,17,Ternopol
2336,2291,9,873,1460,3,1463,0,1463,51,688,724,22.04.2019 00:15,163,17,Ternopol
2256,2212,12,868,1378,10,1388,0,1388,55,686,647,21.04.2019 22:55,163,17,Ternopol
2208,2181,10,763,1435,10,1445,0,1445,56,676,713,22.04.2019 00:45,163,17,Ternopol
2400,2356,7,848,1545,7,1552,0,1552,63,724,765,22.04.2019 00:15,163,17,Ternopol
2288,2242,8,838,1444,6,1450,0,1450,55,661,734,22.04.2019 00:05,163,17,Ternopol
2384,2343,3,885,1497,2,1499,0,1499,51,693,755,22.04.2019 00:15,163,17,Ternopol
2320,2296,5,880,1436,4,1440,0,1440,34,692,714,22.04.2019 03:59,163,17,Ternopol
2064,2038,11,776,1279,9,1288,0,1288,48,624,616,21.04.2019 23:30,163,17,Ternopol
2064,2031,1,804,1259,1,1260,0,1260,43,614,603,22.04.2019 00:20,163,17,Ternopol
144,7,3,137,4,3,7,0,7,0,4,3,22.04.2019 00:08,163,17,Ternopol
848,261,19,599,232,17,249,0,249,27,122,100,22.04.2019 04:30,163,17,Ternopol
176,21,12,156,8,12,20,0,20,1,12,7,21.04.2019 21:20,163,17,Ternopol
272,45,33,232,11,29,40,0,40,2,17,21,22.04.2019 01:51,163,17,Ternopol
704,168,115,554,48,102,150,0,150,4,78,68,22.04.2019 00:15,163,17,Ternopol
416,105,89,311,16,89,105,0,105,4,57,44,22.04.2019 00:13,163,17,Ternopol
288,76,44,213,32,43,75,0,75,4,28,43,22.04.2019 00:10,163,17,Ternopol
528,503,21,186,323,19,342,0,342,11,151,180,21.04.2019 22:05,164,17,Ternopol
336,327,17,114,205,17,222,0,222,6,113,103,21.04.2019 20:50,164,17,Ternopol
112,112,2,26,84,2,86,0,86,3,43,40,21.04.2019 20:32,164,17,Ternopol
752,733,41,354,360,38,398,0,398,8,252,138,21.04.2019 23:45,164,17,Ternopol
448,435,28,166,254,28,282,0,282,2,115,165,21.04.2019 22:40,164,17,Ternopol
656,642,17,279,360,17,377,0,377,4,273,100,22.04.2019 00:20,164,17,Ternopol
352,340,20,115,217,20,237,0,237,2,168,67,21.04.2019 23:50,164,17,Ternopol
400,383,10,128,262,10,272,0,272,4,150,118,21.04.2019 21:12,164,17,Ternopol
688,671,59,226,403,59,462,0,462,10,199,253,21.04.2019 21:50,164,17,Ternopol
160,145,17,69,77,14,91,0,91,3,56,32,22.04.2019 00:40,164,17,Ternopol
784,772,52,252,484,48,532,0,532,14,211,307,21.04.2019 23:55,164,17,Ternopol
304,287,27,121,158,25,183,0,183,8,116,59,21.04.2019 20:40,164,17,Ternopol
1712,1695,24,931,760,21,781,0,781,21,415,345,22.04.2019 00:05,164,17,Ternopol
976,979,18,498,460,18,478,0,478,10,281,187,21.04.2019 20:59,164,17,Ternopol
832,810,60,285,489,58,547,0,547,13,274,260,21.04.2019 21:15,164,17,Ternopol
176,166,11,48,117,11,128,0,128,1,59,68,21.04.2019 21:00,164,17,Ternopol
176,173,19,32,125,19,144,0,144,6,56,82,21.04.2019 21:50,164,17,Ternopol
608,597,36,254,320,34,354,0,354,3,227,124,21.04.2019 21:25,164,17,Ternopol
1216,1200,70,354,795,67,862,0,862,19,389,454,21.04.2019 21:15,164,17,Ternopol
336,328,25,127,184,25,209,0,209,8,116,85,21.04.2019 21:00,164,17,Ternopol
944,932,33,536,379,29,408,0,408,13,286,109,22.04.2019 00:30,164,17,Ternopol
848,829,35,284,529,35,564,0,564,11,309,244,21.04.2019 22:03,164,17,Ternopol
160,154,3,54,103,3,106,0,106,1,49,56,21.04.2019 21:10,164,17,Ternopol
304,292,16,109,179,16,195,0,195,2,84,109,21.04.2019 20:50,164,17,Ternopol
480,462,15,173,295,12,307,0,307,15,152,140,21.04.2019 21:35,164,17,Ternopol
544,532,45,196,307,41,348,0,348,4,158,186,21.04.2019 21:26,164,17,Ternopol
160,150,6,58,96,6,102,0,102,3,52,47,21.04.2019 20:36,164,17,Ternopol
368,365,35,95,238,35,273,0,273,3,151,119,21.04.2019 20:50,164,17,Ternopol
752,735,5,291,457,4,461,0,461,13,215,233,21.04.2019 20:41,164,17,Ternopol
2048,2032,30,836,1183,29,1212,0,1212,48,567,597,21.04.2019 21:25,164,17,Ternopol
1232,1202,33,503,697,32,729,0,729,33,352,344,21.04.2019 21:10,164,17,Ternopol
1968,1955,21,855,1094,19,1113,0,1113,54,540,519,21.04.2019 22:01,164,17,Ternopol
2272,2246,8,984,1282,6,1288,0,1288,44,653,591,21.04.2019 22:10,164,17,Ternopol
1648,1604,20,713,918,17,935,0,935,38,479,418,21.04.2019 21:30,164,17,Ternopol
480,463,23,77,380,23,403,0,403,2,188,213,21.04.2019 22:00,164,17,Ternopol
160,155,12,35,113,12,125,0,125,2,85,38,22.04.2019 00:10,164,17,Ternopol
192,178,5,67,121,4,125,0,125,3,78,44,21.04.2019 22:30,164,17,Ternopol
224,211,17,73,136,15,151,0,151,4,84,63,21.04.2019 21:40,164,17,Ternopol
576,562,44,157,376,43,419,0,419,3,206,210,21.04.2019 21:00,164,17,Ternopol
544,532,36,112,396,36,432,0,432,7,159,266,21.04.2019 20:43,164,17,Ternopol
464,451,40,189,238,37,275,0,275,6,181,88,21.04.2019 22:00,164,17,Ternopol
512,497,39,202,271,39,310,0,310,5,159,146,21.04.2019 21:30,164,17,Ternopol
320,305,25,125,174,21,195,0,195,5,124,66,21.04.2019 21:10,164,17,Ternopol
224,209,16,95,113,16,129,0,129,2,84,43,21.04.2019 21:30,164,17,Ternopol
256,248,18,90,148,18,166,0,166,2,93,71,22.04.2019 00:30,164,17,Ternopol
160,154,15,60,85,15,100,0,100,1,46,53,21.04.2019 21:30,164,17,Ternopol
304,297,13,86,208,10,218,0,218,6,113,99,21.04.2019 21:15,164,17,Ternopol
256,236,16,76,164,16,180,0,180,5,56,119,21.04.2019 21:30,164,17,Ternopol
432,423,42,118,273,41,314,0,314,13,120,181,21.04.2019 21:25,164,17,Ternopol
432,421,9,175,249,8,257,0,257,6,165,86,21.04.2019 21:40,164,17,Ternopol
528,520,15,230,286,12,298,0,298,11,165,122,21.04.2019 21:15,164,17,Ternopol
672,649,51,269,355,48,403,0,403,9,211,183,21.04.2019 23:15,164,17,Ternopol
144,129,11,60,73,11,84,0,84,1,57,26,21.04.2019 20:35,164,17,Ternopol
208,205,26,85,99,24,123,0,123,3,58,62,21.04.2019 20:15,164,17,Ternopol
1040,1021,67,372,601,67,668,0,668,19,266,383,21.04.2019 22:30,164,17,Ternopol
320,313,8,77,235,8,243,0,243,8,122,113,22.04.2019 00:15,164,17,Ternopol
464,459,38,138,289,37,326,0,326,1,215,110,21.04.2019 20:55,164,17,Ternopol
176,161,21,60,96,20,116,0,116,0,29,87,21.04.2019 20:40,164,17,Ternopol
400,392,29,150,222,28,250,0,250,5,88,157,21.04.2019 22:05,164,17,Ternopol
160,148,12,48,100,12,112,0,112,4,47,61,21.04.2019 21:15,164,17,Ternopol
656,646,49,209,401,46,447,0,447,12,207,228,21.04.2019 21:30,164,17,Ternopol
496,496,38,123,337,36,373,0,373,6,168,199,21.04.2019 21:40,164,17,Ternopol
208,207,29,62,117,29,146,0,146,5,44,97,21.04.2019 23:15,164,17,Ternopol
944,926,22,486,436,22,458,0,458,18,226,214,21.04.2019 22:00,164,17,Ternopol
544,538,38,120,387,37,424,0,424,1,205,218,21.04.2019 21:40,164,17,Ternopol
352,351,34,116,204,32,236,0,236,1,121,114,21.04.2019 20:59,164,17,Ternopol
224,213,16,70,138,16,154,0,154,2,96,56,21.04.2019 22:30,164,17,Ternopol
560,556,33,186,342,32,374,0,374,16,151,207,21.04.2019 22:40,164,17,Ternopol
720,705,37,201,484,35,519,0,519,15,145,359,21.04.2019 22:00,164,17,Ternopol
315,327,9,68,240,7,247,0,247,12,99,136,21.04.2019 21:21,164,17,Ternopol
1088,1072,86,328,682,78,760,0,760,22,363,375,22.04.2019 00:05,164,17,Ternopol
368,370,32,121,218,29,247,0,247,4,119,124,21.04.2019 22:00,164,17,Ternopol
80,82,5,17,59,4,63,0,63,0,40,23,21.04.2019 22:00,164,17,Ternopol
496,483,33,156,310,30,340,0,340,2,185,153,21.04.2019 23:30,164,17,Ternopol
288,274,28,91,169,28,197,0,197,7,73,117,21.04.2019 21:05,164,17,Ternopol
672,224,0,448,224,0,224,0,224,7,145,72,21.04.2019 21:40,164,17,Ternopol
2000,1971,42,836,1136,28,1164,0,1164,35,636,493,22.04.2019 00:56,164,17,Ternopol
192,193,9,80,103,9,112,0,112,2,61,49,21.04.2019 21:45,164,17,Ternopol
272,259,15,90,167,15,182,0,182,3,109,70,21.04.2019 20:40,164,17,Ternopol
112,104,7,47,58,7,65,0,65,3,26,36,21.04.2019 20:30,164,17,Ternopol
784,775,8,333,443,8,451,0,451,19,307,125,21.04.2019 22:00,164,17,Ternopol
144,144,2,41,101,2,103,0,103,2,55,46,21.04.2019 22:10,164,17,Ternopol
608,604,14,279,316,13,329,0,329,12,217,100,21.04.2019 22:55,164,17,Ternopol
1120,1094,58,459,611,50,661,0,661,13,410,238,21.04.2019 23:30,164,17,Ternopol
608,587,22,228,362,18,380,0,380,13,237,130,21.04.2019 20:15,164,17,Ternopol
992,969,14,356,622,14,636,0,636,11,348,277,21.04.2019 20:55,164,17,Ternopol
816,809,5,302,510,4,514,0,514,17,286,211,21.04.2019 21:10,164,17,Ternopol
288,284,12,126,155,7,162,0,162,0,109,53,21.04.2019 20:35,164,17,Ternopol
400,390,12,137,251,12,263,0,263,7,174,82,21.04.2019 23:23,164,17,Ternopol
128,121,2,50,76,2,78,0,78,4,51,23,21.04.2019 23:05,164,17,Ternopol
624,607,6,290,328,6,334,0,334,6,212,116,21.04.2019 21:10,164,17,Ternopol
1008,997,35,426,547,35,582,0,582,12,322,248,21.04.2019 21:06,164,17,Ternopol
544,534,31,180,333,31,364,0,364,11,265,88,21.04.2019 22:00,164,17,Ternopol
96,92,6,38,52,6,58,0,58,0,43,15,21.04.2019 22:10,164,17,Ternopol
384,373,24,137,223,24,247,0,247,11,117,119,21.04.2019 21:00,164,17,Ternopol
288,284,4,98,186,4,190,0,190,3,126,61,21.04.2019 21:00,164,17,Ternopol
320,305,12,85,223,12,235,0,235,7,103,125,21.04.2019 21:05,164,17,Ternopol
304,297,9,115,181,8,189,0,189,7,114,68,21.04.2019 22:40,164,17,Ternopol
784,762,14,270,501,13,514,0,514,12,345,157,22.04.2019 00:20,164,17,Ternopol
288,286,42,89,161,38,199,0,199,4,74,121,21.04.2019 21:05,164,17,Ternopol
256,248,20,85,151,20,171,0,171,4,81,86,21.04.2019 22:26,164,17,Ternopol
80,73,3,26,51,3,54,0,54,0,37,17,21.04.2019 20:36,164,17,Ternopol
272,261,25,116,132,24,156,0,156,0,99,57,21.04.2019 21:30,164,17,Ternopol
112,108,3,27,82,3,85,0,85,0,67,18,21.04.2019 21:40,164,17,Ternopol
432,423,23,133,276,23,299,0,299,6,170,123,21.04.2019 21:30,164,17,Ternopol
896,886,6,427,463,6,469,0,469,24,295,150,21.04.2019 21:20,164,17,Ternopol
1984,1966,14,906,1064,14,1078,0,1078,44,647,387,21.04.2019 21:30,164,17,Ternopol
1696,1669,15,763,918,15,933,0,933,35,545,353,21.04.2019 23:30,164,17,Ternopol
1520,1505,10,716,794,10,804,0,804,35,481,288,21.04.2019 22:10,164,17,Ternopol
1296,1288,27,602,667,27,694,0,694,46,415,233,22.04.2019 00:33,164,17,Ternopol
928,899,17,411,500,17,517,0,517,23,316,178,21.04.2019 21:25,164,17,Ternopol
912,910,6,401,506,5,511,0,511,15,304,192,21.04.2019 22:10,164,17,Ternopol
1456,1429,26,679,755,22,777,0,777,26,429,322,21.04.2019 21:30,164,17,Ternopol
1168,1152,4,527,637,4,641,0,641,16,411,214,21.04.2019 20:00,164,17,Ternopol
1856,1829,9,870,977,9,986,0,986,32,622,332,21.04.2019 21:28,164,17,Ternopol
1712,1667,38,783,895,34,929,0,929,33,556,340,21.04.2019 22:00,164,17,Ternopol
576,572,47,206,331,39,370,0,370,2,269,99,21.04.2019 22:48,164,17,Ternopol
832,814,14,283,537,12,549,0,549,7,287,255,21.04.2019 21:55,164,17,Ternopol
784,779,3,235,546,3,549,0,549,12,373,164,21.04.2019 22:00,164,17,Ternopol
1088,1076,38,406,650,32,682,0,682,17,403,262,21.04.2019 21:00,164,17,Ternopol
128,127,6,54,68,6,74,0,74,4,50,20,21.04.2019 22:15,164,17,Ternopol
544,531,35,214,298,32,330,0,330,10,225,95,21.04.2019 21:00,164,17,Ternopol
416,410,25,201,190,25,215,0,215,10,150,55,21.04.2019 22:15,164,17,Ternopol
304,293,5,111,188,5,193,0,193,4,130,59,21.04.2019 21:21,164,17,Ternopol
272,262,12,107,153,12,165,0,165,2,104,59,21.04.2019 22:10,164,17,Ternopol
2000,1997,18,891,1092,17,1109,0,1109,48,792,269,22.04.2019 00:10,164,17,Ternopol
2032,2007,37,1096,912,24,936,0,936,24,665,247,22.04.2019 00:10,164,17,Ternopol
1184,1160,24,614,549,21,570,0,570,29,383,158,22.04.2019 01:00,164,17,Ternopol
1248,1226,79,648,535,65,600,0,600,33,393,174,21.04.2019 23:15,164,17,Ternopol
368,357,0,209,159,0,159,0,159,3,116,40,22.04.2019 00:10,164,17,Ternopol
1232,1215,78,537,626,69,695,0,695,20,420,255,21.04.2019 20:30,164,17,Ternopol
1184,1161,47,486,652,46,698,0,698,12,542,144,21.04.2019 22:20,164,17,Ternopol
960,947,58,521,399,40,439,0,439,12,318,109,21.04.2019 22:05,164,17,Ternopol
288,277,18,137,133,18,151,0,151,5,79,67,21.04.2019 20:37,164,17,Ternopol
448,437,10,198,241,9,250,0,250,11,161,78,21.04.2019 21:50,164,17,Ternopol
320,316,22,110,190,20,210,0,210,7,135,68,21.04.2019 20:34,164,17,Ternopol
128,11,11,119,0,9,9,0,9,0,7,2,21.04.2019 21:00,164,17,Ternopol
320,307,29,125,166,29,195,0,195,1,109,85,22.04.2019 01:15,164,17,Ternopol
176,169,6,65,105,6,111,0,111,4,56,51,21.04.2019 21:30,164,17,Ternopol
672,655,41,256,377,39,416,0,416,12,232,172,22.04.2019 03:00,164,17,Ternopol
160,146,12,55,93,12,105,0,105,9,56,40,21.04.2019 22:00,164,17,Ternopol
656,652,50,177,429,50,479,0,479,11,221,247,21.04.2019 22:17,164,17,Ternopol
848,838,25,366,460,22,482,0,482,6,289,187,21.04.2019 23:30,164,17,Ternopol
240,231,21,72,148,20,168,0,168,7,108,53,21.04.2019 23:00,164,17,Ternopol
784,771,28,281,476,27,503,0,503,11,222,270,21.04.2019 21:15,164,17,Ternopol
624,616,56,201,370,53,423,0,423,9,280,134,21.04.2019 21:16,164,17,Ternopol
448,442,45,136,267,45,312,0,312,9,188,115,21.04.2019 21:00,164,17,Ternopol
496,477,24,167,305,24,329,0,329,10,193,126,21.04.2019 21:15,164,17,Ternopol
560,549,56,216,290,54,344,0,344,11,196,137,21.04.2019 21:20,164,17,Ternopol
464,449,40,197,228,39,267,0,267,3,101,163,21.04.2019 21:20,164,17,Ternopol
96,81,6,52,38,6,44,0,44,3,24,17,21.04.2019 20:30,164,17,Ternopol
576,568,30,228,320,28,348,0,348,6,210,132,22.04.2019 01:30,164,17,Ternopol
224,215,16,80,129,15,144,0,144,3,93,48,22.04.2019 00:15,164,17,Ternopol
384,381,16,157,212,15,227,0,227,4,115,108,22.04.2019 00:15,164,17,Ternopol
640,632,19,296,325,19,344,0,344,7,211,126,21.04.2019 21:30,164,17,Ternopol
320,310,30,147,143,30,173,0,173,7,94,72,21.04.2019 22:25,164,17,Ternopol
304,293,36,95,174,35,209,0,209,3,95,111,21.04.2019 21:10,164,17,Ternopol
416,412,20,113,283,20,303,0,303,12,156,135,21.04.2019 21:10,164,17,Ternopol
176,182,15,50,113,13,126,0,126,1,47,78,21.04.2019 20:50,164,17,Ternopol
256,249,14,77,166,13,179,0,179,2,104,73,21.04.2019 21:00,164,17,Ternopol
416,413,22,182,214,20,234,0,234,15,129,90,22.04.2019 00:45,164,17,Ternopol
1712,1694,18,701,994,17,1011,0,1011,38,587,386,22.04.2019 00:10,164,17,Ternopol
1472,1445,11,665,799,8,807,0,807,26,487,294,22.04.2019 00:15,164,17,Ternopol
896,881,16,435,445,16,461,0,461,7,308,146,22.04.2019 01:00,164,17,Ternopol
640,628,34,313,296,31,327,0,327,7,198,122,22.04.2019 02:20,164,17,Ternopol
1584,1550,13,723,849,12,861,0,861,27,552,282,22.04.2019 00:30,164,17,Ternopol
128,125,3,47,78,3,81,0,81,3,53,25,22.04.2019 00:30,164,17,Ternopol
160,153,12,52,97,11,108,0,108,1,88,19,21.04.2019 22:10,164,17,Ternopol
304,286,9,129,166,9,175,0,175,5,106,64,21.04.2019 22:00,164,17,Ternopol
480,476,46,169,265,46,311,0,311,8,156,147,21.04.2019 22:20,164,17,Ternopol
112,100,9,43,60,9,69,0,69,3,35,31,21.04.2019 21:45,164,17,Ternopol
256,249,38,111,116,29,145,0,145,6,80,59,22.04.2019 00:05,164,17,Ternopol
432,405,25,140,267,25,292,0,292,8,198,86,22.04.2019 00:20,164,17,Ternopol
160,157,7,41,112,7,119,0,119,3,67,49,21.04.2019 22:30,164,17,Ternopol
400,394,18,161,221,18,239,0,239,9,128,102,22.04.2019 00:23,164,17,Ternopol
192,180,14,72,106,14,120,0,120,8,74,38,21.04.2019 21:35,164,17,Ternopol
496,477,30,173,293,30,323,0,323,10,171,142,21.04.2019 22:00,164,17,Ternopol
240,226,19,98,125,17,142,0,142,7,82,53,21.04.2019 22:59,164,17,Ternopol
112,106,4,39,70,3,73,0,73,2,52,19,21.04.2019 20:25,164,17,Ternopol
592,578,47,167,378,47,425,0,425,25,210,190,21.04.2019 21:00,164,17,Ternopol
288,274,18,95,175,18,193,0,193,6,112,75,21.04.2019 21:00,164,17,Ternopol
384,378,29,144,213,27,240,0,240,6,100,134,22.04.2019 00:05,164,17,Ternopol
656,644,21,242,393,21,414,0,414,9,222,183,21.04.2019 22:05,164,17,Ternopol
336,318,22,148,167,21,188,0,188,9,100,79,21.04.2019 23:47,164,17,Ternopol
336,319,25,136,175,25,200,0,200,4,109,87,22.04.2019 00:30,164,17,Ternopol
784,767,93,249,454,81,535,0,535,5,297,233,21.04.2019 21:15,164,17,Ternopol
176,176,18,63,98,15,113,0,113,0,56,57,21.04.2019 21:18,164,17,Ternopol
352,351,33,100,220,32,252,0,252,6,138,108,21.04.2019 23:50,164,17,Ternopol
96,83,8,26,62,8,70,0,70,0,50,20,21.04.2019 20:20,164,17,Ternopol
64,57,9,15,40,9,49,0,49,0,37,12,21.04.2019 20:50,164,17,Ternopol
480,486,55,81,344,55,399,0,399,4,194,201,22.04.2019 00:10,164,17,Ternopol
448,429,49,191,211,46,257,0,257,0,136,121,21.04.2019 22:20,164,17,Ternopol
752,744,24,171,558,23,581,0,581,13,309,259,21.04.2019 21:30,164,17,Ternopol
352,339,15,129,209,14,223,0,223,9,133,81,21.04.2019 22:00,164,17,Ternopol
464,459,28,190,249,25,274,0,274,5,168,101,22.04.2019 00:10,164,17,Ternopol
352,338,38,110,205,37,242,0,242,3,145,94,21.04.2019 22:00,164,17,Ternopol
736,725,57,231,452,53,505,0,505,12,311,182,22.04.2019 00:05,164,17,Ternopol
1056,1036,65,331,663,62,725,0,725,14,421,290,21.04.2019 22:30,164,17,Ternopol
288,276,9,73,206,9,215,0,215,1,139,75,21.04.2019 23:20,164,17,Ternopol
832,829,31,344,459,29,488,0,488,15,277,196,21.04.2019 21:55,164,17,Ternopol
304,303,24,88,193,23,216,0,216,3,107,106,21.04.2019 21:55,164,17,Ternopol
112,105,7,45,60,7,67,0,67,0,27,40,21.04.2019 22:10,164,17,Ternopol
784,774,61,284,440,60,500,0,500,16,269,215,22.04.2019 01:28,164,17,Ternopol
288,283,17,83,188,17,205,0,205,7,124,74,21.04.2019 22:45,164,17,Ternopol
544,540,59,165,320,59,379,0,379,15,118,246,21.04.2019 21:00,164,17,Ternopol
240,232,14,62,164,14,178,0,178,5,108,65,21.04.2019 20:15,164,17,Ternopol
560,546,11,215,337,8,345,0,345,7,218,120,21.04.2019 22:10,164,17,Ternopol
288,282,17,95,176,17,193,0,193,4,79,110,21.04.2019 22:10,164,17,Ternopol
320,310,16,106,198,16,214,0,214,5,124,85,21.04.2019 20:40,164,17,Ternopol
480,464,16,195,271,14,285,0,285,20,125,140,21.04.2019 23:15,164,17,Ternopol
288,284,21,97,171,20,191,0,191,4,100,87,22.04.2019 00:17,164,17,Ternopol
336,323,17,141,181,14,195,0,195,5,93,97,22.04.2019 00:05,164,17,Ternopol
1088,1077,48,320,720,48,768,0,768,22,411,335,21.04.2019 22:15,164,17,Ternopol
304,292,10,113,182,9,191,0,191,9,93,89,21.04.2019 20:45,164,17,Ternopol
400,390,18,119,263,18,281,0,281,5,190,86,21.04.2019 20:41,164,17,Ternopol
288,273,19,85,185,18,203,0,203,10,132,61,21.04.2019 20:35,164,17,Ternopol
240,231,21,52,167,21,188,0,188,1,124,63,21.04.2019 22:15,164,17,Ternopol
528,524,45,159,324,45,369,0,369,12,139,218,21.04.2019 23:00,164,17,Ternopol
1200,1185,104,270,833,97,930,0,930,30,487,413,21.04.2019 22:10,164,17,Ternopol
368,352,29,134,207,27,234,0,234,4,108,122,21.04.2019 22:55,164,17,Ternopol
64,59,5,20,39,5,44,0,44,1,16,27,21.04.2019 22:10,164,17,Ternopol
1152,1142,22,504,628,20,648,0,648,25,364,259,21.04.2019 22:10,164,17,Ternopol
944,914,21,429,497,18,515,0,515,15,312,188,21.04.2019 23:45,164,17,Ternopol
1904,1864,11,761,1132,11,1143,0,1143,28,638,477,21.04.2019 23:00,164,17,Ternopol
768,741,7,341,422,5,427,0,427,14,229,184,21.04.2019 22:20,164,17,Ternopol
1600,1570,22,714,869,17,886,0,886,31,450,405,22.04.2019 01:00,164,17,Ternopol
368,353,30,106,233,29,262,0,262,3,138,121,21.04.2019 22:15,164,17,Ternopol
112,103,12,38,62,12,74,0,74,2,32,40,21.04.2019 22:00,164,17,Ternopol
208,206,16,88,111,9,120,0,120,1,70,49,21.04.2019 20:35,164,17,Ternopol
1152,1116,15,585,552,15,567,0,567,22,309,236,22.04.2019 00:37,164,17,Ternopol
912,887,23,395,495,22,517,0,517,29,283,205,21.04.2019 21:36,164,17,Ternopol
912,899,14,335,563,14,577,0,577,19,355,203,21.04.2019 23:10,164,17,Ternopol
80,71,9,24,47,9,56,0,56,2,36,18,21.04.2019 22:13,164,17,Ternopol
432,421,40,92,300,40,340,0,340,14,155,171,21.04.2019 20:57,164,17,Ternopol
192,184,26,52,118,22,140,0,140,3,70,67,21.04.2019 22:30,164,17,Ternopol
608,587,32,184,394,30,424,0,424,9,241,174,21.04.2019 22:20,164,17,Ternopol
976,957,24,377,575,24,599,0,599,17,318,264,21.04.2019 21:20,164,17,Ternopol
544,541,16,156,374,14,388,0,388,6,162,220,21.04.2019 21:06,164,17,Ternopol
288,282,18,74,196,18,214,0,214,7,115,92,21.04.2019 22:05,164,17,Ternopol
112,100,14,46,53,13,66,0,66,1,20,45,21.04.2019 20:46,164,17,Ternopol
240,232,12,90,140,10,150,0,150,2,103,45,21.04.2019 22:05,164,17,Ternopol
240,230,13,74,153,13,166,0,166,4,84,78,21.04.2019 21:30,164,17,Ternopol
240,232,21,102,117,21,138,0,138,3,94,41,21.04.2019 21:40,164,17,Ternopol
96,91,8,22,66,8,74,0,74,0,37,37,21.04.2019 21:15,164,17,Ternopol
784,795,80,247,465,72,537,0,537,12,323,202,21.04.2019 21:50,164,17,Ternopol
480,469,48,141,294,45,339,0,339,13,155,171,21.04.2019 20:54,164,17,Ternopol
128,121,16,50,63,15,78,0,78,5,47,26,22.04.2019 00:12,164,17,Ternopol
480,466,41,142,301,37,338,0,338,1,226,111,22.04.2019 00:12,164,17,Ternopol
352,346,30,122,200,30,230,0,230,4,113,113,21.04.2019 23:00,164,17,Ternopol
240,226,20,79,144,17,161,0,161,2,83,76,22.04.2019 00:15,164,17,Ternopol
320,303,8,133,182,5,187,0,187,2,98,87,22.04.2019 00:26,164,17,Ternopol
96,94,7,46,43,7,50,0,50,4,23,23,21.04.2019 21:15,164,17,Ternopol
528,507,34,171,323,34,357,0,357,2,179,176,21.04.2019 21:11,164,17,Ternopol
560,542,54,223,288,49,337,0,337,1,203,133,21.04.2019 21:12,164,17,Ternopol
768,759,43,261,470,37,507,0,507,7,299,201,21.04.2019 21:40,164,17,Ternopol
624,610,9,219,396,9,405,0,405,9,171,225,21.04.2019 21:00,164,17,Ternopol
400,389,22,137,243,20,263,0,263,6,151,106,21.04.2019 23:05,164,17,Ternopol
288,274,11,96,183,9,192,0,192,2,95,95,21.04.2019 20:31,164,17,Ternopol
848,838,58,328,474,46,520,0,520,15,313,192,22.04.2019 00:30,164,17,Ternopol
416,412,26,162,231,23,254,0,254,5,133,116,21.04.2019 21:08,164,17,Ternopol
304,301,20,101,183,20,203,0,203,10,122,71,21.04.2019 21:10,164,17,Ternopol
832,820,62,281,490,61,551,0,551,10,403,138,21.04.2019 21:40,164,17,Ternopol
224,217,21,86,120,18,138,0,138,3,97,38,21.04.2019 20:30,164,17,Ternopol
368,349,11,121,236,11,247,0,247,2,167,78,21.04.2019 21:00,164,17,Ternopol
64,51,7,24,33,7,40,0,40,2,32,6,21.04.2019 20:30,164,17,Ternopol
400,400,34,128,239,33,272,0,272,5,171,96,21.04.2019 22:30,164,17,Ternopol
304,295,12,135,160,9,169,0,169,3,96,70,21.04.2019 21:15,164,17,Ternopol
80,78,6,28,47,5,52,0,52,1,35,16,21.04.2019 20:30,164,17,Ternopol
528,500,40,221,274,33,307,0,307,5,170,132,21.04.2019 21:30,164,17,Ternopol
240,231,21,78,143,19,162,0,162,4,74,84,21.04.2019 21:10,164,17,Ternopol
176,167,16,61,99,16,115,0,115,3,56,56,21.04.2019 21:00,164,17,Ternopol
368,360,28,115,228,25,253,0,253,7,145,101,21.04.2019 20:50,164,17,Ternopol
320,316,22,93,205,22,227,0,227,1,126,100,21.04.2019 21:10,164,17,Ternopol
368,362,34,153,182,33,215,0,215,1,104,110,21.04.2019 22:10,164,17,Ternopol
560,553,51,198,314,48,362,0,362,7,225,130,21.04.2019 22:10,164,17,Ternopol
192,173,11,96,89,7,96,0,96,1,56,39,21.04.2019 21:47,164,17,Ternopol
464,450,26,165,274,25,299,0,299,9,152,138,21.04.2019 21:30,164,17,Ternopol
208,205,15,62,131,15,146,0,146,2,88,56,21.04.2019 21:20,164,17,Ternopol
480,471,20,167,293,20,313,0,313,6,173,134,21.04.2019 21:00,164,17,Ternopol
320,306,20,86,217,17,234,0,234,7,122,105,21.04.2019 22:05,164,17,Ternopol
160,155,14,41,105,14,119,0,119,1,66,52,21.04.2019 21:30,164,17,Ternopol
416,410,46,166,212,38,250,0,250,7,114,129,21.04.2019 21:00,164,17,Ternopol
320,303,22,97,201,22,223,0,223,1,141,81,21.04.2019 22:00,164,17,Ternopol
256,239,29,91,137,28,165,0,165,1,70,94,21.04.2019 21:19,164,17,Ternopol
528,520,10,149,369,10,379,0,379,7,212,160,21.04.2019 20:46,164,17,Ternopol
256,242,11,80,165,11,176,0,176,4,100,72,21.04.2019 21:30,164,17,Ternopol
528,514,16,166,346,16,362,0,362,4,223,135,21.04.2019 21:15,164,17,Ternopol
352,336,33,112,210,30,240,0,240,7,92,141,21.04.2019 21:40,164,17,Ternopol
336,315,18,140,178,18,196,0,196,2,106,88,21.04.2019 23:15,164,17,Ternopol
336,328,8,101,228,7,235,0,235,2,149,84,21.04.2019 21:07,164,17,Ternopol
288,278,18,97,175,16,191,0,191,5,109,77,21.04.2019 20:40,164,17,Ternopol
528,518,35,223,271,34,305,0,305,5,174,126,21.04.2019 21:40,164,17,Ternopol
464,444,32,196,238,30,268,0,268,4,187,77,21.04.2019 21:15,164,17,Ternopol
320,299,27,114,179,27,206,0,206,7,126,73,21.04.2019 21:20,164,17,Ternopol
416,410,39,151,232,33,265,0,265,2,167,96,21.04.2019 21:27,164,17,Ternopol
160,147,20,56,87,17,104,0,104,0,48,56,21.04.2019 21:40,164,17,Ternopol
448,441,62,111,276,61,337,0,337,3,178,156,21.04.2019 20:45,164,17,Ternopol
432,424,31,137,267,28,295,0,295,4,146,145,21.04.2019 21:30,164,17,Ternopol
784,756,50,321,414,49,463,0,463,9,306,148,21.04.2019 22:30,164,17,Ternopol
432,429,36,115,282,35,317,0,317,7,164,146,21.04.2019 21:15,164,17,Ternopol
448,438,26,157,265,26,291,0,291,9,188,94,21.04.2019 21:30,164,17,Ternopol
560,547,36,199,325,36,361,0,361,6,249,106,21.04.2019 21:30,164,17,Ternopol
1840,1805,32,723,1086,31,1117,0,1117,28,664,425,21.04.2019 22:25,164,17,Ternopol
1984,1959,32,717,1241,26,1267,0,1267,31,826,410,21.04.2019 23:47,164,17,Ternopol
48,26,0,23,25,0,25,0,25,0,8,17,21.04.2019 21:05,164,17,Ternopol
160,31,6,134,20,6,26,0,26,2,10,14,21.04.2019 20:45,164,17,Ternopol
240,231,15,85,141,14,155,0,155,4,79,72,21.04.2019 20:45,164,17,Ternopol
128,74,0,108,20,0,20,0,20,0,14,6,22.04.2019 01:10,164,17,Ternopol
1648,1593,9,704,936,8,944,0,944,36,466,442,22.04.2019 02:10,165,17,Ternopol
704,682,5,294,406,4,410,0,410,19,176,215,22.04.2019 00:12,165,17,Ternopol
1728,1696,39,655,1040,33,1073,0,1073,34,481,558,22.04.2019 04:20,165,17,Ternopol
720,718,8,297,418,5,423,0,423,19,188,216,22.04.2019 01:15,165,17,Ternopol
784,774,10,303,472,9,481,0,481,27,243,211,22.04.2019 00:03,165,17,Ternopol
1472,1433,18,584,870,18,888,0,888,37,378,473,22.04.2019 00:10,165,17,Ternopol
2048,1974,31,868,1152,28,1180,0,1180,38,576,566,22.04.2019 05:30,165,17,Ternopol
1712,1693,40,764,913,35,948,0,948,27,445,476,22.04.2019 00:35,165,17,Ternopol
1456,1444,27,545,888,23,911,0,911,41,341,529,22.04.2019 00:06,165,17,Ternopol
736,722,26,295,416,25,441,0,441,12,216,213,22.04.2019 00:59,165,17,Ternopol
640,629,24,215,404,21,425,0,425,15,195,215,22.04.2019 00:25,165,17,Ternopol
368,364,24,73,273,22,295,0,295,9,166,120,21.04.2019 22:22,165,17,Ternopol
400,395,51,126,226,48,274,0,274,10,120,144,21.04.2019 20:30,165,17,Ternopol
432,425,43,173,217,42,259,0,259,5,106,148,22.04.2019 00:50,165,17,Ternopol
256,242,31,73,153,30,183,0,183,5,58,120,22.04.2019 01:05,165,17,Ternopol
160,156,9,52,99,9,108,0,108,4,27,77,22.04.2019 00:50,165,17,Ternopol
528,526,64,100,368,60,428,0,428,11,122,295,22.04.2019 00:40,165,17,Ternopol
528,518,41,126,362,40,402,0,402,8,99,295,22.04.2019 00:20,165,17,Ternopol
368,356,23,98,247,23,270,0,270,4,142,124,22.04.2019 00:55,165,17,Ternopol
672,660,48,199,428,45,473,0,473,16,216,241,22.04.2019 00:30,165,17,Ternopol
352,330,21,96,236,20,256,0,256,1,85,170,22.04.2019 00:25,165,17,Ternopol
208,196,12,53,143,12,155,0,155,7,75,73,22.04.2019 00:05,165,17,Ternopol
384,392,24,84,276,24,300,0,300,7,95,198,22.04.2019 00:30,165,17,Ternopol
640,634,61,179,404,57,461,0,461,12,232,217,21.04.2019 21:30,165,17,Ternopol
192,188,11,73,111,8,119,0,119,9,76,34,22.04.2019 00:45,165,17,Ternopol
576,563,46,203,330,43,373,0,373,11,204,158,22.04.2019 01:10,165,17,Ternopol
112,106,0,46,66,0,66,0,66,0,43,23,22.04.2019 00:10,165,17,Ternopol
960,930,54,393,516,51,567,0,567,15,216,336,22.04.2019 01:05,165,17,Ternopol
512,516,19,155,338,19,357,0,357,8,180,169,22.04.2019 00:15,165,17,Ternopol
512,499,48,101,363,48,411,0,411,11,137,263,22.04.2019 00:30,165,17,Ternopol
256,247,29,92,137,27,164,0,164,5,100,59,21.04.2019 22:15,165,17,Ternopol
576,553,36,138,405,33,438,0,438,5,206,227,22.04.2019 00:50,165,17,Ternopol
560,559,51,240,280,40,320,0,320,9,124,187,21.04.2019 21:10,165,17,Ternopol
320,301,27,95,200,25,225,0,225,5,89,131,21.04.2019 21:30,165,17,Ternopol
224,213,36,103,95,26,121,0,121,1,72,48,21.04.2019 22:45,165,17,Ternopol
320,310,23,105,193,22,215,0,215,9,89,117,22.04.2019 00:15,165,17,Ternopol
96,85,3,49,44,3,47,0,47,1,33,13,21.04.2019 23:45,165,17,Ternopol
496,489,34,131,332,33,365,0,365,5,187,173,22.04.2019 01:20,165,17,Ternopol
416,417,21,115,282,19,301,0,301,10,136,155,22.04.2019 00:15,165,17,Ternopol
320,305,33,80,210,30,240,0,240,6,105,129,22.04.2019 00:15,165,17,Ternopol
208,203,29,36,143,29,172,0,172,2,80,90,22.04.2019 00:14,165,17,Ternopol
432,422,46,114,277,41,318,0,318,5,129,184,22.04.2019 00:30,165,17,Ternopol
224,228,16,84,124,16,140,0,140,3,44,93,22.04.2019 00:40,165,17,Ternopol
592,588,58,184,352,56,408,0,408,1,236,171,22.04.2019 00:20,165,17,Ternopol
400,397,21,131,248,21,269,0,269,4,186,79,22.04.2019 00:30,165,17,Ternopol
688,692,80,245,376,67,443,0,443,14,201,228,22.04.2019 00:20,165,17,Ternopol
608,592,68,216,324,68,392,0,392,15,192,185,22.04.2019 00:40,165,17,Ternopol
304,281,21,130,155,19,174,0,174,3,57,114,22.04.2019 00:10,165,17,Ternopol
464,451,48,111,309,44,353,0,353,12,139,202,21.04.2019 21:30,165,17,Ternopol
240,221,79,74,96,70,166,0,166,2,51,113,21.04.2019 21:05,165,17,Ternopol
960,940,74,413,479,68,547,0,547,20,225,302,22.04.2019 00:20,165,17,Ternopol
160,147,13,41,107,12,119,0,119,4,44,71,22.04.2019 00:37,165,17,Ternopol
1536,1548,15,606,915,15,930,0,930,33,435,462,22.04.2019 01:45,165,17,Ternopol
1312,1315,7,556,749,7,756,0,756,21,340,395,22.04.2019 00:50,165,17,Ternopol
1520,1503,13,660,848,12,860,0,860,36,450,374,22.04.2019 00:15,165,17,Ternopol
880,858,29,331,520,29,549,0,549,17,266,266,22.04.2019 00:10,165,17,Ternopol
256,248,6,126,124,6,130,0,130,2,84,44,22.04.2019 00:05,165,17,Ternopol
1312,1281,31,523,761,28,789,0,789,23,412,354,22.04.2019 08:00,165,17,Ternopol
752,738,34,329,392,31,423,0,423,15,193,215,22.04.2019 00:15,165,17,Ternopol
288,273,13,91,185,12,197,0,197,5,97,95,22.04.2019 01:28,165,17,Ternopol
64,59,4,29,32,3,35,0,35,0,10,25,22.04.2019 00:10,165,17,Ternopol
208,205,14,25,169,14,183,0,183,3,52,128,22.04.2019 00:55,165,17,Ternopol
512,501,52,163,304,45,349,0,349,6,78,265,22.04.2019 00:30,165,17,Ternopol
96,96,8,21,67,8,75,0,75,0,17,58,22.04.2019 02:00,165,17,Ternopol
144,137,15,34,95,15,110,0,110,1,45,64,22.04.2019 00:15,165,17,Ternopol
144,143,16,29,101,14,115,0,115,4,42,69,22.04.2019 00:50,165,17,Ternopol
352,349,42,90,225,37,262,0,262,2,103,157,22.04.2019 00:20,165,17,Ternopol
192,188,16,38,138,16,154,0,154,4,54,96,21.04.2019 20:35,165,17,Ternopol
336,323,42,82,212,42,254,0,254,3,85,166,22.04.2019 00:40,165,17,Ternopol
80,72,16,21,43,16,59,0,59,2,15,42,22.04.2019 00:20,165,17,Ternopol
192,183,24,83,86,23,109,0,109,3,35,71,22.04.2019 00:10,165,17,Ternopol
96,78,10,49,37,10,47,0,47,0,17,30,22.04.2019 00:30,165,17,Ternopol
144,140,20,24,102,18,120,0,120,3,54,63,22.04.2019 00:25,165,17,Ternopol
144,145,20,23,101,20,121,0,121,2,52,67,22.04.2019 00:23,165,17,Ternopol
128,132,15,54,60,14,74,0,74,0,38,36,22.04.2019 00:15,165,17,Ternopol
752,754,45,218,489,45,534,0,534,19,259,256,22.04.2019 00:10,165,17,Ternopol
608,598,37,197,374,37,411,0,411,13,229,169,22.04.2019 00:10,165,17,Ternopol
208,201,35,44,130,34,164,0,164,2,83,79,22.04.2019 00:20,165,17,Ternopol
224,215,21,74,131,19,150,0,150,8,77,65,22.04.2019 00:40,165,17,Ternopol
400,396,29,170,201,29,230,0,230,10,119,101,22.04.2019 00:10,165,17,Ternopol
96,80,12,54,33,9,42,0,42,2,25,15,22.04.2019 00:30,165,17,Ternopol
96,97,11,27,58,11,69,0,69,2,22,45,22.04.2019 01:45,165,17,Ternopol
80,77,6,20,56,4,60,0,60,0,18,42,22.04.2019 00:25,165,17,Ternopol
144,140,10,38,98,8,106,0,106,0,39,67,22.04.2019 00:20,165,17,Ternopol
80,79,7,26,49,5,54,0,54,0,12,42,22.04.2019 00:10,165,17,Ternopol
800,803,72,241,496,63,559,0,559,11,250,298,21.04.2019 22:25,165,17,Ternopol
688,671,65,145,479,64,543,0,543,42,205,296,22.04.2019 00:10,165,17,Ternopol
192,187,4,65,125,2,127,0,127,4,72,51,22.04.2019 00:05,165,17,Ternopol
320,303,21,102,198,20,218,0,218,15,94,109,22.04.2019 00:05,165,17,Ternopol
112,91,3,53,56,3,59,0,59,1,23,35,22.04.2019 00:10,165,17,Ternopol
368,349,23,102,246,20,266,0,266,9,165,92,22.04.2019 00:15,165,17,Ternopol
352,348,32,60,260,32,292,0,292,13,131,148,22.04.2019 01:05,165,17,Ternopol
240,234,23,56,161,23,184,0,184,5,30,149,21.04.2019 21:35,165,17,Ternopol
256,257,8,76,172,8,180,0,180,3,74,103,22.04.2019 00:10,165,17,Ternopol
528,511,43,79,406,43,449,0,449,8,173,268,22.04.2019 00:15,165,17,Ternopol
224,218,13,68,144,12,156,0,156,6,66,84,22.04.2019 00:35,165,17,Ternopol
272,265,16,85,175,12,187,0,187,0,53,134,22.04.2019 00:45,165,17,Ternopol
576,567,64,156,359,61,420,0,420,8,179,233,22.04.2019 00:20,165,17,Ternopol
336,325,19,100,219,17,236,0,236,3,109,124,22.04.2019 00:45,165,17,Ternopol
576,567,56,175,347,54,401,0,401,8,190,203,22.04.2019 00:05,165,17,Ternopol
112,98,10,42,61,9,70,0,70,2,36,32,22.04.2019 00:03,165,17,Ternopol
272,259,20,72,181,19,200,0,200,8,94,98,22.04.2019 01:00,165,17,Ternopol
544,529,35,218,292,34,326,0,326,10,191,125,22.04.2019 01:10,165,17,Ternopol
192,179,10,69,113,10,123,0,123,0,57,66,22.04.2019 00:30,165,17,Ternopol
496,491,30,141,326,29,355,0,355,9,163,183,22.04.2019 00:20,165,17,Ternopol
272,270,15,45,213,14,227,0,227,6,119,102,21.04.2019 22:00,165,17,Ternopol
128,122,11,39,78,11,89,0,89,0,55,34,22.04.2019 00:05,165,17,Ternopol
272,269,40,112,125,35,160,0,160,7,83,70,22.04.2019 00:15,165,17,Ternopol
1536,1507,96,500,941,95,1036,0,1036,38,497,501,22.04.2019 00:30,165,17,Ternopol
1200,1176,56,393,751,56,807,0,807,16,346,445,22.04.2019 01:00,165,17,Ternopol
528,528,62,115,355,58,413,0,413,3,182,228,22.04.2019 00:30,165,17,Ternopol
400,393,48,125,227,48,275,0,275,9,118,148,22.04.2019 00:25,165,17,Ternopol
304,303,20,97,187,20,207,0,207,4,84,119,22.04.2019 00:15,165,17,Ternopol
272,262,29,96,151,25,176,0,176,3,82,91,22.04.2019 00:25,165,17,Ternopol
240,231,26,83,131,26,157,0,157,1,85,71,22.04.2019 00:30,165,17,Ternopol
336,313,35,117,187,32,219,0,219,4,108,107,22.04.2019 00:15,165,17,Ternopol
352,341,41,139,179,34,213,0,213,2,93,118,22.04.2019 00:10,165,17,Ternopol
256,249,11,91,154,11,165,0,165,3,89,73,22.04.2019 00:45,165,17,Ternopol
224,218,20,78,126,20,146,0,146,4,92,50,21.04.2019 22:05,165,17,Ternopol
224,203,11,99,114,11,125,0,125,0,50,75,22.04.2019 00:18,165,17,Ternopol
224,215,20,56,149,19,168,0,168,1,57,110,22.04.2019 00:20,165,17,Ternopol
176,177,18,52,109,15,124,0,124,6,35,83,22.04.2019 00:20,165,17,Ternopol
672,666,30,221,421,30,451,0,451,6,140,305,22.04.2019 00:50,165,17,Ternopol
304,283,22,94,188,22,210,0,210,11,67,132,21.04.2019 23:15,165,17,Ternopol
352,335,17,119,216,17,233,0,233,7,110,116,21.04.2019 21:55,165,17,Ternopol
352,334,6,98,248,6,254,0,254,4,117,133,22.04.2019 01:30,165,17,Ternopol
240,229,20,99,125,16,141,0,141,5,65,71,22.04.2019 00:20,165,17,Ternopol
160,159,15,51,96,13,109,0,109,2,41,66,22.04.2019 00:10,165,17,Ternopol
160,148,8,54,98,8,106,0,106,3,54,49,22.04.2019 00:15,165,17,Ternopol
528,540,24,96,408,24,432,0,432,7,206,219,22.04.2019 00:30,165,17,Ternopol
336,325,30,75,231,30,261,0,261,3,96,162,21.04.2019 21:10,165,17,Ternopol
208,199,20,73,117,18,135,0,135,8,55,72,21.04.2019 20:30,165,17,Ternopol
144,130,15,45,84,15,99,0,99,0,32,67,22.04.2019 00:15,165,17,Ternopol
400,387,50,139,211,50,261,0,261,8,140,113,22.04.2019 00:25,165,17,Ternopol
160,160,12,57,95,8,103,0,103,2,32,69,22.04.2019 00:27,165,17,Ternopol
160,151,14,65,83,12,95,0,95,2,49,44,22.04.2019 00:15,165,17,Ternopol
272,270,21,71,180,21,201,0,201,3,107,91,22.04.2019 01:20,165,17,Ternopol
144,134,7,49,90,5,95,0,95,3,40,52,22.04.2019 00:05,165,17,Ternopol
352,343,35,87,233,32,265,0,265,6,118,141,22.04.2019 00:50,165,17,Ternopol
128,116,14,37,77,14,91,0,91,5,39,47,22.04.2019 00:30,165,17,Ternopol
176,43,14,137,26,13,39,0,39,0,19,20,22.04.2019 00:15,165,17,Ternopol
48,17,7,31,10,7,17,0,17,0,0,17,22.04.2019 00:12,165,17,Ternopol
1776,1761,34,662,1080,34,1114,0,1114,46,460,608,22.04.2019 00:10,165,17,Ternopol
1680,1645,26,678,979,23,1002,0,1002,27,456,519,21.04.2019 22:00,165,17,Ternopol
1648,1632,29,728,892,28,920,0,920,31,405,484,22.04.2019 00:15,165,17,Ternopol
1696,1678,36,655,1005,36,1041,0,1041,29,512,500,22.04.2019 00:05,165,17,Ternopol
1344,1333,80,381,884,79,963,0,963,18,504,441,22.04.2019 00:20,165,17,Ternopol
448,430,34,125,289,34,323,0,323,6,182,135,22.04.2019 01:10,165,17,Ternopol
320,314,35,106,179,35,214,0,214,7,84,123,22.04.2019 00:20,165,17,Ternopol
240,235,34,64,142,34,176,0,176,4,84,88,22.04.2019 00:15,165,17,Ternopol
336,325,46,80,215,41,256,0,256,6,126,124,22.04.2019 00:40,165,17,Ternopol
512,504,47,100,369,43,412,0,412,2,191,219,22.04.2019 00:30,165,17,Ternopol
240,227,30,59,153,28,181,0,181,2,87,92,22.04.2019 00:40,165,17,Ternopol
368,356,34,148,188,32,220,0,220,3,82,135,21.04.2019 21:10,165,17,Ternopol
32,39,13,0,20,12,32,0,32,0,12,20,21.04.2019 21:00,165,17,Ternopol
1056,1046,45,414,599,43,642,0,642,9,366,267,21.04.2019 22:06,165,17,Ternopol
288,293,39,84,170,34,204,0,204,2,81,121,22.04.2019 00:05,165,17,Ternopol
160,148,18,54,93,13,106,0,106,4,47,55,22.04.2019 00:20,165,17,Ternopol
432,431,26,131,275,26,301,0,301,8,112,181,22.04.2019 00:40,165,17,Ternopol
560,542,44,145,373,42,415,0,415,4,152,259,22.04.2019 00:15,165,17,Ternopol
384,372,31,99,258,27,285,0,285,12,119,154,22.04.2019 00:03,165,17,Ternopol
400,387,34,107,262,31,293,0,293,11,143,139,22.04.2019 00:10,165,17,Ternopol
192,186,19,51,122,19,141,0,141,1,51,89,22.04.2019 01:30,165,17,Ternopol
800,785,49,343,411,46,457,0,457,6,228,223,21.04.2019 22:00,165,17,Ternopol
736,727,91,241,409,86,495,0,495,8,260,227,22.04.2019 00:25,165,17,Ternopol
560,542,59,145,358,57,415,0,415,8,199,208,22.04.2019 00:05,165,17,Ternopol
608,597,27,268,314,26,340,0,340,6,195,139,21.04.2019 21:30,165,17,Ternopol
272,271,37,90,151,31,182,0,182,5,88,89,22.04.2019 00:35,165,17,Ternopol
320,315,26,66,228,26,254,0,254,7,138,109,22.04.2019 00:20,165,17,Ternopol
1024,996,11,453,561,10,571,0,571,28,295,248,21.04.2019 21:50,165,17,Ternopol
1072,1054,65,276,731,65,796,0,796,13,364,419,22.04.2019 00:20,165,17,Ternopol
704,689,70,168,469,67,536,0,536,5,236,295,22.04.2019 00:07,165,17,Ternopol
800,788,50,247,505,48,553,0,553,19,238,296,22.04.2019 00:25,165,17,Ternopol
144,130,2,54,88,2,90,0,90,2,51,37,22.04.2019 00:15,165,17,Ternopol
816,815,85,316,417,83,500,0,500,9,209,282,22.04.2019 00:40,165,17,Ternopol
512,495,30,150,332,30,362,0,362,16,208,138,22.04.2019 00:10,165,17,Ternopol
272,259,27,93,154,25,179,0,179,6,56,117,22.04.2019 00:20,165,17,Ternopol
336,331,30,84,227,25,252,0,252,2,106,144,22.04.2019 00:10,165,17,Ternopol
144,140,7,41,96,7,103,0,103,0,61,42,21.04.2019 21:05,165,17,Ternopol
400,388,38,104,263,33,296,0,296,6,119,171,22.04.2019 00:05,165,17,Ternopol
304,297,23,61,222,21,243,0,243,4,78,161,21.04.2019 21:00,165,17,Ternopol
384,380,36,117,232,35,267,0,267,2,116,149,22.04.2019 00:20,165,17,Ternopol
496,477,39,186,281,29,310,0,310,9,136,165,22.04.2019 00:05,165,17,Ternopol
672,668,47,247,381,44,425,0,425,7,195,223,21.04.2019 22:31,165,17,Ternopol
624,394,33,230,362,32,394,0,394,13,192,189,21.04.2019 21:26,165,17,Ternopol
752,742,66,191,496,65,561,0,561,15,233,313,22.04.2019 00:20,165,17,Ternopol
416,419,24,143,251,22,273,0,273,4,167,102,22.04.2019 00:10,165,17,Ternopol
752,733,52,286,421,45,466,0,466,15,187,264,22.04.2019 00:50,165,17,Ternopol
208,30,22,185,1,22,23,0,23,0,6,17,22.04.2019 00:03,165,17,Ternopol
528,515,20,155,353,20,373,0,373,3,119,251,22.04.2019 00:15,165,17,Ternopol
416,405,30,135,252,29,281,0,281,10,108,163,22.04.2019 00:15,165,17,Ternopol
544,527,33,283,228,33,261,0,261,7,109,145,22.04.2019 00:10,165,17,Ternopol
528,513,44,212,273,43,316,0,316,1,218,97,22.04.2019 00:18,165,17,Ternopol
416,405,41,165,210,41,251,0,251,6,173,72,22.04.2019 00:17,165,17,Ternopol
272,259,23,116,134,22,156,0,156,3,79,74,22.04.2019 00:20,165,17,Ternopol
304,298,19,92,193,19,212,0,212,6,117,89,22.04.2019 00:10,165,17,Ternopol
160,157,15,55,93,12,105,0,105,1,56,48,21.04.2019 22:00,165,17,Ternopol
224,218,12,99,113,12,125,0,125,5,68,52,21.04.2019 20:15,165,17,Ternopol
720,714,71,310,339,71,410,0,410,6,203,201,22.04.2019 00:20,165,17,Ternopol
688,661,39,211,438,39,477,0,477,12,186,279,22.04.2019 00:30,165,17,Ternopol
384,383,33,78,275,31,306,0,306,7,160,139,22.04.2019 00:10,165,17,Ternopol
224,219,27,47,153,24,177,0,177,8,86,83,22.04.2019 00:30,165,17,Ternopol
368,357,17,184,170,14,184,0,184,6,93,85,22.04.2019 00:23,165,17,Ternopol
256,258,23,65,168,23,191,0,191,14,65,112,22.04.2019 00:25,165,17,Ternopol
224,208,17,73,134,17,151,0,151,0,95,56,22.04.2019 00:50,165,17,Ternopol
64,59,7,24,33,7,40,0,40,1,16,23,22.04.2019 00:20,165,17,Ternopol
592,592,42,209,341,42,383,0,383,15,122,246,22.04.2019 00:21,165,17,Ternopol
384,368,25,123,236,25,261,0,261,6,114,141,21.04.2019 20:40,165,17,Ternopol
512,495,42,209,261,42,303,0,303,10,118,175,22.04.2019 00:35,165,17,Ternopol
608,584,59,222,328,58,386,0,386,9,121,256,22.04.2019 00:40,165,17,Ternopol
432,417,35,163,234,35,269,0,269,6,77,186,22.04.2019 00:55,165,17,Ternopol
272,265,19,95,158,19,177,0,177,6,43,128,21.04.2019 22:35,165,17,Ternopol
64,62,12,10,42,12,54,0,54,2,2,50,21.04.2019 23:15,165,17,Ternopol
112,108,11,29,72,11,83,0,83,0,24,59,22.04.2019 00:15,165,17,Ternopol
496,493,21,226,249,21,270,0,270,5,125,140,21.04.2019 20:59,165,17,Ternopol
112,98,2,56,54,2,56,0,56,1,17,38,22.04.2019 00:25,165,17,Ternopol
112,108,17,45,51,16,67,0,67,1,21,45,21.04.2019 23:50,165,17,Ternopol
208,194,21,97,91,20,111,0,111,4,24,83,22.04.2019 00:30,165,17,Ternopol
560,543,52,215,293,52,345,0,345,7,143,195,22.04.2019 02:35,165,17,Ternopol
144,134,6,41,97,6,103,0,103,3,42,58,22.04.2019 02:00,165,17,Ternopol
432,420,25,119,288,25,313,0,313,7,111,195,21.04.2019 22:45,165,17,Ternopol
112,110,0,58,54,0,54,0,54,1,10,43,22.04.2019 00:30,165,17,Ternopol
960,955,42,265,654,41,695,0,695,11,234,450,21.04.2019 21:50,165,17,Ternopol
736,711,53,341,345,50,395,0,395,13,161,221,22.04.2019 01:30,165,17,Ternopol
416,397,31,154,231,31,262,0,262,9,70,183,22.04.2019 01:03,165,17,Ternopol
1152,1136,11,475,666,11,677,0,677,23,293,361,22.04.2019 00:10,165,17,Ternopol
1056,1033,5,473,578,5,583,0,583,25,257,301,22.04.2019 00:10,165,17,Ternopol
400,387,11,96,293,11,304,0,304,9,105,190,22.04.2019 00:05,165,17,Ternopol
880,856,43,336,501,43,544,0,544,15,220,309,22.04.2019 00:47,165,17,Ternopol
1264,1227,70,446,758,60,818,0,818,26,334,458,22.04.2019 01:45,165,17,Ternopol
576,560,30,272,277,27,304,0,304,9,169,126,22.04.2019 00:10,165,17,Ternopol
304,296,8,131,165,8,173,0,173,8,107,58,22.04.2019 00:10,165,17,Ternopol
640,625,73,208,359,73,432,0,432,10,155,267,22.04.2019 00:40,165,17,Ternopol
224,214,11,97,116,11,127,0,127,4,52,71,22.04.2019 00:09,165,17,Ternopol
112,34,10,79,24,9,33,0,33,1,10,22,21.04.2019 20:40,165,17,Ternopol
496,479,35,163,302,31,333,0,333,6,142,185,22.04.2019 00:20,165,17,Ternopol
320,308,14,104,202,14,216,0,216,10,80,126,22.04.2019 02:30,165,17,Ternopol
2128,2153,48,775,1307,46,1353,0,1353,34,659,660,22.04.2019 00:01,165,17,Ternopol
1664,1639,37,634,999,31,1030,0,1030,45,483,502,22.04.2019 04:35,165,17,Ternopol
912,907,8,310,596,6,602,0,602,21,294,287,22.04.2019 01:01,165,17,Ternopol
960,944,58,348,557,55,612,0,612,20,256,336,22.04.2019 03:45,165,17,Ternopol
176,164,3,46,127,3,130,0,130,2,33,95,22.04.2019 03:30,165,17,Ternopol
2032,2109,57,659,1324,49,1373,0,1373,53,566,754,22.04.2019 01:20,165,17,Ternopol
2160,2129,21,880,1265,15,1280,0,1280,46,618,616,22.04.2019 00:25,165,17,Ternopol
2256,2220,21,919,1320,17,1337,0,1337,42,638,657,22.04.2019 01:20,165,17,Ternopol
224,208,9,91,124,9,133,0,133,8,69,56,22.04.2019 00:25,165,17,Ternopol
1504,1471,41,598,867,39,906,0,906,24,436,446,22.04.2019 00:10,165,17,Ternopol
1120,1102,31,445,648,27,675,0,675,23,372,280,22.04.2019 00:20,165,17,Ternopol
1552,1533,42,526,987,39,1026,0,1026,44,434,548,22.04.2019 00:08,165,17,Ternopol
1984,1971,41,669,1277,38,1315,0,1315,70,596,649,21.04.2019 21:58,165,17,Ternopol
1776,1753,87,652,1041,83,1124,0,1124,39,548,537,21.04.2019 21:14,165,17,Ternopol
992,972,51,303,639,50,689,0,689,11,341,337,22.04.2019 00:25,165,17,Ternopol
1376,1372,20,431,931,14,945,0,945,30,449,466,22.04.2019 00:05,165,17,Ternopol
624,607,26,228,372,24,396,0,396,18,246,132,22.04.2019 00:20,165,17,Ternopol
272,262,16,63,193,16,209,0,209,1,120,88,22.04.2019 00:10,165,17,Ternopol
560,552,25,207,332,21,353,0,353,14,179,160,21.04.2019 22:00,165,17,Ternopol
336,212,15,124,197,15,212,0,212,7,78,127,21.04.2019 23:10,165,17,Ternopol
768,751,51,217,500,51,551,5,551,13,318,220,22.04.2019 04:30,165,17,Ternopol
496,476,42,146,311,39,350,0,350,16,167,167,21.04.2019 23:45,165,17,Ternopol
688,677,66,237,386,65,451,0,451,10,172,269,21.04.2019 20:56,165,17,Ternopol
544,538,59,193,295,56,351,0,351,6,150,195,21.04.2019 23:30,165,17,Ternopol
400,388,21,94,285,21,306,0,306,12,147,147,21.04.2019 22:20,165,17,Ternopol
208,192,12,52,144,12,156,0,156,4,76,76,21.04.2019 22:20,165,17,Ternopol
784,771,70,256,461,67,528,0,528,13,201,314,22.04.2019 00:35,165,17,Ternopol
352,338,33,121,198,33,231,0,231,3,131,97,22.04.2019 00:30,165,17,Ternopol
560,543,56,226,281,53,334,0,334,14,147,173,22.04.2019 01:20,165,17,Ternopol
512,513,13,125,374,13,387,0,387,14,163,210,22.04.2019 01:10,165,17,Ternopol
304,291,11,87,206,11,217,0,217,6,65,146,22.04.2019 00:20,165,17,Ternopol
1040,1021,72,334,635,71,706,0,706,17,429,260,22.04.2019 00:26,165,17,Ternopol
112,107,10,32,71,9,80,0,80,0,55,25,22.04.2019 00:25,165,17,Ternopol
352,348,29,134,189,29,218,0,218,8,70,140,22.04.2019 00:20,165,17,Ternopol
432,416,23,148,262,22,284,0,284,5,157,122,21.04.2019 21:45,165,17,Ternopol
624,609,43,153,431,40,471,0,471,8,214,249,21.04.2019 20:30,165,17,Ternopol
1632,1622,44,518,1071,43,1114,0,1114,22,512,580,22.04.2019 00:25,165,17,Ternopol
1344,1335,90,501,759,84,843,0,843,17,440,386,22.04.2019 03:05,165,17,Ternopol
1440,1431,22,527,892,21,913,0,913,22,397,494,22.04.2019 00:05,165,17,Ternopol
2416,2392,99,860,1471,85,1556,0,1556,66,735,755,22.04.2019 01:30,165,17,Ternopol
752,746,17,255,482,15,497,0,497,15,243,239,22.04.2019 00:20,165,17,Ternopol
128,158,77,0,76,52,128,0,128,5,50,73,22.04.2019 01:05,165,17,Ternopol
1584,1570,45,504,1043,37,1080,0,1080,33,447,600,22.04.2019 01:00,165,17,Ternopol
1088,1045,60,383,651,54,705,0,705,31,306,368,22.04.2019 00:30,165,17,Ternopol
496,453,27,166,304,26,330,0,330,17,145,168,22.04.2019 00:40,165,17,Ternopol
784,786,61,199,524,61,585,0,585,17,237,331,22.04.2019 01:00,165,17,Ternopol
496,474,42,171,285,40,325,0,325,10,185,130,22.04.2019 00:05,165,17,Ternopol
496,483,18,189,289,18,307,0,307,8,148,151,22.04.2019 00:02,165,17,Ternopol
448,430,27,170,251,27,278,0,278,5,160,113,22.04.2019 00:30,165,17,Ternopol
224,219,14,71,140,13,153,0,153,0,75,78,22.04.2019 00:05,165,17,Ternopol
576,559,27,234,316,26,342,0,342,9,142,191,22.04.2019 00:10,165,17,Ternopol
1072,1052,24,378,670,24,694,0,694,25,377,292,22.04.2019 00:15,165,17,Ternopol
496,491,36,134,326,36,362,0,362,11,103,248,22.04.2019 00:25,165,17,Ternopol
480,479,21,126,335,19,354,0,354,16,137,201,22.04.2019 00:10,165,17,Ternopol
592,589,16,195,381,16,397,0,397,16,204,177,22.04.2019 00:40,165,17,Ternopol
288,280,19,98,174,16,190,0,190,7,94,89,22.04.2019 00:10,165,17,Ternopol
592,573,35,174,385,33,418,0,418,18,208,192,22.04.2019 00:55,165,17,Ternopol
496,484,53,127,316,53,369,0,369,7,174,188,22.04.2019 00:15,165,17,Ternopol
848,831,27,301,522,25,547,0,547,24,284,239,22.04.2019 00:15,165,17,Ternopol
1184,1157,42,437,714,33,747,0,747,31,330,386,22.04.2019 00:20,165,17,Ternopol
112,19,2,93,17,2,19,0,19,1,6,12,22.04.2019 00:57,165,17,Ternopol
224,49,10,179,36,9,45,0,45,0,18,27,22.04.2019 00:05,165,17,Ternopol
48,19,0,29,19,0,19,0,19,1,7,11,21.04.2019 20:20,165,17,Ternopol
48,40,18,17,13,18,31,0,31,0,14,17,22.04.2019 00:30,165,17,Ternopol
928,900,22,340,568,20,588,0,588,22,290,276,22.04.2019 00:30,165,17,Ternopol
2224,2217,13,886,1326,12,1338,0,1338,45,587,706,22.04.2019 01:55,165,17,Ternopol
1200,1182,1,510,689,1,690,0,690,28,349,313,21.04.2019 22:45,165,17,Ternopol
1984,1954,9,903,1076,5,1081,0,1081,40,499,542,22.04.2019 01:15,165,17,Ternopol
80,35,22,48,13,19,32,0,32,1,12,19,22.04.2019 00:10,165,17,Ternopol
720,703,36,202,484,34,518,0,518,6,247,265,22.04.2019 00:15,166,17,Ternopol
864,839,53,229,584,51,635,0,635,9,341,285,22.04.2019 00:35,166,17,Ternopol
128,117,13,37,78,13,91,0,91,4,47,40,22.04.2019 00:05,166,17,Ternopol
464,460,32,174,259,31,290,0,290,10,104,176,22.04.2019 01:30,166,17,Ternopol
544,538,36,161,348,35,383,0,383,9,124,250,22.04.2019 00:05,166,17,Ternopol
352,344,1,119,232,1,233,0,233,1,108,124,22.04.2019 01:10,166,17,Ternopol
1040,1025,23,414,603,23,626,0,626,26,290,310,22.04.2019 00:10,166,17,Ternopol
1200,1173,34,561,606,33,639,0,639,16,339,284,22.04.2019 02:00,166,17,Ternopol
1120,1096,31,527,564,29,593,0,593,17,309,267,21.04.2019 23:45,166,17,Ternopol
736,728,28,299,412,25,437,0,437,20,217,200,22.04.2019 00:51,166,17,Ternopol
1952,1922,17,770,1167,15,1182,0,1182,38,584,560,22.04.2019 00:30,166,17,Ternopol
1024,1003,12,448,564,12,576,0,576,17,282,277,22.04.2019 00:30,166,17,Ternopol
928,910,29,357,542,29,571,0,571,21,274,276,22.04.2019 00:30,166,17,Ternopol
784,767,26,267,491,26,517,0,517,14,232,271,22.04.2019 01:30,166,17,Ternopol
640,634,35,264,341,35,376,0,376,14,175,187,22.04.2019 00:25,166,17,Ternopol
224,209,17,90,117,17,134,0,134,2,60,72,22.04.2019 00:10,166,17,Ternopol
416,408,46,122,253,41,294,0,294,4,103,187,21.04.2019 21:00,166,17,Ternopol
112,108,12,33,68,11,79,0,79,1,31,47,21.04.2019 21:30,166,17,Ternopol
592,587,13,122,458,12,470,0,470,5,205,260,22.04.2019 00:10,166,17,Ternopol
1264,1238,73,490,704,70,774,0,774,25,442,307,22.04.2019 00:10,166,17,Ternopol
480,476,11,82,387,11,398,0,398,9,102,287,22.04.2019 01:35,166,17,Ternopol
448,441,23,117,309,22,331,0,331,8,165,158,22.04.2019 06:15,166,17,Ternopol
352,340,11,75,266,11,277,0,277,1,129,147,22.04.2019 01:15,166,17,Ternopol
544,527,27,192,325,27,352,0,352,14,235,103,22.04.2019 00:01,166,17,Ternopol
1776,1744,86,753,939,84,1023,0,1023,27,581,415,22.04.2019 00:30,166,17,Ternopol
208,207,15,38,155,15,170,0,170,3,79,88,22.04.2019 00:05,166,17,Ternopol
1072,1054,72,339,661,72,733,0,733,12,401,320,22.04.2019 00:30,166,17,Ternopol
224,208,22,73,129,22,151,0,151,0,51,100,22.04.2019 00:40,166,17,Ternopol
704,687,36,291,377,36,413,0,413,6,130,277,22.04.2019 00:55,166,17,Ternopol
208,197,6,93,110,5,115,0,115,5,19,91,22.04.2019 01:05,166,17,Ternopol
720,702,49,266,409,45,454,0,454,11,242,201,22.04.2019 00:05,166,17,Ternopol
736,731,52,280,405,51,456,0,456,8,268,180,22.04.2019 00:50,166,17,Ternopol
352,333,34,130,189,33,222,0,222,3,154,65,22.04.2019 00:20,166,17,Ternopol
144,132,12,72,62,10,72,0,72,3,45,24,22.04.2019 00:15,166,17,Ternopol
192,178,10,52,130,10,140,0,140,4,89,47,22.04.2019 01:40,166,17,Ternopol
976,953,29,338,609,29,638,0,638,9,340,289,22.04.2019 00:05,166,17,Ternopol
464,458,29,168,267,29,296,0,296,7,89,200,22.04.2019 00:30,166,17,Ternopol
112,98,4,52,56,4,60,0,60,2,35,23,22.04.2019 00:30,166,17,Ternopol
784,767,39,329,419,36,455,0,455,9,220,226,22.04.2019 00:13,166,17,Ternopol
240,238,4,70,166,4,170,0,170,4,74,92,22.04.2019 00:20,166,17,Ternopol
688,685,40,197,451,40,491,0,491,7,170,314,21.04.2019 20:45,166,17,Ternopol
560,545,26,190,345,25,370,0,370,7,169,194,22.04.2019 01:25,166,17,Ternopol
1152,1143,70,314,772,66,838,0,838,18,346,474,22.04.2019 00:10,166,17,Ternopol
256,254,7,83,166,7,173,0,173,5,99,69,22.04.2019 00:15,166,17,Ternopol
352,339,12,78,262,12,274,0,274,2,147,125,22.04.2019 00:45,166,17,Ternopol
368,358,22,125,221,22,243,0,243,4,128,111,22.04.2019 00:15,166,17,Ternopol
640,629,20,177,443,20,463,0,463,6,249,208,22.04.2019 00:10,166,17,Ternopol
224,218,22,52,152,20,172,0,172,2,79,91,22.04.2019 00:05,166,17,Ternopol
992,981,23,231,738,23,761,0,761,10,346,405,22.04.2019 01:30,166,17,Ternopol
1216,1183,33,479,705,32,737,0,737,18,372,347,22.04.2019 01:30,166,17,Ternopol
624,617,18,140,466,18,484,0,484,10,246,228,22.04.2019 00:16,166,17,Ternopol
336,322,15,87,234,15,249,0,249,5,141,103,22.04.2019 01:40,166,17,Ternopol
800,788,82,283,438,79,517,0,517,13,263,241,22.04.2019 00:12,166,17,Ternopol
832,811,48,255,530,47,577,0,577,13,336,228,22.04.2019 00:05,166,17,Ternopol
240,225,1,83,157,0,157,0,157,4,76,77,21.04.2019 21:00,166,17,Ternopol
800,793,40,226,534,40,574,0,574,5,332,237,22.04.2019 00:15,166,17,Ternopol
1392,1370,91,596,705,91,796,0,796,16,368,412,21.04.2019 21:30,166,17,Ternopol
1344,1320,31,366,947,31,978,0,978,14,590,374,22.04.2019 01:20,166,17,Ternopol
928,916,51,348,534,46,580,0,580,13,325,242,21.04.2019 20:38,166,17,Ternopol
720,709,57,163,500,57,557,0,557,6,329,222,21.04.2019 21:00,166,17,Ternopol
432,425,22,95,315,22,337,0,337,3,193,141,21.04.2019 21:30,166,17,Ternopol
1616,1598,75,673,873,70,943,0,943,35,249,659,22.04.2019 00:40,166,17,Ternopol
224,212,12,55,157,12,169,0,169,6,80,83,22.04.2019 00:25,166,17,Ternopol
832,817,15,339,478,15,493,0,493,8,241,244,21.04.2019 22:00,166,17,Ternopol
1040,1010,27,508,507,25,532,0,532,11,277,244,22.04.2019 00:25,166,17,Ternopol
1120,1106,14,397,709,14,723,0,723,15,349,359,22.04.2019 00:45,166,17,Ternopol
448,441,17,160,271,17,288,0,288,6,157,125,22.04.2019 00:10,166,17,Ternopol
400,390,24,178,200,22,222,0,222,3,126,93,22.04.2019 00:02,166,17,Ternopol
256,249,17,102,137,17,154,0,154,6,84,64,22.04.2019 00:30,166,17,Ternopol
384,368,27,139,219,26,245,0,245,7,96,142,22.04.2019 00:30,166,17,Ternopol
256,10,0,246,10,0,10,0,10,0,4,6,21.04.2019 20:30,166,17,Ternopol
112,101,13,46,53,13,66,0,66,5,36,25,21.04.2019 23:30,166,17,Ternopol
288,279,11,74,205,9,214,0,214,5,105,104,21.04.2019 22:00,166,17,Ternopol
960,958,54,265,643,52,695,0,695,13,394,288,21.04.2019 22:05,166,17,Ternopol
336,324,18,92,226,18,244,0,244,6,159,79,21.04.2019 23:45,166,17,Ternopol
144,134,9,57,78,9,87,0,87,1,65,21,21.04.2019 23:30,166,17,Ternopol
208,192,13,98,101,9,110,0,110,0,56,54,22.04.2019 00:10,166,17,Ternopol
816,794,74,270,475,71,546,0,546,12,268,266,22.04.2019 00:01,166,17,Ternopol
720,724,64,302,356,62,418,0,418,14,240,164,21.04.2019 22:10,166,17,Ternopol
656,641,55,155,448,53,501,0,501,7,271,223,22.04.2019 00:05,166,17,Ternopol
1408,1391,66,564,783,61,844,0,844,29,443,372,22.04.2019 00:30,166,17,Ternopol
1136,1123,92,380,665,91,756,0,756,19,420,317,22.04.2019 00:40,166,17,Ternopol
480,463,26,145,311,24,335,0,335,10,148,177,22.04.2019 00:05,166,17,Ternopol
64,48,7,36,22,6,28,0,28,2,17,9,21.04.2019 21:40,166,17,Ternopol
320,310,22,82,216,22,238,0,238,10,92,136,21.04.2019 22:00,166,17,Ternopol
448,436,45,125,279,44,323,0,323,3,161,159,21.04.2019 20:50,166,17,Ternopol
384,376,20,112,252,20,272,0,272,10,154,108,22.04.2019 00:05,166,17,Ternopol
96,92,7,42,48,6,54,0,54,0,31,23,21.04.2019 22:00,166,17,Ternopol
80,72,6,36,38,6,44,0,44,0,19,25,21.04.2019 21:58,166,17,Ternopol
1680,1664,65,699,921,60,981,0,981,27,458,496,22.04.2019 00:30,166,17,Ternopol
1520,1494,14,721,786,13,799,0,799,34,387,378,21.04.2019 23:40,166,17,Ternopol
1280,1271,39,261,980,39,1019,0,1019,42,572,405,22.04.2019 00:10,166,17,Ternopol
432,417,27,154,251,27,278,0,278,3,136,139,22.04.2019 00:03,166,17,Ternopol
160,158,19,58,85,17,102,0,102,6,40,56,21.04.2019 21:30,166,17,Ternopol
176,169,13,58,106,12,118,0,118,0,50,68,21.04.2019 23:55,166,17,Ternopol
272,268,32,86,154,32,186,0,186,2,86,98,22.04.2019 00:15,166,17,Ternopol
240,229,17,67,158,15,173,0,173,0,91,82,22.04.2019 00:30,166,17,Ternopol
448,440,15,181,252,15,267,0,267,7,170,90,21.04.2019 23:45,166,17,Ternopol
160,151,15,37,108,15,123,0,123,3,55,65,22.04.2019 00:21,166,17,Ternopol
944,916,61,378,508,58,566,0,566,11,400,155,22.04.2019 00:10,166,17,Ternopol
176,162,18,69,89,18,107,0,107,0,52,55,22.04.2019 00:30,166,17,Ternopol
240,237,29,65,146,29,175,0,175,10,110,55,21.04.2019 23:35,166,17,Ternopol
1136,1124,95,446,599,91,690,0,690,24,370,296,22.04.2019 00:15,166,17,Ternopol
336,319,23,75,238,23,261,0,261,11,101,149,21.04.2019 22:30,166,17,Ternopol
848,829,48,299,503,46,549,0,549,12,334,203,22.04.2019 00:04,166,17,Ternopol
224,211,18,74,132,18,150,0,150,2,49,99,22.04.2019 01:15,166,17,Ternopol
992,988,88,382,529,81,610,0,610,12,354,244,21.04.2019 23:05,166,17,Ternopol
496,482,26,137,333,26,359,0,359,11,138,210,22.04.2019 00:15,166,17,Ternopol
272,266,30,42,200,30,230,0,230,1,112,117,22.04.2019 00:10,166,17,Ternopol
784,776,51,290,446,48,494,0,494,11,238,245,22.04.2019 00:20,166,17,Ternopol
576,568,32,122,422,32,454,0,454,13,252,189,21.04.2019 23:50,166,17,Ternopol
48,45,6,25,19,4,23,0,23,0,14,9,22.04.2019 00:15,166,17,Ternopol
720,705,32,220,468,32,500,0,500,6,265,229,22.04.2019 01:05,166,17,Ternopol
464,461,21,139,304,21,325,0,325,5,181,139,21.04.2019 21:30,166,17,Ternopol
640,631,61,191,388,61,449,0,449,15,249,185,21.04.2019 23:52,166,17,Ternopol
160,159,4,43,113,4,117,0,117,1,67,49,22.04.2019 00:20,166,17,Ternopol
352,337,44,105,203,44,247,0,247,2,110,135,22.04.2019 05:10,166,17,Ternopol
1008,992,81,326,601,81,682,0,682,11,439,232,22.04.2019 00:10,166,17,Ternopol
816,806,35,251,530,35,565,0,565,13,310,242,22.04.2019 00:05,166,17,Ternopol
1312,1263,26,542,750,20,770,0,770,42,380,348,22.04.2019 01:05,166,17,Ternopol
1104,1088,22,517,568,19,587,0,587,15,394,178,22.04.2019 00:05,166,17,Ternopol
1424,1404,12,709,705,10,715,0,715,26,423,266,22.04.2019 00:05,166,17,Ternopol
816,797,52,288,482,46,528,0,528,10,312,206,21.04.2019 21:45,166,17,Ternopol
192,189,2,35,155,2,157,0,157,4,122,31,22.04.2019 00:30,166,17,Ternopol
144,134,21,47,78,19,97,0,97,0,55,42,21.04.2019 23:00,166,17,Ternopol
944,125,0,823,121,0,121,0,121,7,103,11,22.04.2019 01:25,166,17,Ternopol
1296,1282,47,565,685,46,731,0,731,31,463,237,22.04.2019 00:40,166,17,Ternopol
960,940,26,372,562,26,588,0,588,21,356,211,22.04.2019 00:10,166,17,Ternopol
960,954,34,365,563,32,595,0,595,12,414,169,22.04.2019 03:35,166,17,Ternopol
1088,1070,36,540,515,33,548,0,548,16,335,197,22.04.2019 00:25,166,17,Ternopol
208,196,11,80,118,10,128,0,128,1,84,43,21.04.2019 23:00,166,17,Ternopol
192,187,30,47,115,30,145,0,145,0,45,100,22.04.2019 00:15,166,17,Ternopol
752,741,54,148,550,54,604,0,604,7,291,306,22.04.2019 00:30,166,17,Ternopol
320,304,21,149,150,21,171,0,171,7,107,57,22.04.2019 00:40,166,17,Ternopol
240,234,20,110,110,20,130,0,130,4,64,62,22.04.2019 02:50,166,17,Ternopol
528,520,33,190,308,30,338,0,338,8,232,98,22.04.2019 00:10,166,17,Ternopol
464,453,34,163,269,32,301,0,301,4,178,119,22.04.2019 00:50,166,17,Ternopol
160,156,9,50,101,9,110,0,110,9,40,61,22.04.2019 00:40,166,17,Ternopol
272,260,23,113,136,23,159,0,159,4,100,55,22.04.2019 00:30,166,17,Ternopol
224,206,16,71,137,16,153,0,153,1,90,62,22.04.2019 00:45,166,17,Ternopol
272,271,25,79,168,25,193,0,193,1,74,118,22.04.2019 00:15,166,17,Ternopol
96,91,18,37,45,14,59,0,59,0,25,34,22.04.2019 00:30,166,17,Ternopol
224,221,30,48,147,29,176,0,176,2,57,117,22.04.2019 00:05,166,17,Ternopol
160,153,13,36,111,13,124,0,124,1,40,83,21.04.2019 20:50,166,17,Ternopol
80,75,4,28,48,4,52,0,52,0,30,22,21.04.2019 21:00,166,17,Ternopol
848,837,37,290,521,37,558,0,558,25,413,120,22.04.2019 00:40,166,17,Ternopol
256,250,17,91,148,17,165,0,165,12,112,41,22.04.2019 00:15,166,17,Ternopol
160,157,12,48,101,11,112,0,112,2,61,49,22.04.2019 00:25,166,17,Ternopol
784,778,33,379,372,33,405,0,405,9,194,202,22.04.2019 00:15,166,17,Ternopol
672,660,74,249,349,74,423,0,423,11,182,230,21.04.2019 22:00,166,17,Ternopol
416,411,30,143,243,30,273,0,273,12,151,110,22.04.2019 00:30,166,17,Ternopol
208,202,15,117,80,11,91,0,91,1,58,32,21.04.2019 23:00,166,17,Ternopol
208,194,18,77,113,18,131,0,131,2,64,65,22.04.2019 00:45,166,17,Ternopol
240,235,28,96,116,28,144,0,144,6,89,49,22.04.2019 00:20,166,17,Ternopol
496,484,49,148,299,49,348,0,348,15,160,173,22.04.2019 00:30,166,17,Ternopol
544,494,37,182,325,37,362,0,362,14,186,162,22.04.2019 00:15,166,17,Ternopol
160,144,9,67,85,8,93,0,93,2,62,29,22.04.2019 00:10,166,17,Ternopol
704,697,50,277,377,50,427,0,427,8,245,174,21.04.2019 21:51,166,17,Ternopol
704,691,56,271,381,52,433,0,433,13,221,199,22.04.2019 00:57,166,17,Ternopol
160,148,2,41,117,2,119,0,119,1,63,55,22.04.2019 00:45,166,17,Ternopol
448,457,34,110,305,33,338,0,338,5,220,113,22.04.2019 00:20,166,17,Ternopol
432,413,18,172,247,13,260,0,260,5,161,94,22.04.2019 00:20,166,17,Ternopol
176,169,14,67,95,14,109,0,109,0,59,50,21.04.2019 23:00,166,17,Ternopol
448,432,33,137,279,32,311,0,311,10,193,108,21.04.2019 20:15,166,17,Ternopol
240,227,34,57,153,30,183,0,183,2,77,104,21.04.2019 21:00,166,17,Ternopol
224,208,5,79,140,5,145,0,145,2,67,76,22.04.2019 00:40,166,17,Ternopol
864,849,58,310,497,57,554,0,554,10,183,361,21.04.2019 23:57,166,17,Ternopol
144,140,10,70,65,9,74,0,74,3,33,38,21.04.2019 21:30,166,17,Ternopol
416,401,13,155,248,13,261,0,261,7,166,88,22.04.2019 02:15,166,17,Ternopol
320,319,41,94,187,39,226,0,226,7,122,97,22.04.2019 00:40,166,17,Ternopol
192,185,12,42,138,12,150,0,150,1,69,80,22.04.2019 00:20,166,17,Ternopol
144,136,13,31,101,12,113,0,113,1,55,57,22.04.2019 01:50,166,17,Ternopol
256,243,25,134,103,19,122,0,122,4,58,60,21.04.2019 21:50,166,17,Ternopol
304,302,26,96,183,25,208,0,208,9,122,77,22.04.2019 00:40,166,17,Ternopol
464,440,48,169,249,46,295,0,295,14,172,109,21.04.2019 20:40,166,17,Ternopol
576,569,70,216,292,68,360,0,360,9,165,186,21.04.2019 21:30,166,17,Ternopol
112,17,0,96,16,0,16,0,16,0,3,13,22.04.2019 00:50,166,17,Ternopol
416,425,58,64,294,58,352,0,352,3,107,242,21.04.2019 21:40,166,17,Ternopol
224,224,14,52,158,14,172,0,172,2,53,117,22.04.2019 00:13,166,17,Ternopol
1072,1103,145,322,614,136,750,0,750,13,424,313,22.04.2019 02:00,166,17,Ternopol
160,147,14,41,105,14,119,0,119,2,38,79,22.04.2019 00:10,166,17,Ternopol
544,527,56,173,317,54,371,0,371,7,179,185,21.04.2019 22:15,166,17,Ternopol
784,773,53,281,451,52,503,0,503,14,241,248,22.04.2019 00:10,166,17,Ternopol
320,304,14,115,192,13,205,0,205,6,132,67,22.04.2019 00:40,166,17,Ternopol
528,512,56,190,285,53,338,0,338,5,133,200,21.04.2019 21:00,166,17,Ternopol
432,433,38,97,298,37,335,0,335,11,122,202,21.04.2019 21:30,166,17,Ternopol
320,312,43,67,210,43,253,0,253,8,150,95,22.04.2019 00:40,166,17,Ternopol
256,245,25,103,131,22,153,0,153,4,67,82,22.04.2019 00:05,166,17,Ternopol
368,352,29,130,211,27,238,0,238,6,87,145,22.04.2019 00:25,166,17,Ternopol
128,118,11,43,77,8,85,0,85,1,49,35,22.04.2019 00:20,166,17,Ternopol
400,401,24,107,269,24,293,0,293,4,168,121,22.04.2019 00:07,166,17,Ternopol
512,504,32,103,377,32,409,0,409,17,211,181,22.04.2019 00:10,166,17,Ternopol
352,344,19,65,268,19,287,0,287,2,122,163,22.04.2019 00:05,166,17,Ternopol
608,601,42,227,341,40,381,0,381,9,159,213,22.04.2019 00:05,166,17,Ternopol
272,262,28,51,193,28,221,0,221,5,91,125,22.04.2019 00:35,166,17,Ternopol
576,572,57,228,292,56,348,0,348,8,182,158,21.04.2019 22:15,166,17,Ternopol
208,211,25,48,135,25,160,0,160,2,59,99,22.04.2019 00:10,166,17,Ternopol
96,83,13,22,61,13,74,0,74,0,31,43,21.04.2019 23:55,166,17,Ternopol
1216,1199,74,496,646,74,720,0,720,13,374,333,22.04.2019 00:25,166,17,Ternopol
1072,1057,38,244,790,38,828,0,828,20,358,450,22.04.2019 00:35,166,17,Ternopol
80,78,15,25,40,15,55,0,55,0,21,34,22.04.2019 00:50,166,17,Ternopol
1056,1037,101,336,625,95,720,0,720,25,488,207,22.04.2019 02:10,166,17,Ternopol
304,294,22,81,201,22,223,0,223,8,150,65,22.04.2019 00:40,166,17,Ternopol
272,264,36,74,168,30,198,0,198,4,72,122,22.04.2019 00:15,166,17,Ternopol
896,874,51,330,521,45,566,0,566,23,334,209,22.04.2019 00:05,166,17,Ternopol
1248,1239,146,255,847,146,993,0,993,16,502,475,22.04.2019 00:50,166,17,Ternopol
928,927,80,156,692,80,772,0,772,17,409,346,22.04.2019 00:05,166,17,Ternopol
160,154,16,37,107,16,123,0,123,8,42,73,21.04.2019 23:30,166,17,Ternopol
416,403,59,110,249,57,306,0,306,5,122,179,22.04.2019 00:05,166,17,Ternopol
352,340,44,116,194,42,236,0,236,1,121,114,22.04.2019 00:10,166,17,Ternopol
784,771,28,326,432,26,458,0,458,7,249,202,22.04.2019 03:00,166,17,Ternopol
352,343,31,92,229,31,260,0,260,9,125,126,22.04.2019 00:20,166,17,Ternopol
288,282,19,96,175,17,192,0,192,8,76,108,21.04.2019 20:40,166,17,Ternopol
368,358,24,123,223,22,245,0,245,5,150,90,22.04.2019 00:02,166,17,Ternopol
480,474,22,167,291,22,313,0,313,5,121,187,22.04.2019 00:30,166,17,Ternopol
416,404,13,166,237,13,250,0,250,7,113,130,21.04.2019 21:50,166,17,Ternopol
368,361,24,124,220,24,244,0,244,9,110,125,22.04.2019 00:20,166,17,Ternopol
224,212,8,88,128,8,136,0,136,0,68,68,22.04.2019 00:10,166,17,Ternopol
848,827,39,238,572,38,610,0,610,16,304,290,22.04.2019 00:15,166,17,Ternopol
416,403,46,141,231,44,275,0,275,5,126,144,21.04.2019 23:30,166,17,Ternopol
416,403,25,133,258,25,283,0,283,5,136,142,22.04.2019 01:30,166,17,Ternopol
272,268,16,61,195,16,211,0,211,7,87,117,21.04.2019 20:30,166,17,Ternopol
176,165,6,35,135,6,141,0,141,0,73,68,22.04.2019 00:00,166,17,Ternopol
64,50,0,18,46,0,46,0,46,0,17,29,22.04.2019 00:15,166,17,Ternopol
592,577,68,124,400,68,468,0,468,25,189,254,22.04.2019 00:15,166,17,Ternopol
592,586,83,187,326,79,405,0,405,6,135,264,22.04.2019 00:55,166,17,Ternopol
384,381,51,122,211,51,262,0,262,2,106,154,22.04.2019 00:15,166,17,Ternopol
176,161,15,59,102,15,117,0,117,2,47,68,22.04.2019 00:05,166,17,Ternopol
336,324,21,87,232,17,249,0,249,5,131,113,22.04.2019 00:15,166,17,Ternopol
272,269,26,67,182,23,205,0,205,6,130,69,22.04.2019 00:05,166,17,Ternopol
1056,1034,59,379,622,55,677,0,677,14,334,329,22.04.2019 00:05,166,17,Ternopol
336,327,14,139,183,14,197,0,197,5,103,89,22.04.2019 00:15,166,17,Ternopol
192,181,10,94,90,8,98,0,98,5,41,52,21.04.2019 23:15,166,17,Ternopol
688,682,69,248,381,59,440,0,440,8,191,241,22.04.2019 01:12,166,17,Ternopol
176,165,23,75,80,21,101,0,101,4,29,68,22.04.2019 00:20,166,17,Ternopol
960,954,14,385,561,14,575,0,575,19,286,270,22.04.2019 00:20,166,17,Ternopol
576,567,17,217,342,17,359,0,359,4,200,155,22.04.2019 00:10,166,17,Ternopol
496,493,6,160,330,6,336,0,336,13,162,161,22.04.2019 00:07,166,17,Ternopol
176,163,15,69,92,15,107,0,107,1,52,54,21.04.2019 20:42,166,17,Ternopol
416,405,37,143,237,36,273,0,273,11,165,97,22.04.2019 00:15,166,17,Ternopol
1408,1398,14,578,818,12,830,0,830,35,394,401,21.04.2019 22:23,166,17,Ternopol
944,945,15,426,504,14,518,0,518,15,243,260,21.04.2019 23:00,166,17,Ternopol
1344,1331,20,574,753,17,770,0,770,27,374,369,21.04.2019 21:30,166,17,Ternopol
2160,2262,17,886,1263,11,1274,0,1274,58,694,522,22.04.2019 01:05,166,17,Ternopol
960,938,13,480,469,11,480,0,480,16,217,247,22.04.2019 00:45,166,17,Ternopol
2160,2133,144,998,1029,133,1162,0,1162,28,620,514,22.04.2019 00:45,166,17,Ternopol
1072,1058,25,417,631,24,655,0,655,27,314,314,22.04.2019 01:00,166,17,Ternopol
272,222,31,51,190,31,221,0,221,25,162,34,21.04.2019 20:50,167,17,Ternopol
560,549,34,219,308,33,341,0,341,12,171,158,21.04.2019 22:55,167,17,Ternopol
128,124,13,43,73,12,85,0,85,2,68,15,21.04.2019 20:39,167,17,Ternopol
400,396,22,84,294,22,316,0,316,5,96,215,21.04.2019 20:30,167,17,Ternopol
1392,1404,65,370,957,65,1022,0,1022,14,592,416,21.04.2019 21:10,167,17,Ternopol
448,439,21,99,330,19,349,0,349,1,125,223,21.04.2019 21:10,167,17,Ternopol
1392,1353,4,667,721,4,725,0,725,35,414,276,21.04.2019 21:47,167,17,Ternopol
2032,2001,31,934,1067,31,1098,0,1098,40,689,369,21.04.2019 22:20,167,17,Ternopol
1520,1485,3,693,824,3,827,0,827,27,482,318,21.04.2019 22:30,167,17,Ternopol
2048,2007,18,980,1050,18,1068,0,1068,30,625,413,22.04.2019 00:30,167,17,Ternopol
1056,1038,17,461,578,17,595,0,595,31,367,197,22.04.2019 00:15,167,17,Ternopol
752,742,83,303,369,80,449,0,449,6,245,198,21.04.2019 22:15,167,17,Ternopol
144,138,9,66,71,7,78,0,78,0,40,38,22.04.2019 00:15,167,17,Ternopol
512,494,23,244,249,19,268,0,268,16,148,104,22.04.2019 01:03,167,17,Ternopol
336,330,24,114,199,23,222,0,222,3,113,106,22.04.2019 00:05,167,17,Ternopol
448,439,2,180,266,2,268,0,268,4,196,68,22.04.2019 00:10,167,17,Ternopol
1184,1170,65,477,644,63,707,0,707,4,380,323,22.04.2019 00:30,167,17,Ternopol
992,978,49,393,550,49,599,0,599,30,368,201,21.04.2019 22:00,167,17,Ternopol
1248,1238,81,470,701,77,778,0,776,19,430,327,22.04.2019 00:28,167,17,Ternopol
976,965,32,202,743,31,774,0,774,20,399,355,22.04.2019 00:15,167,17,Ternopol
1392,1375,41,383,968,41,1009,0,1009,24,560,425,22.04.2019 00:45,167,17,Ternopol
384,391,31,117,240,27,267,0,267,8,166,93,21.04.2019 21:25,167,17,Ternopol
256,245,14,68,174,14,188,0,188,6,95,87,22.04.2019 01:05,167,17,Ternopol
160,143,14,69,79,12,91,0,91,0,50,41,22.04.2019 00:50,167,17,Ternopol
784,764,33,318,437,29,466,0,466,6,288,172,22.04.2019 00:15,167,17,Ternopol
528,522,18,195,317,16,333,0,333,10,197,126,21.04.2019 20:50,167,17,Ternopol
48,47,2,11,35,2,37,0,37,1,10,26,22.04.2019 00:12,167,17,Ternopol
240,242,13,80,149,11,160,0,160,8,97,55,21.04.2019 21:10,167,17,Ternopol
48,51,2,7,39,2,41,0,41,1,20,20,21.04.2019 20:47,167,17,Ternopol
640,621,37,304,299,37,336,0,336,6,166,164,22.04.2019 00:10,167,17,Ternopol
128,115,3,61,64,3,67,0,67,1,47,19,22.04.2019 00:30,167,17,Ternopol
272,262,18,81,173,18,191,0,191,3,72,116,22.04.2019 00:25,167,17,Ternopol
288,287,8,91,189,8,197,0,197,1,147,49,22.04.2019 00:30,167,17,Ternopol
1248,1229,77,423,754,71,825,0,825,30,508,287,21.04.2019 22:01,167,17,Ternopol
1392,1367,46,432,914,46,960,0,960,25,443,492,21.04.2019 21:30,167,17,Ternopol
304,291,13,75,216,13,229,0,229,5,105,119,22.04.2019 00:00,167,17,Ternopol
752,735,55,307,392,53,445,0,445,5,271,169,22.04.2019 00:13,167,17,Ternopol
1280,1264,72,575,641,64,705,0,705,24,480,201,21.04.2019 20:50,167,17,Ternopol
1040,1023,79,386,577,77,654,0,654,5,297,352,22.04.2019 01:00,167,17,Ternopol
1120,1095,66,415,645,60,705,0,705,19,415,271,22.04.2019 00:15,167,17,Ternopol
192,192,11,64,117,11,128,0,128,1,84,43,22.04.2019 00:45,167,17,Ternopol
864,845,44,270,552,42,594,0,594,10,288,296,21.04.2019 21:18,167,17,Ternopol
1904,1865,82,959,866,79,945,0,945,28,506,411,21.04.2019 23:58,167,17,Ternopol
816,855,16,388,412,16,428,0,428,20,205,203,21.04.2019 23:45,167,17,Ternopol
400,390,29,171,202,27,229,0,229,6,115,108,21.04.2019 21:15,167,17,Ternopol
144,142,8,60,76,8,84,0,84,3,37,44,21.04.2019 22:00,167,17,Ternopol
176,162,6,53,117,6,123,0,123,0,71,52,21.04.2019 21:00,167,17,Ternopol
96,83,0,35,61,0,61,0,61,8,40,13,21.04.2019 22:00,167,17,Ternopol
864,846,18,323,523,18,541,0,541,13,332,196,21.04.2019 21:10,167,17,Ternopol
560,539,43,241,279,40,319,0,319,21,148,150,22.04.2019 00:05,167,17,Ternopol
1264,1238,79,572,620,72,692,0,692,17,370,305,22.04.2019 00:15,167,17,Ternopol
384,365,29,168,187,29,216,0,216,2,116,98,21.04.2019 20:15,167,17,Ternopol
704,698,43,261,400,43,443,0,443,8,209,226,22.04.2019 00:10,167,17,Ternopol
896,877,43,376,477,43,520,0,520,16,266,238,22.04.2019 00:30,167,17,Ternopol
96,89,5,32,59,5,64,0,64,2,42,20,21.04.2019 20:35,167,17,Ternopol
288,280,29,85,174,29,203,0,203,2,92,109,21.04.2019 21:55,167,17,Ternopol
656,648,8,196,452,8,460,0,460,12,266,182,21.04.2019 20:45,167,17,Ternopol
528,517,18,173,337,18,355,0,355,12,221,122,21.04.2019 21:00,167,17,Ternopol
64,57,8,21,35,8,43,0,43,1,19,23,22.04.2019 00:35,167,17,Ternopol
592,583,41,187,364,41,405,0,405,7,167,231,21.04.2019 21:00,167,17,Ternopol
880,872,30,416,434,30,464,0,464,7,284,173,22.04.2019 00:35,167,17,Ternopol
1216,1198,95,493,631,92,723,0,723,16,456,251,21.04.2019 21:30,167,17,Ternopol
1152,1127,10,589,555,8,563,0,563,14,396,153,22.04.2019 00:10,167,17,Ternopol
368,356,18,83,269,16,285,0,285,15,173,97,22.04.2019 01:30,167,17,Ternopol
640,628,17,273,350,17,367,0,367,3,234,130,22.04.2019 01:00,167,17,Ternopol
736,731,38,271,430,35,465,0,465,11,271,183,22.04.2019 00:15,167,17,Ternopol
176,170,13,30,133,13,146,0,146,1,55,90,22.04.2019 02:00,167,17,Ternopol
160,157,16,32,113,15,128,0,128,3,96,29,21.04.2019 22:00,167,17,Ternopol
512,505,31,221,260,31,291,0,291,6,194,91,22.04.2019 00:19,167,17,Ternopol
240,221,16,76,148,16,164,0,164,6,84,74,22.04.2019 00:30,167,17,Ternopol
752,743,48,335,372,45,417,0,417,22,233,162,22.04.2019 00:30,167,17,Ternopol
496,480,18,211,268,17,285,0,285,6,167,112,22.04.2019 00:40,167,17,Ternopol
208,199,18,84,107,17,124,0,124,5,67,52,22.04.2019 00:30,167,17,Ternopol
1056,1043,71,441,551,64,615,0,615,12,340,263,22.04.2019 00:50,167,17,Ternopol
528,512,34,205,289,34,323,0,323,8,169,146,22.04.2019 00:20,167,17,Ternopol
176,170,5,55,117,4,121,0,121,3,69,49,22.04.2019 00:50,167,17,Ternopol
1376,1353,87,460,829,87,916,0,916,26,445,445,22.04.2019 00:10,167,17,Ternopol
224,212,18,80,126,18,144,0,144,9,90,45,21.04.2019 23:55,167,17,Ternopol
1136,1127,19,388,729,19,748,0,748,20,359,369,22.04.2019 00:48,167,17,Ternopol
432,418,36,170,232,30,262,0,262,4,139,119,22.04.2019 00:15,167,17,Ternopol
112,104,6,47,60,5,65,0,65,1,36,28,21.04.2019 22:00,167,17,Ternopol
544,530,27,132,386,26,412,0,412,6,168,238,21.04.2019 20:48,167,17,Ternopol
560,546,6,171,383,6,389,0,389,4,230,155,21.04.2019 21:45,167,17,Ternopol
288,272,20,118,157,13,170,0,170,5,123,42,21.04.2019 21:30,167,17,Ternopol
448,438,37,162,250,36,286,0,286,9,125,152,21.04.2019 22:50,167,17,Ternopol
240,227,19,83,140,17,157,0,157,5,96,56,21.04.2019 22:11,167,17,Ternopol
480,474,28,157,295,28,323,0,323,10,215,98,21.04.2019 23:50,167,17,Ternopol
512,498,30,225,257,30,287,0,287,5,198,84,21.04.2019 21:22,167,17,Ternopol
784,770,47,276,462,46,508,0,508,11,325,172,22.04.2019 00:30,167,17,Ternopol
1376,1344,42,551,783,42,825,0,825,18,482,325,21.04.2019 21:06,167,17,Ternopol
624,631,48,227,349,48,397,0,397,6,182,209,22.04.2019 00:18,167,17,Ternopol
288,272,14,92,183,13,196,0,196,8,85,103,22.04.2019 00:15,167,17,Ternopol
304,303,11,124,169,11,180,0,180,0,86,94,22.04.2019 00:25,167,17,Ternopol
352,344,21,125,206,21,227,0,227,3,113,111,21.04.2019 21:30,167,17,Ternopol
192,189,35,43,116,33,149,0,149,3,68,78,22.04.2019 00:00,167,17,Ternopol
2192,2159,37,979,1188,25,1213,0,1213,29,765,419,22.04.2019 01:05,167,17,Ternopol
1600,1570,25,813,765,22,787,0,787,26,490,271,22.04.2019 00:13,167,17,Ternopol
1584,1566,23,674,892,18,910,0,910,29,542,339,21.04.2019 22:35,167,17,Ternopol
2112,2092,10,942,1161,9,1170,0,1170,28,780,362,22.04.2019 00:10,167,17,Ternopol
432,425,16,184,233,15,248,0,248,4,131,113,22.04.2019 00:01,167,17,Ternopol
336,333,19,111,210,15,225,0,225,2,163,60,21.04.2019 22:20,167,17,Ternopol
432,423,22,142,268,22,290,0,290,2,172,116,22.04.2019 00:45,167,17,Ternopol
768,752,55,262,453,53,506,0,506,13,265,228,22.04.2019 00:45,167,17,Ternopol
624,617,60,234,335,55,390,0,390,10,168,212,21.04.2019 21:10,167,17,Ternopol
768,757,22,110,636,22,658,0,658,5,192,461,21.04.2019 23:58,167,17,Ternopol
448,434,10,120,319,9,328,0,328,3,190,135,21.04.2019 21:30,167,17,Ternopol
896,886,17,213,666,17,683,0,683,25,357,301,22.04.2019 00:30,167,17,Ternopol
416,404,32,117,268,31,299,0,299,2,171,126,22.04.2019 00:00,167,17,Ternopol
304,298,13,101,190,13,203,0,203,8,127,68,21.04.2019 21:00,167,17,Ternopol
336,320,11,161,165,10,175,0,175,7,77,91,22.04.2019 00:23,167,17,Ternopol
1456,1447,105,503,852,101,953,0,953,17,555,381,22.04.2019 01:10,167,17,Ternopol
528,523,47,208,273,47,320,0,320,12,127,181,21.04.2019 23:30,167,17,Ternopol
288,282,29,105,159,24,183,0,183,5,96,82,21.04.2019 20:52,167,17,Ternopol
368,350,19,102,247,19,266,0,266,8,105,153,21.04.2019 23:21,167,17,Ternopol
672,653,50,241,383,48,431,0,431,14,183,234,21.04.2019 21:55,167,17,Ternopol
1200,1190,100,496,605,99,704,0,704,15,403,286,22.04.2019 00:20,167,17,Ternopol
128,121,9,33,89,6,95,0,95,0,35,60,21.04.2019 20:45,167,17,Ternopol
1104,1090,67,311,731,62,793,0,793,24,513,256,22.04.2019 00:25,167,17,Ternopol
672,662,19,183,470,19,489,0,489,17,212,260,22.04.2019 00:30,167,17,Ternopol
800,784,59,306,436,58,494,0,494,7,342,145,22.04.2019 00:12,167,17,Ternopol
400,398,37,99,264,37,301,0,301,6,127,168,21.04.2019 20:50,167,17,Ternopol
512,507,29,145,344,23,367,0,367,4,256,107,21.04.2019 21:15,167,17,Ternopol
448,436,32,96,320,32,352,0,352,7,183,162,22.04.2019 00:11,167,17,Ternopol
1136,1146,56,497,583,56,639,0,639,17,343,279,22.04.2019 00:00,167,17,Ternopol
1344,1318,40,633,674,37,711,0,711,20,381,310,21.04.2019 22:40,167,17,Ternopol
80,77,7,17,58,5,63,0,63,3,36,24,21.04.2019 22:10,167,17,Ternopol
640,628,74,221,349,70,419,0,419,5,247,167,21.04.2019 21:50,167,17,Ternopol
160,154,6,37,117,6,123,0,123,6,73,44,21.04.2019 20:55,167,17,Ternopol
432,420,55,158,224,50,274,0,274,6,187,81,22.04.2019 00:35,167,17,Ternopol
176,162,19,47,112,17,129,0,129,0,84,45,21.04.2019 22:53,167,17,Ternopol
560,549,53,143,364,53,417,0,417,7,227,183,21.04.2019 23:45,167,17,Ternopol
256,240,22,116,120,20,140,0,140,3,72,65,21.04.2019 22:03,167,17,Ternopol
304,288,27,130,150,24,174,0,174,3,79,92,22.04.2019 00:01,167,17,Ternopol
640,627,29,169,442,29,471,0,471,10,275,186,21.04.2019 21:25,167,17,Ternopol
400,399,13,124,263,13,276,0,276,4,103,169,22.04.2019 00:10,167,17,Ternopol
272,258,13,100,159,13,172,0,172,6,106,60,21.04.2019 21:50,167,17,Ternopol
592,579,63,181,348,63,411,0,411,9,218,184,22.04.2019 00:02,167,17,Ternopol
592,590,51,126,417,49,466,0,466,14,148,304,21.04.2019 23:16,167,17,Ternopol
1488,1478,42,697,749,42,791,0,791,30,374,387,21.04.2019 21:55,167,17,Ternopol
1424,1398,83,604,737,83,820,0,820,16,447,357,21.04.2019 22:51,167,17,Ternopol
1280,1255,57,470,759,51,810,0,810,24,475,311,22.04.2019 00:15,167,17,Ternopol
208,205,10,66,132,10,142,0,142,1,66,75,21.04.2019 20:45,167,17,Ternopol
112,92,12,46,54,12,66,0,66,3,36,27,21.04.2019 22:50,167,17,Ternopol
208,196,17,104,89,15,104,0,104,2,63,39,21.04.2019 21:30,167,17,Ternopol
800,789,57,192,552,56,608,0,608,11,257,340,21.04.2019 23:08,167,17,Ternopol
832,812,35,343,454,35,489,0,489,7,267,215,21.04.2019 21:10,167,17,Ternopol
704,689,69,234,401,69,470,0,470,7,267,196,22.04.2019 00:10,167,17,Ternopol
944,942,43,379,523,42,565,0,565,21,276,268,21.04.2019 22:48,167,17,Ternopol
336,317,21,94,221,21,242,0,242,4,164,74,21.04.2019 21:15,167,17,Ternopol
384,369,39,104,243,37,280,0,280,9,148,123,21.04.2019 22:45,167,17,Ternopol
448,448,35,147,267,34,301,0,301,9,120,172,21.04.2019 22:15,167,17,Ternopol
1264,1238,16,609,644,11,655,0,655,12,346,297,21.04.2019 22:30,167,17,Ternopol
1280,1233,16,532,732,16,748,0,748,26,355,367,22.04.2019 00:19,167,17,Ternopol
752,729,86,310,358,84,442,0,442,10,197,235,21.04.2019 22:15,167,17,Ternopol
704,694,79,239,395,70,465,0,465,8,214,243,21.04.2019 23:16,167,17,Ternopol
80,68,5,37,38,5,43,0,43,0,8,35,21.04.2019 21:50,167,17,Ternopol
288,285,23,116,149,23,172,0,172,3,108,61,21.04.2019 21:05,167,17,Ternopol
304,290,21,106,178,20,198,0,198,4,91,103,22.04.2019 00:09,167,17,Ternopol
1344,1306,68,429,851,64,915,0,915,15,476,424,21.04.2019 23:20,167,17,Ternopol
976,960,88,148,740,88,828,0,827,16,447,364,22.04.2019 00:30,167,17,Ternopol
368,352,28,174,166,28,194,0,194,9,93,92,21.04.2019 21:20,167,17,Ternopol
336,324,17,121,198,17,215,0,215,6,101,108,21.04.2019 22:18,167,17,Ternopol
128,114,15,56,60,12,72,0,72,2,28,42,21.04.2019 21:10,167,17,Ternopol
384,364,33,140,216,28,244,0,244,0,120,124,22.04.2019 00:10,167,17,Ternopol
496,486,42,208,250,38,288,0,288,5,95,188,21.04.2019 20:38,167,17,Ternopol
480,471,24,150,306,24,330,0,330,4,180,146,21.04.2019 22:02,167,17,Ternopol
1552,1527,88,565,906,81,987,0,987,32,550,405,21.04.2019 21:22,167,17,Ternopol
448,426,51,117,280,51,331,0,331,5,172,154,21.04.2019 21:50,167,17,Ternopol
352,348,29,144,179,29,208,0,208,7,127,74,22.04.2019 00:20,167,17,Ternopol
512,515,45,189,278,45,323,0,323,6,203,114,21.04.2019 21:01,167,17,Ternopol
624,609,59,200,367,57,424,0,424,2,204,218,22.04.2019 00:21,167,17,Ternopol
576,587,78,238,262,76,338,0,338,9,176,153,22.04.2019 00:20,167,17,Ternopol
816,803,48,355,414,47,461,0,461,7,228,226,22.04.2019 00:00,167,17,Ternopol
464,452,34,93,337,34,371,0,371,9,176,186,21.04.2019 22:05,167,17,Ternopol
448,436,48,118,284,46,330,0,330,8,189,133,22.04.2019 00:34,167,17,Ternopol
1328,1308,81,377,886,65,951,0,951,13,303,635,21.04.2019 21:00,167,17,Ternopol
784,774,51,281,452,51,503,0,503,18,315,170,21.04.2019 21:15,167,17,Ternopol
160,155,8,44,108,8,116,0,116,0,63,53,21.04.2019 22:18,167,17,Ternopol
192,179,21,60,111,21,132,0,132,3,52,77,21.04.2019 22:43,167,17,Ternopol
528,517,32,185,317,26,343,0,343,7,143,193,21.04.2019 23:15,167,17,Ternopol
160,153,14,64,87,9,96,0,96,3,55,38,21.04.2019 22:19,167,17,Ternopol
832,816,5,160,667,5,672,0,672,11,253,408,21.04.2019 22:25,167,17,Ternopol
400,384,27,158,217,25,242,0,242,2,111,129,21.04.2019 20:40,167,17,Ternopol
240,235,30,65,146,29,175,0,175,0,76,99,21.04.2019 20:55,167,17,Ternopol
592,586,57,227,309,56,365,0,365,19,245,101,22.04.2019 00:09,167,17,Ternopol
752,734,63,296,393,63,456,0,456,11,261,184,21.04.2019 20:46,167,17,Ternopol
912,898,88,322,503,87,590,0,590,14,307,269,21.04.2019 22:30,167,17,Ternopol
80,82,8,25,48,7,55,0,55,3,27,25,21.04.2019 21:10,167,17,Ternopol
336,332,34,99,205,32,237,0,237,6,101,130,21.04.2019 22:10,167,17,Ternopol
1616,1588,23,661,935,20,955,0,955,29,475,451,21.04.2019 23:30,167,17,Ternopol
1296,1288,20,570,707,19,726,0,726,29,339,358,21.04.2019 21:19,167,17,Ternopol
2016,1998,8,961,1049,6,1055,0,1055,28,521,506,22.04.2019 00:00,167,17,Ternopol
1456,1439,27,662,767,27,794,0,794,21,385,388,22.04.2019 01:38,167,17,Ternopol
1072,1043,14,473,586,13,599,0,599,24,325,250,21.04.2019 23:10,167,17,Ternopol
1072,1048,20,523,532,17,549,0,549,14,256,279,21.04.2019 21:20,167,17,Ternopol
1040,1071,6,358,676,6,682,0,682,13,376,293,21.04.2019 22:05,167,17,Ternopol
1040,1030,17,432,591,17,608,0,608,16,285,307,22.04.2019 00:15,167,17,Ternopol
2176,2088,28,1082,1071,23,1094,0,1094,32,621,441,22.04.2019 00:10,167,17,Ternopol
1632,1608,46,680,917,35,952,0,952,36,483,433,21.04.2019 21:15,167,17,Ternopol
768,766,18,314,438,16,454,0,454,13,211,230,22.04.2019 00:10,167,17,Ternopol
1696,1663,46,807,851,38,889,0,889,29,431,429,22.04.2019 00:25,167,17,Ternopol
736,716,15,319,403,14,417,0,417,11,248,158,22.04.2019 00:07,167,17,Ternopol
1504,1493,57,617,837,50,887,0,887,29,429,429,21.04.2019 22:00,167,17,Ternopol
1600,1576,35,705,862,33,895,0,895,24,437,434,21.04.2019 23:10,167,17,Ternopol
128,117,4,54,71,3,74,0,74,0,37,37,22.04.2019 00:10,167,17,Ternopol
544,539,46,193,308,43,351,0,351,13,149,189,22.04.2019 00:27,167,17,Ternopol
608,598,31,199,379,30,409,0,409,13,194,202,22.04.2019 00:10,167,17,Ternopol
384,363,32,144,213,27,240,0,240,9,139,92,22.04.2019 00:10,167,17,Ternopol
944,925,58,396,496,52,548,0,548,8,369,171,22.04.2019 01:00,167,17,Ternopol
384,109,63,284,45,55,100,0,100,2,47,51,21.04.2019 20:00,167,17,Ternopol
1088,1064,19,540,530,18,548,0,548,14,283,251,21.04.2019 20:48,167,17,Ternopol
128,119,4,50,74,4,78,0,78,0,52,26,21.04.2019 20:30,167,17,Ternopol
2048,2029,20,665,1367,16,1383,0,1383,30,1172,181,22.04.2019 02:00,168,18,Harkov
1952,1927,11,589,1352,11,1363,0,1363,28,1170,165,22.04.2019 02:00,168,18,Harkov
1936,1935,17,615,1312,9,1321,0,1321,24,1105,192,22.04.2019 00:15,168,18,Harkov
1840,1832,14,599,1233,8,1241,0,1241,25,1033,183,22.04.2019 03:30,168,18,Harkov
2000,2016,12,562,1429,9,1438,0,1438,24,1180,234,22.04.2019 00:27,168,18,Harkov
1856,1852,18,619,1226,11,1237,0,1237,31,1015,191,22.04.2019 00:05,168,18,Harkov
2032,1989,3,864,1165,3,1168,0,1168,33,957,178,22.04.2019 04:56,168,18,Harkov
1888,1890,2,624,1263,1,1264,0,1264,36,960,268,22.04.2019 00:20,168,18,Harkov
2096,2033,6,868,1224,4,1228,0,1228,16,1087,125,22.04.2019 00:01,168,18,Harkov
2000,1975,17,626,1360,14,1374,0,1374,25,1181,168,21.04.2019 22:28,168,18,Harkov
2224,2212,34,729,1472,23,1495,0,1495,46,1267,182,22.04.2019 00:30,168,18,Harkov
2112,2093,10,935,1167,10,1177,0,1177,21,959,197,21.04.2019 22:20,168,18,Harkov
2144,2124,16,707,1424,13,1437,0,1437,22,1221,194,22.04.2019 00:01,168,18,Harkov
2064,2047,13,658,1398,8,1406,0,1406,46,1137,223,22.04.2019 00:01,168,18,Harkov
1936,1916,21,595,1326,15,1341,0,1341,24,1118,199,22.04.2019 00:01,168,18,Harkov
1952,1953,13,652,1290,10,1300,0,1300,33,1085,182,22.04.2019 00:01,168,18,Harkov
1808,1801,20,546,1249,13,1262,0,1262,20,1041,201,21.04.2019 21:30,168,18,Harkov
1872,1858,17,604,1256,12,1268,0,1268,29,1025,214,22.04.2019 00:06,168,18,Harkov
2192,2182,35,655,1505,32,1537,0,1537,30,1283,224,22.04.2019 01:37,168,18,Harkov
2160,2150,0,1184,976,0,976,0,976,17,870,89,22.04.2019 00:15,168,18,Harkov
2000,1993,20,634,1356,10,1366,0,1366,32,1120,214,22.04.2019 00:57,168,18,Harkov
2064,2053,16,636,1416,12,1428,0,1428,33,1172,223,22.04.2019 00:24,168,18,Harkov
2240,2225,0,1299,941,0,941,0,941,14,827,100,22.04.2019 00:15,168,18,Harkov
2160,2154,20,699,1450,11,1461,0,1461,40,1172,249,22.04.2019 00:15,168,18,Harkov
2112,2094,9,703,1404,5,1409,0,1409,39,1175,195,22.04.2019 00:05,168,18,Harkov
1856,1835,9,619,1230,7,1237,0,1237,32,975,230,22.04.2019 00:05,168,18,Harkov
2240,2245,23,611,1612,17,1629,0,1629,33,1310,286,22.04.2019 00:15,168,18,Harkov
1760,1761,10,566,1187,7,1194,0,1194,29,975,190,22.04.2019 00:05,168,18,Harkov
2016,2017,20,656,1345,15,1360,0,1360,21,1130,209,22.04.2019 00:15,168,18,Harkov
2048,2048,21,652,1379,17,1396,0,1396,31,1168,197,22.04.2019 00:30,168,18,Harkov
1696,1677,12,569,1118,9,1127,0,1127,45,915,167,22.04.2019 00:25,168,18,Harkov
1840,1837,16,594,1237,9,1246,0,1244,27,1020,197,22.04.2019 01:55,168,18,Harkov
1952,1941,6,632,1314,6,1320,0,1320,40,1085,195,22.04.2019 00:15,168,18,Harkov
1616,1611,8,488,1120,8,1128,0,1128,29,925,174,22.04.2019 00:15,168,18,Harkov
2192,2175,12,674,1507,11,1518,0,1518,32,1245,241,22.04.2019 00:30,168,18,Harkov
2272,2233,13,951,1310,11,1321,0,1321,30,1083,208,22.04.2019 00:12,168,18,Harkov
1808,1792,12,553,1244,11,1255,0,1255,31,994,230,21.04.2019 23:17,168,18,Harkov
1680,1685,17,560,1108,12,1120,0,1120,25,898,197,22.04.2019 00:05,168,18,Harkov
1776,1754,5,577,1194,5,1199,0,1199,30,968,201,21.04.2019 22:18,168,18,Harkov
1824,1813,13,628,1188,8,1196,0,1196,32,950,214,22.04.2019 00:31,168,18,Harkov
1760,1756,10,586,1165,9,1174,0,1174,40,907,227,22.04.2019 00:10,168,18,Harkov
1584,1573,12,508,1067,9,1076,0,1076,26,854,196,22.04.2019 00:07,168,18,Harkov
1728,1712,21,583,1126,19,1145,0,1145,28,880,237,22.04.2019 00:30,168,18,Harkov
1552,1540,12,535,1005,12,1017,0,1017,30,805,182,21.04.2019 22:55,168,18,Harkov
1312,1315,11,452,853,7,860,0,860,14,668,178,21.04.2019 22:15,168,18,Harkov
1728,1738,15,594,1120,14,1134,0,1134,32,899,203,22.04.2019 00:45,168,18,Harkov
1616,1619,9,510,1099,7,1106,0,1106,30,824,252,21.04.2019 22:30,168,18,Harkov
1488,1470,5,503,981,4,985,0,985,38,716,231,22.04.2019 00:20,168,18,Harkov
2032,2037,22,694,1319,19,1338,0,1338,51,1027,260,22.04.2019 01:00,168,18,Harkov
1968,1995,19,740,1215,13,1228,0,1228,26,983,219,22.04.2019 00:15,168,18,Harkov
1984,1987,15,718,1254,12,1266,0,1266,39,1015,212,21.04.2019 22:30,168,18,Harkov
2160,2120,10,887,1266,7,1273,0,1273,26,1025,222,21.04.2019 22:30,168,18,Harkov
2336,2335,28,774,1534,28,1562,0,1562,41,1164,357,21.04.2019 23:32,168,18,Harkov
1920,1930,23,650,1251,19,1270,0,1270,36,985,249,22.04.2019 00:05,168,18,Harkov
2128,2119,22,766,1347,15,1362,0,1362,43,1131,188,22.04.2019 04:15,168,18,Harkov
2048,2049,27,774,1255,19,1274,0,1274,28,1074,172,21.04.2019 22:18,168,18,Harkov
2176,2150,0,1056,1120,0,1120,0,1120,29,910,181,22.04.2019 00:10,168,18,Harkov
1472,1448,0,714,758,0,758,0,758,19,655,84,22.04.2019 00:06,168,18,Harkov
1984,1945,0,1182,802,0,802,0,802,4,735,63,22.04.2019 00:23,168,18,Harkov
2128,2146,13,670,1447,11,1458,0,1458,47,1121,290,21.04.2019 21:30,168,18,Harkov
1984,2009,18,601,1374,9,1383,0,1383,57,1041,285,22.04.2019 00:10,168,18,Harkov
2096,2081,11,629,1457,10,1467,0,1467,40,1089,338,22.04.2019 00:00,168,18,Harkov
2272,2276,18,784,1474,14,1488,0,1488,48,1136,304,22.04.2019 00:10,168,18,Harkov
2112,2098,17,578,1521,13,1534,0,1534,39,1254,241,22.04.2019 03:25,168,18,Harkov
2128,2106,8,613,1509,6,1515,0,1515,34,1299,182,21.04.2019 22:45,168,18,Harkov
2128,2119,2,777,1350,1,1351,0,1351,24,1164,163,22.04.2019 00:35,168,18,Harkov
2208,2226,12,708,1490,10,1500,0,1500,37,1151,312,21.04.2019 22:30,168,18,Harkov
2176,2169,7,724,1445,7,1452,0,1452,40,1116,296,22.04.2019 00:15,168,18,Harkov
1312,1315,9,436,869,7,876,0,876,25,652,199,22.04.2019 00:31,168,18,Harkov
1232,1208,6,390,839,3,842,0,842,29,624,189,21.04.2019 23:25,168,18,Harkov
1920,1919,18,608,1298,14,1312,0,1312,39,957,316,22.04.2019 05:20,168,18,Harkov
2192,2201,12,697,1489,6,1495,0,1495,34,1172,289,22.04.2019 02:30,168,18,Harkov
2048,2054,15,707,1330,11,1341,0,1341,42,1050,249,21.04.2019 22:15,168,18,Harkov
2032,2043,13,673,1349,10,1359,0,1359,41,973,345,22.04.2019 00:17,168,18,Harkov
2272,2277,12,737,1529,6,1535,0,1533,48,1134,351,22.04.2019 00:45,168,18,Harkov
2448,2079,0,698,1750,0,1750,0,1750,34,1237,479,22.04.2019 00:07,168,18,Harkov
1696,1682,29,620,1060,16,1076,0,1076,33,776,267,22.04.2019 00:12,168,18,Harkov
1792,1797,14,655,1127,10,1137,0,1137,42,836,259,22.04.2019 00:20,168,18,Harkov
832,231,41,610,181,41,222,0,222,1,197,24,22.04.2019 00:11,168,18,Harkov
496,181,60,319,117,60,177,0,177,1,127,49,22.04.2019 00:13,168,18,Harkov
128,28,0,100,28,0,28,0,28,0,23,5,22.04.2019 00:10,168,18,Harkov
288,73,4,216,72,0,72,0,72,5,57,10,22.04.2019 00:15,168,18,Harkov
480,138,6,345,130,5,135,0,135,3,126,6,22.04.2019 00:16,168,18,Harkov
800,250,71,551,178,71,249,0,249,8,212,29,22.04.2019 00:01,168,18,Harkov
288,149,73,156,66,66,132,0,132,5,114,13,22.04.2019 00:10,168,18,Harkov
208,104,0,105,103,0,103,0,103,3,96,4,22.04.2019 00:21,168,18,Harkov
96,88,0,13,83,0,83,0,83,1,72,10,22.04.2019 00:07,168,18,Harkov
896,855,2,41,853,2,855,0,855,12,744,99,22.04.2019 00:15,168,18,Harkov
1680,1676,0,716,964,0,964,0,964,15,800,149,21.04.2019 23:30,168,18,Harkov
1200,1209,3,330,868,2,870,0,870,25,611,234,22.04.2019 00:02,168,18,Harkov
1888,1864,0,577,1311,0,1311,0,1311,24,868,419,22.04.2019 00:14,168,18,Harkov
1680,1795,28,505,1153,22,1175,0,1174,41,886,247,22.04.2019 00:10,169,18,Harkov
1792,1852,23,554,1217,21,1238,0,1238,28,941,269,22.04.2019 00:30,169,18,Harkov
2368,2370,28,824,1520,24,1544,0,1544,47,1199,298,22.04.2019 00:01,169,18,Harkov
1744,1821,36,516,1201,27,1228,0,1228,27,872,329,21.04.2019 22:45,169,18,Harkov
1760,1776,28,568,1168,24,1192,0,1192,48,884,260,22.04.2019 00:10,169,18,Harkov
1984,1988,31,565,1397,22,1419,0,1419,44,1075,300,22.04.2019 00:15,169,18,Harkov
1952,1940,5,880,1068,4,1072,0,1072,18,898,156,22.04.2019 00:20,169,18,Harkov
1504,1432,1,453,1050,1,1051,0,1051,25,877,149,21.04.2019 22:40,169,18,Harkov
1376,1371,2,616,758,2,760,0,760,15,658,87,22.04.2019 00:10,169,18,Harkov
2096,2074,17,721,1366,9,1375,0,1375,42,1041,292,21.04.2019 22:05,169,18,Harkov
1744,1780,19,560,1168,16,1184,0,1184,32,862,290,22.04.2019 00:25,169,18,Harkov
1936,1933,25,640,1274,22,1296,0,1296,42,959,295,22.04.2019 00:07,169,18,Harkov
1936,1952,17,690,1233,13,1246,0,1246,31,961,254,22.04.2019 00:12,169,18,Harkov
1840,1833,7,695,1139,6,1145,0,1145,31,990,124,22.04.2019 00:50,169,18,Harkov
1936,1918,10,637,1292,7,1299,0,1299,23,1120,156,22.04.2019 00:40,169,18,Harkov
1840,1847,13,591,1236,13,1249,0,1249,26,1040,183,22.04.2019 01:37,169,18,Harkov
2240,2216,7,764,1472,4,1476,0,1476,39,1271,166,22.04.2019 00:27,169,18,Harkov
1280,1261,3,451,826,3,829,0,829,15,720,94,21.04.2019 23:05,169,18,Harkov
2288,2251,14,677,1603,8,1611,0,1611,33,1400,178,22.04.2019 00:40,169,18,Harkov
3072,2922,7,1021,2047,4,2051,0,2051,42,1658,351,22.04.2019 01:20,169,18,Harkov
1952,1948,6,749,1198,5,1203,0,1203,21,1050,132,22.04.2019 00:15,169,18,Harkov
1392,1394,4,525,864,3,867,0,867,33,659,175,22.04.2019 01:32,169,18,Harkov
1088,1074,0,436,652,0,652,0,652,11,560,81,22.04.2019 00:05,169,18,Harkov
2384,2357,23,845,1525,14,1539,0,1539,32,1267,240,22.04.2019 00:20,169,18,Harkov
2064,2035,29,770,1270,24,1294,0,1294,33,1034,227,22.04.2019 00:40,169,18,Harkov
2288,2263,17,996,1278,14,1292,0,1292,26,1138,128,22.04.2019 04:28,169,18,Harkov
2480,2455,32,932,1522,26,1548,0,1548,35,1370,143,22.04.2019 00:10,169,18,Harkov
1712,1725,9,560,1145,7,1152,0,1152,27,924,201,22.04.2019 00:09,169,18,Harkov
1632,1613,25,639,974,19,993,0,993,21,852,120,22.04.2019 01:40,169,18,Harkov
928,928,24,332,575,21,596,0,596,17,516,63,22.04.2019 00:20,169,18,Harkov
1792,1795,15,731,1049,12,1061,0,1061,16,895,150,22.04.2019 00:30,169,18,Harkov
1648,1622,0,831,817,0,817,0,817,12,764,41,22.04.2019 03:11,169,18,Harkov
2096,2079,11,709,1378,9,1387,0,1387,33,1153,201,22.04.2019 02:40,169,18,Harkov
1760,1776,9,526,1227,7,1234,0,1234,25,991,218,22.04.2019 00:07,169,18,Harkov
1936,1942,5,557,1375,4,1379,0,1379,29,1149,201,22.04.2019 00:00,169,18,Harkov
1664,1652,11,520,1135,9,1144,0,1144,37,937,170,21.04.2019 22:22,169,18,Harkov
1840,1835,13,584,1246,10,1256,0,1256,25,1015,216,22.04.2019 00:45,169,18,Harkov
1792,1792,15,558,1223,11,1234,0,1234,23,1015,196,21.04.2019 23:20,169,18,Harkov
1856,1861,15,576,1271,9,1280,0,1280,34,1043,203,21.04.2019 23:30,169,18,Harkov
1840,1843,11,579,1252,9,1261,0,1261,35,1031,195,22.04.2019 00:12,169,18,Harkov
1936,1949,9,591,1338,7,1345,0,1345,44,1101,200,22.04.2019 00:00,169,18,Harkov
2000,1963,13,826,1164,10,1174,0,1174,13,1025,136,21.04.2019 23:50,169,18,Harkov
2016,2007,8,695,1316,5,1321,0,1321,26,1141,154,22.04.2019 01:10,169,18,Harkov
1904,1870,17,685,1210,9,1219,0,1219,25,1041,153,21.04.2019 23:59,169,18,Harkov
2000,2012,23,624,1363,13,1376,0,1376,26,1122,228,22.04.2019 00:30,169,18,Harkov
2080,2060,19,649,1416,15,1431,0,1431,33,1134,264,22.04.2019 00:15,169,18,Harkov
2112,2097,10,603,1503,6,1509,0,1509,29,1227,253,22.04.2019 00:05,169,18,Harkov
2144,2133,19,684,1445,15,1460,0,1460,48,1210,202,22.04.2019 00:15,169,18,Harkov
2160,2139,16,624,1525,11,1536,0,1536,38,1255,243,22.04.2019 00:05,169,18,Harkov
2176,2165,15,705,1462,9,1471,0,1471,43,1202,226,22.04.2019 00:25,169,18,Harkov
1488,1476,4,483,1001,4,1005,0,1005,25,788,192,22.04.2019 00:47,169,18,Harkov
1680,1664,15,491,1177,12,1189,0,1189,32,919,238,22.04.2019 00:30,169,18,Harkov
1792,1771,13,660,1125,7,1132,0,1132,31,892,209,22.04.2019 00:17,169,18,Harkov
1840,1834,12,541,1290,9,1299,0,1299,32,948,319,22.04.2019 00:11,169,18,Harkov
1360,1348,9,439,914,7,921,0,921,27,739,155,22.04.2019 00:30,169,18,Harkov
1952,1934,8,611,1334,7,1341,0,1341,45,1141,155,22.04.2019 00:05,169,18,Harkov
1888,1883,8,533,1347,8,1355,0,1355,28,1189,138,22.04.2019 00:30,169,18,Harkov
1856,1836,10,550,1297,9,1306,0,1306,29,1103,174,22.04.2019 00:15,169,18,Harkov
1904,1889,13,610,1281,13,1294,0,1294,32,1084,178,22.04.2019 00:18,169,18,Harkov
1744,1732,6,582,1159,3,1162,0,1162,15,1030,117,22.04.2019 00:07,169,18,Harkov
2048,2020,7,670,1374,4,1378,0,1378,23,1156,199,21.04.2019 21:40,169,18,Harkov
2160,2136,11,653,1497,10,1507,0,1507,30,1265,212,22.04.2019 00:10,169,18,Harkov
1312,1299,3,389,921,2,923,0,923,12,777,134,22.04.2019 00:01,169,18,Harkov
1664,1634,4,508,1153,3,1156,0,1156,32,997,127,22.04.2019 00:20,169,18,Harkov
2096,2070,10,678,1409,9,1418,0,1418,30,1225,163,22.04.2019 00:02,169,18,Harkov
2144,2117,14,675,1456,13,1469,0,1469,29,1238,202,22.04.2019 00:52,169,18,Harkov
2112,2079,11,729,1379,4,1383,0,1383,28,1164,191,22.04.2019 02:30,169,18,Harkov
1920,1904,5,553,1365,2,1367,0,1367,25,1176,166,22.04.2019 01:55,169,18,Harkov
1872,1835,12,672,1190,10,1200,0,1200,19,1029,152,22.04.2019 00:20,169,18,Harkov
1712,1696,8,546,1160,6,1166,0,1166,25,989,152,22.04.2019 00:25,169,18,Harkov
2000,1973,5,685,1311,4,1315,0,1315,21,1116,178,22.04.2019 00:05,169,18,Harkov
128,15,0,113,15,0,15,0,15,1,12,2,22.04.2019 00:05,169,18,Harkov
240,71,24,171,45,24,69,0,69,2,55,12,21.04.2019 22:55,169,18,Harkov
272,91,1,181,90,1,91,0,91,4,80,7,21.04.2019 20:55,169,18,Harkov
256,58,0,200,56,0,56,0,56,2,50,4,21.04.2019 21:10,169,18,Harkov
256,67,34,190,32,34,66,0,66,3,52,11,22.04.2019 00:15,169,18,Harkov
160,29,0,131,29,0,29,0,29,1,21,7,22.04.2019 03:40,169,18,Harkov
256,192,0,65,191,0,191,0,191,6,156,29,22.04.2019 00:14,169,18,Harkov
80,39,0,43,37,0,37,0,37,2,25,10,22.04.2019 00:30,169,18,Harkov
128,31,0,97,31,0,31,0,31,0,24,7,22.04.2019 00:15,169,18,Harkov
144,33,6,113,25,6,31,0,31,1,23,7,22.04.2019 00:05,169,18,Harkov
160,69,0,94,66,0,66,0,66,1,56,9,22.04.2019 00:11,169,18,Harkov
512,187,63,333,118,61,179,0,179,9,155,15,22.04.2019 00:10,169,18,Harkov
176,22,2,155,19,2,21,0,21,0,17,4,21.04.2019 21:02,169,18,Harkov
1440,1423,8,544,890,6,896,0,896,24,720,152,22.04.2019 00:30,169,18,Harkov
1744,1796,13,483,1252,9,1261,0,1261,31,1001,229,22.04.2019 00:01,169,18,Harkov
2336,2332,3,792,1541,3,1544,0,1544,40,1295,209,22.04.2019 00:20,169,18,Harkov
1744,1753,13,600,1134,10,1144,0,1144,31,927,186,22.04.2019 00:45,169,18,Harkov
1312,1295,17,481,824,7,831,0,831,17,674,140,22.04.2019 00:15,169,18,Harkov
1216,1203,17,448,753,15,768,0,768,11,643,114,22.04.2019 00:10,169,18,Harkov
1264,1253,21,512,739,13,752,0,752,16,642,94,22.04.2019 00:15,169,18,Harkov
1840,1842,11,590,1240,10,1250,0,1250,33,1008,209,22.04.2019 00:10,169,18,Harkov
1536,1521,19,534,986,16,1002,0,1002,29,843,130,22.04.2019 00:10,169,18,Harkov
1744,1732,12,568,1167,9,1176,0,1176,32,968,176,22.04.2019 00:01,169,18,Harkov
2128,2121,12,683,1436,9,1445,0,1445,25,1187,233,22.04.2019 00:05,169,18,Harkov
96,36,0,60,36,0,36,0,36,0,33,3,22.04.2019 00:05,169,18,Harkov
96,25,2,71,23,2,25,0,25,3,20,2,21.04.2019 22:00,169,18,Harkov
96,20,0,77,19,0,19,0,19,0,17,2,22.04.2019 00:07,169,18,Harkov
1136,1123,17,423,702,11,713,0,713,30,567,116,22.04.2019 00:55,169,18,Harkov
2496,2505,9,843,1646,7,1653,0,1653,35,1310,308,22.04.2019 00:01,169,18,Harkov
1008,997,5,373,631,4,635,0,635,10,539,86,22.04.2019 00:11,169,18,Harkov
832,819,6,271,555,6,561,0,561,10,456,95,22.04.2019 00:24,170,18,Harkov
2096,2081,10,720,1367,9,1376,0,1376,21,1185,170,21.04.2019 21:44,170,18,Harkov
2176,2177,4,710,1463,3,1466,0,1466,24,1267,175,21.04.2019 21:55,170,18,Harkov
1264,1265,4,407,856,1,857,0,857,15,744,98,22.04.2019 00:01,170,18,Harkov
2224,2210,11,937,1280,7,1287,0,1287,31,1105,151,22.04.2019 01:05,170,18,Harkov
2304,2291,22,814,1469,21,1490,0,1490,26,1283,181,21.04.2019 21:51,170,18,Harkov
2096,2090,6,809,1282,5,1287,0,1287,28,1129,130,22.04.2019 00:30,170,18,Harkov
1920,1927,10,675,1240,5,1245,0,1245,26,1117,102,21.04.2019 23:50,170,18,Harkov
2352,2294,14,998,1345,9,1354,0,1354,35,1185,134,22.04.2019 00:13,170,18,Harkov
1872,1873,8,625,1240,7,1247,0,1247,13,1069,165,22.04.2019 00:22,170,18,Harkov
2176,2164,4,738,1436,2,1438,0,1438,28,1229,181,22.04.2019 00:05,170,18,Harkov
2224,2208,14,790,1422,12,1434,0,1434,33,1246,155,22.04.2019 00:10,170,18,Harkov
1984,1969,3,603,1378,3,1381,0,1381,35,1179,167,22.04.2019 00:07,170,18,Harkov
1280,1245,0,597,683,0,683,0,683,17,611,55,22.04.2019 00:28,170,18,Harkov
2176,2163,11,736,1431,9,1440,0,1440,40,1199,201,22.04.2019 00:11,170,18,Harkov
1872,1871,2,719,1152,1,1153,0,1153,19,1024,110,21.04.2019 22:20,170,18,Harkov
1792,1702,0,839,953,0,953,0,953,19,815,119,22.04.2019 03:12,170,18,Harkov
2160,2143,7,713,1442,5,1447,0,1447,21,1255,171,22.04.2019 01:30,170,18,Harkov
2288,2282,10,763,1518,7,1525,0,1525,23,1314,188,22.04.2019 00:05,170,18,Harkov
2032,2009,18,707,1310,15,1325,0,1325,25,1166,134,22.04.2019 00:13,170,18,Harkov
2208,2190,10,762,1438,8,1446,0,1446,26,1259,161,22.04.2019 00:10,170,18,Harkov
2208,2199,16,721,1474,13,1487,0,1487,29,1279,179,21.04.2019 22:20,170,18,Harkov
1328,1324,10,414,905,9,914,0,914,10,807,97,21.04.2019 22:03,170,18,Harkov
1504,1497,7,471,1026,7,1033,0,1033,28,910,95,21.04.2019 21:36,170,18,Harkov
1872,1864,11,632,1230,10,1240,0,1240,20,1062,158,21.04.2019 23:55,170,18,Harkov
1248,1233,14,411,824,13,837,0,837,18,709,110,21.04.2019 21:25,170,18,Harkov
1952,1927,13,682,1258,12,1270,0,1270,14,1126,130,21.04.2019 21:40,170,18,Harkov
1760,1741,8,593,1159,8,1167,0,1167,32,995,140,22.04.2019 00:35,170,18,Harkov
1968,1962,17,689,1266,13,1279,0,1279,24,1096,159,21.04.2019 21:40,170,18,Harkov
2048,2029,15,723,1314,11,1325,0,1325,25,1131,169,22.04.2019 03:24,170,18,Harkov
2048,2020,10,688,1352,8,1360,0,1360,27,1155,178,21.04.2019 22:12,170,18,Harkov
2336,2312,10,809,1517,10,1527,0,1527,36,1299,192,21.04.2019 23:18,170,18,Harkov
2224,2217,14,715,1500,9,1509,0,1509,22,1315,172,21.04.2019 21:58,170,18,Harkov
2032,2017,10,739,1284,9,1293,0,1293,29,1150,114,21.04.2019 21:27,170,18,Harkov
2112,2108,18,787,1310,15,1325,0,1325,18,1152,155,21.04.2019 21:01,170,18,Harkov
2272,2240,11,817,1447,8,1455,0,1455,36,1226,193,21.04.2019 21:55,170,18,Harkov
2064,2053,12,615,1441,8,1449,0,1449,35,1223,191,21.04.2019 23:55,170,18,Harkov
1664,1654,7,501,1156,7,1163,0,1163,37,965,161,22.04.2019 00:03,170,18,Harkov
2000,1978,7,629,1364,7,1371,0,1371,25,1168,178,22.04.2019 00:15,170,18,Harkov
1744,1746,13,588,1147,9,1156,0,1156,18,995,143,21.04.2019 21:30,170,18,Harkov
1648,1637,12,483,1153,11,1164,0,1164,28,982,154,22.04.2019 02:30,170,18,Harkov
1856,1849,13,545,1300,11,1311,0,1311,33,1107,171,21.04.2019 23:10,170,18,Harkov
1888,1892,18,559,1312,17,1329,0,1329,29,1084,216,21.04.2019 22:55,170,18,Harkov
1952,1933,22,627,1306,19,1325,0,1325,28,1106,191,22.04.2019 00:01,170,18,Harkov
2000,1993,10,632,1358,10,1368,0,1368,44,1146,178,21.04.2019 22:30,170,18,Harkov
1920,1912,10,624,1288,8,1296,0,1296,22,1100,174,22.04.2019 02:16,170,18,Harkov
1504,1484,15,469,1021,14,1035,0,1035,21,880,134,22.04.2019 00:05,170,18,Harkov
1968,1962,15,669,1289,10,1299,0,1299,35,1101,163,22.04.2019 00:30,170,18,Harkov
1920,1924,20,623,1281,16,1297,0,1297,26,1087,184,22.04.2019 03:10,170,18,Harkov
2336,2325,12,766,1562,8,1570,0,1570,30,1287,253,22.04.2019 00:05,170,18,Harkov
1856,1853,15,618,1227,11,1238,0,1238,23,1062,153,22.04.2019 00:02,170,18,Harkov
1824,1814,11,597,1216,11,1227,0,1227,25,1038,164,22.04.2019 00:07,170,18,Harkov
1888,1886,28,582,1281,25,1306,0,1306,24,1096,186,22.04.2019 00:17,170,18,Harkov
1920,1905,12,668,1240,12,1252,0,1252,26,1039,187,22.04.2019 00:10,170,18,Harkov
2128,2092,13,703,1414,11,1425,0,1425,29,1233,163,21.04.2019 21:55,170,18,Harkov
1904,1911,20,573,1317,14,1331,0,1331,33,1102,196,21.04.2019 21:40,170,18,Harkov
1808,1796,11,621,1178,9,1187,0,1187,26,1020,141,21.04.2019 21:31,170,18,Harkov
1840,1817,9,616,1216,8,1224,0,1224,26,1029,169,21.04.2019 23:50,170,18,Harkov
2192,2183,13,732,1448,12,1460,0,1460,28,1244,188,21.04.2019 22:01,170,18,Harkov
1968,1965,22,599,1351,18,1369,0,1369,31,1156,182,22.04.2019 01:40,170,18,Harkov
1776,1762,12,576,1191,9,1200,0,1200,24,1021,155,21.04.2019 22:35,170,18,Harkov
2080,2054,7,701,1374,5,1379,0,1379,40,1186,153,21.04.2019 22:05,170,18,Harkov
1967,1985,20,639,1315,13,1328,0,1328,29,1155,144,21.04.2019 21:10,170,18,Harkov
1760,1754,12,591,1161,8,1169,0,1169,38,1006,125,21.04.2019 21:00,170,18,Harkov
1920,1909,10,671,1239,10,1249,0,1249,19,1081,149,22.04.2019 00:45,170,18,Harkov
2032,2021,13,628,1393,11,1404,0,1404,26,1212,166,22.04.2019 00:03,170,18,Harkov
2080,2069,10,678,1394,8,1402,0,1402,25,1192,185,22.04.2019 00:03,170,18,Harkov
2432,2399,6,797,1633,2,1635,0,1635,44,1325,266,22.04.2019 00:20,170,18,Harkov
2304,2268,6,764,1534,6,1540,0,1539,40,1295,204,22.04.2019 03:55,170,18,Harkov
2064,2053,15,679,1371,14,1385,0,1385,36,1161,188,21.04.2019 21:00,170,18,Harkov
1952,1955,15,612,1325,15,1340,0,1340,16,1164,160,21.04.2019 22:30,170,18,Harkov
1840,1848,11,537,1295,8,1303,0,1303,29,1109,165,21.04.2019 22:50,170,18,Harkov
2160,2148,9,690,1463,7,1470,0,1470,37,1246,187,21.04.2019 21:50,170,18,Harkov
1968,1957,7,595,1367,6,1373,0,1373,31,1150,192,22.04.2019 00:06,170,18,Harkov
2287,2278,9,765,1514,8,1522,0,1522,34,1269,219,22.04.2019 00:05,170,18,Harkov
2240,2223,5,680,1555,5,1560,0,1560,24,1288,248,22.04.2019 00:30,170,18,Harkov
2224,2203,4,762,1459,3,1462,0,1462,37,1214,211,22.04.2019 00:01,170,18,Harkov
384,293,106,97,184,103,287,0,287,10,245,32,21.04.2019 23:22,170,18,Harkov
512,143,97,371,45,96,141,0,141,3,116,22,21.04.2019 23:22,170,18,Harkov
448,52,16,397,36,15,51,0,51,0,47,4,21.04.2019 20:57,170,18,Harkov
1120,511,27,616,477,27,504,0,504,58,359,87,22.04.2019 00:15,170,18,Harkov
288,54,2,235,51,2,53,0,53,0,50,3,21.04.2019 21:30,170,18,Harkov
2160,2149,35,727,1402,31,1433,0,1433,40,1244,149,21.04.2019 21:40,171,18,Harkov
2096,2109,29,661,1414,21,1435,0,1435,38,1240,157,21.04.2019 21:15,171,18,Harkov
1664,1635,7,529,1129,6,1135,0,1135,29,972,134,21.04.2019 21:30,171,18,Harkov
2112,2090,28,766,1325,21,1346,0,1346,37,1159,150,22.04.2019 00:15,171,18,Harkov
2080,2049,28,723,1337,20,1357,0,1357,34,1179,144,22.04.2019 00:16,171,18,Harkov
1792,1771,25,582,1198,12,1210,0,1210,28,1017,165,21.04.2019 22:20,171,18,Harkov
1616,1598,25,521,1074,21,1095,0,1095,16,916,163,21.04.2019 22:45,171,18,Harkov
1744,1729,31,556,1169,19,1188,0,1188,21,1024,143,21.04.2019 22:06,171,18,Harkov
2000,1967,22,742,1239,19,1258,0,1258,27,1071,160,21.04.2019 23:02,171,18,Harkov
1520,1517,22,533,972,15,987,0,987,21,867,99,22.04.2019 00:15,171,18,Harkov
1744,1739,25,491,1234,19,1253,0,1253,26,1048,179,21.04.2019 22:00,171,18,Harkov
1456,1456,18,500,943,13,956,0,956,28,803,125,22.04.2019 00:05,171,18,Harkov
2032,2018,18,627,1392,13,1405,0,1405,23,1193,189,22.04.2019 00:05,171,18,Harkov
2032,2023,33,646,1361,25,1386,0,1386,34,1194,158,22.04.2019 00:10,171,18,Harkov
1856,1846,32,582,1245,29,1274,0,1274,34,1084,156,22.04.2019 00:07,171,18,Harkov
1712,1686,35,567,1118,27,1145,0,1145,19,961,165,22.04.2019 00:01,171,18,Harkov
1856,1855,11,560,1288,8,1296,0,1296,35,1068,193,22.04.2019 00:15,171,18,Harkov
1808,1802,19,549,1243,16,1259,0,1259,31,1063,165,22.04.2019 00:05,171,18,Harkov
1920,1887,21,691,1213,16,1229,0,1229,30,1047,152,22.04.2019 00:20,171,18,Harkov
2176,2176,14,835,1334,7,1341,0,1341,23,1171,147,22.04.2019 00:50,171,18,Harkov
2096,2105,8,635,1456,5,1461,0,1461,27,1303,131,22.04.2019 00:05,171,18,Harkov
2272,2261,13,711,1552,9,1561,0,1561,36,1321,204,21.04.2019 23:02,171,18,Harkov
2224,2195,13,918,1298,8,1306,0,1306,28,1139,139,22.04.2019 00:01,171,18,Harkov
2208,2199,18,714,1480,14,1494,0,1494,37,1285,172,22.04.2019 00:10,171,18,Harkov
1744,1706,13,744,992,8,1000,0,1000,21,873,106,22.04.2019 00:10,171,18,Harkov
1488,1482,12,503,976,9,985,0,985,18,838,129,21.04.2019 21:40,171,18,Harkov
2000,1964,18,759,1224,17,1241,0,1241,23,1079,139,22.04.2019 00:04,171,18,Harkov
1952,1909,13,818,1124,10,1134,0,1134,18,985,131,22.04.2019 00:21,171,18,Harkov
2128,2110,21,737,1377,14,1391,0,1391,33,1161,197,22.04.2019 00:05,171,18,Harkov
2080,2062,21,643,1420,17,1437,0,1437,26,1228,183,22.04.2019 00:12,171,18,Harkov
2192,2171,24,764,1412,16,1428,0,1428,39,1211,178,22.04.2019 00:02,171,18,Harkov
2160,2151,18,700,1448,12,1460,0,1460,38,1251,171,22.04.2019 00:06,171,18,Harkov
1984,1986,29,644,1319,21,1340,0,1340,32,1115,193,22.04.2019 00:02,171,18,Harkov
2128,2133,17,751,1365,12,1377,0,1377,37,1159,181,21.04.2019 22:00,171,18,Harkov
1840,1849,16,629,1200,11,1211,0,1211,22,1038,151,21.04.2019 21:20,171,18,Harkov
2160,2157,22,759,1386,15,1401,0,1401,36,1181,184,21.04.2019 21:37,171,18,Harkov
1872,1883,12,599,1265,8,1273,0,1273,29,1058,186,22.04.2019 00:02,171,18,Harkov
2192,2181,11,777,1406,9,1415,0,1415,37,1165,213,22.04.2019 00:30,171,18,Harkov
1968,1954,12,671,1288,9,1297,0,1297,35,1090,172,22.04.2019 00:53,171,18,Harkov
1984,1969,17,716,1260,8,1268,0,1268,32,1036,200,21.04.2019 22:45,171,18,Harkov
2288,2284,15,821,1456,11,1467,0,1467,46,1230,191,21.04.2019 23:10,171,18,Harkov
1360,1359,15,425,924,11,935,0,935,30,767,138,21.04.2019 22:25,171,18,Harkov
1760,1763,4,570,1186,4,1190,0,1190,29,1000,161,22.04.2019 00:20,171,18,Harkov
1936,1950,22,666,1254,16,1270,0,1270,20,1092,158,22.04.2019 00:10,171,18,Harkov
1952,1990,14,657,1288,7,1295,0,1295,22,1102,171,22.04.2019 00:25,171,18,Harkov
1808,1791,8,686,1119,3,1122,0,1122,37,933,152,22.04.2019 00:05,171,18,Harkov
1696,1774,12,483,1204,9,1213,0,1213,27,996,190,22.04.2019 00:01,171,18,Harkov
2112,2171,14,563,1539,10,1549,0,1549,49,1232,268,21.04.2019 22:10,171,18,Harkov
2256,2245,8,637,1612,7,1619,0,1619,49,1343,227,22.04.2019 00:40,171,18,Harkov
1824,1821,35,590,1215,19,1234,0,1234,18,1065,151,21.04.2019 22:41,171,18,Harkov
688,681,16,238,442,8,450,0,450,10,406,34,21.04.2019 21:30,171,18,Harkov
944,932,3,324,617,3,620,0,620,13,541,66,21.04.2019 21:20,171,18,Harkov
1424,1415,11,484,931,9,940,0,940,6,804,130,21.04.2019 22:10,171,18,Harkov
1360,1363,12,454,897,9,906,0,906,19,785,102,22.04.2019 00:20,171,18,Harkov
2160,2141,14,845,1303,12,1315,0,1314,25,1161,128,22.04.2019 02:04,171,18,Harkov
2240,2225,29,861,1357,22,1379,0,1378,33,1193,152,22.04.2019 00:15,171,18,Harkov
2256,2207,8,872,1379,5,1384,0,1384,39,1218,127,22.04.2019 00:23,171,18,Harkov
1920,1892,15,694,1216,10,1226,0,1226,36,1079,111,21.04.2019 23:47,171,18,Harkov
1840,1816,13,656,1173,11,1184,0,1184,27,1014,143,22.04.2019 00:10,171,18,Harkov
1504,1487,12,511,983,10,993,0,993,16,886,91,22.04.2019 00:12,171,18,Harkov
2240,2215,10,841,1391,8,1399,0,1399,28,1258,113,22.04.2019 00:20,171,18,Harkov
2048,2025,7,675,1370,3,1373,0,1373,31,1177,165,22.04.2019 00:15,171,18,Harkov
2048,2039,13,726,1311,11,1322,0,1322,23,1120,179,21.04.2019 22:45,171,18,Harkov
1632,1620,10,589,1034,9,1043,0,1043,20,932,91,21.04.2019 21:20,171,18,Harkov
1984,1966,16,725,1245,14,1259,0,1259,24,1087,148,21.04.2019 22:22,171,18,Harkov
2112,2093,6,771,1335,6,1341,0,1341,39,1157,145,22.04.2019 00:30,171,18,Harkov
1728,1721,3,537,1188,3,1191,0,1191,19,1019,153,22.04.2019 00:15,171,18,Harkov
2000,1969,11,705,1286,9,1295,0,1295,39,1090,166,22.04.2019 01:05,171,18,Harkov
2016,2001,13,664,1342,10,1352,0,1351,42,1171,138,22.04.2019 03:07,171,18,Harkov
1888,1868,5,693,1190,5,1195,0,1195,20,1023,152,22.04.2019 00:25,171,18,Harkov
2160,2127,4,791,1367,2,1369,0,1369,32,1170,167,22.04.2019 00:19,171,18,Harkov
2288,2257,10,801,1480,7,1487,0,1487,35,1272,180,22.04.2019 01:12,171,18,Harkov
1984,1968,9,676,1302,6,1308,0,1308,19,1139,150,21.04.2019 22:00,171,18,Harkov
1904,1892,6,657,1242,5,1247,0,1247,33,1038,176,21.04.2019 22:15,171,18,Harkov
1904,1881,5,719,1182,3,1185,0,1184,29,1032,123,22.04.2019 00:10,171,18,Harkov
2192,2164,13,722,1465,5,1470,0,1470,29,1258,183,21.04.2019 21:55,171,18,Harkov
384,114,11,270,103,11,114,0,114,0,100,14,21.04.2019 21:30,171,18,Harkov
240,108,0,143,97,0,97,0,97,2,85,10,22.04.2019 00:12,171,18,Harkov
384,219,28,169,189,26,215,0,215,6,179,30,21.04.2019 22:05,171,18,Harkov
352,121,20,232,100,20,120,0,120,3,102,15,21.04.2019 22:08,171,18,Harkov
272,37,17,235,20,17,37,0,37,0,36,1,21.04.2019 21:50,171,18,Harkov
1008,989,15,401,597,10,607,0,607,6,523,78,21.04.2019 22:05,171,18,Harkov
1728,1700,27,622,1084,22,1106,0,1106,22,946,138,21.04.2019 22:20,171,18,Harkov
320,327,1,82,237,1,238,0,238,8,186,44,21.04.2019 21:10,171,18,Harkov
2192,2191,25,809,1365,18,1383,0,1383,35,1195,153,22.04.2019 00:10,172,18,Harkov
2304,2287,10,847,1450,7,1457,0,1457,34,1226,197,22.04.2019 00:05,172,18,Harkov
2032,2031,3,710,1320,2,1322,0,1322,30,1156,136,22.04.2019 00:15,172,18,Harkov
1984,1964,15,723,1248,13,1261,0,1261,31,1084,146,22.04.2019 00:26,172,18,Harkov
2224,2185,29,788,1409,27,1436,0,1436,32,1246,158,22.04.2019 00:02,172,18,Harkov
2272,2245,12,852,1411,9,1420,0,1420,35,1220,165,22.04.2019 00:36,172,18,Harkov
2496,2481,3,1110,1383,3,1386,0,1386,28,1214,144,22.04.2019 00:30,172,18,Harkov
2320,2291,15,741,1565,14,1579,0,1579,38,1315,226,22.04.2019 00:30,172,18,Harkov
2368,2338,8,803,1559,6,1565,0,1565,34,1348,183,22.04.2019 00:20,172,18,Harkov
1872,1844,16,658,1203,11,1214,0,1214,17,1050,147,22.04.2019 00:07,172,18,Harkov
1824,1809,13,631,1182,11,1193,0,1193,36,1030,127,21.04.2019 22:30,172,18,Harkov
1808,1807,13,604,1194,10,1204,0,1204,24,1049,131,22.04.2019 00:07,172,18,Harkov
2016,1986,20,718,1281,17,1298,0,1298,21,1159,118,21.04.2019 22:32,172,18,Harkov
2192,2174,16,656,1521,15,1536,0,1536,35,1304,197,22.04.2019 00:02,172,18,Harkov
2096,2068,14,673,1412,11,1423,0,1423,26,1224,173,22.04.2019 03:00,172,18,Harkov
2160,2116,11,768,1386,6,1392,0,1392,27,1202,163,22.04.2019 01:10,172,18,Harkov
2032,2008,11,693,1330,9,1339,0,1339,30,1154,155,22.04.2019 00:35,172,18,Harkov
1904,1880,6,628,1270,6,1276,0,1276,35,1100,141,22.04.2019 00:15,172,18,Harkov
2128,2108,16,671,1447,10,1457,0,1457,34,1269,154,22.04.2019 00:20,172,18,Harkov
1696,1691,19,497,1181,18,1199,0,1199,21,1026,152,22.04.2019 00:30,172,18,Harkov
1680,1665,14,528,1142,10,1152,0,1152,32,1002,118,22.04.2019 00:10,172,18,Harkov
1920,1915,17,691,1213,16,1229,0,1229,30,1034,165,22.04.2019 00:03,172,18,Harkov
2336,2309,14,712,1613,11,1624,0,1624,25,1384,215,22.04.2019 00:55,172,18,Harkov
2080,2062,13,704,1366,10,1376,0,1376,26,1202,148,22.04.2019 00:01,172,18,Harkov
2432,2444,19,840,1575,17,1592,0,1592,32,1391,169,22.04.2019 00:06,172,18,Harkov
2240,2239,15,681,1546,13,1559,0,1559,38,1346,175,21.04.2019 22:35,172,18,Harkov
2208,2212,15,733,1465,10,1475,0,1475,42,1302,131,22.04.2019 00:10,172,18,Harkov
2080,2066,11,712,1362,6,1368,0,1368,31,1187,150,22.04.2019 01:25,172,18,Harkov
2464,2460,13,968,1487,9,1496,0,1496,42,1270,184,22.04.2019 00:10,172,18,Harkov
2272,2264,10,875,1388,9,1397,0,1397,28,1204,165,21.04.2019 22:46,172,18,Harkov
2064,2083,7,711,1348,5,1353,0,1353,44,1185,124,22.04.2019 00:20,172,18,Harkov
2064,2062,18,673,1374,17,1391,0,1391,27,1224,140,22.04.2019 00:15,172,18,Harkov
2256,2253,17,779,1461,16,1477,0,1477,48,1294,135,22.04.2019 00:01,172,18,Harkov
2096,2061,26,720,1365,11,1376,0,1376,30,1212,134,22.04.2019 00:15,172,18,Harkov
2032,2018,10,690,1335,7,1342,0,1342,37,1148,157,21.04.2019 22:30,172,18,Harkov
2096,2113,12,693,1395,8,1403,0,1403,27,1252,124,22.04.2019 00:39,172,18,Harkov
2224,2217,15,879,1334,11,1345,0,1345,28,1204,113,22.04.2019 00:11,172,18,Harkov
2208,2208,15,699,1498,11,1509,0,1509,32,1275,202,22.04.2019 00:20,172,18,Harkov
2096,2102,17,643,1445,8,1453,0,1453,27,1278,148,22.04.2019 00:02,172,18,Harkov
2288,2260,11,804,1475,9,1484,0,1484,33,1271,180,22.04.2019 06:20,172,18,Harkov
2256,2245,13,756,1493,7,1500,0,1500,27,1335,138,22.04.2019 00:20,172,18,Harkov
2208,2202,18,703,1489,16,1505,0,1505,26,1355,124,22.04.2019 00:32,172,18,Harkov
2272,2269,24,805,1452,15,1467,0,1467,32,1306,129,22.04.2019 00:10,172,18,Harkov
2064,1817,11,850,1205,9,1214,0,1214,19,1076,119,22.04.2019 00:43,172,18,Harkov
2368,2344,14,812,1546,10,1556,0,1556,24,1344,186,22.04.2019 00:05,172,18,Harkov
2112,2078,28,645,1445,22,1467,0,1467,34,1265,168,21.04.2019 23:30,172,18,Harkov
2288,2253,8,791,1490,7,1497,0,1497,27,1303,167,22.04.2019 00:05,172,18,Harkov
2096,2076,8,902,1187,7,1194,0,1194,28,1082,84,22.04.2019 00:10,172,18,Harkov
2160,2138,8,744,1410,6,1416,0,1416,32,1230,154,22.04.2019 00:57,172,18,Harkov
2400,2386,12,852,1538,10,1548,0,1548,26,1393,129,22.04.2019 00:10,172,18,Harkov
2288,2276,8,736,1547,5,1552,0,1552,39,1354,159,22.04.2019 01:05,172,18,Harkov
2288,2257,10,830,1451,7,1458,0,1458,16,1321,121,22.04.2019 00:35,172,18,Harkov
2224,2192,13,658,1558,8,1566,0,1566,40,1384,142,22.04.2019 00:28,172,18,Harkov
2112,2104,15,643,1457,12,1469,0,1469,30,1300,139,22.04.2019 00:45,172,18,Harkov
2048,2016,15,642,1392,14,1406,0,1406,36,1225,145,22.04.2019 00:05,172,18,Harkov
2240,2242,19,660,1562,18,1580,0,1580,20,1404,156,22.04.2019 00:32,172,18,Harkov
1984,1959,14,657,1318,9,1327,0,1327,31,1170,126,22.04.2019 00:05,172,18,Harkov
2224,2208,5,768,1452,4,1456,0,1456,20,1268,168,22.04.2019 00:35,172,18,Harkov
2240,2221,24,743,1477,20,1497,0,1497,26,1345,126,22.04.2019 00:30,172,18,Harkov
2240,2238,26,754,1470,16,1486,0,1486,26,1318,142,22.04.2019 00:31,172,18,Harkov
2048,2032,17,623,1409,16,1425,0,1425,16,1286,123,22.04.2019 00:03,172,18,Harkov
2224,2187,13,711,1503,10,1513,0,1513,30,1331,152,22.04.2019 00:10,172,18,Harkov
2480,2446,7,746,1727,7,1734,0,1734,21,1514,199,22.04.2019 00:10,172,18,Harkov
2080,2055,10,714,1361,5,1366,0,1366,28,1186,152,22.04.2019 00:20,172,18,Harkov
2224,2189,17,866,1346,12,1358,0,1358,31,1176,151,22.04.2019 00:50,172,18,Harkov
2192,2175,12,669,1514,9,1523,0,1523,38,1306,179,22.04.2019 00:07,172,18,Harkov
1968,1952,10,630,1330,8,1338,0,1338,27,1180,131,22.04.2019 00:35,172,18,Harkov
2096,2102,14,686,1399,11,1410,0,1410,34,1236,140,22.04.2019 00:10,172,18,Harkov
1968,1958,12,586,1373,9,1382,0,1382,29,1196,157,22.04.2019 00:32,172,18,Harkov
480,117,41,365,74,41,115,0,115,3,107,5,21.04.2019 20:50,172,18,Harkov
160,48,0,115,45,0,45,0,45,1,39,5,21.04.2019 21:22,172,18,Harkov
256,11,0,245,11,0,11,0,11,0,9,2,22.04.2019 00:25,172,18,Harkov
96,94,0,77,19,0,19,0,19,0,19,0,22.04.2019 00:20,172,18,Harkov
128,65,0,73,55,0,55,0,55,0,54,1,21.04.2019 22:10,172,18,Harkov
1344,723,0,626,718,0,718,0,718,12,669,37,22.04.2019 00:20,172,18,Harkov
1664,1672,10,575,1084,5,1089,0,1089,27,924,138,22.04.2019 00:25,172,18,Harkov
800,776,16,320,464,16,480,0,480,9,438,33,21.04.2019 23:15,172,18,Harkov
192,213,1,43,149,0,149,0,149,0,133,16,22.04.2019 00:05,172,18,Harkov
128,126,0,32,96,0,96,0,96,1,79,16,21.04.2019 21:30,172,18,Harkov
1728,1784,14,486,1230,12,1242,0,1242,42,956,244,22.04.2019 00:15,173,18,Harkov
1808,1860,4,523,1283,2,1285,0,1285,34,1046,205,22.04.2019 00:15,173,18,Harkov
1952,2001,10,588,1356,8,1364,0,1364,29,1072,263,22.04.2019 00:10,173,18,Harkov
1408,1469,11,577,824,7,831,0,831,16,695,120,22.04.2019 00:01,173,18,Harkov
2192,2221,21,733,1442,17,1459,0,1459,52,1173,234,22.04.2019 00:40,173,18,Harkov
1968,1957,17,632,1322,14,1336,0,1336,29,1100,207,22.04.2019 00:07,173,18,Harkov
2160,2144,8,730,1425,5,1430,0,1430,23,1168,239,22.04.2019 00:20,173,18,Harkov
2016,2008,23,615,1387,14,1401,0,1401,34,1151,216,22.04.2019 00:05,173,18,Harkov
2128,2133,20,766,1344,18,1362,0,1362,25,1173,164,22.04.2019 00:11,173,18,Harkov
2128,2132,7,846,1278,4,1282,0,1282,22,1142,118,22.04.2019 00:01,173,18,Harkov
2320,2294,16,734,1572,14,1586,0,1586,27,1319,240,22.04.2019 00:01,173,18,Harkov
2080,2072,14,639,1428,13,1441,0,1441,25,1291,125,22.04.2019 00:05,173,18,Harkov
1616,1599,13,492,1111,13,1124,0,1124,21,959,144,22.04.2019 00:40,173,18,Harkov
1392,1397,7,441,946,5,951,0,951,16,844,91,22.04.2019 00:01,173,18,Harkov
2256,2271,19,818,1424,14,1438,0,1438,29,1205,204,22.04.2019 00:03,173,18,Harkov
2064,2061,15,651,1400,13,1413,0,1413,34,1210,169,22.04.2019 00:10,173,18,Harkov
1808,1819,15,560,1233,15,1248,0,1248,30,1066,152,22.04.2019 00:10,173,18,Harkov
2224,2193,29,768,1433,23,1456,0,1456,44,1202,210,22.04.2019 00:10,173,18,Harkov
2144,2146,23,764,1362,18,1380,0,1380,22,1211,147,22.04.2019 00:20,173,18,Harkov
1920,1924,19,804,1102,14,1116,0,1116,14,969,133,22.04.2019 00:04,173,18,Harkov
2112,2091,11,801,1302,9,1311,0,1311,20,1125,166,22.04.2019 00:07,173,18,Harkov
2032,2009,20,749,1266,17,1283,0,1283,26,1134,123,22.04.2019 00:05,173,18,Harkov
1872,1869,23,648,1209,15,1224,0,1224,17,1097,110,22.04.2019 00:05,173,18,Harkov
2112,2102,17,712,1386,14,1400,0,1400,26,1251,123,22.04.2019 00:10,173,18,Harkov
2096,2088,10,738,1352,6,1358,0,1358,18,1212,128,22.04.2019 00:10,173,18,Harkov
1792,1809,14,642,1140,10,1150,0,1150,23,1017,110,22.04.2019 00:01,173,18,Harkov
2128,2134,20,628,1488,12,1500,0,1500,27,1326,147,22.04.2019 00:05,173,18,Harkov
2096,2080,14,652,1433,11,1444,0,1444,42,1262,140,22.04.2019 00:05,173,18,Harkov
2016,2155,10,609,1397,10,1407,0,1407,21,1225,161,22.04.2019 00:05,173,18,Harkov
2688,2605,15,1050,1626,12,1638,0,1638,46,1420,172,22.04.2019 00:11,173,18,Harkov
1760,1738,8,607,1145,8,1153,0,1153,32,1012,109,22.04.2019 00:30,173,18,Harkov
1648,1652,23,553,1074,21,1095,0,1095,12,959,124,22.04.2019 00:24,173,18,Harkov
2064,2057,28,692,1348,24,1372,0,1372,32,1165,175,22.04.2019 00:15,173,18,Harkov
2400,2391,16,933,1456,11,1467,0,1466,27,1301,138,22.04.2019 00:02,173,18,Harkov
1872,1894,12,603,1260,9,1269,0,1269,38,1075,156,22.04.2019 00:05,173,18,Harkov
2112,2113,26,637,1453,22,1475,0,1475,37,1265,173,22.04.2019 00:05,173,18,Harkov
320,187,8,140,172,8,180,0,180,2,161,17,22.04.2019 00:02,173,18,Harkov
256,162,151,114,11,131,142,0,142,3,124,15,22.04.2019 00:03,173,18,Harkov
288,261,0,27,261,0,261,0,261,6,242,13,22.04.2019 00:05,173,18,Harkov
1344,1347,14,538,796,10,806,0,806,26,638,142,22.04.2019 00:15,173,18,Harkov
1232,1218,22,503,714,15,729,0,729,15,587,127,22.04.2019 00:18,173,18,Harkov
2048,2105,22,751,1284,13,1297,0,1297,25,1107,165,22.04.2019 00:28,173,18,Harkov
2352,2338,20,686,1654,12,1666,0,1666,54,1252,360,22.04.2019 00:45,173,18,Harkov
2128,2139,24,742,1367,19,1386,0,1386,49,1087,250,22.04.2019 00:05,173,18,Harkov
2240,2234,19,805,1417,18,1435,0,1435,36,1180,219,22.04.2019 00:15,173,18,Harkov
1440,1403,19,503,924,13,937,0,937,33,727,177,22.04.2019 00:10,173,18,Harkov
1104,1115,16,412,681,11,692,0,692,16,543,133,22.04.2019 00:31,173,18,Harkov
2224,2210,12,828,1391,5,1396,0,1396,26,1162,208,22.04.2019 00:05,173,18,Harkov
2224,2210,22,862,1347,15,1362,0,1362,26,1177,159,22.04.2019 00:32,173,18,Harkov
1728,1720,18,725,992,11,1003,0,1003,19,823,161,22.04.2019 00:39,173,18,Harkov
1376,1370,6,586,785,5,790,0,790,19,685,86,22.04.2019 00:22,173,18,Harkov
2304,2306,29,691,1590,23,1613,0,1613,35,1278,300,22.04.2019 00:48,173,18,Harkov
1920,1907,41,615,1279,26,1305,0,1305,42,1025,238,22.04.2019 00:03,173,18,Harkov
1760,1762,32,578,1155,27,1182,0,1182,39,933,210,22.04.2019 00:15,173,18,Harkov
2032,2035,34,670,1335,27,1362,0,1362,30,1107,225,22.04.2019 00:05,173,18,Harkov
624,611,3,257,364,3,367,0,367,3,331,33,22.04.2019 00:50,173,18,Harkov
1200,1190,6,478,719,3,722,0,722,17,609,96,22.04.2019 01:05,173,18,Harkov
512,514,2,168,342,2,344,0,344,3,308,33,22.04.2019 00:10,173,18,Harkov
1984,1978,9,784,1194,6,1200,0,1200,31,1025,144,22.04.2019 00:30,173,18,Harkov
1984,1969,14,647,1327,10,1337,0,1337,28,1151,158,22.04.2019 00:08,173,18,Harkov
2080,2064,7,682,1392,6,1398,0,1398,37,1197,164,22.04.2019 00:50,173,18,Harkov
2000,1997,9,612,1381,7,1388,0,1388,24,1188,176,21.04.2019 23:55,173,18,Harkov
2016,2002,16,626,1378,12,1390,0,1390,31,1183,176,22.04.2019 00:10,173,18,Harkov
2304,2270,25,857,1433,14,1447,0,1447,28,1292,127,22.04.2019 01:05,173,18,Harkov
2112,2089,38,762,1320,30,1350,0,1350,34,1198,118,22.04.2019 00:35,173,18,Harkov
2192,2176,38,859,1312,21,1333,0,1333,21,1169,143,22.04.2019 00:15,173,18,Harkov
2288,2281,25,783,1485,20,1505,0,1505,44,1335,126,22.04.2019 00:52,173,18,Harkov
2288,2258,27,829,1445,14,1459,0,1459,40,1298,121,22.04.2019 00:20,173,18,Harkov
2352,2324,26,862,1471,19,1490,0,1490,27,1352,111,22.04.2019 00:18,173,18,Harkov
2096,2070,17,704,1379,13,1392,0,1392,32,1233,127,22.04.2019 04:25,173,18,Harkov
2176,2164,22,804,1359,13,1372,0,1372,22,1215,135,22.04.2019 00:15,173,18,Harkov
2192,2182,10,809,1376,7,1383,0,1383,29,1251,103,22.04.2019 00:40,173,18,Harkov
2368,2354,13,780,1578,10,1588,0,1588,22,1414,152,22.04.2019 00:20,173,18,Harkov
1840,1825,14,701,1131,8,1139,0,1139,23,1027,89,22.04.2019 00:58,173,18,Harkov
1712,1709,21,616,1075,21,1096,0,1096,19,979,98,22.04.2019 00:15,173,18,Harkov
1712,1710,15,642,1060,10,1070,0,1070,13,975,82,22.04.2019 00:02,173,18,Harkov
176,52,0,124,52,0,52,0,52,0,48,4,22.04.2019 00:06,173,18,Harkov
624,624,0,0,624,0,624,0,624,18,560,46,22.04.2019 00:01,173,18,Harkov
224,143,18,86,120,18,138,0,138,7,118,13,22.04.2019 00:15,173,18,Harkov
2032,1936,12,104,1916,12,1928,0,1928,114,1766,48,22.04.2019 01:45,174,18,Harkov
1120,1142,7,416,699,5,704,0,704,19,584,101,21.04.2019 22:42,174,18,Harkov
1712,1723,15,625,1077,10,1087,0,1087,20,914,153,22.04.2019 00:05,174,18,Harkov
1360,1344,5,669,689,2,691,0,691,11,617,63,22.04.2019 01:15,174,18,Harkov
2416,2385,9,982,1427,7,1434,0,1434,16,1214,204,22.04.2019 00:11,174,18,Harkov
1872,1867,14,709,1155,8,1163,0,1163,25,985,153,22.04.2019 00:45,174,18,Harkov
2016,1995,9,852,1157,7,1164,0,1164,21,981,162,22.04.2019 00:10,174,18,Harkov
1920,1896,14,603,1304,13,1317,0,1317,26,1084,207,22.04.2019 03:20,174,18,Harkov
1872,1844,15,561,1298,13,1311,0,1311,26,1134,151,22.04.2019 01:10,174,18,Harkov
2160,2129,20,638,1502,20,1522,0,1522,29,1276,217,22.04.2019 01:10,174,18,Harkov
1920,1900,10,670,1242,8,1250,0,1250,1,1091,158,22.04.2019 00:40,174,18,Harkov
1648,1622,10,572,1070,6,1076,0,1076,24,932,120,22.04.2019 00:25,174,18,Harkov
1376,1347,12,432,936,8,944,0,944,21,809,114,22.04.2019 01:30,174,18,Harkov
1200,1180,8,434,761,5,766,0,766,16,670,80,21.04.2019 23:00,174,18,Harkov
2416,2370,13,813,1594,9,1603,0,1603,35,1359,209,22.04.2019 00:15,174,18,Harkov
1232,1216,7,447,779,6,785,0,785,21,683,81,22.04.2019 00:02,174,18,Harkov
2208,2189,11,891,1308,9,1317,0,1317,30,1124,163,22.04.2019 00:45,174,18,Harkov
2176,2086,4,891,1283,2,1285,0,1285,20,1093,172,22.04.2019 00:23,174,18,Harkov
1312,1290,5,418,889,5,894,0,894,21,773,100,22.04.2019 00:05,174,18,Harkov
2208,2181,13,846,1352,10,1362,0,1362,18,1187,157,22.04.2019 00:15,174,18,Harkov
2208,2194,16,622,1572,14,1586,0,1586,27,1358,201,22.04.2019 00:27,174,18,Harkov
2320,2305,7,777,1537,6,1543,0,1543,35,1289,219,22.04.2019 00:26,174,18,Harkov
2464,2388,17,948,1501,15,1516,0,1516,28,1262,226,22.04.2019 02:35,174,18,Harkov
1328,1298,2,593,734,1,735,0,735,17,614,104,22.04.2019 00:11,174,18,Harkov
1504,1523,6,475,1024,5,1029,0,1029,20,865,144,22.04.2019 00:40,174,18,Harkov
1312,1317,10,419,885,8,893,0,893,16,743,134,22.04.2019 00:15,174,18,Harkov
1696,1689,10,522,1166,8,1174,0,1174,27,995,152,22.04.2019 00:10,174,18,Harkov
1664,1660,10,448,1206,10,1216,0,1216,26,1000,190,22.04.2019 00:36,174,18,Harkov
1696,1671,6,487,1205,4,1209,0,1209,28,1006,175,22.04.2019 00:15,174,18,Harkov
1536,1537,8,447,1081,8,1089,0,1089,25,882,182,22.04.2019 00:10,174,18,Harkov
1552,1534,5,517,1030,5,1035,0,1035,28,863,144,22.04.2019 01:30,174,18,Harkov
1360,1350,3,412,945,3,948,0,948,24,766,158,22.04.2019 00:10,174,18,Harkov
1120,1119,9,368,744,8,752,0,752,12,674,66,22.04.2019 00:02,174,18,Harkov
2320,2296,9,752,1561,7,1568,0,1568,30,1327,211,22.04.2019 00:20,174,18,Harkov
2272,2250,23,795,1465,12,1477,0,1477,29,1296,152,22.04.2019 00:10,174,18,Harkov
1232,1216,13,422,798,12,810,0,810,20,699,91,22.04.2019 00:20,174,18,Harkov
1200,1176,2,400,798,2,800,0,800,12,683,105,22.04.2019 05:00,174,18,Harkov
2112,2093,15,689,1412,11,1423,0,1423,35,1229,159,22.04.2019 00:06,174,18,Harkov
2032,1986,19,703,1310,19,1329,0,1329,27,1183,119,22.04.2019 01:15,174,18,Harkov
2000,1995,8,661,1332,7,1339,0,1339,39,1185,115,22.04.2019 00:30,174,18,Harkov
2080,2054,10,675,1397,8,1405,0,1405,34,1236,135,22.04.2019 00:15,174,18,Harkov
2032,2012,19,734,1281,17,1298,0,1298,22,1133,143,22.04.2019 00:10,174,18,Harkov
2240,2205,17,812,1412,16,1428,0,1428,40,1247,141,22.04.2019 00:28,174,18,Harkov
944,933,8,299,637,8,645,0,645,6,550,89,22.04.2019 00:30,174,18,Harkov
272,85,26,187,59,26,85,0,85,2,73,10,22.04.2019 00:20,174,18,Harkov
224,88,35,140,53,31,84,0,84,0,79,5,22.04.2019 00:30,174,18,Harkov
176,48,7,130,40,6,46,0,46,1,39,6,22.04.2019 00:30,174,18,Harkov
272,209,6,63,203,6,209,0,209,2,181,26,22.04.2019 00:05,174,18,Harkov
224,69,7,156,61,7,68,0,68,2,59,7,22.04.2019 00:07,174,18,Harkov
176,72,1,104,71,1,72,0,72,2,67,3,22.04.2019 00:05,174,18,Harkov
96,38,0,59,37,0,37,0,37,1,33,3,22.04.2019 00:08,174,18,Harkov
1504,466,0,1038,466,0,466,0,466,19,429,18,21.04.2019 23:45,174,18,Harkov
2032,2066,12,612,1410,10,1420,0,1420,33,1179,208,22.04.2019 00:30,174,18,Harkov
2064,2156,11,727,1329,8,1337,0,1337,38,1133,166,22.04.2019 00:40,174,18,Harkov
1520,1532,12,550,959,11,970,0,970,10,848,112,22.04.2019 00:05,174,18,Harkov
2384,2401,22,1016,1351,17,1368,0,1368,32,1176,160,22.04.2019 00:05,174,18,Harkov
2352,2317,32,830,1500,22,1522,0,1522,41,1287,194,22.04.2019 00:35,174,18,Harkov
1456,1444,17,603,839,14,853,0,853,21,743,89,22.04.2019 00:18,174,18,Harkov
1664,1648,10,615,1040,9,1049,0,1049,25,880,144,22.04.2019 00:02,174,18,Harkov
1232,1242,6,391,835,6,841,0,841,15,712,114,22.04.2019 00:06,174,18,Harkov
2080,2073,12,704,1367,9,1376,0,1376,33,1088,255,22.04.2019 00:16,174,18,Harkov
2400,2392,16,839,1546,15,1561,0,1561,39,1248,274,22.04.2019 00:05,174,18,Harkov
2128,2137,26,704,1403,21,1424,0,1424,40,1172,212,22.04.2019 00:05,174,18,Harkov
2112,2101,25,669,1421,22,1443,0,1443,32,1133,278,22.04.2019 00:15,174,18,Harkov
2096,2104,24,612,1463,21,1484,0,1484,42,1225,217,22.04.2019 00:43,174,18,Harkov
2176,2162,15,715,1453,8,1461,0,1461,33,1238,190,22.04.2019 00:30,174,18,Harkov
2384,2361,19,810,1561,13,1574,0,1574,32,1288,254,22.04.2019 00:02,174,18,Harkov
2208,2183,13,669,1529,10,1539,0,1539,41,1295,203,22.04.2019 00:10,174,18,Harkov
1728,1706,18,560,1153,15,1168,0,1168,22,1004,142,22.04.2019 00:02,174,18,Harkov
2432,2412,17,781,1635,16,1651,0,1651,37,1358,256,22.04.2019 00:10,174,18,Harkov
1904,1887,18,649,1242,13,1255,0,1255,29,1075,151,22.04.2019 00:11,174,18,Harkov
1984,1950,13,828,1145,11,1156,0,1156,20,1028,108,22.04.2019 00:11,174,18,Harkov
1328,1308,21,412,903,13,916,0,916,17,792,107,22.04.2019 00:05,174,18,Harkov
1584,1569,11,641,932,11,943,0,943,16,833,94,22.04.2019 00:05,174,18,Harkov
2064,2043,27,717,1322,25,1347,0,1347,31,1204,112,22.04.2019 00:15,174,18,Harkov
1456,1411,13,557,887,12,899,0,899,17,773,109,22.04.2019 00:11,174,18,Harkov
1168,1345,8,374,790,4,794,0,794,22,648,124,22.04.2019 02:15,174,18,Harkov
1936,1955,28,582,1332,22,1354,0,1354,28,1143,183,22.04.2019 00:15,174,18,Harkov
2192,2194,15,746,1433,13,1446,0,1446,36,1254,156,22.04.2019 00:10,174,18,Harkov
2096,2060,11,706,1380,10,1390,0,1390,34,1233,123,22.04.2019 00:10,174,18,Harkov
2000,1994,17,654,1332,14,1346,0,1346,20,1200,126,22.04.2019 00:05,174,18,Harkov
2112,2104,25,726,1368,18,1386,0,1386,24,1228,134,22.04.2019 00:15,174,18,Harkov
2176,2169,13,694,1471,11,1482,0,1482,39,1276,167,22.04.2019 00:22,174,18,Harkov
2112,2081,18,721,1378,13,1391,0,1391,32,1188,171,22.04.2019 00:40,174,18,Harkov
1968,1953,17,605,1350,13,1363,0,1363,38,1166,159,22.04.2019 00:15,174,18,Harkov
288,296,104,11,178,99,277,0,277,14,229,34,22.04.2019 00:11,174,18,Harkov
352,122,19,230,103,19,122,0,122,2,107,13,22.04.2019 00:05,174,18,Harkov
240,45,2,197,41,2,43,0,43,1,39,3,22.04.2019 00:05,174,18,Harkov
96,87,1,9,86,1,87,0,87,0,73,14,22.04.2019 00:05,174,18,Harkov
80,13,0,67,13,0,13,0,13,0,12,1,22.04.2019 00:07,174,18,Harkov
1472,1469,9,590,876,6,882,0,882,19,761,102,22.04.2019 00:15,174,18,Harkov
832,832,19,234,580,18,598,0,598,12,514,72,22.04.2019 00:20,175,18,Harkov
2192,2186,26,738,1435,19,1454,0,1454,22,1248,184,22.04.2019 00:05,175,18,Harkov
1616,1620,24,472,1123,21,1144,0,1144,24,955,165,22.04.2019 00:03,175,18,Harkov
2064,2051,15,649,1401,14,1415,0,1415,25,1198,192,22.04.2019 00:20,175,18,Harkov
1776,1770,17,485,1276,15,1291,0,1291,23,1114,154,22.04.2019 00:20,175,18,Harkov
1792,1781,21,594,1183,15,1198,0,1198,11,1041,146,22.04.2019 00:20,175,18,Harkov
1744,1731,28,620,1106,18,1124,0,1124,28,959,137,22.04.2019 00:20,175,18,Harkov
1424,1395,23,513,896,15,911,0,911,26,822,63,22.04.2019 01:20,175,18,Harkov
1344,1318,13,496,839,9,848,0,848,13,745,90,22.04.2019 00:30,175,18,Harkov
1728,1714,30,680,1025,23,1048,0,1048,28,903,117,22.04.2019 00:01,175,18,Harkov
2160,2135,35,860,1276,24,1300,0,1300,17,1171,112,22.04.2019 00:10,175,18,Harkov
1552,1545,28,608,917,27,944,0,944,19,836,89,22.04.2019 01:10,175,18,Harkov
2000,1975,26,798,1185,17,1202,0,1202,20,1075,107,22.04.2019 00:02,175,18,Harkov
2064,2039,32,923,1111,30,1141,0,1141,21,1071,49,22.04.2019 00:03,175,18,Harkov
1328,1303,4,597,729,2,731,0,731,12,667,52,22.04.2019 00:07,175,18,Harkov
1584,1577,8,572,1006,6,1012,0,1012,12,954,46,22.04.2019 00:15,175,18,Harkov
432,431,2,215,215,2,217,0,217,2,206,9,22.04.2019 00:10,175,18,Harkov
1760,1752,13,606,1145,9,1154,0,1154,21,973,160,22.04.2019 00:10,175,18,Harkov
2320,2295,8,725,1588,7,1595,0,1595,23,1363,209,21.04.2019 22:00,175,18,Harkov
2112,2097,10,745,1358,9,1367,0,1367,19,1229,119,22.04.2019 00:30,175,18,Harkov
1936,1901,21,773,1149,14,1163,0,1163,25,1061,77,22.04.2019 00:25,175,18,Harkov
1968,1955,9,694,1266,8,1274,0,1274,24,1150,100,22.04.2019 00:25,175,18,Harkov
1856,1830,18,713,1126,17,1143,0,1143,13,1049,81,21.04.2019 22:00,175,18,Harkov
992,994,10,348,636,8,644,0,644,8,579,57,21.04.2019 20:50,175,18,Harkov
1632,1612,110,538,1001,93,1094,0,1094,12,992,90,22.04.2019 00:07,175,18,Harkov
768,760,37,265,471,32,503,0,503,4,447,52,22.04.2019 00:10,175,18,Harkov
1824,1814,43,696,1091,37,1128,0,1128,19,1040,69,22.04.2019 00:03,175,18,Harkov
1616,1592,21,592,1004,20,1024,0,1024,14,934,76,22.04.2019 00:05,175,18,Harkov
1840,1823,50,712,1082,46,1128,0,1128,10,1029,89,22.04.2019 00:09,175,18,Harkov
352,354,3,128,221,3,224,0,224,0,205,19,22.04.2019 00:50,175,18,Harkov
2032,2006,22,732,1288,12,1300,0,1300,23,1142,135,22.04.2019 00:05,175,18,Harkov
192,189,4,72,116,4,120,0,120,1,101,18,22.04.2019 00:10,175,18,Harkov
2176,2148,13,777,1389,10,1399,0,1399,16,1224,159,22.04.2019 00:05,175,18,Harkov
2240,2197,15,803,1426,11,1437,0,1437,24,1268,145,22.04.2019 00:25,175,18,Harkov
2128,2110,10,711,1408,9,1417,0,1417,22,1226,169,22.04.2019 00:45,175,18,Harkov
1904,1873,14,662,1233,9,1242,0,1242,13,1085,144,22.04.2019 00:10,175,18,Harkov
1424,1402,6,581,839,4,843,0,843,18,766,59,22.04.2019 00:30,175,18,Harkov
1504,1480,17,539,957,8,965,0,965,16,867,82,22.04.2019 00:10,175,18,Harkov
2128,2118,43,755,1345,28,1373,0,1373,17,1254,102,22.04.2019 00:30,175,18,Harkov
304,305,26,93,187,24,211,0,211,2,186,23,22.04.2019 00:07,175,18,Harkov
304,306,3,100,202,2,204,0,204,0,187,17,22.04.2019 00:20,175,18,Harkov
928,906,1,335,592,1,593,0,593,11,532,50,22.04.2019 00:36,175,18,Harkov
352,339,6,128,218,6,224,0,224,2,197,25,22.04.2019 00:25,175,18,Harkov
720,720,19,265,439,16,455,0,455,6,396,53,22.04.2019 00:35,175,18,Harkov
656,646,44,217,402,37,439,0,439,3,372,64,21.04.2019 22:00,175,18,Harkov
336,345,18,103,217,16,233,0,233,1,199,33,21.04.2019 22:55,175,18,Harkov
2048,2022,21,776,1254,18,1272,0,1272,19,1194,59,22.04.2019 00:24,175,18,Harkov
2048,2028,37,734,1287,27,1314,0,1314,13,1245,56,22.04.2019 01:25,175,18,Harkov
928,916,19,372,540,16,556,0,556,7,475,74,22.04.2019 00:20,175,18,Harkov
624,605,50,207,372,45,417,0,417,6,367,44,22.04.2019 00:05,175,18,Harkov
1536,1521,16,510,1012,14,1026,0,1026,24,874,128,21.04.2019 23:10,175,18,Harkov
1824,1824,34,578,1218,28,1246,0,1246,17,1059,170,22.04.2019 00:10,175,18,Harkov
800,775,11,273,516,11,527,0,527,12,465,50,22.04.2019 00:15,175,18,Harkov
112,102,1,104,7,1,8,0,8,0,7,1,21.04.2019 20:37,175,18,Harkov
192,39,0,153,39,0,39,0,39,0,36,3,22.04.2019 00:06,175,18,Harkov
1168,1148,7,412,751,5,756,0,756,12,635,109,22.04.2019 00:30,175,18,Harkov
1424,1394,9,439,977,8,985,0,985,19,886,80,22.04.2019 00:38,175,18,Harkov
1152,1143,4,441,707,4,711,0,711,10,631,70,22.04.2019 00:48,175,18,Harkov
768,758,5,281,482,5,487,0,487,6,448,33,22.04.2019 00:05,175,18,Harkov
512,505,17,206,297,9,306,0,306,5,271,30,22.04.2019 00:10,175,18,Harkov
1168,1163,24,396,751,21,772,0,772,11,686,75,22.04.2019 00:05,175,18,Harkov
1168,1153,34,373,764,31,795,0,795,13,694,88,22.04.2019 00:10,175,18,Harkov
1216,1197,67,475,685,56,741,0,741,6,693,42,22.04.2019 00:05,175,18,Harkov
480,475,38,181,267,32,299,0,299,3,267,29,22.04.2019 00:05,175,18,Harkov
560,542,32,252,281,27,308,0,308,5,271,32,22.04.2019 00:03,175,18,Harkov
1552,1526,111,514,938,100,1038,0,1038,37,907,94,22.04.2019 00:30,175,18,Harkov
2016,1988,24,813,1182,21,1203,0,1203,30,1095,78,22.04.2019 00:10,175,18,Harkov
880,855,43,312,528,40,568,0,568,9,477,82,22.04.2019 00:15,175,18,Harkov
480,459,28,211,242,27,269,0,269,3,254,12,22.04.2019 00:10,175,18,Harkov
1184,1161,32,504,652,28,680,0,680,9,601,70,22.04.2019 00:05,175,18,Harkov
1616,1603,46,637,939,40,979,0,979,4,895,80,22.04.2019 00:10,175,18,Harkov
1008,1001,6,348,659,1,660,0,660,16,583,61,21.04.2019 23:10,175,18,Harkov
1664,1643,4,589,1072,3,1075,0,1075,19,940,116,22.04.2019 00:08,175,18,Harkov
1248,1233,3,435,810,3,813,0,813,15,716,82,22.04.2019 00:50,175,18,Harkov
1056,1053,6,395,657,4,661,0,661,7,585,69,22.04.2019 01:00,175,18,Harkov
1104,1114,15,367,725,12,737,0,737,15,631,91,22.04.2019 00:52,175,18,Harkov
1536,1510,24,572,945,19,964,0,964,16,839,109,22.04.2019 00:30,175,18,Harkov
2096,2060,28,783,1296,17,1313,0,1313,25,1127,161,22.04.2019 04:55,175,18,Harkov
2048,2043,39,730,1288,30,1318,0,1318,23,1113,182,22.04.2019 00:20,175,18,Harkov
2320,2291,20,815,1490,15,1505,0,1505,21,1277,207,22.04.2019 00:15,175,18,Harkov
592,576,7,235,351,6,357,0,357,2,319,36,22.04.2019 00:10,175,18,Harkov
560,536,5,191,366,3,369,0,369,10,306,53,22.04.2019 00:05,175,18,Harkov
2144,2154,7,638,1502,4,1506,0,1506,36,1265,205,22.04.2019 00:43,175,18,Harkov
2176,2145,8,670,1501,5,1506,0,1506,37,1310,159,22.04.2019 00:40,175,18,Harkov
1680,1676,3,466,1212,2,1214,0,1214,23,1032,159,22.04.2019 01:15,175,18,Harkov
1488,1477,6,486,998,4,1002,0,1002,31,857,114,22.04.2019 00:42,175,18,Harkov
1056,1040,75,406,585,65,650,0,650,5,592,53,22.04.2019 02:00,175,18,Harkov
80,70,5,30,47,3,50,0,50,1,46,3,22.04.2019 00:20,175,18,Harkov
1120,1109,50,430,644,46,690,0,690,16,618,56,22.04.2019 00:10,175,18,Harkov
496,493,20,219,260,17,277,0,277,1,252,24,22.04.2019 00:15,175,18,Harkov
976,963,28,394,560,22,582,0,582,3,550,29,22.04.2019 00:47,175,18,Harkov
976,955,22,295,659,22,681,0,681,14,632,35,22.04.2019 00:05,175,18,Harkov
880,455,162,432,289,159,448,0,448,29,345,74,22.04.2019 00:35,175,18,Harkov
1136,1130,8,466,664,6,670,0,670,9,600,61,22.04.2019 00:15,175,18,Harkov
1840,1815,33,712,1104,24,1128,0,1128,25,994,109,22.04.2019 01:05,175,18,Harkov
880,865,13,388,484,8,492,0,492,16,444,32,22.04.2019 00:21,175,18,Harkov
1520,1516,30,515,981,24,1005,0,1005,18,892,95,22.04.2019 01:50,175,18,Harkov
848,841,15,287,547,14,561,0,561,15,491,55,22.04.2019 00:05,175,18,Harkov
1456,1449,31,482,949,25,974,0,974,15,851,108,22.04.2019 04:15,175,18,Harkov
1280,1260,18,504,763,13,776,0,776,18,690,68,22.04.2019 02:42,175,18,Harkov
928,917,11,354,566,8,574,0,574,13,516,45,22.04.2019 00:10,175,18,Harkov
1344,1333,24,506,817,21,838,0,838,21,708,109,22.04.2019 00:15,175,18,Harkov
1456,1435,23,580,857,19,876,0,876,12,804,60,22.04.2019 00:10,175,18,Harkov
784,773,13,297,480,7,487,0,487,12,441,34,22.04.2019 00:15,175,18,Harkov
1296,1270,21,572,703,21,724,0,724,5,669,50,22.04.2019 00:30,175,18,Harkov
1280,1254,16,481,792,7,799,0,799,20,702,77,22.04.2019 00:05,175,18,Harkov
1088,1077,19,406,668,14,682,0,682,17,582,83,22.04.2019 00:12,175,18,Harkov
1184,1158,11,409,768,7,775,0,775,15,691,69,22.04.2019 00:15,175,18,Harkov
912,907,7,352,555,5,560,0,560,11,497,52,22.04.2019 00:40,175,18,Harkov
944,937,12,377,556,11,567,0,567,6,502,59,22.04.2019 00:05,175,18,Harkov
752,740,14,297,445,10,455,0,455,10,412,33,22.04.2019 00:10,175,18,Harkov
48,19,0,30,18,0,18,0,18,0,8,10,22.04.2019 00:23,176,18,Harkov
688,673,17,255,418,15,433,0,433,9,392,32,22.04.2019 00:56,176,18,Harkov
1408,1389,25,489,895,24,919,0,919,8,832,79,22.04.2019 00:23,176,18,Harkov
1408,1387,41,491,877,40,917,0,917,11,828,78,22.04.2019 00:49,176,18,Harkov
752,734,43,349,370,33,403,0,403,4,375,24,22.04.2019 00:30,176,18,Harkov
592,581,27,240,332,20,352,0,352,4,322,26,22.04.2019 00:10,176,18,Harkov
128,120,6,58,65,5,70,0,70,2,60,8,21.04.2019 20:40,176,18,Harkov
1008,988,36,419,561,28,589,0,589,8,515,66,21.04.2019 22:04,176,18,Harkov
992,971,25,392,581,19,600,0,600,5,579,16,21.04.2019 20:59,176,18,Harkov
752,729,14,338,404,10,414,0,414,6,378,30,22.04.2019 00:05,176,18,Harkov
848,834,30,386,437,25,462,0,462,6,421,35,21.04.2019 21:40,176,18,Harkov
160,146,13,59,92,9,101,0,101,1,99,1,22.04.2019 00:05,176,18,Harkov
1008,997,47,514,453,41,494,0,494,12,461,21,22.04.2019 00:02,176,18,Harkov
144,138,13,43,88,13,101,0,101,3,88,10,21.04.2019 21:10,176,18,Harkov
448,431,7,200,243,5,248,0,248,2,229,17,21.04.2019 21:50,176,18,Harkov
384,368,22,160,204,20,224,0,224,1,204,19,21.04.2019 20:23,176,18,Harkov
480,472,19,182,286,12,298,0,298,0,280,18,22.04.2019 00:08,176,18,Harkov
528,519,43,203,283,42,325,0,325,4,292,29,22.04.2019 00:05,176,18,Harkov
240,221,18,108,117,15,132,0,132,3,120,9,21.04.2019 20:40,176,18,Harkov
160,150,15,56,90,14,104,0,104,0,90,14,21.04.2019 21:06,176,18,Harkov
384,364,1,216,168,0,168,0,168,2,160,6,22.04.2019 00:05,176,18,Harkov
432,411,14,203,217,12,229,0,229,2,219,8,22.04.2019 00:01,176,18,Harkov
992,971,57,490,450,52,502,0,502,7,455,40,22.04.2019 00:05,176,18,Harkov
416,410,27,217,177,22,199,0,199,2,187,10,22.04.2019 00:10,176,18,Harkov
592,572,36,278,284,30,314,0,314,2,287,25,21.04.2019 21:30,176,18,Harkov
416,402,31,156,229,31,260,0,260,1,238,21,21.04.2019 20:55,176,18,Harkov
960,925,48,391,526,43,569,0,569,2,504,63,21.04.2019 22:20,176,18,Harkov
384,380,46,119,225,40,265,0,265,9,243,13,22.04.2019 00:15,176,18,Harkov
1072,1057,52,378,652,42,694,0,694,4,661,29,22.04.2019 01:02,176,18,Harkov
2160,2159,26,729,1407,24,1431,0,1431,13,1307,111,22.04.2019 00:10,176,18,Harkov
2240,2200,38,878,1327,35,1362,0,1362,30,1227,105,22.04.2019 01:30,176,18,Harkov
2064,2024,30,770,1269,25,1294,0,1294,27,1192,75,22.04.2019 00:05,176,18,Harkov
2336,2299,33,1045,1266,25,1291,0,1291,17,1206,68,22.04.2019 03:10,176,18,Harkov
1664,1634,20,710,939,15,954,0,954,9,891,54,22.04.2019 00:35,176,18,Harkov
1664,1628,20,667,981,16,997,0,997,23,916,58,22.04.2019 00:10,176,18,Harkov
1584,1571,26,588,974,22,996,0,996,11,932,53,22.04.2019 01:05,176,18,Harkov
1872,1845,124,748,1010,114,1124,0,1124,21,975,128,22.04.2019 01:45,176,18,Harkov
1504,1476,46,691,767,46,813,0,813,14,754,45,22.04.2019 00:10,176,18,Harkov
1408,1373,47,702,664,42,706,0,706,10,654,42,22.04.2019 00:15,176,18,Harkov
1408,1392,102,471,849,88,937,0,937,13,804,120,21.04.2019 21:44,176,18,Harkov
1760,1750,32,678,1061,21,1082,0,1082,22,956,104,22.04.2019 00:20,176,18,Harkov
1184,1161,26,576,588,20,608,0,608,14,554,40,22.04.2019 00:01,176,18,Harkov
592,585,27,261,310,21,331,0,331,3,307,21,22.04.2019 00:01,176,18,Harkov
1264,1231,60,492,719,53,772,0,772,8,725,39,22.04.2019 00:30,176,18,Harkov
480,457,12,206,265,9,274,0,274,3,262,9,22.04.2019 00:20,176,18,Harkov
496,482,16,219,264,13,277,0,277,0,256,21,22.04.2019 00:55,176,18,Harkov
272,267,10,105,160,7,167,0,167,2,156,9,22.04.2019 00:40,176,18,Harkov
224,204,4,92,128,4,132,0,132,3,120,9,22.04.2019 01:07,176,18,Harkov
320,309,1,118,201,1,202,0,202,2,161,39,22.04.2019 00:01,176,18,Harkov
624,616,55,260,315,49,364,0,364,4,322,38,22.04.2019 00:15,176,18,Harkov
336,326,19,104,215,17,232,0,232,5,213,14,22.04.2019 00:10,176,18,Harkov
272,263,25,79,168,25,193,0,193,0,176,17,21.04.2019 21:00,176,18,Harkov
240,222,13,55,173,12,185,0,185,0,177,8,21.04.2019 22:10,176,18,Harkov
320,314,27,65,232,23,255,0,255,3,244,8,21.04.2019 23:50,176,18,Harkov
176,173,11,92,80,4,84,0,84,2,70,12,22.04.2019 00:50,176,18,Harkov
432,413,9,191,232,9,241,0,241,3,221,17,22.04.2019 00:03,176,18,Harkov
144,132,14,58,75,11,86,0,86,0,72,14,21.04.2019 20:50,176,18,Harkov
720,703,35,335,364,21,385,0,385,0,363,22,22.04.2019 01:22,176,18,Harkov
192,187,8,75,109,8,117,0,117,0,111,6,21.04.2019 20:40,176,18,Harkov
336,321,5,139,192,5,197,0,197,4,166,27,22.04.2019 00:10,176,18,Harkov
288,280,16,65,207,16,223,0,223,3,202,18,22.04.2019 00:20,176,18,Harkov
288,282,18,108,165,15,180,0,180,2,162,16,21.04.2019 20:45,176,18,Harkov
256,247,30,94,132,30,162,0,162,4,122,36,21.04.2019 20:29,176,18,Harkov
672,651,33,240,401,31,432,0,432,9,377,46,22.04.2019 00:15,176,18,Harkov
208,196,16,74,118,16,134,0,134,0,120,14,22.04.2019 00:18,176,18,Harkov
288,265,31,105,157,26,183,0,183,3,158,22,21.04.2019 20:58,176,18,Harkov
640,621,23,236,388,16,404,0,404,4,350,50,22.04.2019 00:05,176,18,Harkov
352,345,22,125,208,19,227,0,227,2,218,7,21.04.2019 21:10,176,18,Harkov
912,893,41,378,497,37,534,0,534,11,488,35,22.04.2019 00:10,176,18,Harkov
528,515,36,231,265,32,297,0,297,2,278,17,22.04.2019 00:45,176,18,Harkov
528,518,33,163,336,29,365,0,365,9,321,35,22.04.2019 00:40,176,18,Harkov
240,299,12,55,178,7,185,0,185,0,160,25,22.04.2019 00:07,176,18,Harkov
416,413,17,129,274,13,287,0,287,4,249,34,22.04.2019 00:10,176,18,Harkov
496,495,9,165,324,7,331,0,331,3,290,38,22.04.2019 00:01,176,18,Harkov
688,654,21,276,396,16,412,0,412,3,376,33,21.04.2019 21:10,176,18,Harkov
2256,2221,59,799,1408,49,1457,0,1457,22,1329,106,22.04.2019 01:15,176,18,Harkov
1072,1048,28,395,650,27,677,0,677,9,639,29,21.04.2019 22:10,176,18,Harkov
240,220,13,97,130,13,143,0,143,0,125,18,21.04.2019 21:00,176,18,Harkov
960,930,72,381,515,64,579,0,579,10,543,26,22.04.2019 00:23,176,18,Harkov
128,129,11,51,69,8,77,0,77,0,74,3,22.04.2019 00:50,176,18,Harkov
288,273,20,121,150,17,167,0,167,2,159,6,22.04.2019 03:35,176,18,Harkov
640,634,55,213,372,55,427,0,427,1,407,19,21.04.2019 21:00,176,18,Harkov
752,733,70,275,410,67,477,0,477,4,440,33,21.04.2019 21:05,176,18,Harkov
128,130,9,48,74,6,80,0,80,1,68,11,21.04.2019 21:00,176,18,Harkov
816,784,60,314,445,57,502,0,502,7,465,30,21.04.2019 21:00,176,18,Harkov
112,110,9,31,72,9,81,0,81,0,71,10,21.04.2019 20:30,176,18,Harkov
64,57,2,24,38,2,40,0,40,0,38,2,21.04.2019 20:45,176,18,Harkov
512,506,34,179,303,30,333,0,333,3,310,20,22.04.2019 02:30,176,18,Harkov
400,381,36,155,209,36,245,0,245,3,233,9,22.04.2019 00:15,176,18,Harkov
352,342,24,116,212,24,236,0,236,6,194,36,22.04.2019 00:05,176,18,Harkov
512,504,40,188,284,40,324,0,324,3,297,24,22.04.2019 00:40,176,18,Harkov
208,205,6,64,138,6,144,0,144,4,105,35,22.04.2019 00:35,176,18,Harkov
224,216,19,87,123,14,137,0,137,2,127,8,21.04.2019 22:45,176,18,Harkov
128,116,9,54,65,9,74,0,74,0,66,8,21.04.2019 21:30,176,18,Harkov
512,498,70,215,237,60,297,0,297,0,261,36,21.04.2019 20:35,176,18,Harkov
912,902,66,240,607,65,672,0,672,4,620,48,22.04.2019 01:30,176,18,Harkov
432,422,54,159,221,52,273,0,273,0,255,18,21.04.2019 22:05,176,18,Harkov
1040,1019,56,441,546,53,599,0,599,5,562,32,22.04.2019 00:03,176,18,Harkov
1104,1081,86,463,561,80,641,0,641,8,588,45,22.04.2019 00:15,176,18,Harkov
416,402,37,88,294,34,328,0,328,6,305,17,21.04.2019 21:05,176,18,Harkov
1568,1560,21,610,937,21,958,0,958,10,853,95,22.04.2019 00:05,176,18,Harkov
1744,1732,11,718,1016,10,1026,0,1026,21,920,85,22.04.2019 00:46,176,18,Harkov
912,898,11,374,527,11,538,0,538,9,477,52,22.04.2019 00:30,176,18,Harkov
112,126,13,17,82,13,95,0,95,1,80,14,22.04.2019 00:01,176,18,Harkov
224,212,14,64,146,14,160,0,160,0,142,18,22.04.2019 00:10,176,18,Harkov
256,249,2,106,148,2,150,0,150,0,135,15,22.04.2019 00:12,176,18,Harkov
832,820,48,308,477,47,524,0,524,14,477,33,22.04.2019 00:40,176,18,Harkov
176,177,23,74,84,18,102,0,102,1,88,13,22.04.2019 00:05,176,18,Harkov
1520,1508,51,654,820,46,866,0,866,12,791,63,22.04.2019 01:05,176,18,Harkov
560,560,49,217,297,46,343,0,343,9,263,71,22.04.2019 00:03,176,18,Harkov
1824,1802,29,678,1121,25,1146,0,1146,10,1079,57,22.04.2019 00:07,176,18,Harkov
1216,1202,16,455,748,13,761,0,761,6,728,27,22.04.2019 00:07,176,18,Harkov
1296,1275,18,486,792,18,810,0,810,8,768,34,22.04.2019 00:15,176,18,Harkov
512,509,6,213,293,6,299,0,299,3,279,17,22.04.2019 01:35,176,18,Harkov
2112,2085,16,746,1355,11,1366,0,1366,23,1273,70,22.04.2019 00:05,176,18,Harkov
2064,2031,21,834,1215,15,1230,0,1230,25,1151,54,22.04.2019 00:02,176,18,Harkov
1424,1407,30,475,920,29,949,0,949,19,860,70,22.04.2019 00:20,176,18,Harkov
1040,1026,20,334,687,19,706,0,706,23,629,54,22.04.2019 00:08,176,18,Harkov
1568,1562,13,636,922,10,932,0,932,26,834,72,22.04.2019 00:05,176,18,Harkov
1856,1819,14,699,1145,12,1157,0,1157,25,1052,80,22.04.2019 00:10,176,18,Harkov
1984,1966,22,847,1118,19,1137,0,1137,18,1036,83,21.04.2019 23:37,176,18,Harkov
2048,2016,40,683,1330,35,1365,0,1365,23,1271,71,21.04.2019 20:57,176,18,Harkov
2016,1982,31,615,1372,29,1401,0,1401,21,1314,66,22.04.2019 00:16,176,18,Harkov
1776,1775,18,620,1138,18,1156,0,1156,15,1096,45,21.04.2019 22:00,176,18,Harkov
1760,1740,16,657,1090,13,1103,0,1103,14,1029,60,22.04.2019 00:20,176,18,Harkov
352,345,14,134,205,13,218,0,218,6,200,12,22.04.2019 00:30,176,18,Harkov
480,480,24,186,273,21,294,0,294,3,257,34,22.04.2019 00:40,176,18,Harkov
480,468,36,218,235,27,262,0,262,7,221,34,22.04.2019 00:05,176,18,Harkov
992,969,50,372,572,48,620,0,620,22,530,68,22.04.2019 00:15,176,18,Harkov
560,547,24,192,346,22,368,0,368,5,344,19,22.04.2019 00:09,176,18,Harkov
240,239,15,74,152,14,166,0,166,4,149,13,22.04.2019 00:02,176,18,Harkov
576,561,41,210,327,39,366,0,366,2,267,97,22.04.2019 00:05,176,18,Harkov
896,876,18,263,616,17,633,0,633,8,589,36,22.04.2019 00:27,176,18,Harkov
1600,1580,36,556,1013,31,1044,0,1044,19,986,39,22.04.2019 00:15,176,18,Harkov
2208,2173,24,814,1372,22,1394,0,1394,21,1308,65,22.04.2019 00:10,176,18,Harkov
320,303,2,120,198,2,200,0,200,3,188,9,22.04.2019 00:10,176,18,Harkov
1280,1258,33,420,831,29,860,0,860,16,739,105,21.04.2019 21:17,176,18,Harkov
752,726,48,347,363,42,405,0,405,11,337,57,21.04.2019 21:50,176,18,Harkov
576,571,25,200,352,24,376,0,376,3,314,59,22.04.2019 00:05,176,18,Harkov
768,761,38,288,444,36,480,0,480,13,451,16,22.04.2019 00:17,176,18,Harkov
272,262,21,129,125,18,143,0,143,1,124,18,22.04.2019 00:59,176,18,Harkov
1664,1648,36,599,1036,29,1065,0,1065,21,987,57,22.04.2019 00:00,176,18,Harkov
1728,1709,24,551,1158,19,1177,0,1177,25,1040,112,22.04.2019 00:10,176,18,Harkov
2160,2130,25,749,1390,21,1411,0,1411,25,1267,119,22.04.2019 00:06,176,18,Harkov
1344,1316,20,474,851,19,870,0,870,19,799,52,22.04.2019 00:01,176,18,Harkov
1824,1808,29,566,1233,25,1258,0,1258,24,1142,92,22.04.2019 00:05,176,18,Harkov
1520,1495,22,518,980,22,1002,0,1002,25,890,87,22.04.2019 00:15,176,18,Harkov
1984,1958,52,553,1389,42,1431,0,1431,26,1276,129,22.04.2019 00:10,176,18,Harkov
1504,1481,13,504,993,7,1000,0,1000,24,896,80,22.04.2019 00:20,176,18,Harkov
1712,1704,32,600,1084,28,1112,0,1112,8,1009,95,21.04.2019 22:10,176,18,Harkov
1904,1890,32,544,1332,28,1360,0,1360,21,1233,106,22.04.2019 00:05,176,18,Harkov
2320,2292,27,788,1511,21,1532,0,1532,15,1404,113,21.04.2019 21:30,176,18,Harkov
1952,1927,43,737,1186,29,1215,0,1215,25,1106,84,22.04.2019 00:15,176,18,Harkov
1200,1190,21,486,696,18,714,0,714,8,651,55,21.04.2019 23:00,176,18,Harkov
1600,1597,34,602,965,33,998,0,998,25,904,69,22.04.2019 02:15,176,18,Harkov
1744,1918,16,531,1204,9,1213,0,1213,27,915,271,22.04.2019 00:05,176,18,Harkov
2208,2190,9,715,1485,8,1493,0,1493,25,1322,146,22.04.2019 00:07,176,18,Harkov
208,45,15,163,30,15,45,0,45,0,30,15,22.04.2019 00:02,176,18,Harkov
1680,1652,15,688,980,12,992,0,992,11,865,116,22.04.2019 00:15,177,18,Harkov
384,392,6,104,274,6,280,0,280,7,225,48,22.04.2019 00:25,177,18,Harkov
1808,1809,21,654,1135,19,1154,0,1154,14,998,142,22.04.2019 00:30,177,18,Harkov
1120,1106,10,462,648,10,658,0,658,6,590,62,22.04.2019 00:15,177,18,Harkov
304,290,25,119,161,24,185,0,185,3,160,22,22.04.2019 00:01,177,18,Harkov
448,420,7,210,231,7,238,0,238,1,206,31,22.04.2019 00:15,177,18,Harkov
960,946,45,397,518,45,563,0,563,9,495,59,22.04.2019 00:20,177,18,Harkov
352,351,26,135,191,26,217,0,217,2,194,21,21.04.2019 20:25,177,18,Harkov
272,269,20,99,153,20,173,0,173,5,149,19,22.04.2019 00:25,177,18,Harkov
272,261,11,107,154,11,165,0,165,1,148,16,22.04.2019 00:05,177,18,Harkov
320,314,11,102,207,11,218,0,218,1,185,32,22.04.2019 00:05,177,18,Harkov
304,285,19,120,165,19,184,0,184,3,160,21,22.04.2019 00:20,177,18,Harkov
320,306,3,148,169,3,172,0,172,1,158,13,22.04.2019 00:10,177,18,Harkov
448,438,12,204,232,12,244,0,244,0,230,14,22.04.2019 00:15,177,18,Harkov
864,848,3,461,400,3,403,0,403,8,365,30,22.04.2019 00:05,177,18,Harkov
512,498,37,203,274,35,309,0,309,5,264,40,22.04.2019 00:39,177,18,Harkov
128,127,9,43,76,9,85,0,85,0,61,24,22.04.2019 01:30,177,18,Harkov
1040,1043,15,429,598,13,611,0,611,3,552,56,22.04.2019 00:11,177,18,Harkov
768,769,58,275,439,54,493,0,493,2,434,57,22.04.2019 01:50,177,18,Harkov
896,892,58,315,527,54,581,0,581,27,505,49,22.04.2019 01:45,177,18,Harkov
112,103,4,45,63,4,67,0,67,1,60,6,22.04.2019 00:04,177,18,Harkov
512,508,17,195,302,15,317,0,317,9,259,49,22.04.2019 00:10,177,18,Harkov
192,187,14,64,116,12,128,0,128,3,110,15,22.04.2019 00:10,177,18,Harkov
272,270,10,107,155,10,165,0,165,0,149,16,22.04.2019 00:10,177,18,Harkov
288,281,17,86,186,16,202,0,202,2,190,10,22.04.2019 00:10,177,18,Harkov
608,591,50,179,379,50,429,0,429,2,363,64,22.04.2019 00:43,177,18,Harkov
192,177,14,62,116,14,130,0,130,0,122,8,22.04.2019 00:10,177,18,Harkov
1056,1039,43,303,712,41,753,0,753,14,430,309,22.04.2019 00:20,177,18,Harkov
512,497,44,194,274,44,318,0,318,4,289,25,22.04.2019 00:20,177,18,Harkov
528,502,24,187,318,23,341,0,341,6,309,26,22.04.2019 00:39,177,18,Harkov
384,375,24,175,186,23,209,0,209,3,186,20,22.04.2019 00:05,177,18,Harkov
288,297,20,82,187,19,206,0,206,2,183,21,22.04.2019 00:30,177,18,Harkov
576,553,30,281,267,28,295,0,295,6,275,14,22.04.2019 00:30,177,18,Harkov
960,948,60,371,532,57,589,0,589,5,539,45,22.04.2019 00:10,177,18,Harkov
1344,1335,44,463,838,43,881,0,881,16,801,64,22.04.2019 01:15,177,18,Harkov
480,469,48,177,260,43,303,0,303,8,261,34,22.04.2019 00:15,177,18,Harkov
496,484,39,197,265,34,299,0,299,2,270,27,22.04.2019 00:13,177,18,Harkov
592,598,38,254,302,36,338,0,338,6,311,21,22.04.2019 00:09,177,18,Harkov
592,587,52,233,309,50,359,0,359,3,311,45,22.04.2019 00:20,177,18,Harkov
192,186,11,101,82,9,91,0,91,0,84,7,22.04.2019 00:07,177,18,Harkov
400,395,18,190,193,17,210,0,210,1,187,22,22.04.2019 00:05,177,18,Harkov
464,454,38,189,244,31,275,0,275,4,236,35,22.04.2019 00:20,177,18,Harkov
912,935,61,341,520,51,571,0,571,12,506,53,22.04.2019 00:02,177,18,Harkov
208,201,13,94,105,9,114,0,114,2,90,22,22.04.2019 00:02,177,18,Harkov
2000,1704,59,968,983,49,1032,0,1032,18,886,128,22.04.2019 01:40,177,18,Harkov
544,522,33,241,273,30,303,0,303,6,277,20,22.04.2019 00:05,177,18,Harkov
432,318,49,142,263,27,290,0,290,10,202,78,22.04.2019 00:15,177,18,Harkov
480,469,29,196,255,29,284,0,284,1,268,15,22.04.2019 00:05,177,18,Harkov
176,164,6,76,95,5,100,0,100,1,84,15,22.04.2019 00:10,177,18,Harkov
592,577,40,259,297,36,333,0,333,2,309,22,22.04.2019 00:10,177,18,Harkov
512,505,32,183,298,31,329,0,329,3,297,29,22.04.2019 00:05,177,18,Harkov
880,874,33,323,526,31,557,0,557,7,510,40,22.04.2019 00:05,177,18,Harkov
448,441,35,197,218,33,251,0,251,0,228,23,22.04.2019 00:15,177,18,Harkov
336,331,26,144,168,24,192,0,192,2,171,19,22.04.2019 00:15,177,18,Harkov
368,354,33,127,212,29,241,0,241,1,235,5,22.04.2019 00:01,177,18,Harkov
912,887,41,337,538,37,575,0,575,11,527,37,22.04.2019 00:30,177,18,Harkov
272,260,26,107,139,26,165,0,165,0,145,20,22.04.2019 00:01,177,18,Harkov
752,746,34,309,412,31,443,0,443,2,417,24,22.04.2019 00:30,177,18,Harkov
128,124,1,59,68,1,69,0,69,0,52,17,22.04.2019 00:05,177,18,Harkov
496,479,26,236,235,25,260,0,260,3,227,30,22.04.2019 00:10,177,18,Harkov
64,64,6,36,22,6,28,0,28,0,21,7,22.04.2019 00:05,177,18,Harkov
336,322,9,174,153,9,162,0,162,5,136,21,21.04.2019 20:50,177,18,Harkov
144,130,11,76,60,8,68,0,68,1,56,11,22.04.2019 00:10,177,18,Harkov
208,193,6,95,108,5,113,0,113,0,100,13,22.04.2019 00:10,177,18,Harkov
784,780,57,319,417,48,465,0,465,3,402,60,22.04.2019 00:16,177,18,Harkov
800,790,66,362,375,63,438,0,438,5,396,37,22.04.2019 00:26,177,18,Harkov
320,308,18,112,190,18,208,0,208,3,181,24,22.04.2019 00:10,177,18,Harkov
736,721,24,281,431,24,455,0,455,3,424,28,22.04.2019 00:10,177,18,Harkov
1664,1641,33,748,887,29,916,0,916,12,855,49,22.04.2019 00:05,177,18,Harkov
1472,1450,19,474,983,15,998,0,998,8,916,74,22.04.2019 00:05,177,18,Harkov
1744,1712,61,714,979,51,1030,0,1030,12,939,79,22.04.2019 00:30,177,18,Harkov
112,97,10,57,45,10,55,0,55,2,46,7,22.04.2019 00:50,177,18,Harkov
832,824,5,334,493,5,498,0,498,10,465,23,22.04.2019 00:40,177,18,Harkov
320,305,36,105,180,35,215,0,215,1,198,16,22.04.2019 00:40,177,18,Harkov
128,117,11,47,70,11,81,0,81,0,71,10,22.04.2019 00:05,177,18,Harkov
688,666,53,335,307,46,353,0,353,4,331,18,22.04.2019 00:05,177,18,Harkov
352,342,15,164,175,13,188,0,188,4,174,10,22.04.2019 00:05,177,18,Harkov
128,122,4,38,86,4,90,0,90,2,73,15,22.04.2019 00:05,177,18,Harkov
144,134,7,68,70,6,76,0,76,0,68,8,22.04.2019 00:10,177,18,Harkov
1104,1084,34,363,709,32,741,0,741,11,695,35,22.04.2019 01:40,177,18,Harkov
624,604,14,233,378,13,391,0,391,3,371,17,22.04.2019 00:08,177,18,Harkov
272,268,24,105,145,22,167,0,167,2,157,8,22.04.2019 00:10,177,18,Harkov
464,447,17,134,318,12,330,0,330,4,308,18,22.04.2019 00:05,177,18,Harkov
1488,1471,9,596,888,4,892,0,892,17,767,108,22.04.2019 00:40,177,18,Harkov
1488,1472,18,525,951,12,963,0,963,21,833,109,22.04.2019 00:58,177,18,Harkov
1856,1833,12,701,1146,9,1155,0,1155,24,1021,110,22.04.2019 00:45,177,18,Harkov
912,888,4,412,496,4,500,0,500,6,448,46,22.04.2019 00:16,177,18,Harkov
176,168,8,79,89,8,97,0,97,1,81,15,22.04.2019 00:05,177,18,Harkov
208,209,0,83,125,0,125,0,125,1,113,11,22.04.2019 00:07,177,18,Harkov
320,325,6,117,197,6,203,0,203,2,179,22,22.04.2019 00:45,177,18,Harkov
528,526,5,210,315,3,318,0,318,4,285,29,22.04.2019 00:20,177,18,Harkov
144,129,6,55,84,5,89,0,89,1,84,4,22.04.2019 00:15,177,18,Harkov
400,387,4,224,172,4,176,0,176,1,159,16,22.04.2019 00:05,177,18,Harkov
624,595,11,371,244,9,253,0,253,2,235,16,22.04.2019 00:10,177,18,Harkov
208,201,0,102,106,0,106,0,106,0,94,12,22.04.2019 00:05,177,18,Harkov
272,258,1,140,131,1,132,0,132,0,112,20,22.04.2019 00:45,177,18,Harkov
640,622,5,240,395,5,400,0,400,6,347,47,22.04.2019 00:30,177,18,Harkov
496,490,4,222,270,4,274,0,274,3,253,18,22.04.2019 00:10,177,18,Harkov
544,523,7,222,315,7,322,0,322,6,301,15,22.04.2019 00:10,177,18,Harkov
512,499,8,275,230,7,237,0,237,4,213,20,22.04.2019 00:40,177,18,Harkov
768,742,7,366,397,5,402,0,402,10,361,31,22.04.2019 00:23,177,18,Harkov
272,258,5,155,112,5,117,0,117,4,97,16,22.04.2019 00:05,177,18,Harkov
560,545,8,256,296,8,304,0,304,0,289,15,22.04.2019 00:05,177,18,Harkov
544,525,3,236,305,3,308,0,308,5,285,18,22.04.2019 00:15,177,18,Harkov
480,469,3,197,282,1,283,0,283,4,251,28,22.04.2019 00:02,177,18,Harkov
496,473,2,268,227,1,228,0,228,3,213,12,22.04.2019 00:02,177,18,Harkov
512,493,18,246,249,17,266,0,266,5,230,31,22.04.2019 00:05,177,18,Harkov
384,369,1,182,201,1,202,0,202,7,166,29,22.04.2019 00:25,177,18,Harkov
960,929,7,409,545,6,551,0,551,5,498,48,22.04.2019 00:05,177,18,Harkov
1824,1812,8,746,1072,6,1078,0,1078,20,982,76,22.04.2019 02:15,177,18,Harkov
1472,1458,18,547,909,16,925,0,925,22,816,87,22.04.2019 00:38,177,18,Harkov
2032,2017,20,816,1200,16,1216,0,1216,29,1089,98,22.04.2019 00:20,177,18,Harkov
1744,1707,19,695,1034,15,1049,0,1049,19,913,117,22.04.2019 01:30,177,18,Harkov
1840,1815,17,724,1103,13,1116,0,1116,23,114,979,22.04.2019 00:35,177,18,Harkov
1584,1573,5,687,894,3,897,0,897,16,795,86,22.04.2019 03:15,177,18,Harkov
1648,1635,8,666,976,6,982,0,982,17,851,114,22.04.2019 00:45,177,18,Harkov
1616,1609,17,603,1001,12,1013,0,1013,22,876,115,22.04.2019 00:21,177,18,Harkov
1840,1826,10,741,1093,6,1099,0,1099,16,960,123,22.04.2019 02:10,177,18,Harkov
1712,1698,13,632,1068,12,1080,0,1080,14,974,92,22.04.2019 00:30,177,18,Harkov
1328,1310,8,507,815,6,821,0,821,11,750,60,22.04.2019 00:05,177,18,Harkov
2128,2108,11,813,1305,10,1315,0,1315,16,1203,96,22.04.2019 00:20,177,18,Harkov
2144,2109,22,829,1298,17,1315,0,1315,27,1190,98,22.04.2019 00:15,177,18,Harkov
1856,1850,3,702,1152,2,1154,0,1154,14,1072,68,21.04.2019 23:20,177,18,Harkov
1648,1659,11,636,1003,9,1012,0,1012,19,911,82,22.04.2019 00:10,177,18,Harkov
1872,1870,18,789,1069,14,1083,0,1083,16,995,72,22.04.2019 01:32,177,18,Harkov
1264,1240,10,559,696,9,705,0,705,21,608,76,22.04.2019 00:25,177,18,Harkov
1648,1639,14,631,1006,11,1017,0,1017,22,930,65,22.04.2019 00:45,177,18,Harkov
2016,1998,27,802,1194,20,1214,0,1214,22,1105,87,22.04.2019 00:20,177,18,Harkov
1904,1893,17,743,1147,14,1161,0,1161,23,1056,82,22.04.2019 00:05,177,18,Harkov
1952,1935,14,737,1204,11,1215,0,1215,15,1088,112,22.04.2019 00:05,177,18,Harkov
1968,1947,10,956,1005,7,1012,0,1012,15,920,77,22.04.2019 00:10,177,18,Harkov
240,57,0,187,53,0,53,0,53,1,49,3,22.04.2019 00:22,177,18,Harkov
96,29,5,73,20,3,23,0,23,1,21,1,22.04.2019 00:45,177,18,Harkov
2000,1988,39,737,1232,31,1263,0,1263,20,1115,128,22.04.2019 00:15,177,18,Harkov
2096,2086,32,772,1299,25,1324,0,1324,29,1180,115,22.04.2019 00:25,177,18,Harkov
1456,1432,28,519,916,21,937,0,937,17,838,82,22.04.2019 00:05,177,18,Harkov
1680,1677,35,609,1043,28,1071,0,1071,16,952,103,22.04.2019 00:05,177,18,Harkov
2256,2214,26,940,1297,19,1316,0,1316,23,1195,98,22.04.2019 00:30,177,18,Harkov
1456,1431,26,548,892,16,908,0,908,12,842,54,22.04.2019 00:35,177,18,Harkov
2064,2034,50,758,1259,47,1306,0,1306,24,1162,120,22.04.2019 00:30,177,18,Harkov
2224,2180,20,802,1405,17,1422,0,1422,13,1284,125,22.04.2019 00:31,177,18,Harkov
960,944,14,345,606,9,615,0,615,6,570,39,22.04.2019 00:25,177,18,Harkov
1968,1938,83,804,1092,72,1164,0,1164,34,1029,101,22.04.2019 00:25,177,18,Harkov
2032,2009,50,750,1240,42,1282,0,1282,26,1176,80,22.04.2019 00:05,177,18,Harkov
1728,1710,30,693,1009,26,1035,0,1035,20,921,94,21.04.2019 21:30,177,18,Harkov
1072,1061,19,334,722,16,738,0,738,4,700,34,22.04.2019 00:15,177,18,Harkov
1024,1020,12,345,667,12,679,0,679,5,628,46,22.04.2019 00:10,177,18,Harkov
1808,1779,6,674,1128,6,1134,0,1134,17,1072,45,22.04.2019 00:20,177,18,Harkov
1056,1057,11,366,679,11,690,0,690,16,639,35,22.04.2019 00:25,177,18,Harkov
1104,1094,14,429,665,10,675,0,675,10,630,35,22.04.2019 00:38,177,18,Harkov
1232,1203,6,423,803,6,809,0,809,12,754,43,22.04.2019 00:10,177,18,Harkov
1056,1032,11,391,658,7,665,0,665,6,625,34,22.04.2019 00:05,177,18,Harkov
1456,1425,18,647,795,14,809,0,809,9,762,38,22.04.2019 00:03,177,18,Harkov
1632,1609,20,706,911,15,926,0,926,18,842,66,22.04.2019 00:09,177,18,Harkov
1552,1538,15,844,694,14,708,0,708,7,672,29,22.04.2019 00:08,177,18,Harkov
1920,1902,12,884,1029,7,1036,0,1036,11,973,52,22.04.2019 00:02,177,18,Harkov
1456,1439,7,618,832,6,838,0,838,14,765,59,22.04.2019 00:30,177,18,Harkov
1328,1317,2,606,720,2,722,0,722,14,663,45,22.04.2019 00:10,177,18,Harkov
1536,1506,20,677,843,16,859,0,859,17,786,56,22.04.2019 00:35,177,18,Harkov
1616,1604,20,667,933,16,949,0,949,23,863,63,22.04.2019 00:01,177,18,Harkov
1664,1640,13,675,976,13,989,0,989,17,926,46,22.04.2019 00:04,177,18,Harkov
288,52,52,242,0,46,46,0,46,0,44,2,22.04.2019 00:10,177,18,Harkov
176,15,0,162,14,0,14,0,14,0,14,0,22.04.2019 00:20,177,18,Harkov
1104,1099,20,365,723,16,739,0,739,9,664,66,22.04.2019 00:01,178,18,Harkov
1744,1715,46,624,1079,41,1120,0,1120,22,1023,75,22.04.2019 00:05,178,18,Harkov
1744,1728,27,581,1139,24,1163,0,1163,14,1060,89,22.04.2019 00:10,178,18,Harkov
2256,2217,27,831,1402,23,1425,0,1425,24,1322,79,22.04.2019 00:10,178,18,Harkov
2000,1988,35,598,1370,32,1402,0,1402,38,1263,101,22.04.2019 00:10,178,18,Harkov
2288,2232,33,852,1408,28,1436,0,1436,26,1306,104,22.04.2019 00:10,178,18,Harkov
2368,2404,29,805,1537,26,1563,0,1563,24,1458,81,22.04.2019 00:10,178,18,Harkov
2112,2099,33,815,1273,24,1297,0,1297,26,1199,72,22.04.2019 00:15,178,18,Harkov
1328,1305,37,552,744,32,776,0,776,15,707,54,22.04.2019 00:20,178,18,Harkov
2208,2172,37,809,1370,29,1399,0,1399,17,1301,81,22.04.2019 00:10,178,18,Harkov
304,304,9,81,216,7,223,0,223,6,204,13,21.04.2019 21:50,178,18,Harkov
1520,1490,21,559,946,15,961,0,961,7,900,54,22.04.2019 00:03,178,18,Harkov
1792,1773,21,689,1086,17,1103,0,1103,16,1042,45,22.04.2019 00:05,178,18,Harkov
832,824,8,290,535,7,542,0,542,10,501,31,22.04.2019 00:10,178,18,Harkov
2224,2208,26,924,1275,25,1300,0,1300,21,1199,80,22.04.2019 00:05,178,18,Harkov
2144,2117,18,902,1225,17,1242,0,1242,5,1173,64,22.04.2019 05:42,178,18,Harkov
2112,2086,29,911,1180,21,1201,0,1201,11,1146,44,21.04.2019 21:07,178,18,Harkov
2272,2228,26,973,1281,18,1299,0,1299,18,1206,75,22.04.2019 00:20,178,18,Harkov
1328,1299,17,595,717,16,733,0,733,13,661,59,21.04.2019 21:57,178,18,Harkov
608,602,10,308,292,8,300,0,300,8,270,22,22.04.2019 00:05,178,18,Harkov
480,468,17,172,291,17,308,0,308,3,263,42,22.04.2019 00:40,178,18,Harkov
2336,2291,48,764,1546,26,1572,0,1572,21,1458,93,22.04.2019 02:10,178,18,Harkov
720,718,23,288,412,20,432,0,432,4,401,27,22.04.2019 00:36,178,18,Harkov
2272,2235,26,890,1363,19,1382,0,1382,17,1297,68,22.04.2019 00:03,178,18,Harkov
2224,2210,15,799,1415,10,1425,0,1425,21,1325,79,22.04.2019 00:20,178,18,Harkov
576,568,23,216,337,23,360,0,360,3,350,7,22.04.2019 00:15,178,18,Harkov
336,325,4,139,193,4,197,0,197,2,185,10,22.04.2019 00:02,178,18,Harkov
816,802,48,240,533,43,576,0,576,8,534,34,22.04.2019 00:05,178,18,Harkov
624,605,85,244,299,81,380,0,380,4,346,30,22.04.2019 01:00,178,18,Harkov
1248,1225,47,412,796,40,836,0,836,19,757,60,22.04.2019 00:01,178,18,Harkov
1168,1146,40,395,734,39,773,0,773,14,719,40,22.04.2019 01:22,178,18,Harkov
544,536,8,232,307,5,312,0,312,0,295,17,22.04.2019 00:40,178,18,Harkov
384,365,19,197,168,19,187,0,187,3,174,10,22.04.2019 00:10,178,18,Harkov
480,460,28,210,243,27,270,0,270,1,245,24,22.04.2019 00:05,178,18,Harkov
448,439,40,179,237,32,269,0,269,5,240,24,21.04.2019 21:20,178,18,Harkov
832,814,58,288,488,56,544,0,544,2,514,28,22.04.2019 00:05,178,18,Harkov
192,180,24,71,99,22,121,0,121,0,110,11,22.04.2019 00:05,178,18,Harkov
736,717,45,254,442,40,482,0,482,11,430,41,22.04.2019 00:03,178,18,Harkov
496,469,35,226,239,31,270,0,270,1,244,25,22.04.2019 00:05,178,18,Harkov
880,860,72,422,393,65,458,0,458,3,426,29,22.04.2019 00:05,178,18,Harkov
640,628,21,243,379,18,397,0,397,9,337,51,22.04.2019 00:03,178,18,Harkov
304,299,17,92,200,12,212,0,212,3,178,31,21.04.2019 22:00,178,18,Harkov
592,583,35,178,380,34,414,0,414,3,383,28,22.04.2019 00:05,178,18,Harkov
1280,1263,57,485,746,49,795,0,795,14,752,29,22.04.2019 00:30,178,18,Harkov
320,310,24,118,179,23,202,0,202,1,188,13,22.04.2019 00:15,178,18,Harkov
1600,1571,110,470,1035,95,1130,0,1130,14,1076,40,22.04.2019 00:05,178,18,Harkov
240,234,22,72,146,22,168,0,168,2,153,13,22.04.2019 03:03,178,18,Harkov
496,485,8,194,297,5,302,0,302,1,289,12,22.04.2019 00:05,178,18,Harkov
704,675,65,288,363,53,416,0,416,3,399,14,21.04.2019 22:00,178,18,Harkov
1792,1757,44,734,1022,36,1058,0,1058,17,992,49,21.04.2019 20:54,178,18,Harkov
560,549,37,224,299,37,336,0,336,11,299,26,22.04.2019 00:25,178,18,Harkov
752,743,38,235,480,37,517,0,517,7,464,46,21.04.2019 21:10,178,18,Harkov
320,314,29,101,193,26,219,0,219,3,199,17,22.04.2019 00:07,178,18,Harkov
672,662,49,208,416,48,464,0,464,5,435,24,22.04.2019 00:55,178,18,Harkov
736,720,54,229,455,52,507,0,507,2,471,34,21.04.2019 23:40,178,18,Harkov
192,192,26,57,109,26,135,0,135,1,104,30,22.04.2019 00:40,178,18,Harkov
272,47,17,225,30,17,47,0,47,2,34,11,22.04.2019 00:10,178,18,Harkov
720,311,24,409,287,24,311,0,311,8,236,67,22.04.2019 00:01,178,18,Harkov
672,661,7,247,418,7,425,0,425,4,401,20,22.04.2019 00:03,178,18,Harkov
1424,1377,16,598,810,16,826,0,826,13,742,71,22.04.2019 00:10,178,18,Harkov
1568,1527,41,593,941,34,975,0,975,24,863,88,22.04.2019 00:45,178,18,Harkov
1184,1151,21,543,621,20,641,0,641,12,557,72,22.04.2019 02:00,178,18,Harkov
976,940,15,373,588,15,603,0,603,17,530,56,22.04.2019 00:45,178,18,Harkov
672,653,22,255,395,22,417,0,417,4,364,49,22.04.2019 00:10,178,18,Harkov
1312,1272,34,673,609,30,639,0,639,9,570,60,21.04.2019 22:00,178,18,Harkov
1024,999,16,522,492,10,502,0,502,6,468,28,22.04.2019 00:40,178,18,Harkov
320,320,15,133,178,9,187,0,187,1,166,20,21.04.2019 21:05,178,18,Harkov
400,378,13,165,223,12,235,0,235,2,202,31,22.04.2019 00:40,178,18,Harkov
528,522,21,177,332,19,351,0,351,4,321,26,21.04.2019 23:50,178,18,Harkov
512,492,24,242,250,20,270,0,270,2,230,38,22.04.2019 00:50,178,18,Harkov
560,544,37,237,292,31,323,0,323,4,301,18,22.04.2019 00:05,178,18,Harkov
208,195,13,94,101,13,114,0,114,1,94,19,22.04.2019 01:30,178,18,Harkov
480,469,26,207,247,26,273,0,273,14,236,23,22.04.2019 00:10,178,18,Harkov
512,505,23,202,291,19,310,0,310,5,286,19,21.04.2019 22:10,178,18,Harkov
576,568,48,221,314,41,355,0,355,8,309,38,21.04.2019 21:30,178,18,Harkov
352,337,24,144,187,21,208,0,208,2,194,12,22.04.2019 00:15,178,18,Harkov
688,677,52,295,348,45,393,0,393,9,350,34,22.04.2019 00:15,178,18,Harkov
624,601,40,253,335,36,371,0,371,3,347,21,21.04.2019 22:28,178,18,Harkov
544,533,36,209,302,33,335,0,335,2,293,40,22.04.2019 00:10,178,18,Harkov
432,415,22,168,242,22,264,0,264,1,220,43,22.04.2019 00:05,178,18,Harkov
928,910,36,417,477,34,511,0,511,6,470,35,21.04.2019 22:45,178,18,Harkov
272,258,15,102,157,13,170,0,170,1,141,28,22.04.2019 00:10,178,18,Harkov
416,404,29,124,263,29,292,0,292,2,267,23,22.04.2019 00:15,178,18,Harkov
160,157,18,56,89,15,104,0,104,0,81,23,21.04.2019 21:00,178,18,Harkov
80,71,3,24,53,3,56,0,56,0,45,11,21.04.2019 21:05,178,18,Harkov
608,588,33,254,327,27,354,0,354,9,304,41,22.04.2019 00:20,178,18,Harkov
400,388,27,109,265,26,291,0,291,6,238,47,22.04.2019 00:25,178,18,Harkov
192,180,19,47,126,19,145,0,145,3,107,35,22.04.2019 00:20,178,18,Harkov
528,522,19,201,309,18,327,0,327,6,300,21,22.04.2019 00:05,178,18,Harkov
128,28,12,100,16,12,28,0,28,0,27,1,22.04.2019 00:30,178,18,Harkov
128,65,6,70,52,6,58,0,58,3,44,11,22.04.2019 00:25,178,18,Harkov
1808,1789,11,711,1087,10,1097,0,1097,19,957,121,22.04.2019 01:20,178,18,Harkov
943,915,8,402,534,7,541,0,541,8,487,46,22.04.2019 05:02,178,18,Harkov
672,652,27,274,374,24,398,0,398,6,342,50,21.04.2019 21:20,178,18,Harkov
432,411,9,224,201,7,208,0,208,5,181,22,21.04.2019 22:30,178,18,Harkov
400,389,13,165,224,11,235,0,235,6,194,35,21.04.2019 22:25,178,18,Harkov
416,406,2,200,214,2,216,0,216,1,193,22,22.04.2019 00:30,178,18,Harkov
672,650,3,336,334,2,336,0,336,3,304,29,21.04.2019 23:05,178,18,Harkov
240,221,0,129,111,0,111,0,111,3,93,15,21.04.2019 23:30,178,18,Harkov
768,752,20,334,414,20,434,0,434,3,382,49,22.04.2019 02:40,178,18,Harkov
624,614,50,237,341,46,387,0,387,6,325,56,21.04.2019 23:30,178,18,Harkov
496,489,9,226,261,9,270,0,270,4,239,27,22.04.2019 00:10,178,18,Harkov
320,307,11,137,172,11,183,0,183,3,165,15,21.04.2019 21:30,178,18,Harkov
736,724,25,305,415,16,431,0,431,6,370,55,22.04.2019 00:10,178,18,Harkov
848,836,15,396,438,14,452,0,452,6,409,37,22.04.2019 00:05,178,18,Harkov
416,408,2,194,220,2,222,0,222,2,208,12,21.04.2019 21:10,178,18,Harkov
432,420,9,180,244,8,252,0,252,0,225,27,22.04.2019 00:10,178,18,Harkov
224,216,6,95,123,6,129,0,129,4,107,18,21.04.2019 20:30,178,18,Harkov
576,564,16,264,298,14,312,0,312,3,268,41,21.04.2019 20:50,178,18,Harkov
400,387,7,191,202,7,209,0,209,6,168,35,22.04.2019 00:15,178,18,Harkov
416,395,1,196,219,1,220,0,220,1,179,40,21.04.2019 21:50,178,18,Harkov
464,445,6,201,258,5,263,0,263,3,240,20,22.04.2019 01:05,178,18,Harkov
272,274,11,123,143,6,149,0,149,0,137,12,22.04.2019 01:28,178,18,Harkov
448,430,11,178,259,11,270,0,270,3,249,18,21.04.2019 22:40,178,18,Harkov
272,256,2,91,179,2,181,0,181,4,167,10,22.04.2019 00:45,178,18,Harkov
336,321,16,142,180,14,194,0,194,2,173,19,21.04.2019 21:41,178,18,Harkov
688,672,24,306,360,22,382,0,382,7,333,42,22.04.2019 01:00,178,18,Harkov
688,667,14,269,407,12,419,0,419,6,375,38,22.04.2019 00:05,178,18,Harkov
96,8,1,88,7,1,8,0,8,0,5,3,22.04.2019 00:20,178,18,Harkov
224,218,29,97,100,27,127,0,127,2,111,14,22.04.2019 00:15,178,18,Harkov
304,293,36,145,128,31,159,0,159,1,146,12,22.04.2019 00:05,178,18,Harkov
576,569,25,208,348,20,368,0,368,7,333,28,22.04.2019 00:15,178,18,Harkov
144,149,30,59,61,24,85,0,85,1,66,18,22.04.2019 00:05,178,18,Harkov
432,416,53,172,214,46,260,0,260,1,210,49,22.04.2019 00:30,178,18,Harkov
1008,1040,107,351,571,86,657,0,657,6,588,63,22.04.2019 01:10,178,18,Harkov
336,332,59,131,153,52,205,0,205,1,177,27,22.04.2019 00:20,178,18,Harkov
304,302,12,133,162,9,171,0,171,2,144,25,22.04.2019 00:45,178,18,Harkov
768,746,25,307,447,14,461,0,461,8,426,27,22.04.2019 01:30,178,18,Harkov
256,245,23,85,151,20,171,0,171,0,158,13,22.04.2019 00:10,178,18,Harkov
544,523,60,217,271,56,327,0,327,0,282,45,22.04.2019 00:10,178,18,Harkov
240,240,25,74,143,23,166,0,166,3,150,13,21.04.2019 23:55,178,18,Harkov
400,384,84,158,167,75,242,0,242,0,228,14,22.04.2019 00:10,178,18,Harkov
400,387,24,156,220,24,244,0,244,2,210,32,22.04.2019 00:05,178,18,Harkov
864,849,74,332,460,72,532,0,532,8,466,58,22.04.2019 00:05,178,18,Harkov
528,518,49,199,288,41,329,0,329,8,260,61,21.04.2019 22:00,178,18,Harkov
480,460,52,166,266,48,314,0,314,2,295,17,22.04.2019 00:20,178,18,Harkov
448,440,47,171,233,44,277,0,277,1,254,22,22.04.2019 00:15,178,18,Harkov
1312,1294,123,575,642,95,737,0,737,7,689,41,21.04.2019 22:01,178,18,Harkov
640,637,58,228,361,51,412,0,412,3,373,36,22.04.2019 01:00,178,18,Harkov
576,555,60,173,349,54,403,0,403,3,375,25,22.04.2019 00:15,178,18,Harkov
384,377,42,149,198,37,235,0,235,2,210,23,21.04.2019 23:45,178,18,Harkov
448,445,32,165,256,27,283,0,283,1,258,24,22.04.2019 00:45,178,18,Harkov
688,683,46,260,384,44,428,0,428,1,401,26,22.04.2019 00:15,178,18,Harkov
528,511,61,248,223,57,280,0,280,5,243,32,22.04.2019 00:10,178,18,Harkov
432,429,18,148,269,15,284,0,284,3,256,25,22.04.2019 00:15,178,18,Harkov
1280,1255,24,530,731,19,750,0,750,19,670,61,22.04.2019 01:15,178,18,Harkov
336,338,18,145,176,15,191,0,191,8,173,10,22.04.2019 00:15,178,18,Harkov
1104,1087,39,389,686,29,715,0,715,17,664,34,22.04.2019 00:10,178,18,Harkov
2272,2241,63,894,1328,50,1378,0,1378,32,1255,91,22.04.2019 00:05,178,18,Harkov
1840,1808,53,697,1103,40,1143,0,1143,22,1046,75,22.04.2019 01:15,178,18,Harkov
1696,1661,38,784,880,32,912,0,912,18,832,62,22.04.2019 00:55,178,18,Harkov
2176,2139,42,829,1317,30,1347,0,1347,23,1231,93,22.04.2019 00:10,178,18,Harkov
2160,2118,57,825,1292,43,1335,0,1335,31,1220,84,22.04.2019 00:10,178,18,Harkov
1952,1910,47,720,1188,44,1232,0,1232,26,1136,70,22.04.2019 00:50,178,18,Harkov
2208,2167,38,821,1357,30,1387,0,1387,28,1280,79,22.04.2019 00:15,178,18,Harkov
2160,2118,29,799,1341,20,1361,0,1361,15,1263,83,22.04.2019 00:45,178,18,Harkov
2272,2235,65,831,1388,53,1441,0,1441,34,1312,95,22.04.2019 02:30,178,18,Harkov
1984,1929,31,778,1180,26,1206,0,1206,21,1089,96,22.04.2019 00:45,178,18,Harkov
144,24,11,120,13,11,24,0,24,0,19,5,21.04.2019 23:58,178,18,Harkov
256,252,0,4,252,0,252,0,252,1,157,94,22.04.2019 00:10,178,18,Harkov
192,182,29,78,90,24,114,0,114,0,102,12,22.04.2019 00:05,179,18,Harkov
688,678,32,219,437,32,469,0,469,8,419,42,21.04.2019 22:30,179,18,Harkov
656,639,61,209,390,57,447,0,447,7,427,13,21.04.2019 21:06,179,18,Harkov
560,553,40,228,301,31,332,0,332,3,288,41,22.04.2019 00:27,179,18,Harkov
400,390,19,130,251,19,270,0,270,3,251,16,22.04.2019 05:40,179,18,Harkov
608,607,41,211,363,34,397,0,397,6,329,62,22.04.2019 01:16,179,18,Harkov
256,253,9,88,160,8,168,0,168,2,146,20,22.04.2019 00:35,179,18,Harkov
256,237,10,89,157,10,167,0,167,0,157,10,22.04.2019 00:05,179,18,Harkov
160,142,9,54,101,5,106,0,106,0,100,6,22.04.2019 00:05,179,18,Harkov
224,212,18,78,129,17,146,0,146,2,125,19,22.04.2019 00:05,179,18,Harkov
784,767,52,248,484,52,536,0,536,2,496,38,22.04.2019 01:05,179,18,Harkov
320,312,8,136,178,6,184,0,184,5,174,5,22.04.2019 00:30,179,18,Harkov
176,179,12,92,72,12,84,0,84,4,72,8,21.04.2019 21:10,179,18,Harkov
624,613,12,203,409,12,421,0,421,2,402,17,21.04.2019 21:10,179,18,Harkov
464,441,49,174,250,40,290,0,290,2,250,38,21.04.2019 22:15,179,18,Harkov
176,164,4,56,116,4,120,0,120,0,98,22,22.04.2019 00:05,179,18,Harkov
480,461,37,202,243,35,278,0,278,3,255,20,22.04.2019 00:20,179,18,Harkov
432,410,24,179,231,22,253,0,253,3,227,23,21.04.2019 21:25,179,18,Harkov
480,458,24,191,268,21,289,0,289,3,245,41,22.04.2019 00:14,179,18,Harkov
272,267,16,75,183,14,197,0,197,2,177,18,22.04.2019 00:03,179,18,Harkov
1264,1240,21,629,621,14,635,0,635,5,598,32,21.04.2019 22:05,179,18,Harkov
1536,1508,30,679,831,26,857,0,857,18,770,69,22.04.2019 00:10,179,18,Harkov
1472,1448,33,525,928,19,947,0,947,13,871,63,22.04.2019 00:20,179,18,Harkov
1632,1607,17,535,1085,12,1097,0,1097,14,1011,72,22.04.2019 00:01,179,18,Harkov
1680,1651,19,568,1102,10,1112,0,1112,18,1028,66,22.04.2019 00:13,179,18,Harkov
1456,1430,30,493,936,27,963,0,963,12,890,61,22.04.2019 00:01,179,18,Harkov
816,807,32,278,514,24,538,0,538,6,504,28,21.04.2019 23:32,179,18,Harkov
784,765,26,248,511,25,536,0,536,11,490,35,22.04.2019 00:21,179,18,Harkov
1008,1015,20,301,688,19,707,0,707,12,637,58,22.04.2019 00:40,179,18,Harkov
1520,1504,34,514,978,28,1006,0,1006,18,920,68,22.04.2019 02:20,179,18,Harkov
1152,1157,30,388,744,20,764,0,764,8,704,52,21.04.2019 22:50,179,18,Harkov
800,790,18,298,489,13,502,0,502,7,468,27,21.04.2019 22:05,179,18,Harkov
1520,1511,22,504,999,17,1016,0,1016,13,943,60,22.04.2019 00:07,179,18,Harkov
688,671,17,254,423,11,434,0,434,4,402,28,22.04.2019 00:05,179,18,Harkov
688,672,18,238,433,17,450,0,450,5,418,27,22.04.2019 00:01,179,18,Harkov
1072,1042,22,406,646,20,666,0,666,10,632,24,22.04.2019 00:10,179,18,Harkov
592,571,11,282,300,10,310,0,310,8,285,17,22.04.2019 00:05,179,18,Harkov
544,524,30,221,298,25,323,0,323,2,300,21,22.04.2019 00:05,179,18,Harkov
368,352,14,149,207,12,219,0,219,7,205,7,21.04.2019 20:23,179,18,Harkov
464,460,37,185,244,35,279,0,279,2,255,22,21.04.2019 21:15,179,18,Harkov
576,567,34,191,357,28,385,0,385,5,329,51,21.04.2019 21:05,179,18,Harkov
384,379,23,120,248,16,264,0,264,2,240,22,21.04.2019 21:04,179,18,Harkov
448,436,31,150,269,29,298,0,298,5,286,7,21.04.2019 21:17,179,18,Harkov
256,241,25,90,142,24,166,0,166,0,152,14,21.04.2019 21:30,179,18,Harkov
896,885,68,396,445,55,500,0,500,8,457,35,22.04.2019 00:10,179,18,Harkov
912,902,76,363,478,71,549,0,549,6,500,43,22.04.2019 00:10,179,18,Harkov
1760,1741,73,584,1116,60,1176,0,1176,24,1083,69,21.04.2019 20:56,179,18,Harkov
832,828,34,323,483,26,509,0,509,7,476,26,22.04.2019 00:05,179,18,Harkov
688,664,90,242,361,85,446,0,446,4,421,21,21.04.2019 21:50,179,18,Harkov
736,727,50,243,443,50,493,0,493,8,470,15,22.04.2019 00:03,179,18,Harkov
1264,1242,57,450,770,44,814,0,814,10,773,31,22.04.2019 00:05,179,18,Harkov
352,337,20,102,232,18,250,0,250,3,224,23,22.04.2019 00:15,179,18,Harkov
1552,1532,35,589,938,25,963,0,963,11,918,34,21.04.2019 23:45,179,18,Harkov
1632,1594,28,549,1058,25,1083,0,1083,10,1005,68,21.04.2019 22:15,179,18,Harkov
1040,1019,19,402,622,16,638,0,638,4,617,17,21.04.2019 23:00,179,18,Harkov
192,179,2,33,157,2,159,0,159,1,134,24,21.04.2019 20:26,179,18,Harkov
1040,1024,25,386,633,21,654,0,654,8,600,46,21.04.2019 21:00,179,18,Harkov
208,204,16,83,111,14,125,0,125,1,106,18,22.04.2019 00:35,179,18,Harkov
320,312,21,90,211,19,230,0,230,0,224,6,22.04.2019 00:05,179,18,Harkov
640,635,35,229,381,30,411,0,411,7,379,25,22.04.2019 00:03,179,18,Harkov
176,171,10,57,109,10,119,0,119,0,112,7,21.04.2019 21:30,179,18,Harkov
176,167,9,59,110,7,117,0,117,2,110,5,21.04.2019 20:56,179,18,Harkov
240,45,26,197,19,24,43,0,43,0,39,4,21.04.2019 20:40,179,18,Harkov
288,285,9,108,172,8,180,0,180,2,156,22,22.04.2019 00:10,179,18,Harkov
336,325,1,157,178,1,179,0,179,0,156,23,21.04.2019 21:20,179,18,Harkov
464,455,36,179,250,35,285,0,285,1,252,32,21.04.2019 20:45,179,18,Harkov
192,183,6,82,105,5,110,0,110,2,81,27,22.04.2019 01:30,179,18,Harkov
128,126,5,49,74,5,79,0,79,3,50,26,21.04.2019 20:55,179,18,Harkov
464,444,2,209,254,1,255,0,255,5,233,17,21.04.2019 23:40,179,18,Harkov
160,147,5,70,86,4,90,0,90,0,76,14,21.04.2019 21:00,179,18,Harkov
128,123,0,52,76,0,76,0,76,3,60,13,21.04.2019 21:00,179,18,Harkov
512,507,22,215,275,22,297,0,297,1,253,43,21.04.2019 20:40,179,18,Harkov
224,220,10,100,114,10,124,0,124,3,110,11,22.04.2019 00:08,179,18,Harkov
512,499,1,209,302,1,303,0,303,6,248,49,22.04.2019 00:03,179,18,Harkov
192,177,0,88,104,0,104,0,104,0,91,13,21.04.2019 21:00,179,18,Harkov
752,743,9,371,372,9,381,0,381,5,346,30,22.04.2019 04:15,179,18,Harkov
576,553,17,262,299,15,314,0,314,6,270,38,22.04.2019 00:08,179,18,Harkov
368,352,1,178,189,1,190,0,190,2,156,32,22.04.2019 00:05,179,18,Harkov
176,166,0,91,85,0,85,0,85,0,69,16,21.04.2019 20:30,179,18,Harkov
688,677,32,277,380,31,411,0,411,2,354,55,21.04.2019 22:00,179,18,Harkov
416,399,30,165,225,26,251,0,251,4,234,13,21.04.2019 20:50,179,18,Harkov
208,203,9,81,118,9,127,0,127,0,112,15,21.04.2019 23:57,179,18,Harkov
176,167,9,80,87,9,96,0,96,0,89,7,22.04.2019 00:05,179,18,Harkov
608,594,4,262,343,3,346,0,346,4,320,22,21.04.2019 20:50,179,18,Harkov
848,821,7,410,431,7,438,0,438,7,398,33,22.04.2019 00:35,179,18,Harkov
176,161,0,96,80,0,80,0,80,1,72,7,22.04.2019 00:15,179,18,Harkov
432,425,6,163,263,6,269,0,269,7,246,16,22.04.2019 00:10,179,18,Harkov
1328,1297,12,530,786,12,798,0,798,14,722,62,21.04.2019 21:30,179,18,Harkov
896,881,10,390,496,10,506,0,506,5,453,48,21.04.2019 21:33,179,18,Harkov
1360,1336,14,622,726,12,738,0,738,13,674,51,21.04.2019 21:43,179,18,Harkov
816,801,24,384,410,22,432,0,432,6,390,36,21.04.2019 21:55,179,18,Harkov
1456,1426,27,491,942,23,965,0,965,30,833,102,22.04.2019 00:05,179,18,Harkov
800,784,15,356,430,14,444,0,444,6,408,30,22.04.2019 00:15,179,18,Harkov
1744,1710,28,645,1080,19,1099,0,1099,19,964,116,22.04.2019 00:35,179,18,Harkov
1472,1439,19,608,847,17,864,0,864,19,792,53,21.04.2019 22:37,179,18,Harkov
1616,1580,10,578,1030,8,1038,0,1038,20,932,86,22.04.2019 00:10,179,18,Harkov
2080,2031,16,879,1190,11,1201,0,1201,27,1093,81,22.04.2019 00:16,179,18,Harkov
752,733,12,309,432,11,443,0,443,6,409,28,21.04.2019 21:00,179,18,Harkov
1072,1041,15,474,587,11,598,0,598,13,540,45,22.04.2019 00:10,179,18,Harkov
1808,1774,46,703,1071,34,1105,0,1105,18,1020,67,22.04.2019 01:10,179,18,Harkov
1536,1497,27,649,862,25,887,0,887,16,810,61,22.04.2019 00:05,179,18,Harkov
912,885,7,419,487,6,493,0,493,8,430,55,22.04.2019 01:00,179,18,Harkov
816,805,11,368,441,7,448,0,448,4,413,31,22.04.2019 00:45,179,18,Harkov
256,259,2,99,155,2,157,0,157,1,145,11,22.04.2019 00:37,179,18,Harkov
192,66,15,130,48,14,62,0,62,0,56,6,22.04.2019 00:30,179,18,Harkov
1184,1163,24,512,654,18,672,0,672,8,593,71,22.04.2019 00:10,180,18,Harkov
1744,1714,42,648,1059,37,1096,0,1096,15,988,93,22.04.2019 00:25,180,18,Harkov
1648,1623,38,633,986,29,1015,0,1015,19,901,95,22.04.2019 00:25,180,18,Harkov
1184,1189,19,414,753,17,770,0,770,12,679,79,22.04.2019 00:25,180,18,Harkov
1696,1679,81,612,1014,70,1084,0,1084,12,961,111,22.04.2019 00:55,180,18,Harkov
1344,1310,28,603,716,25,741,0,741,17,681,43,22.04.2019 00:20,180,18,Harkov
1728,1692,45,692,1004,32,1036,0,1036,18,931,87,22.04.2019 00:15,180,18,Harkov
624,620,19,206,400,18,418,0,418,5,353,60,22.04.2019 00:30,180,18,Harkov
1024,991,7,401,616,7,623,0,623,4,581,38,22.04.2019 02:00,180,18,Harkov
304,300,30,133,148,23,171,0,171,2,144,25,22.04.2019 00:15,180,18,Harkov
288,279,31,101,159,28,187,0,187,3,169,15,22.04.2019 00:40,180,18,Harkov
1040,1017,53,383,609,48,657,0,657,8,568,81,22.04.2019 00:20,180,18,Harkov
352,337,27,160,171,21,192,0,192,1,157,34,22.04.2019 00:20,180,18,Harkov
240,231,15,102,125,13,138,0,138,3,115,20,22.04.2019 00:32,180,18,Harkov
272,265,14,114,144,14,158,0,158,3,136,19,22.04.2019 00:12,180,18,Harkov
608,590,19,257,333,18,351,0,351,5,306,40,22.04.2019 00:10,180,18,Harkov
416,407,34,165,218,33,251,0,251,1,203,47,22.04.2019 00:10,180,18,Harkov
464,473,13,182,270,12,282,0,282,3,252,27,22.04.2019 00:30,180,18,Harkov
336,325,16,134,190,12,202,0,202,1,183,18,22.04.2019 00:02,180,18,Harkov
720,709,7,373,343,4,347,0,347,4,318,25,22.04.2019 00:05,180,18,Harkov
336,316,4,160,172,4,176,0,176,3,157,16,22.04.2019 00:20,180,18,Harkov
768,749,27,299,445,24,469,0,469,6,418,45,22.04.2019 01:50,180,18,Harkov
816,799,15,320,482,14,496,0,496,4,442,50,22.04.2019 00:10,180,18,Harkov
576,561,16,231,332,13,345,0,345,6,325,14,22.04.2019 00:10,180,18,Harkov
464,445,25,175,266,23,289,0,289,7,264,18,22.04.2019 00:20,180,18,Harkov
672,656,36,285,358,29,387,0,387,6,334,47,22.04.2019 00:40,180,18,Harkov
400,390,5,167,229,4,233,0,233,1,207,25,22.04.2019 00:55,180,18,Harkov
528,522,48,250,244,34,278,0,278,4,240,34,22.04.2019 00:15,180,18,Harkov
208,205,14,102,92,14,106,0,106,1,93,12,22.04.2019 02:18,180,18,Harkov
320,315,1,151,169,0,169,0,169,1,156,12,22.04.2019 02:30,180,18,Harkov
320,308,10,118,192,10,202,0,202,2,127,73,22.04.2019 00:15,180,18,Harkov
240,231,11,52,180,8,188,0,188,1,135,52,22.04.2019 01:30,180,18,Harkov
432,416,21,161,252,19,271,0,271,4,247,20,22.04.2019 00:05,180,18,Harkov
352,380,16,87,250,15,265,0,265,3,212,50,22.04.2019 00:30,180,18,Harkov
1360,1330,54,633,685,42,727,0,727,14,639,74,22.04.2019 02:20,180,18,Harkov
1184,1167,30,579,581,24,605,0,605,15,545,45,22.04.2019 00:42,180,18,Harkov
1632,1612,28,670,938,24,962,0,962,9,885,68,22.04.2019 00:45,180,18,Harkov
880,867,14,326,543,11,554,0,554,8,503,43,22.04.2019 00:15,180,18,Harkov
832,824,25,326,484,22,506,0,506,8,446,52,22.04.2019 00:10,180,18,Harkov
1184,1160,75,591,532,61,593,0,593,9,541,43,22.04.2019 01:30,180,18,Harkov
800,779,59,310,437,53,490,0,490,11,419,60,22.04.2019 01:30,180,18,Harkov
304,299,26,103,177,24,201,0,201,6,176,19,22.04.2019 00:10,180,18,Harkov
736,717,51,339,352,45,397,0,397,9,368,20,22.04.2019 00:45,180,18,Harkov
480,474,20,178,285,17,302,0,302,4,271,27,22.04.2019 00:10,180,18,Harkov
784,762,56,306,426,52,478,0,478,5,435,38,22.04.2019 00:15,180,18,Harkov
384,387,8,133,246,5,251,0,251,3,208,40,22.04.2019 00:20,180,18,Harkov
624,613,37,259,329,36,365,0,365,8,303,54,21.04.2019 20:59,180,18,Harkov
1456,1440,49,535,880,41,921,0,921,8,804,109,22.04.2019 00:05,180,18,Harkov
176,29,7,148,21,7,28,0,28,0,21,7,22.04.2019 00:20,180,18,Harkov
1792,1759,34,705,1058,29,1087,0,1087,11,977,99,22.04.2019 00:15,180,18,Harkov
1424,1414,30,530,868,26,894,0,894,18,779,97,21.04.2019 21:48,180,18,Harkov
1616,1606,21,590,1009,17,1026,0,1026,12,910,104,22.04.2019 00:10,180,18,Harkov
2080,2072,20,744,1318,18,1336,0,1336,33,1173,130,22.04.2019 00:05,180,18,Harkov
1360,1330,22,554,786,20,806,0,806,17,740,49,22.04.2019 00:12,180,18,Harkov
944,930,12,407,527,10,537,0,537,8,497,32,22.04.2019 00:45,180,18,Harkov
256,253,15,135,111,10,121,0,121,0,104,17,22.04.2019 00:03,180,18,Harkov
368,364,16,123,234,11,245,0,245,6,210,29,22.04.2019 01:30,180,18,Harkov
304,302,18,118,170,16,186,0,186,4,154,28,22.04.2019 00:20,180,18,Harkov
224,223,8,83,137,4,141,0,141,1,131,9,22.04.2019 00:10,180,18,Harkov
272,274,37,114,124,34,158,0,158,0,151,7,22.04.2019 00:30,180,18,Harkov
176,163,16,76,85,15,100,0,100,3,88,9,22.04.2019 00:20,180,18,Harkov
1040,1026,22,390,632,18,650,0,650,11,586,53,22.04.2019 00:10,180,18,Harkov
528,528,30,234,268,26,294,0,294,4,274,16,22.04.2019 00:10,180,18,Harkov
192,180,5,110,80,2,82,0,82,2,65,15,22.04.2019 00:04,180,18,Harkov
592,581,21,255,318,19,337,0,337,7,268,62,22.04.2019 00:24,180,18,Harkov
416,414,41,165,217,34,251,0,251,1,159,91,22.04.2019 00:10,180,18,Harkov
816,807,31,405,387,24,411,0,411,6,367,38,22.04.2019 00:20,180,18,Harkov
880,868,57,443,404,33,437,0,437,3,409,25,22.04.2019 00:45,180,18,Harkov
752,730,32,305,421,26,447,0,447,10,399,38,22.04.2019 00:10,180,18,Harkov
1360,1334,58,576,733,51,784,0,784,13,718,53,22.04.2019 00:15,180,18,Harkov
768,743,163,236,376,156,532,0,532,7,389,136,22.04.2019 00:25,180,18,Harkov
384,377,14,183,189,12,201,0,201,3,181,17,22.04.2019 00:45,180,18,Harkov
80,76,22,29,35,16,51,0,51,2,32,17,22.04.2019 00:15,180,18,Harkov
272,261,3,115,157,0,157,0,157,1,118,38,22.04.2019 00:15,180,18,Harkov
352,350,14,129,210,13,223,0,223,1,195,27,22.04.2019 00:10,180,18,Harkov
832,823,67,401,372,59,431,0,431,2,397,32,22.04.2019 00:10,180,18,Harkov
1296,1271,61,570,669,57,726,0,726,16,662,48,22.04.2019 00:28,180,18,Harkov
1008,1000,34,393,588,27,615,0,615,9,564,42,22.04.2019 00:30,180,18,Harkov
1040,1009,15,457,568,15,583,0,583,6,524,53,22.04.2019 00:35,180,18,Harkov
832,801,19,338,479,15,494,0,494,14,421,59,22.04.2019 00:15,180,18,Harkov
944,911,23,402,523,19,542,0,542,5,485,52,22.04.2019 00:20,180,18,Harkov
288,283,26,113,150,25,175,0,175,1,162,12,22.04.2019 00:25,180,18,Harkov
672,660,45,294,333,45,378,0,378,9,316,53,22.04.2019 00:55,180,18,Harkov
176,161,26,80,71,25,96,0,96,2,75,19,22.04.2019 00:25,180,18,Harkov
1488,1479,53,646,795,47,842,0,842,20,748,74,22.04.2019 00:40,180,18,Harkov
144,138,13,61,73,10,83,0,83,1,70,12,22.04.2019 00:50,180,18,Harkov
288,270,28,109,151,28,179,0,179,5,158,16,22.04.2019 01:20,180,18,Harkov
48,19,0,29,19,0,19,0,19,0,17,2,22.04.2019 00:15,180,18,Harkov
176,169,15,59,103,14,117,0,117,0,109,8,22.04.2019 00:45,180,18,Harkov
512,500,37,221,260,31,291,0,291,4,243,44,22.04.2019 00:40,180,18,Harkov
896,874,32,384,481,31,512,0,512,11,449,52,21.04.2019 23:05,180,18,Harkov
368,353,19,99,250,19,269,0,269,6,207,56,22.04.2019 01:05,180,18,Harkov
704,684,17,306,385,13,398,0,398,4,349,45,22.04.2019 02:20,180,18,Harkov
624,610,48,256,324,44,368,0,368,3,325,40,22.04.2019 00:50,180,18,Harkov
240,226,10,81,149,10,159,0,159,1,146,12,22.04.2019 01:15,180,18,Harkov
544,525,40,229,278,37,315,0,315,1,268,46,22.04.2019 01:50,180,18,Harkov
608,615,40,187,381,40,421,0,421,8,351,62,22.04.2019 00:30,180,18,Harkov
176,173,12,75,92,9,101,0,101,0,78,23,22.04.2019 00:20,180,18,Harkov
432,423,31,131,273,28,301,0,301,3,254,44,22.04.2019 00:10,180,18,Harkov
1264,1229,64,565,638,61,699,0,699,10,644,45,22.04.2019 01:20,180,18,Harkov
1424,1382,39,696,694,34,728,0,728,16,645,67,22.04.2019 00:20,180,18,Harkov
112,30,9,82,21,9,30,0,30,0,17,13,22.04.2019 00:30,180,18,Harkov
576,561,42,278,259,39,298,0,298,2,273,23,22.04.2019 00:05,180,18,Harkov
1616,1603,6,578,1033,5,1038,0,1038,11,914,113,22.04.2019 00:11,180,18,Harkov
1296,1284,15,471,813,12,825,0,825,12,728,85,22.04.2019 01:50,180,18,Harkov
2400,2384,22,933,1447,20,1467,0,1467,28,1296,143,22.04.2019 00:05,180,18,Harkov
1712,1686,23,648,1045,19,1064,0,1064,20,941,103,22.04.2019 00:07,180,18,Harkov
1984,1958,33,816,1139,29,1168,0,1168,21,1074,73,22.04.2019 00:17,180,18,Harkov
272,261,42,96,138,38,176,0,176,1,151,24,22.04.2019 00:45,180,18,Harkov
384,374,16,178,191,15,206,0,206,5,169,32,22.04.2019 00:20,180,18,Harkov
720,706,44,300,379,41,420,0,420,1,371,48,22.04.2019 00:15,180,18,Harkov
480,472,60,179,248,53,301,0,301,7,271,23,22.04.2019 00:10,180,18,Harkov
304,293,23,147,136,21,157,0,157,4,143,10,22.04.2019 00:10,180,18,Harkov
336,328,21,186,136,14,150,0,150,1,124,25,22.04.2019 00:10,180,18,Harkov
480,462,40,195,248,37,285,0,285,6,262,17,22.04.2019 01:10,180,18,Harkov
560,546,27,234,302,24,326,0,326,0,303,23,22.04.2019 00:30,180,18,Harkov
576,562,16,298,263,15,278,0,278,0,264,14,22.04.2019 00:30,180,18,Harkov
704,695,25,290,389,25,414,0,414,5,388,21,22.04.2019 00:20,180,18,Harkov
288,278,5,128,156,4,160,0,160,1,147,12,22.04.2019 00:30,180,18,Harkov
288,281,8,175,106,7,113,0,113,5,94,14,22.04.2019 00:40,180,18,Harkov
624,614,27,269,332,23,355,0,355,3,314,38,22.04.2019 00:10,180,18,Harkov
752,735,18,304,431,17,448,0,448,10,405,33,22.04.2019 01:55,180,18,Harkov
224,218,6,86,132,6,138,0,138,2,121,15,22.04.2019 01:25,180,18,Harkov
480,468,65,207,216,57,273,0,273,2,256,15,22.04.2019 00:10,180,18,Harkov
448,445,57,168,224,56,280,0,280,8,261,11,22.04.2019 01:10,180,18,Harkov
352,336,55,122,175,55,230,0,230,2,217,11,22.04.2019 00:15,180,18,Harkov
128,114,9,59,63,6,69,0,69,0,59,10,22.04.2019 02:02,180,18,Harkov
96,80,13,40,43,13,56,0,56,0,54,2,22.04.2019 00:40,180,18,Harkov
560,553,31,198,337,25,362,0,362,4,321,37,22.04.2019 00:15,180,18,Harkov
160,20,6,140,14,6,20,0,20,1,16,3,22.04.2019 01:25,180,18,Harkov
1344,1333,30,544,771,29,800,0,800,11,730,59,22.04.2019 00:10,180,18,Harkov
1392,1365,66,583,749,60,809,0,809,5,749,55,22.04.2019 00:30,180,18,Harkov
560,542,23,185,352,23,375,0,375,6,346,23,22.04.2019 00:05,180,18,Harkov
1728,1716,25,612,1096,20,1116,0,1116,24,983,109,21.04.2019 22:00,181,18,Harkov
1856,1841,335,541,997,318,1315,0,1315,27,1043,245,21.04.2019 21:40,181,18,Harkov
1840,1820,18,698,1124,18,1142,0,1142,17,1034,91,21.04.2019 21:44,181,18,Harkov
1856,1834,22,611,1226,19,1245,0,1245,26,1079,140,21.04.2019 21:40,181,18,Harkov
2000,1977,29,650,1323,27,1350,0,1350,25,1199,126,21.04.2019 21:30,181,18,Harkov
1936,1908,22,704,1213,19,1232,0,1232,23,1086,123,21.04.2019 21:38,181,18,Harkov
2000,1977,12,785,1205,10,1215,0,1215,24,1091,100,21.04.2019 21:43,181,18,Harkov
992,971,14,355,624,13,637,0,637,18,566,53,21.04.2019 20:55,181,18,Harkov
2208,2178,40,792,1388,28,1416,0,1416,27,1270,119,21.04.2019 21:53,181,18,Harkov
1248,1232,36,536,679,33,712,0,712,18,646,48,22.04.2019 00:15,181,18,Harkov
1824,1803,21,579,1224,21,1245,0,1245,28,1123,94,22.04.2019 00:30,181,18,Harkov
1872,1850,24,632,1228,12,1240,0,1240,25,1113,102,21.04.2019 23:10,181,18,Harkov
1936,1918,26,692,1225,19,1244,0,1244,13,1149,82,21.04.2019 21:35,181,18,Harkov
1952,1919,30,694,1235,23,1258,0,1258,30,1141,87,21.04.2019 22:00,181,18,Harkov
1904,1887,15,630,1264,10,1274,0,1274,27,1131,116,22.04.2019 00:05,181,18,Harkov
1872,1855,20,621,1238,13,1251,0,1251,20,1151,80,21.04.2019 22:10,181,18,Harkov
1312,1286,14,525,775,12,787,0,787,4,734,49,22.04.2019 00:10,181,18,Harkov
400,382,10,189,201,10,211,0,211,1,188,22,22.04.2019 00:15,181,18,Harkov
2064,2030,52,753,1284,27,1311,0,1311,20,1130,161,22.04.2019 00:33,181,18,Harkov
2080,2049,70,933,1094,53,1147,0,1147,17,1005,125,22.04.2019 00:20,181,18,Harkov
560,550,13,153,395,12,407,0,407,6,387,14,22.04.2019 00:07,181,18,Harkov
784,765,35,268,481,35,516,0,516,3,492,21,22.04.2019 00:10,181,18,Harkov
832,822,35,316,481,35,516,0,516,8,490,18,21.04.2019 23:30,181,18,Harkov
576,569,24,222,331,23,354,0,354,3,335,16,22.04.2019 00:30,181,18,Harkov
224,210,8,106,113,5,118,0,118,1,104,13,22.04.2019 00:15,181,18,Harkov
304,288,19,132,153,19,172,0,172,3,141,28,22.04.2019 00:20,181,18,Harkov
432,414,25,169,238,25,263,0,263,2,249,12,22.04.2019 00:10,181,18,Harkov
1264,1238,27,494,746,24,770,0,770,7,722,41,22.04.2019 00:35,181,18,Harkov
848,833,17,315,516,17,533,0,533,15,487,31,22.04.2019 00:15,181,18,Harkov
464,470,11,186,270,8,278,0,278,5,257,16,22.04.2019 00:15,181,18,Harkov
672,671,47,218,419,35,454,0,454,2,406,46,22.04.2019 00:03,181,18,Harkov
176,175,10,60,107,9,116,0,116,0,94,22,22.04.2019 00:35,181,18,Harkov
1760,1726,51,693,1023,44,1067,0,1067,20,956,91,21.04.2019 23:10,181,18,Harkov
1152,1124,35,408,719,25,744,0,744,11,643,90,22.04.2019 00:20,181,18,Harkov
448,444,22,176,255,17,272,0,272,1,245,26,22.04.2019 00:20,181,18,Harkov
368,352,19,122,232,14,246,0,246,4,210,32,22.04.2019 00:20,181,18,Harkov
992,978,48,429,525,38,563,0,563,9,519,35,22.04.2019 00:23,181,18,Harkov
1152,1117,30,565,563,24,587,0,587,9,482,96,22.04.2019 00:23,181,18,Harkov
2192,2166,61,915,1221,56,1277,0,1277,26,1165,86,22.04.2019 00:02,181,18,Harkov
1952,1905,51,936,978,38,1016,0,1016,18,945,53,22.04.2019 00:15,181,18,Harkov
224,209,2,103,119,2,121,0,121,3,116,2,22.04.2019 00:10,181,18,Harkov
816,798,29,262,528,26,554,0,554,4,497,53,22.04.2019 00:20,181,18,Harkov
224,218,4,88,133,3,136,0,136,2,120,14,22.04.2019 00:05,181,18,Harkov
1776,1779,62,612,1116,48,1164,0,1164,11,1044,109,22.04.2019 01:05,181,18,Harkov
736,724,21,335,382,19,401,0,401,4,363,34,21.04.2019 22:40,181,18,Harkov
496,484,31,103,364,29,393,0,393,7,330,56,21.04.2019 21:30,181,18,Harkov
1920,1874,24,799,1104,17,1121,0,1121,16,1004,101,22.04.2019 00:15,181,18,Harkov
224,40,26,187,12,25,37,0,37,0,32,5,21.04.2019 20:15,181,18,Harkov
2256,2230,12,917,1328,11,1339,0,1339,24,1166,149,22.04.2019 00:05,181,18,Harkov
1792,1766,23,676,1098,18,1116,0,1116,21,974,121,22.04.2019 00:05,181,18,Harkov
2144,2111,7,909,1230,5,1235,0,1235,31,1077,127,21.04.2019 22:15,181,18,Harkov
1983,1967,12,742,1232,9,1241,0,1241,18,1098,125,21.04.2019 22:05,181,18,Harkov
2320,2288,10,974,1340,6,1346,0,1346,20,1216,110,21.04.2019 22:50,181,18,Harkov
2256,2220,6,1055,1196,5,1201,0,1201,15,1075,111,22.04.2019 00:50,181,18,Harkov
1888,1865,14,802,1076,10,1086,0,1086,27,961,98,22.04.2019 00:15,181,18,Harkov
1248,1228,8,524,718,6,724,0,724,11,628,85,21.04.2019 22:00,181,18,Harkov
2144,2122,21,881,1247,16,1263,0,1263,12,1150,101,22.04.2019 00:05,181,18,Harkov
2160,2129,8,857,1295,8,1303,0,1303,22,1185,96,22.04.2019 00:07,181,18,Harkov
1184,1166,6,379,802,3,805,0,805,26,699,80,22.04.2019 00:10,181,18,Harkov
1824,1802,29,655,1146,23,1169,0,1169,18,1044,107,22.04.2019 00:05,181,18,Harkov
1872,1852,38,653,1188,31,1219,0,1219,15,1094,110,22.04.2019 01:30,181,18,Harkov
1808,1786,52,565,1205,38,1243,0,1243,27,1085,131,21.04.2019 23:05,181,18,Harkov
2096,2076,14,803,1287,6,1293,0,1293,25,1188,80,22.04.2019 00:30,181,18,Harkov
1776,1765,13,592,1173,11,1184,0,1184,16,1079,89,22.04.2019 00:31,181,18,Harkov
1968,1955,13,696,1260,12,1272,0,1272,17,1165,90,22.04.2019 00:15,181,18,Harkov
1728,1716,13,655,1063,10,1073,0,1073,16,978,79,22.04.2019 00:15,181,18,Harkov
1264,1246,28,436,808,20,828,0,828,18,733,77,22.04.2019 00:07,181,18,Harkov
1680,1666,26,667,993,20,1013,0,1013,62,896,55,22.04.2019 00:50,181,18,Harkov
1792,1776,26,628,1139,25,1164,0,1164,20,1076,68,22.04.2019 00:20,181,18,Harkov
1760,1741,25,678,1059,23,1082,0,1082,15,975,92,22.04.2019 00:30,181,18,Harkov
128,116,0,60,68,0,68,0,68,2,58,8,22.04.2019 00:10,181,18,Harkov
2352,2326,14,883,1455,14,1469,0,1469,38,1349,82,22.04.2019 00:15,181,18,Harkov
2208,2192,17,840,1355,13,1368,0,1368,17,1279,72,22.04.2019 00:02,181,18,Harkov
1600,1590,12,648,942,10,952,0,952,16,857,79,22.04.2019 00:02,181,18,Harkov
1264,1234,6,494,767,3,770,0,770,11,665,94,22.04.2019 00:10,181,18,Harkov
1424,1423,13,625,789,10,799,0,799,20,714,65,22.04.2019 00:11,181,18,Harkov
1264,1242,9,536,722,6,728,0,728,20,582,126,22.04.2019 00:20,181,18,Harkov
1952,1945,18,709,1226,17,1243,0,1243,35,1101,107,22.04.2019 00:05,181,18,Harkov
1680,1673,13,613,1055,12,1067,0,1067,17,940,110,22.04.2019 00:19,181,18,Harkov
928,908,7,356,569,3,572,0,572,8,486,78,22.04.2019 00:10,181,18,Harkov
1632,1609,25,673,939,20,959,0,959,16,836,107,22.04.2019 00:05,181,18,Harkov
1888,1860,11,739,1143,6,1149,0,1149,26,972,151,22.04.2019 00:10,181,18,Harkov
1808,1776,18,736,1054,18,1072,0,1072,23,971,78,22.04.2019 00:07,181,18,Harkov
832,825,62,328,446,58,504,0,504,33,427,44,22.04.2019 00:30,181,18,Harkov
1888,1865,27,599,1265,24,1289,0,1289,30,1169,90,22.04.2019 00:20,181,18,Harkov
1936,1910,47,711,1182,43,1225,0,1225,22,1128,75,21.04.2019 23:05,181,18,Harkov
1984,1972,29,662,1294,28,1322,0,1322,12,1192,118,22.04.2019 00:10,181,18,Harkov
1808,1784,11,610,1191,7,1198,0,1198,17,1086,95,22.04.2019 00:09,181,18,Harkov
1104,1089,13,392,700,12,712,0,712,15,655,42,22.04.2019 00:24,181,18,Harkov
624,612,33,207,392,25,417,0,417,6,372,39,22.04.2019 00:05,181,18,Harkov
304,280,21,89,196,19,215,0,215,3,183,29,22.04.2019 00:05,181,18,Harkov
1744,1723,11,657,1076,11,1087,0,1087,31,980,76,22.04.2019 00:32,181,18,Harkov
1376,1364,5,502,869,5,874,0,874,27,748,99,22.04.2019 00:10,181,18,Harkov
2096,2091,11,740,1348,8,1356,0,1356,23,1156,177,22.04.2019 00:38,181,18,Harkov
1840,1825,15,712,1115,13,1128,0,1128,19,982,127,21.04.2019 22:10,181,18,Harkov
1792,1753,26,583,1187,22,1209,0,1209,17,1100,92,22.04.2019 01:00,181,18,Harkov
2224,2198,63,768,1415,41,1456,0,1456,23,1325,108,22.04.2019 01:55,181,18,Harkov
1504,1492,1,584,919,1,920,0,920,19,821,80,22.04.2019 00:05,181,18,Harkov
2144,2120,20,762,1369,13,1382,0,1382,34,1194,154,22.04.2019 00:05,181,18,Harkov
992,954,1,477,514,1,515,0,515,5,470,40,22.04.2019 00:40,181,18,Harkov
1056,1035,14,339,704,13,717,0,717,11,667,39,22.04.2019 00:20,181,18,Harkov
256,248,3,135,119,2,121,0,121,2,111,8,22.04.2019 00:05,181,18,Harkov
176,168,2,88,86,2,88,0,88,2,84,2,21.04.2019 22:30,181,18,Harkov
2160,2154,53,732,1391,37,1428,0,1428,27,1251,150,22.04.2019 00:20,181,18,Harkov
1504,1483,131,500,881,123,1004,0,1004,32,866,106,22.04.2019 00:30,181,18,Harkov
224,35,9,190,26,8,34,0,34,0,32,2,22.04.2019 00:15,181,18,Harkov
992,881,0,111,881,0,881,0,881,21,761,99,21.04.2019 22:40,181,18,Harkov
144,112,0,33,111,0,111,0,111,2,103,6,22.04.2019 00:10,181,18,Harkov
432,430,0,2,430,0,430,0,430,44,377,9,22.04.2019 00:07,182,19,Herson
32,17,0,15,17,0,17,0,17,0,14,3,21.04.2019 21:00,182,19,Herson
128,88,0,40,88,0,88,0,88,5,76,7,22.04.2019 00:10,182,19,Herson
1312,1307,5,533,776,3,779,0,779,17,638,124,22.04.2019 00:22,182,19,Herson
1872,1855,8,791,1074,7,1081,0,1081,21,915,145,22.04.2019 00:23,182,19,Herson
1888,1866,8,875,1012,1,1013,0,1013,15,831,167,22.04.2019 00:45,182,19,Herson
1856,1842,8,704,1146,6,1152,0,1152,24,946,182,22.04.2019 00:52,182,19,Herson
1200,1185,4,435,763,2,765,0,765,15,607,143,22.04.2019 00:04,182,19,Herson
1904,1873,5,751,1151,2,1153,0,1153,27,921,205,22.04.2019 00:05,182,19,Herson
960,952,4,427,532,1,533,0,533,10,420,103,22.04.2019 00:17,182,19,Herson
1136,1118,5,427,704,5,709,0,709,19,567,123,22.04.2019 00:30,182,19,Herson
1104,1144,4,417,684,3,687,0,687,13,550,124,22.04.2019 00:15,182,19,Herson
2112,2103,6,796,1311,5,1316,0,1316,30,1077,209,22.04.2019 00:01,182,19,Herson
2080,2070,17,866,1201,13,1214,0,1214,25,945,244,22.04.2019 00:20,182,19,Herson
1808,1786,11,765,1035,8,1043,0,1043,37,814,192,22.04.2019 00:10,182,19,Herson
1424,1426,6,651,770,3,773,0,773,12,642,119,22.04.2019 00:10,182,19,Herson
2112,2083,13,842,1257,13,1270,0,1270,36,1029,205,22.04.2019 00:30,182,19,Herson
1582,1552,9,721,856,5,861,0,861,17,694,150,22.04.2019 00:35,182,19,Herson
2016,2006,8,903,1107,6,1113,0,1113,24,904,185,22.04.2019 00:05,182,19,Herson
1232,1206,2,566,665,1,666,0,666,17,539,110,22.04.2019 00:08,182,19,Herson
1328,1302,8,543,780,5,785,0,785,17,624,144,22.04.2019 00:01,182,19,Herson
2128,2127,2,943,1184,1,1185,0,1185,23,979,183,22.04.2019 00:58,182,19,Herson
1840,1821,4,875,961,4,965,0,965,16,796,153,22.04.2019 00:15,182,19,Herson
1712,1681,9,784,922,6,928,0,928,17,741,170,22.04.2019 00:30,182,19,Herson
1360,1352,10,520,831,9,840,0,840,23,665,152,21.04.2019 21:22,182,19,Herson
1696,1676,14,673,1012,11,1023,0,1023,36,791,196,22.04.2019 00:10,182,19,Herson
2144,2126,14,871,1260,13,1273,0,1273,25,1029,219,21.04.2019 21:10,182,19,Herson
2128,2125,8,771,1352,5,1357,0,1357,31,1067,259,22.04.2019 00:09,182,19,Herson
2144,2108,5,856,1284,4,1288,0,1288,22,1037,229,22.04.2019 01:10,182,19,Herson
2304,2271,14,940,1353,11,1364,0,1364,26,1093,245,22.04.2019 00:40,182,19,Herson
1328,1325,5,610,715,3,718,0,718,17,596,105,22.04.2019 00:05,182,19,Herson
2160,2143,9,854,1298,8,1306,0,1306,17,1087,202,22.04.2019 00:06,182,19,Herson
1648,1640,4,709,937,2,939,0,939,19,764,156,22.04.2019 00:10,182,19,Herson
1712,1702,14,663,1040,9,1049,0,1049,33,868,148,22.04.2019 00:44,182,19,Herson
1872,1845,9,778,1086,8,1094,0,1094,28,890,176,22.04.2019 00:11,182,19,Herson
1488,1471,3,687,798,3,801,0,801,6,684,111,22.04.2019 01:05,182,19,Herson
1632,1608,5,720,907,5,912,0,912,17,787,108,22.04.2019 00:55,182,19,Herson
1392,1388,5,611,776,5,781,0,781,16,678,87,22.04.2019 04:01,182,19,Herson
384,365,0,172,212,0,212,0,212,2,171,39,21.04.2019 20:20,182,19,Herson
240,228,1,145,94,1,95,0,95,0,80,15,21.04.2019 21:30,182,19,Herson
560,560,1,189,370,1,371,0,371,9,301,61,22.04.2019 00:05,182,19,Herson
512,109,60,404,49,59,108,0,108,2,91,15,22.04.2019 00:15,182,19,Herson
224,49,0,180,44,0,44,0,44,0,35,9,22.04.2019 00:12,182,19,Herson
96,9,0,87,9,0,9,0,9,0,6,3,22.04.2019 00:10,182,19,Herson
2320,2318,26,973,1326,21,1347,0,1347,20,1087,240,22.04.2019 00:15,182,19,Herson
1904,1950,6,723,1176,5,1181,0,1181,34,880,267,22.04.2019 00:56,182,19,Herson
1680,1655,5,633,1044,3,1047,0,1047,25,818,204,21.04.2019 23:10,182,19,Herson
2032,2031,15,862,1161,9,1170,0,1170,38,930,202,22.04.2019 02:53,182,19,Herson
2144,2117,17,796,1331,17,1348,0,1348,35,1056,257,22.04.2019 00:27,182,19,Herson
2144,2129,12,884,1249,11,1260,0,1260,25,997,238,22.04.2019 04:18,182,19,Herson
2320,2301,22,904,1406,10,1416,0,1416,31,1134,251,22.04.2019 00:10,182,19,Herson
2096,2101,16,802,1281,13,1294,0,1293,26,1033,234,22.04.2019 00:30,182,19,Herson
2032,2042,20,804,1214,14,1228,0,1228,19,959,250,22.04.2019 00:25,182,19,Herson
1904,1897,8,827,1072,5,1077,0,1077,14,879,184,21.04.2019 22:21,182,19,Herson
1408,1433,4,535,872,1,873,0,873,25,679,169,21.04.2019 21:35,182,19,Herson
1424,1522,9,523,893,8,901,0,901,26,663,212,22.04.2019 00:26,182,19,Herson
2080,2057,10,980,1095,5,1100,0,1100,33,906,161,22.04.2019 00:20,182,19,Herson
1616,1652,6,607,1004,5,1009,0,1009,19,751,239,22.04.2019 00:26,182,19,Herson
2032,2036,11,885,1138,9,1147,0,1147,28,922,197,22.04.2019 00:15,182,19,Herson
2016,1974,17,828,1177,11,1188,0,1188,18,960,210,22.04.2019 00:37,182,19,Herson
1968,1949,11,797,1163,8,1171,0,1171,36,921,214,22.04.2019 00:15,182,19,Herson
2208,2198,15,834,1365,9,1374,0,1374,46,1113,215,22.04.2019 00:15,182,19,Herson
2160,2130,10,900,1253,7,1260,0,1260,15,1037,208,22.04.2019 00:20,182,19,Herson
1920,1901,8,803,1112,5,1117,0,1117,28,910,179,22.04.2019 03:30,182,19,Herson
1728,1726,3,682,1043,3,1046,0,1046,31,854,161,21.04.2019 21:45,182,19,Herson
1968,1962,2,864,1102,2,1104,0,1104,38,921,145,22.04.2019 00:50,182,19,Herson
2272,2243,10,997,1266,9,1275,0,1275,30,1045,200,22.04.2019 00:20,182,19,Herson
2160,2121,18,910,1232,18,1250,0,1250,19,1028,203,22.04.2019 00:15,182,19,Herson
2256,2228,21,897,1347,12,1359,0,1359,38,1103,218,22.04.2019 00:20,182,19,Herson
2336,2312,6,924,1409,3,1412,0,1412,31,1161,220,22.04.2019 01:10,182,19,Herson
1824,1809,8,724,1096,4,1100,0,1100,24,913,163,21.04.2019 23:45,182,19,Herson
2368,2367,11,1027,1334,7,1341,0,1341,44,1052,245,22.04.2019 00:10,182,19,Herson
2096,2061,12,838,1248,10,1258,0,1258,21,1034,203,22.04.2019 00:38,182,19,Herson
1792,1786,12,638,1151,3,1154,0,1154,33,935,186,22.04.2019 00:40,182,19,Herson
2176,2181,7,790,1380,6,1386,0,1386,30,1175,181,22.04.2019 00:30,182,19,Herson
2256,2224,5,895,1360,1,1361,0,1361,32,1150,179,22.04.2019 01:10,182,19,Herson
2288,2258,14,880,1400,8,1408,0,1408,36,1188,184,22.04.2019 00:52,182,19,Herson
2496,2462,16,909,1573,14,1587,0,1587,27,1308,252,22.04.2019 01:35,182,19,Herson
2288,2271,22,845,1431,12,1443,0,1443,19,1167,257,22.04.2019 01:15,182,19,Herson
2288,2282,41,855,1402,31,1433,0,1433,41,1146,246,22.04.2019 00:15,182,19,Herson
2352,2345,16,851,1487,14,1501,0,1501,25,1170,306,22.04.2019 00:40,182,19,Herson
2368,2339,4,928,1437,3,1440,0,1440,44,1129,267,22.04.2019 00:25,182,19,Herson
2352,2310,6,959,1390,3,1393,0,1393,32,1092,269,22.04.2019 00:10,182,19,Herson
2256,2248,22,840,1405,11,1416,0,1416,27,1118,271,22.04.2019 00:20,182,19,Herson
2272,2257,18,840,1425,7,1432,0,1432,30,1159,243,22.04.2019 00:03,182,19,Herson
2240,2227,4,875,1363,2,1365,0,1365,34,1102,229,22.04.2019 00:17,182,19,Herson
2272,2241,22,862,1395,15,1410,0,1410,35,1110,265,22.04.2019 00:48,182,19,Herson
176,51,5,147,28,1,29,0,29,0,26,3,22.04.2019 00:15,182,19,Herson
352,115,20,240,93,19,112,0,112,3,98,11,21.04.2019 22:00,182,19,Herson
96,41,1,56,39,1,40,0,40,1,30,9,22.04.2019 00:10,182,19,Herson
64,53,52,37,1,26,27,0,27,0,18,9,21.04.2019 21:45,182,19,Herson
128,15,0,114,14,0,14,0,14,0,11,3,21.04.2019 20:50,182,19,Herson
368,37,9,331,28,9,37,0,37,2,29,6,22.04.2019 00:20,182,19,Herson
240,108,21,139,82,19,101,0,101,4,77,20,21.04.2019 21:30,182,19,Herson
592,86,23,509,68,15,83,0,83,2,71,10,22.04.2019 00:17,182,19,Herson
368,169,21,221,126,21,147,0,147,8,124,15,21.04.2019 22:05,182,19,Herson
1056,688,0,410,646,0,646,0,646,38,570,38,22.04.2019 00:05,182,19,Herson
2224,2176,0,1926,298,0,298,0,298,7,235,56,22.04.2019 00:30,182,19,Herson
176,138,6,38,132,6,138,0,138,13,116,9,22.04.2019 00:23,183,19,Herson
2256,2224,5,990,1261,5,1266,0,1266,24,993,249,22.04.2019 02:17,183,19,Herson
1856,1847,15,779,1065,12,1077,0,1077,18,818,241,22.04.2019 02:28,183,19,Herson
2080,2056,14,976,1096,8,1104,0,1104,17,882,205,22.04.2019 04:14,183,19,Herson
1840,1815,20,864,962,14,976,0,976,18,735,223,22.04.2019 03:14,183,19,Herson
1456,1441,15,637,808,11,819,0,819,17,657,145,22.04.2019 04:19,183,19,Herson
1312,1288,38,593,682,37,719,0,719,6,586,127,22.04.2019 03:20,183,19,Herson
1168,1144,12,574,582,12,594,0,594,12,501,81,22.04.2019 03:15,183,19,Herson
1040,1016,11,484,546,10,556,0,556,6,432,118,22.04.2019 02:58,183,19,Herson
1744,1716,78,852,831,61,892,0,892,10,747,135,22.04.2019 00:00,183,19,Herson
1712,1682,24,823,869,20,889,0,889,9,691,189,21.04.2019 23:23,183,19,Herson
1856,1834,24,960,874,22,896,0,896,12,739,145,22.04.2019 00:10,183,19,Herson
864,840,19,357,493,14,507,0,507,14,377,116,22.04.2019 05:47,183,19,Herson
272,271,7,91,175,6,181,0,181,4,144,33,22.04.2019 02:24,183,19,Herson
1744,1719,17,857,874,13,887,0,887,11,771,105,22.04.2019 01:51,183,19,Herson
384,362,7,215,164,5,169,0,169,2,117,50,22.04.2019 01:13,183,19,Herson
1120,1101,24,568,533,19,552,0,552,14,444,94,22.04.2019 01:24,183,19,Herson
496,481,16,256,228,12,240,0,240,2,206,32,21.04.2019 22:52,183,19,Herson
1520,1503,7,796,717,7,724,0,724,6,575,143,22.04.2019 02:30,183,19,Herson
1743,1718,61,799,897,47,944,0,944,23,791,130,22.04.2019 04:41,183,19,Herson
2240,2198,45,928,1278,34,1312,0,1312,27,1067,218,22.04.2019 03:05,183,19,Herson
1616,1586,18,799,804,13,817,0,817,17,635,165,22.04.2019 03:10,183,19,Herson
2096,2069,24,1045,1031,20,1051,0,1051,13,884,154,22.04.2019 03:57,183,19,Herson
1952,1920,27,868,1068,16,1084,0,1084,14,936,134,22.04.2019 03:10,183,19,Herson
768,758,23,414,338,16,354,0,354,7,266,81,22.04.2019 04:08,183,19,Herson
2048,2026,22,1048,988,12,1000,0,1000,23,831,146,22.04.2019 04:57,183,19,Herson
688,668,19,331,339,18,357,0,357,6,283,68,22.04.2019 00:45,183,19,Herson
1136,1124,27,555,560,21,581,0,581,10,471,100,21.04.2019 23:16,183,19,Herson
624,616,16,292,318,14,332,0,332,6,239,87,22.04.2019 01:06,183,19,Herson
288,274,6,151,132,5,137,0,137,0,113,24,22.04.2019 00:25,183,19,Herson
1040,1033,18,480,544,16,560,0,560,7,428,125,22.04.2019 02:31,183,19,Herson
528,514,8,251,270,7,277,0,277,5,189,83,22.04.2019 00:49,183,19,Herson
496,490,8,249,239,8,247,0,247,4,199,44,22.04.2019 02:08,183,19,Herson
864,854,5,362,497,5,502,0,502,0,418,84,21.04.2019 23:20,183,19,Herson
400,394,1,179,220,1,221,0,221,4,188,29,22.04.2019 02:12,183,19,Herson
2368,2342,8,1070,1291,7,1298,0,1298,42,1071,185,22.04.2019 03:18,183,19,Herson
2400,2378,18,1097,1288,15,1303,0,1303,36,1069,198,22.04.2019 00:35,183,19,Herson
2432,2408,9,991,1436,5,1441,0,1441,30,1161,250,22.04.2019 01:13,183,19,Herson
144,133,0,60,84,0,84,0,84,0,72,12,22.04.2019 00:11,183,19,Herson
1264,372,0,892,372,0,372,0,372,33,321,18,22.04.2019 00:44,183,19,Herson
2176,2149,11,859,1310,7,1317,0,1317,34,1079,204,22.04.2019 03:29,183,19,Herson
2128,2113,2,885,1242,1,1243,0,1243,22,1002,219,22.04.2019 05:35,183,19,Herson
1952,1934,7,836,1109,7,1116,0,1116,29,891,196,22.04.2019 04:24,183,19,Herson
2192,2195,13,1055,1128,9,1137,0,1137,13,957,167,22.04.2019 08:04,183,19,Herson
2288,2256,15,976,1302,10,1312,0,1312,27,1092,193,22.04.2019 04:29,183,19,Herson
816,806,1,355,460,1,461,0,461,14,371,76,22.04.2019 04:28,183,19,Herson
848,833,0,278,570,0,570,0,570,5,437,128,22.04.2019 06:10,183,19,Herson
288,103,19,197,76,15,91,0,91,0,79,12,22.04.2019 04:22,183,19,Herson
2288,2268,4,826,1460,2,1462,0,1462,27,1167,268,22.04.2019 03:46,183,19,Herson
2160,2127,8,793,1360,7,1367,0,1367,35,1087,245,21.04.2019 22:30,183,19,Herson
2176,2160,8,838,1331,7,1338,0,1338,36,1071,231,22.04.2019 02:55,183,19,Herson
2064,2040,4,947,1114,3,1117,0,1117,29,884,203,22.04.2019 03:44,183,19,Herson
2064,2041,10,827,1230,7,1237,0,1237,33,983,221,22.04.2019 04:17,183,19,Herson
2240,2215,18,1005,1219,16,1235,0,1235,40,983,212,22.04.2019 04:26,183,19,Herson
2080,2052,13,830,1244,6,1250,0,1250,24,991,235,22.04.2019 03:30,183,19,Herson
1408,1398,8,545,857,6,863,0,863,20,691,152,22.04.2019 00:47,183,19,Herson
1696,1676,8,749,941,6,947,0,947,28,766,153,22.04.2019 01:43,183,19,Herson
2336,2322,9,1080,1247,9,1256,0,1256,24,1014,218,22.04.2019 04:32,183,19,Herson
640,629,2,321,317,2,319,0,319,9,247,63,22.04.2019 00:31,183,19,Herson
2176,2158,9,889,1280,7,1287,0,1287,29,1008,250,21.04.2019 22:17,183,19,Herson
2256,2246,6,1004,1247,5,1252,0,1252,29,977,246,22.04.2019 02:02,183,19,Herson
1248,1232,5,504,739,5,744,0,744,17,595,132,22.04.2019 03:23,183,19,Herson
1872,1850,11,756,1105,11,1116,0,1116,36,893,187,22.04.2019 03:17,183,19,Herson
1824,1816,13,869,944,11,955,0,955,30,755,170,22.04.2019 03:44,183,19,Herson
2064,2035,8,928,1129,7,1136,0,1136,44,897,195,22.04.2019 03:33,183,19,Herson
1824,1792,5,709,1111,4,1115,0,1115,35,911,169,22.04.2019 01:40,183,19,Herson
1824,1813,12,747,1069,8,1077,0,1077,30,852,195,22.04.2019 03:08,183,19,Herson
1552,1510,5,631,918,3,921,0,921,23,702,196,22.04.2019 00:37,183,19,Herson
1584,1569,13,700,875,9,884,0,884,18,736,130,22.04.2019 01:25,183,19,Herson
1904,1862,12,811,1085,8,1093,0,1093,24,871,198,22.04.2019 04:35,183,19,Herson
2176,2168,15,881,1283,12,1295,0,1295,25,1029,241,22.04.2019 01:52,183,19,Herson
2288,2258,20,959,1313,16,1329,0,1329,33,1080,216,22.04.2019 02:55,183,19,Herson
2000,1976,16,883,1110,7,1117,0,1117,24,904,189,22.04.2019 01:54,183,19,Herson
2064,2040,12,913,1144,7,1151,0,1151,22,928,201,22.04.2019 02:00,183,19,Herson
1968,1942,21,807,1145,16,1161,0,1161,25,948,188,22.04.2019 00:12,183,19,Herson
2272,2261,10,1026,1239,7,1246,0,1246,17,1019,210,22.04.2019 04:11,183,19,Herson
1296,1272,9,539,748,9,757,0,757,14,607,136,22.04.2019 01:48,183,19,Herson
1472,1458,8,654,812,6,818,0,818,11,686,121,22.04.2019 01:50,183,19,Herson
1040,1014,8,409,624,7,631,0,631,10,510,111,22.04.2019 03:00,183,19,Herson
2000,1970,19,822,1165,13,1178,0,1178,17,984,177,22.04.2019 04:11,183,19,Herson
1984,1953,15,778,1192,14,1206,0,1206,23,993,190,22.04.2019 03:33,183,19,Herson
1792,1779,11,802,982,8,990,0,990,24,827,139,22.04.2019 04:15,183,19,Herson
1760,1733,18,731,1015,14,1029,0,1029,17,839,173,22.04.2019 04:47,183,19,Herson
1760,1754,9,646,1109,5,1114,0,1114,22,891,201,22.04.2019 04:06,183,19,Herson
1824,1810,17,692,1119,13,1132,0,1132,28,888,216,22.04.2019 04:55,183,19,Herson
2064,2053,21,819,1231,14,1245,0,1245,30,1016,199,22.04.2019 03:02,183,19,Herson
1712,1686,14,703,996,13,1009,0,1009,31,795,183,22.04.2019 01:28,183,19,Herson
1712,1688,3,673,1037,2,1039,0,1039,25,837,177,22.04.2019 01:38,183,19,Herson
1344,1315,14,582,753,9,762,0,762,12,620,130,22.04.2019 01:08,183,19,Herson
2128,2105,9,820,1299,9,1308,0,1308,39,1051,218,22.04.2019 02:05,183,19,Herson
1344,1330,5,505,834,5,839,0,839,17,669,153,22.04.2019 00:01,183,19,Herson
1584,1574,14,582,989,13,1002,0,1002,27,829,146,22.04.2019 02:55,183,19,Herson
1872,1862,15,790,1071,11,1082,0,1082,28,866,188,22.04.2019 01:47,183,19,Herson
1648,1629,16,824,810,14,824,0,824,31,684,109,22.04.2019 01:39,183,19,Herson
1904,1871,20,890,997,17,1014,0,1014,25,878,111,22.04.2019 02:11,183,19,Herson
2176,2151,21,1089,1073,14,1087,0,1087,21,944,122,22.04.2019 02:23,183,19,Herson
1504,1478,10,682,814,8,822,0,822,11,706,105,22.04.2019 03:50,183,19,Herson
1184,1166,7,501,678,5,683,0,683,10,576,97,22.04.2019 01:06,183,19,Herson
320,305,7,85,228,7,235,0,235,6,210,19,22.04.2019 01:17,183,19,Herson
416,34,18,383,16,17,33,0,33,1,28,4,22.04.2019 01:02,183,19,Herson
112,51,1,63,48,1,49,0,49,0,40,9,22.04.2019 00:15,183,19,Herson
48,14,0,35,13,0,13,0,13,0,13,0,21.04.2019 21:57,183,19,Herson
1584,1547,2,675,909,0,909,0,909,25,741,143,22.04.2019 01:18,183,19,Herson
1424,1405,5,602,819,3,822,0,822,16,706,100,22.04.2019 01:03,183,19,Herson
976,212,202,769,10,197,207,0,207,4,156,47,22.04.2019 00:06,183,19,Herson
80,28,10,53,17,10,27,0,27,2,18,7,22.04.2019 00:29,183,19,Herson
2320,2276,16,1196,1112,12,1124,0,1124,15,993,116,22.04.2019 00:40,184,19,Herson
1968,1932,18,959,995,14,1009,0,1009,18,855,136,22.04.2019 00:40,184,19,Herson
1232,1208,15,548,672,12,684,0,684,10,583,91,21.04.2019 21:31,184,19,Herson
1856,1838,20,778,1062,16,1078,0,1078,13,916,149,22.04.2019 01:20,184,19,Herson
1680,1650,18,702,964,14,978,0,978,16,810,152,22.04.2019 00:15,184,19,Herson
1904,1869,16,875,1017,12,1029,0,1029,15,910,104,22.04.2019 00:25,184,19,Herson
848,836,12,412,424,12,436,0,436,2,384,50,21.04.2019 20:40,184,19,Herson
1920,1897,49,798,1081,41,1122,0,1122,23,949,150,22.04.2019 00:15,184,19,Herson
1664,1630,36,704,931,29,960,0,960,20,847,93,22.04.2019 01:10,184,19,Herson
1424,1396,29,685,719,20,739,0,739,14,632,93,21.04.2019 21:55,184,19,Herson
1664,1639,21,775,873,16,889,0,889,20,801,68,21.04.2019 22:25,184,19,Herson
576,560,4,241,331,4,335,0,335,7,308,20,21.04.2019 21:30,184,19,Herson
1392,1377,57,693,643,56,699,0,699,15,571,113,21.04.2019 21:22,184,19,Herson
848,826,40,408,405,35,440,0,440,7,316,117,21.04.2019 20:41,184,19,Herson
432,415,9,168,256,8,264,0,264,6,201,57,21.04.2019 21:15,184,19,Herson
1392,1375,56,566,772,54,826,0,826,15,564,247,21.04.2019 21:30,184,19,Herson
336,320,9,161,168,7,175,0,175,1,166,8,21.04.2019 20:45,184,19,Herson
1184,1148,16,615,557,12,569,0,569,9,463,97,21.04.2019 21:00,184,19,Herson
176,172,8,89,79,8,87,0,87,1,65,21,21.04.2019 22:15,184,19,Herson
656,632,24,296,336,24,360,0,360,2,267,91,22.04.2019 00:15,184,19,Herson
192,180,0,105,87,0,87,0,87,2,42,43,21.04.2019 21:25,184,19,Herson
352,341,2,216,135,1,136,0,136,1,113,22,21.04.2019 21:46,184,19,Herson
1632,1615,36,827,773,32,805,0,805,14,696,95,22.04.2019 00:50,184,19,Herson
336,313,7,173,158,5,163,0,163,3,134,26,21.04.2019 20:40,184,19,Herson
784,757,17,357,412,15,427,0,427,5,350,72,21.04.2019 22:05,184,19,Herson
160,146,5,78,77,5,82,0,82,0,65,17,21.04.2019 20:50,184,19,Herson
80,69,0,39,41,0,41,0,41,3,21,17,21.04.2019 21:05,184,19,Herson
816,805,39,325,458,33,491,0,491,5,450,36,21.04.2019 21:50,184,19,Herson
832,821,25,427,382,23,405,0,405,6,295,104,21.04.2019 20:39,184,19,Herson
176,174,9,62,105,9,114,0,114,1,92,21,21.04.2019 20:32,184,19,Herson
1632,1606,62,768,802,62,864,0,864,8,725,131,21.04.2019 21:30,184,19,Herson
416,393,12,200,204,12,216,0,216,3,161,52,21.04.2019 20:55,184,19,Herson
880,847,19,399,462,19,481,0,481,5,403,73,21.04.2019 20:40,184,19,Herson
320,305,10,78,232,10,242,0,242,4,214,24,21.04.2019 23:00,184,19,Herson
512,500,35,206,273,33,306,0,306,0,265,41,21.04.2019 20:55,184,19,Herson
576,559,7,275,295,6,301,0,301,4,241,56,22.04.2019 01:10,184,19,Herson
528,514,1,296,231,1,232,0,232,8,179,45,21.04.2019 21:00,184,19,Herson
1104,1072,47,551,509,44,553,0,553,12,439,102,21.04.2019 21:51,184,19,Herson
96,89,0,50,46,0,46,0,46,0,40,6,21.04.2019 20:18,184,19,Herson
240,226,10,110,120,10,130,0,130,5,101,24,21.04.2019 20:40,184,19,Herson
784,759,23,355,410,19,429,0,429,6,372,51,21.04.2019 21:30,184,19,Herson
192,29,7,164,22,6,28,0,28,0,25,3,21.04.2019 22:25,184,19,Herson
1696,1658,38,792,875,29,904,0,904,18,796,90,22.04.2019 01:20,184,19,Herson
1392,1366,37,657,707,28,735,0,735,17,641,77,21.04.2019 22:00,184,19,Herson
1392,1360,24,660,711,21,732,0,732,11,620,101,22.04.2019 00:50,184,19,Herson
1552,1521,38,732,789,31,820,0,820,11,703,106,22.04.2019 00:10,184,19,Herson
1232,1200,24,608,608,16,624,0,624,9,528,87,22.04.2019 00:25,184,19,Herson
208,198,3,99,106,3,109,0,109,0,87,22,21.04.2019 23:10,184,19,Herson
128,120,2,40,86,2,88,0,88,0,62,26,21.04.2019 20:45,184,19,Herson
336,328,34,132,170,34,204,0,204,4,187,13,22.04.2019 02:00,184,19,Herson
208,200,0,93,115,0,115,0,115,2,99,14,22.04.2019 01:20,184,19,Herson
1216,1198,57,584,591,41,632,0,632,7,518,107,22.04.2019 00:14,184,19,Herson
64,60,1,15,48,1,49,0,49,1,27,21,22.04.2019 00:03,184,19,Herson
928,905,35,407,486,35,521,0,521,6,460,55,22.04.2019 00:10,184,19,Herson
480,458,23,205,254,21,275,0,275,7,209,59,21.04.2019 21:20,184,19,Herson
384,374,27,115,242,27,269,0,269,7,251,11,21.04.2019 23:00,184,19,Herson
1040,1022,28,508,506,26,532,0,532,8,445,79,22.04.2019 00:30,184,19,Herson
784,763,20,372,392,20,412,0,412,8,326,78,22.04.2019 00:10,184,19,Herson
608,591,13,311,284,13,297,0,297,3,279,15,21.04.2019 21:00,184,19,Herson
48,40,0,17,31,0,31,0,31,0,22,9,22.04.2019 00:25,184,19,Herson
96,24,3,72,21,3,24,0,24,0,18,6,21.04.2019 23:35,184,19,Herson
1152,1129,10,483,660,9,669,0,669,10,593,66,21.04.2019 20:40,184,19,Herson
1120,1101,18,506,598,16,614,0,614,8,546,60,22.04.2019 03:45,184,19,Herson
1792,1776,37,819,936,37,973,0,973,14,856,103,22.04.2019 03:00,184,19,Herson
1408,1371,33,530,845,33,878,0,878,10,734,134,22.04.2019 00:10,184,19,Herson
288,272,15,93,180,15,195,0,195,2,181,12,21.04.2019 22:30,184,19,Herson
1200,1188,50,511,646,43,689,0,689,10,589,90,21.04.2019 21:57,184,19,Herson
400,384,21,187,195,18,213,0,213,2,174,37,21.04.2019 20:30,184,19,Herson
912,891,33,411,468,33,501,0,501,5,452,44,21.04.2019 22:20,184,19,Herson
1232,1213,53,515,667,50,717,0,717,12,610,95,21.04.2019 21:10,184,19,Herson
720,710,44,226,450,44,494,0,494,13,430,51,21.04.2019 20:35,184,19,Herson
656,643,43,265,348,43,391,0,391,5,326,60,21.04.2019 22:30,184,19,Herson
1280,1256,88,620,581,79,660,0,660,10,561,89,21.04.2019 22:00,184,19,Herson
256,255,11,116,129,11,140,0,140,2,117,21,21.04.2019 20:30,184,19,Herson
432,421,21,226,185,21,206,0,206,1,191,14,21.04.2019 20:55,184,19,Herson
1376,1357,54,512,814,50,864,0,864,13,729,122,21.04.2019 22:17,184,19,Herson
288,268,10,156,122,10,132,0,132,2,103,27,21.04.2019 21:00,184,19,Herson
400,389,20,183,197,20,217,0,217,3,183,31,21.04.2019 21:20,184,19,Herson
144,132,8,66,70,8,78,0,78,1,60,17,21.04.2019 20:40,184,19,Herson
336,330,21,119,198,19,217,0,217,3,188,26,21.04.2019 21:20,184,19,Herson
224,208,33,109,85,30,115,0,115,4,84,27,21.04.2019 22:45,184,19,Herson
352,342,22,123,208,21,229,0,229,3,182,44,21.04.2019 20:40,184,19,Herson
560,534,39,241,282,37,319,0,319,7,250,62,21.04.2019 23:15,184,19,Herson
336,317,24,161,153,22,175,0,175,4,150,21,21.04.2019 21:30,184,19,Herson
480,459,37,231,217,32,249,0,249,0,196,53,21.04.2019 20:39,184,19,Herson
560,547,30,206,327,27,354,0,354,5,257,92,22.04.2019 00:40,184,19,Herson
448,441,25,204,222,22,244,0,244,6,207,31,21.04.2019 21:25,184,19,Herson
640,632,43,270,327,43,370,0,370,6,311,53,21.04.2019 20:45,184,19,Herson
160,154,8,73,80,7,87,0,87,3,78,6,21.04.2019 21:00,184,19,Herson
80,73,1,38,41,1,42,0,42,0,37,5,21.04.2019 20:20,184,19,Herson
64,58,0,28,36,0,36,0,36,0,26,10,21.04.2019 20:05,184,19,Herson
336,324,19,138,180,18,198,0,198,0,173,25,22.04.2019 00:20,184,19,Herson
176,163,4,93,79,4,83,0,83,4,62,17,21.04.2019 20:28,184,19,Herson
112,99,0,58,54,0,54,0,54,2,32,20,21.04.2019 20:42,184,19,Herson
1632,1615,78,755,805,72,877,0,877,19,727,131,21.04.2019 21:28,184,19,Herson
1056,1027,28,421,609,26,635,0,635,11,536,88,22.04.2019 02:15,184,19,Herson
992,969,21,460,512,20,532,0,532,8,450,74,21.04.2019 20:45,184,19,Herson
336,323,16,112,208,16,224,0,224,5,197,22,21.04.2019 21:10,184,19,Herson
320,306,15,148,160,12,172,0,172,5,129,38,21.04.2019 20:25,184,19,Herson
160,146,4,59,98,3,101,0,101,0,84,17,21.04.2019 21:28,184,19,Herson
608,586,33,255,324,29,353,0,353,6,268,79,21.04.2019 21:16,184,19,Herson
576,556,17,258,302,16,318,0,318,3,279,36,21.04.2019 21:00,184,19,Herson
512,492,40,209,265,38,303,0,303,3,239,61,21.04.2019 21:31,184,19,Herson
240,229,3,121,116,3,119,0,119,1,110,8,21.04.2019 20:45,184,19,Herson
1536,1507,42,717,787,32,819,0,819,21,730,68,21.04.2019 21:05,184,19,Herson
576,563,32,236,318,22,340,0,340,8,297,35,21.04.2019 21:05,184,19,Herson
256,247,30,114,115,27,142,0,142,1,120,21,21.04.2019 21:30,184,19,Herson
464,448,28,202,235,27,262,0,262,5,226,31,21.04.2019 21:00,184,19,Herson
224,211,12,92,120,12,132,0,132,1,117,14,21.04.2019 20:31,184,19,Herson
528,504,44,211,273,44,317,0,317,3,284,30,21.04.2019 21:45,184,19,Herson
640,630,44,281,319,40,359,0,359,3,307,49,21.04.2019 21:00,184,19,Herson
400,380,29,161,215,24,239,0,239,3,204,32,21.04.2019 20:35,184,19,Herson
144,142,15,36,93,15,108,0,108,4,95,9,21.04.2019 20:20,184,19,Herson
448,436,35,170,247,31,278,0,278,4,244,30,21.04.2019 20:48,184,19,Herson
2208,2188,41,992,1184,32,1216,0,1216,32,949,235,22.04.2019 01:20,184,19,Herson
2240,2186,65,946,1238,56,1294,0,1294,21,1071,202,22.04.2019 00:50,184,19,Herson
144,139,0,73,71,0,71,0,71,0,57,14,21.04.2019 21:00,184,19,Herson
1408,1364,54,688,674,46,720,0,720,10,593,117,21.04.2019 23:30,184,19,Herson
832,818,58,380,405,47,452,0,452,8,375,69,22.04.2019 00:30,184,19,Herson
464,448,25,228,216,20,236,0,236,6,184,46,22.04.2019 00:15,184,19,Herson
656,639,49,300,317,39,356,0,356,6,293,57,22.04.2019 00:10,184,19,Herson
96,79,13,47,37,12,49,0,49,0,39,10,21.04.2019 21:30,184,19,Herson
688,672,24,300,367,21,388,0,388,3,324,61,22.04.2019 00:10,184,19,Herson
720,704,59,360,306,54,360,0,360,8,289,63,22.04.2019 00:10,184,19,Herson
400,394,21,174,207,19,226,0,226,7,168,51,22.04.2019 00:10,184,19,Herson
1312,1271,48,687,582,43,625,0,625,7,511,107,22.04.2019 00:15,184,19,Herson
384,379,12,162,212,10,222,0,222,5,168,49,22.04.2019 00:25,184,19,Herson
768,746,25,287,458,23,481,0,481,10,324,147,22.04.2019 00:05,184,19,Herson
272,262,13,111,152,9,161,0,161,3,133,25,22.04.2019 00:20,184,19,Herson
80,71,6,48,27,5,32,0,32,1,18,13,21.04.2019 21:16,184,19,Herson
688,670,16,310,363,15,378,0,378,2,309,67,22.04.2019 00:10,184,19,Herson
608,584,19,236,354,18,372,0,372,5,293,74,22.04.2019 00:10,184,19,Herson
2128,2100,55,935,1148,45,1193,0,1193,35,971,187,22.04.2019 00:47,184,19,Herson
2112,2082,28,908,1188,16,1204,0,1204,26,963,215,21.04.2019 21:44,184,19,Herson
752,725,25,347,384,21,405,0,405,4,337,64,21.04.2019 21:00,184,19,Herson
160,161,2,76,82,2,84,0,84,0,73,11,21.04.2019 20:35,184,19,Herson
448,436,2,229,217,2,219,0,219,6,184,29,21.04.2019 21:05,184,19,Herson
1104,1074,50,538,521,45,566,0,566,8,462,96,22.04.2019 00:01,184,19,Herson
432,415,27,180,228,24,252,0,252,5,213,34,22.04.2019 00:25,184,19,Herson
80,72,1,33,46,1,47,0,47,1,33,13,21.04.2019 20:35,184,19,Herson
912,892,38,428,452,32,484,0,484,9,302,173,22.04.2019 00:45,184,19,Herson
416,403,22,181,215,20,235,0,235,0,186,49,22.04.2019 00:05,184,19,Herson
160,153,9,69,82,9,91,0,91,2,74,15,22.04.2019 00:05,184,19,Herson
704,696,68,317,319,68,387,0,387,9,316,62,22.04.2019 00:05,184,19,Herson
1056,1032,47,560,456,40,496,0,496,10,300,186,22.04.2019 00:05,184,19,Herson
352,351,28,161,166,25,191,0,191,1,143,47,22.04.2019 00:10,184,19,Herson
912,893,60,401,456,55,511,0,511,12,403,96,22.04.2019 00:05,184,19,Herson
912,889,42,391,479,42,521,0,521,16,394,111,21.04.2019 23:59,184,19,Herson
800,776,56,299,448,53,501,0,501,11,356,134,22.04.2019 00:05,184,19,Herson
1040,1015,43,488,513,39,552,0,552,9,401,142,22.04.2019 01:40,184,19,Herson
1424,1392,78,621,736,67,803,0,803,9,698,96,22.04.2019 00:40,184,19,Herson
272,270,21,122,136,14,150,0,150,6,133,11,22.04.2019 00:30,184,19,Herson
1392,1368,7,578,810,4,814,0,814,16,716,82,22.04.2019 00:08,184,19,Herson
1120,1089,9,449,665,6,671,0,671,17,565,89,21.04.2019 23:02,184,19,Herson
2384,2363,16,1046,1325,13,1338,0,1338,24,1137,176,22.04.2019 00:15,184,19,Herson
832,830,4,357,472,3,475,0,475,15,389,71,22.04.2019 00:10,184,19,Herson
2352,2307,6,938,1411,3,1414,0,1414,25,1186,203,21.04.2019 22:20,184,19,Herson
2288,2243,7,914,1368,6,1374,0,1374,20,1137,217,22.04.2019 00:10,184,19,Herson
1312,1290,7,509,797,6,803,0,803,18,644,141,22.04.2019 00:20,184,19,Herson
2256,2224,8,922,1329,5,1334,0,1334,33,1107,194,22.04.2019 00:02,184,19,Herson
1760,1740,7,670,1086,4,1090,0,1090,12,893,185,21.04.2019 22:05,184,19,Herson
912,893,15,362,539,11,550,0,550,12,466,72,22.04.2019 00:10,184,19,Herson
1312,1284,6,570,738,4,742,0,742,19,629,94,22.04.2019 00:10,184,19,Herson
1120,1113,8,444,670,6,676,0,676,20,553,103,22.04.2019 00:10,184,19,Herson
912,933,14,291,607,14,621,0,621,13,465,143,21.04.2019 21:45,184,19,Herson
960,949,14,330,622,8,630,0,630,21,496,113,22.04.2019 00:02,184,19,Herson
1408,1392,13,556,841,11,852,0,852,27,712,113,21.04.2019 20:59,184,19,Herson
1728,1701,11,713,1009,6,1015,0,1015,15,851,149,22.04.2019 00:30,184,19,Herson
1776,1758,9,735,1035,6,1041,0,1041,21,907,113,22.04.2019 03:26,184,19,Herson
1040,1077,6,336,699,5,704,0,704,29,589,86,21.04.2019 23:30,184,19,Herson
1376,1430,9,523,845,8,853,0,853,20,708,125,22.04.2019 00:15,184,19,Herson
832,820,3,371,458,3,461,0,461,1,380,80,22.04.2019 00:19,184,19,Herson
1760,1728,10,720,1032,8,1040,0,1040,24,921,95,22.04.2019 00:07,184,19,Herson
2032,1997,21,880,1139,13,1152,0,1152,22,1017,113,22.04.2019 03:20,184,19,Herson
1360,1340,11,593,760,7,767,0,767,11,645,111,22.04.2019 00:15,184,19,Herson
1024,1003,8,458,558,8,566,0,566,18,464,84,22.04.2019 00:25,184,19,Herson
480,473,12,210,261,9,270,0,270,1,237,32,21.04.2019 23:00,184,19,Herson
560,549,11,247,302,11,313,0,313,2,273,38,22.04.2019 00:15,184,19,Herson
1008,987,13,446,550,12,562,0,562,9,495,58,21.04.2019 23:45,184,19,Herson
384,42,42,346,0,38,38,0,38,0,35,3,22.04.2019 00:37,184,19,Herson
656,643,46,250,365,41,406,0,406,2,347,57,22.04.2019 00:05,185,19,Herson
144,134,6,54,84,6,90,0,90,0,77,13,22.04.2019 00:05,185,19,Herson
416,410,16,156,245,15,260,0,260,6,212,42,21.04.2019 22:50,185,19,Herson
960,944,68,399,501,60,561,0,561,8,477,76,22.04.2019 01:35,185,19,Herson
848,828,5,363,481,4,485,0,485,16,411,58,22.04.2019 00:18,185,19,Herson
1504,1519,11,665,830,9,839,0,839,18,724,97,21.04.2019 21:15,185,19,Herson
1280,1251,3,563,715,2,717,0,717,16,644,57,22.04.2019 02:30,185,19,Herson
976,982,0,388,588,0,588,0,588,14,529,45,22.04.2019 00:35,185,19,Herson
1200,1188,7,647,547,6,553,0,553,7,463,83,22.04.2019 02:23,185,19,Herson
1424,1399,7,763,655,6,661,0,661,17,541,103,22.04.2019 01:50,185,19,Herson
656,648,16,271,372,13,385,0,385,3,356,26,22.04.2019 00:05,185,19,Herson
752,735,9,330,413,9,422,0,422,1,386,35,21.04.2019 20:40,185,19,Herson
752,733,1,385,366,1,367,0,367,7,346,14,22.04.2019 00:07,185,19,Herson
864,850,41,469,361,34,395,0,395,8,316,71,22.04.2019 00:50,185,19,Herson
112,115,0,69,43,0,43,0,43,0,39,4,21.04.2019 20:55,185,19,Herson
1024,1016,37,480,509,35,544,0,544,14,494,36,21.04.2019 21:45,185,19,Herson
1200,1176,56,583,561,56,617,0,617,7,589,21,21.04.2019 22:50,185,19,Herson
608,591,27,263,319,26,345,0,345,4,292,49,22.04.2019 00:01,185,19,Herson
624,614,27,272,326,26,352,0,352,6,323,23,21.04.2019 21:15,185,19,Herson
496,489,23,184,295,17,312,0,312,6,277,29,22.04.2019 00:10,185,19,Herson
512,494,5,273,234,5,239,0,239,5,211,23,22.04.2019 00:05,185,19,Herson
784,777,16,354,414,16,430,0,430,6,383,41,21.04.2019 21:37,185,19,Herson
592,574,29,240,325,27,352,0,352,8,300,44,21.04.2019 21:25,185,19,Herson
1088,1111,33,448,608,32,640,0,640,12,573,55,21.04.2019 23:25,185,19,Herson
160,153,0,77,83,0,83,0,83,3,74,6,22.04.2019 01:05,185,19,Herson
416,401,6,179,232,5,237,0,237,3,216,18,21.04.2019 23:23,185,19,Herson
256,241,3,129,124,3,127,0,127,2,109,16,21.04.2019 20:30,185,19,Herson
464,487,0,180,284,0,284,0,284,6,234,44,21.04.2019 21:00,185,19,Herson
1040,1045,45,441,556,43,599,0,599,9,535,55,22.04.2019 00:10,185,19,Herson
624,601,24,273,327,24,351,0,351,3,235,113,22.04.2019 00:10,185,19,Herson
784,763,12,355,417,12,429,0,429,1,396,32,22.04.2019 00:32,185,19,Herson
560,549,5,250,305,5,310,0,310,1,262,47,22.04.2019 01:15,185,19,Herson
656,643,30,302,324,30,354,0,354,6,313,35,21.04.2019 23:55,185,19,Herson
1104,1077,18,523,567,14,581,0,581,5,473,103,22.04.2019 00:50,185,19,Herson
176,169,4,61,111,4,115,0,115,0,90,25,22.04.2019 00:30,185,19,Herson
496,472,16,226,259,11,270,0,270,3,228,39,22.04.2019 00:25,185,19,Herson
432,422,8,229,198,5,203,0,203,2,180,21,21.04.2019 21:50,185,19,Herson
608,596,25,302,281,25,306,0,306,5,233,68,22.04.2019 01:50,185,19,Herson
160,151,0,70,90,0,90,0,90,1,78,11,22.04.2019 00:20,185,19,Herson
624,616,15,250,363,11,374,0,374,12,336,26,21.04.2019 23:40,185,19,Herson
336,321,5,87,244,5,249,0,249,1,223,25,21.04.2019 21:20,185,19,Herson
480,470,4,211,267,2,269,0,269,2,236,31,21.04.2019 20:45,185,19,Herson
592,585,0,266,326,0,326,0,326,3,294,29,21.04.2019 21:03,185,19,Herson
2416,2389,16,923,1482,11,1493,0,1493,21,1308,164,22.04.2019 02:10,185,19,Herson
1776,1767,56,756,983,37,1020,0,1020,18,860,142,22.04.2019 00:20,185,19,Herson
624,611,27,317,282,25,307,0,307,2,253,52,21.04.2019 22:32,185,19,Herson
464,449,0,222,242,0,242,0,242,3,185,54,21.04.2019 20:21,185,19,Herson
864,836,16,440,409,15,424,0,424,3,330,91,21.04.2019 22:45,185,19,Herson
304,294,3,148,153,3,156,0,156,4,128,24,21.04.2019 22:40,185,19,Herson
784,770,24,368,400,16,416,0,416,7,336,73,21.04.2019 20:30,185,19,Herson
304,285,14,113,178,13,191,0,191,5,158,28,22.04.2019 00:10,185,19,Herson
352,343,7,160,188,4,192,0,192,0,173,19,21.04.2019 23:00,185,19,Herson
656,635,26,311,319,26,345,0,345,3,281,61,21.04.2019 23:35,185,19,Herson
1184,1161,29,581,580,23,603,0,603,12,551,40,22.04.2019 06:10,185,19,Herson
352,342,7,144,201,7,208,0,208,1,178,29,21.04.2019 22:01,185,19,Herson
576,567,17,252,308,16,324,0,324,5,285,34,21.04.2019 22:20,185,19,Herson
528,512,32,258,239,31,270,0,270,7,216,47,22.04.2019 01:20,185,19,Herson
320,306,16,153,152,15,167,0,167,2,140,25,21.04.2019 23:55,185,19,Herson
960,936,11,448,504,8,512,0,512,5,451,56,22.04.2019 01:05,185,19,Herson
1312,1277,19,528,770,14,784,0,784,12,647,125,22.04.2019 00:40,185,19,Herson
1424,1382,26,627,774,23,797,0,797,10,681,106,22.04.2019 01:10,185,19,Herson
480,466,10,234,237,9,246,0,246,2,224,20,22.04.2019 00:05,185,19,Herson
800,799,9,362,431,7,438,0,438,7,382,49,22.04.2019 00:30,185,19,Herson
880,856,15,454,412,14,426,0,426,10,360,56,21.04.2019 23:50,185,19,Herson
688,677,14,315,360,13,373,0,373,5,280,88,22.04.2019 00:12,185,19,Herson
528,514,9,230,289,9,298,0,298,6,270,22,22.04.2019 00:06,185,19,Herson
560,542,11,309,243,8,251,0,251,1,200,50,22.04.2019 00:10,185,19,Herson
1456,1440,17,708,736,12,748,0,748,12,644,92,22.04.2019 01:20,185,19,Herson
432,424,4,197,233,2,235,0,235,6,209,20,21.04.2019 21:30,185,19,Herson
400,392,19,150,231,19,250,0,250,0,209,41,21.04.2019 20:45,185,19,Herson
288,278,13,76,199,13,212,0,212,3,198,11,21.04.2019 21:35,185,19,Herson
304,300,0,148,156,0,156,0,156,4,142,10,22.04.2019 00:02,185,19,Herson
320,309,1,143,177,0,177,0,177,2,156,19,21.04.2019 23:50,185,19,Herson
240,236,0,130,110,0,110,0,110,4,90,16,22.04.2019 00:05,185,19,Herson
704,697,12,303,391,10,401,0,401,9,350,42,22.04.2019 00:30,185,19,Herson
1664,1635,20,804,843,17,860,0,860,15,757,88,21.04.2019 21:30,185,19,Herson
672,659,20,338,314,20,334,0,334,3,295,36,22.04.2019 00:30,185,19,Herson
1680,1662,13,860,809,11,820,0,820,13,672,135,22.04.2019 00:10,185,19,Herson
112,112,6,22,84,6,90,0,90,1,76,13,21.04.2019 21:50,185,19,Herson
256,252,19,102,140,14,154,0,154,0,141,13,21.04.2019 22:30,185,19,Herson
832,805,45,430,365,37,402,0,402,5,375,22,22.04.2019 00:05,185,19,Herson
64,67,0,8,56,0,56,0,56,0,45,11,21.04.2019 21:30,185,19,Herson
1216,1216,27,501,690,25,715,0,715,6,650,59,22.04.2019 00:05,185,19,Herson
800,773,7,466,329,5,334,0,334,2,314,18,22.04.2019 00:15,185,19,Herson
704,688,2,356,346,2,348,0,348,5,306,37,22.04.2019 00:14,185,19,Herson
1120,1089,19,640,464,16,480,0,480,4,419,57,22.04.2019 00:30,185,19,Herson
1296,1270,21,619,656,21,677,0,677,8,587,82,21.04.2019 23:50,185,19,Herson
1440,1415,31,575,836,29,865,0,865,5,792,68,22.04.2019 00:05,185,19,Herson
496,488,24,231,241,24,265,0,265,1,234,30,22.04.2019 00:05,185,19,Herson
704,682,3,333,368,3,371,0,371,6,297,68,21.04.2019 21:20,185,19,Herson
400,424,4,173,223,4,227,0,227,5,191,31,21.04.2019 23:15,185,19,Herson
608,592,3,283,323,2,325,0,325,5,259,61,21.04.2019 22:25,185,19,Herson
1536,1491,12,718,812,6,818,0,818,15,700,103,22.04.2019 00:35,185,19,Herson
1808,1775,22,775,1011,22,1033,0,1033,19,880,134,22.04.2019 00:10,185,19,Herson
2096,2057,13,828,1255,13,1268,0,1268,10,1104,154,21.04.2019 20:55,185,19,Herson
1680,1651,21,651,1021,8,1029,0,1029,23,866,140,22.04.2019 00:15,185,19,Herson
1232,1207,19,499,722,11,733,0,733,12,628,93,22.04.2019 01:53,185,19,Herson
1456,1429,16,617,828,11,839,0,839,12,712,115,22.04.2019 00:25,185,19,Herson
2032,1990,17,912,1104,16,1120,0,1120,24,950,146,22.04.2019 00:25,185,19,Herson
2032,2006,24,705,1308,19,1327,0,1327,43,1090,194,22.04.2019 00:25,185,19,Herson
2016,1975,22,832,1165,19,1184,0,1184,22,995,167,22.04.2019 00:58,185,19,Herson
1872,1840,12,675,1187,10,1197,0,1197,24,1014,159,22.04.2019 00:20,185,19,Herson
1904,1876,22,669,1218,17,1235,0,1235,26,1053,156,22.04.2019 01:15,185,19,Herson
208,194,110,27,81,100,181,0,181,10,104,67,22.04.2019 00:18,185,19,Herson
256,96,27,168,68,20,88,0,88,0,81,7,21.04.2019 22:00,185,19,Herson
48,17,0,33,15,0,15,0,15,0,12,3,21.04.2019 20:35,185,19,Herson
2176,2149,4,929,1243,4,1247,0,1247,17,1054,176,22.04.2019 00:27,186,19,Herson
1104,1092,2,481,621,2,623,0,623,15,539,69,22.04.2019 00:20,186,19,Herson
2144,2134,12,915,1220,9,1229,0,1229,16,1054,159,22.04.2019 00:25,186,19,Herson
2128,2104,8,858,1262,8,1270,0,1270,20,1073,177,22.04.2019 00:20,186,19,Herson
1600,1585,7,738,856,6,862,0,862,8,748,106,22.04.2019 00:15,186,19,Herson
1920,1908,10,861,1051,8,1059,0,1059,13,922,124,22.04.2019 01:10,186,19,Herson
208,202,92,35,102,71,173,0,173,4,141,28,22.04.2019 00:25,186,19,Herson
816,800,13,344,459,13,472,0,472,7,386,79,22.04.2019 00:20,186,19,Herson
880,870,2,437,441,2,443,0,443,4,384,55,22.04.2019 00:05,186,19,Herson
400,392,0,180,220,0,220,0,220,2,197,21,22.04.2019 00:15,186,19,Herson
400,388,4,174,222,4,226,0,226,3,191,32,21.04.2019 23:55,186,19,Herson
1856,1831,10,976,874,6,880,0,880,14,707,159,22.04.2019 00:50,186,19,Herson
112,103,0,52,60,0,60,0,60,0,49,11,22.04.2019 00:30,186,19,Herson
1568,1541,22,848,699,21,720,0,720,14,549,157,22.04.2019 00:10,186,19,Herson
784,762,4,361,419,4,423,0,423,2,338,83,22.04.2019 00:40,186,19,Herson
688,682,22,318,348,22,370,0,370,12,311,47,22.04.2019 00:10,186,19,Herson
304,286,12,101,191,12,203,0,203,3,152,48,22.04.2019 00:15,186,19,Herson
1632,1609,14,762,856,14,870,0,870,16,749,105,22.04.2019 00:20,186,19,Herson
2336,2315,0,1185,1151,0,1151,0,1151,16,1020,115,22.04.2019 01:04,186,19,Herson
1632,1706,2,747,883,2,885,0,885,9,801,75,22.04.2019 00:55,186,19,Herson
688,693,19,283,386,19,405,0,405,5,324,76,22.04.2019 00:20,186,19,Herson
1360,1362,2,658,700,2,702,0,702,14,559,129,21.04.2019 23:10,186,19,Herson
1136,1118,11,550,577,9,586,0,586,7,439,140,22.04.2019 00:30,186,19,Herson
1072,1043,18,540,516,16,532,0,532,17,386,129,22.04.2019 00:30,186,19,Herson
192,175,1,89,102,1,103,0,103,0,78,25,21.04.2019 20:43,186,19,Herson
784,756,0,439,345,0,345,0,345,7,248,90,22.04.2019 00:05,186,19,Herson
224,216,1,84,140,0,140,0,140,3,120,17,21.04.2019 23:00,186,19,Herson
240,224,1,115,125,0,125,0,125,1,107,17,21.04.2019 23:10,186,19,Herson
928,917,2,482,444,2,446,0,446,4,372,70,22.04.2019 00:48,186,19,Herson
688,671,8,334,346,8,354,0,354,8,256,90,22.04.2019 00:03,186,19,Herson
96,93,0,28,68,0,68,0,68,0,58,10,22.04.2019 00:10,186,19,Herson
352,347,1,111,240,1,241,0,241,3,207,31,22.04.2019 00:20,186,19,Herson
96,97,0,33,63,0,63,0,63,2,49,12,22.04.2019 01:20,186,19,Herson
928,901,30,395,509,24,533,0,533,7,428,98,22.04.2019 00:20,186,19,Herson
256,241,9,125,122,9,131,0,131,2,121,8,22.04.2019 00:13,186,19,Herson
720,697,0,349,371,0,371,0,371,5,263,103,22.04.2019 00:05,186,19,Herson
336,326,0,175,161,0,161,0,161,5,118,38,22.04.2019 00:07,186,19,Herson
160,151,0,68,92,0,92,0,92,1,71,20,22.04.2019 00:20,186,19,Herson
896,870,7,410,479,7,486,0,486,8,418,60,22.04.2019 01:30,186,19,Herson
240,225,0,104,136,0,136,0,136,1,122,13,22.04.2019 00:30,186,19,Herson
176,165,0,75,101,0,101,0,101,0,81,20,22.04.2019 00:03,186,19,Herson
720,703,18,336,366,18,384,0,384,7,282,95,22.04.2019 00:15,186,19,Herson
816,802,12,411,393,12,405,0,405,3,340,62,22.04.2019 00:25,186,19,Herson
2160,2132,20,1010,1133,17,1150,0,1150,24,970,156,22.04.2019 00:40,186,19,Herson
1488,1471,4,740,744,4,748,0,748,22,573,153,22.04.2019 00:10,186,19,Herson
224,219,0,119,105,0,105,0,105,0,77,28,22.04.2019 00:15,186,19,Herson
608,110,0,498,110,0,110,0,110,7,96,7,22.04.2019 00:18,186,19,Herson
2272,2400,46,875,1360,37,1397,0,1397,27,1058,312,22.04.2019 02:00,186,19,Herson
2064,2022,16,900,1150,14,1164,0,1164,23,942,199,22.04.2019 00:58,186,19,Herson
2336,2296,35,1030,1272,34,1306,0,1306,32,1087,187,22.04.2019 01:25,186,19,Herson
1632,1628,27,679,928,25,953,0,953,25,775,153,22.04.2019 00:30,186,19,Herson
1136,1119,33,546,567,23,590,0,590,17,483,90,22.04.2019 00:20,186,19,Herson
512,499,5,220,288,4,292,0,292,8,254,30,22.04.2019 00:21,186,19,Herson
944,912,21,269,654,21,675,0,675,12,617,46,22.04.2019 00:50,186,19,Herson
896,885,20,366,512,18,530,0,530,6,492,32,22.04.2019 00:25,186,19,Herson
688,684,30,256,407,25,432,0,432,4,404,24,22.04.2019 00:07,186,19,Herson
336,323,12,145,182,9,191,0,191,3,171,17,22.04.2019 00:15,186,19,Herson
496,474,8,242,248,6,254,0,254,1,179,74,21.04.2019 21:52,186,19,Herson
432,423,10,200,223,9,232,0,232,1,188,43,22.04.2019 00:50,186,19,Herson
912,886,30,412,475,25,500,0,500,6,423,71,22.04.2019 00:50,186,19,Herson
416,418,10,146,261,9,270,0,270,3,238,29,21.04.2019 21:09,186,19,Herson
1104,1141,36,473,598,33,631,0,631,5,537,89,22.04.2019 08:00,186,19,Herson
368,378,17,165,188,15,203,0,203,3,173,27,22.04.2019 00:25,186,19,Herson
240,260,11,110,123,7,130,0,130,4,88,38,22.04.2019 00:15,186,19,Herson
1712,1682,0,807,905,0,905,0,905,24,762,119,22.04.2019 00:15,186,19,Herson
1568,1545,11,705,854,9,863,0,863,9,749,105,22.04.2019 00:15,186,19,Herson
1984,1964,29,775,1184,25,1209,0,1209,33,1024,152,22.04.2019 02:10,186,19,Herson
1920,1910,39,835,1060,25,1085,0,1085,30,935,120,22.04.2019 00:15,186,19,Herson
2224,2207,19,960,1250,14,1264,0,1264,29,1098,137,22.04.2019 00:55,186,19,Herson
2160,2125,24,939,1205,16,1221,0,1221,26,1048,147,22.04.2019 00:30,186,19,Herson
1760,1738,24,736,1006,18,1024,0,1024,25,891,108,22.04.2019 00:05,186,19,Herson
1920,1905,21,768,1136,16,1152,0,1152,22,986,144,22.04.2019 00:50,186,19,Herson
1488,1479,9,596,883,9,892,0,892,25,780,87,22.04.2019 01:00,186,19,Herson
1408,1386,13,701,696,11,707,0,707,20,578,109,22.04.2019 00:25,186,19,Herson
2048,2032,33,1057,962,29,991,0,991,6,862,123,22.04.2019 00:30,186,19,Herson
2336,2343,33,994,1317,25,1342,0,1342,21,1149,172,21.04.2019 22:20,186,19,Herson
1472,1455,15,623,835,14,849,0,849,18,722,109,22.04.2019 00:16,186,19,Herson
464,463,7,265,195,4,199,0,199,3,174,22,21.04.2019 22:01,186,19,Herson
1312,1328,4,595,713,4,717,0,717,18,544,155,22.04.2019 00:20,186,19,Herson
1280,1267,3,635,642,3,645,0,645,9,508,128,21.04.2019 21:21,186,19,Herson
944,924,21,468,463,13,476,0,476,8,402,66,21.04.2019 21:59,186,19,Herson
240,227,2,117,122,1,123,0,123,7,97,19,22.04.2019 00:07,186,19,Herson
1088,1065,27,500,562,26,588,0,588,11,505,72,22.04.2019 00:05,186,19,Herson
384,371,6,205,175,4,179,0,179,2,156,21,22.04.2019 00:10,186,19,Herson
848,840,7,453,388,7,395,0,395,4,359,32,22.04.2019 00:10,186,19,Herson
208,206,5,85,118,5,123,0,123,6,95,22,21.04.2019 21:30,186,19,Herson
720,701,14,319,394,7,401,0,401,8,360,33,22.04.2019 00:20,186,19,Herson
448,434,12,203,234,11,245,0,245,4,210,31,22.04.2019 00:10,186,19,Herson
848,826,11,366,474,8,482,0,482,7,408,67,22.04.2019 00:30,186,19,Herson
960,944,5,467,489,4,493,0,493,5,427,61,22.04.2019 00:05,186,19,Herson
1392,1367,14,664,715,13,728,0,728,9,639,80,22.04.2019 00:05,186,19,Herson
2160,2194,28,854,1282,24,1306,0,1306,31,990,285,22.04.2019 00:45,186,19,Herson
1248,1230,15,529,705,14,719,0,719,16,580,123,22.04.2019 00:20,186,19,Herson
1840,1811,7,875,960,5,965,0,965,22,798,145,22.04.2019 00:25,186,19,Herson
1504,1496,9,624,875,5,880,0,880,14,686,180,22.04.2019 00:05,186,19,Herson
992,976,5,449,539,4,543,0,543,5,453,85,22.04.2019 00:10,186,19,Herson
1952,1936,8,849,1096,7,1103,0,1103,17,888,198,22.04.2019 01:15,186,19,Herson
1408,1404,5,549,854,5,859,0,859,27,695,137,22.04.2019 00:10,186,19,Herson
2048,2025,15,883,1156,9,1165,0,1165,33,963,169,22.04.2019 00:20,186,19,Herson
1472,1455,14,680,783,9,792,0,792,18,664,110,22.04.2019 00:45,186,19,Herson
1232,1215,1,446,785,1,786,0,786,16,645,125,22.04.2019 00:02,186,19,Herson
688,664,0,378,310,0,310,0,310,9,268,33,22.04.2019 00:55,186,19,Herson
1136,1122,7,452,679,5,684,0,684,7,576,101,21.04.2019 22:16,186,19,Herson
336,327,0,149,187,0,187,0,187,3,161,23,22.04.2019 00:50,186,19,Herson
752,728,26,338,396,18,414,0,414,6,341,67,22.04.2019 00:50,186,19,Herson
448,440,27,205,220,23,243,0,243,3,212,28,22.04.2019 00:30,186,19,Herson
480,467,20,217,247,16,263,0,263,5,241,17,22.04.2019 00:01,186,19,Herson
400,382,16,151,233,16,249,0,249,3,213,33,22.04.2019 00:35,186,19,Herson
1568,1569,36,736,797,35,832,0,832,4,669,159,22.04.2019 00:15,186,19,Herson
1376,1359,44,588,744,44,788,0,788,10,674,104,22.04.2019 00:30,186,19,Herson
464,457,5,203,259,2,261,0,261,2,222,37,22.04.2019 00:15,186,19,Herson
1040,1026,6,486,550,4,554,0,554,5,438,111,22.04.2019 00:10,186,19,Herson
1280,1251,24,591,671,18,689,0,689,6,607,76,22.04.2019 00:20,186,19,Herson
2112,2076,37,1070,1018,24,1042,0,1042,10,916,116,22.04.2019 00:30,186,19,Herson
320,316,6,152,162,6,168,0,168,4,134,30,22.04.2019 00:30,186,19,Herson
880,855,4,450,428,2,430,0,430,7,383,40,22.04.2019 00:45,186,19,Herson
864,847,4,474,386,4,390,0,390,3,351,36,22.04.2019 00:10,186,19,Herson
720,703,2,329,389,2,391,0,391,0,374,17,22.04.2019 00:30,186,19,Herson
1024,1014,6,516,502,6,508,0,508,4,459,45,22.04.2019 00:05,186,19,Herson
1040,1015,6,527,507,6,513,0,513,2,485,26,22.04.2019 01:30,186,19,Herson
960,946,44,460,461,39,500,0,500,10,413,77,22.04.2019 00:02,186,19,Herson
2192,2172,0,1030,1162,0,1162,0,1162,22,1005,135,22.04.2019 00:25,186,19,Herson
2096,2073,3,1116,977,3,980,0,980,14,840,126,22.04.2019 00:40,186,19,Herson
288,278,0,119,169,0,169,0,169,4,129,36,22.04.2019 00:30,186,19,Herson
1296,1271,21,577,700,19,719,0,719,7,638,74,22.04.2019 00:05,186,19,Herson
768,750,31,392,348,28,376,0,376,3,326,47,22.04.2019 00:05,186,19,Herson
1456,1429,31,770,659,27,686,0,686,10,561,115,22.04.2019 00:25,186,19,Herson
1472,1454,8,678,787,7,794,0,794,11,712,71,22.04.2019 00:10,186,19,Herson
432,422,12,159,261,12,273,0,273,7,239,27,22.04.2019 00:05,186,19,Herson
400,389,2,184,214,2,216,0,216,3,191,22,22.04.2019 01:20,186,19,Herson
1200,1193,52,574,588,38,626,0,626,3,571,52,22.04.2019 01:10,186,19,Herson
1168,1139,50,519,605,44,649,0,649,7,530,112,22.04.2019 00:40,186,19,Herson
128,112,0,68,60,0,60,0,60,0,57,3,22.04.2019 00:30,186,19,Herson
944,924,8,583,353,8,361,0,361,7,317,37,22.04.2019 00:15,186,19,Herson
1040,1028,3,546,491,3,494,0,494,11,416,67,22.04.2019 00:50,186,19,Herson
720,682,1,336,383,1,384,0,384,7,325,52,22.04.2019 00:15,186,19,Herson
720,692,4,383,334,3,337,0,337,11,290,36,22.04.2019 01:05,186,19,Herson
1088,1068,5,511,572,5,577,0,577,9,548,20,22.04.2019 00:45,186,19,Herson
944,940,6,503,436,5,441,0,441,3,351,87,21.04.2019 21:40,186,19,Herson
1296,1274,5,695,597,4,601,0,601,12,512,77,22.04.2019 00:05,186,19,Herson
640,622,0,357,283,0,283,0,283,8,216,59,22.04.2019 00:15,186,19,Herson
1264,1247,3,622,639,3,642,0,642,7,563,72,22.04.2019 00:13,186,19,Herson
1728,1719,7,732,990,6,996,0,996,16,853,127,22.04.2019 01:05,186,19,Herson
1632,1627,16,657,961,14,975,0,975,14,845,116,22.04.2019 00:55,186,19,Herson
1632,1616,7,747,878,7,885,0,885,12,776,97,22.04.2019 01:20,186,19,Herson
1520,1523,7,698,816,6,822,0,822,18,721,83,22.04.2019 01:50,186,19,Herson
1424,1386,49,655,725,44,769,0,769,6,675,88,22.04.2019 00:30,186,19,Herson
208,194,3,86,119,3,122,0,122,1,97,24,22.04.2019 00:02,186,19,Herson
480,477,22,9,449,22,471,0,471,62,378,31,22.04.2019 00:15,187,20,Hmelnitsk
1152,1134,9,430,715,7,722,0,722,10,529,183,22.04.2019 00:05,187,20,Hmelnitsk
1936,1907,13,801,1124,11,1135,0,1135,38,873,224,22.04.2019 01:05,187,20,Hmelnitsk
1472,1448,24,584,873,15,888,0,888,29,664,195,22.04.2019 01:31,187,20,Hmelnitsk
1488,1482,6,535,952,1,953,0,952,26,695,231,22.04.2019 07:00,187,20,Hmelnitsk
2032,2010,19,800,1223,9,1232,0,1232,38,902,292,22.04.2019 02:50,187,20,Hmelnitsk
2000,1986,7,703,1294,3,1297,0,1297,41,921,335,22.04.2019 00:15,187,20,Hmelnitsk
2384,2354,9,753,1624,7,1631,0,1631,37,1132,462,22.04.2019 01:05,187,20,Hmelnitsk
2224,2186,8,788,1430,6,1436,0,1436,43,1056,337,22.04.2019 00:20,187,20,Hmelnitsk
1360,1349,20,483,860,17,877,0,877,25,660,192,22.04.2019 00:35,187,20,Hmelnitsk
1776,1753,20,613,1146,17,1163,0,1163,33,792,338,22.04.2019 00:10,187,20,Hmelnitsk
2336,2313,17,777,1549,10,1559,0,1559,53,1040,466,22.04.2019 00:20,187,20,Hmelnitsk
2128,2101,20,752,1363,13,1376,0,1374,46,1022,306,22.04.2019 00:17,187,20,Hmelnitsk
2160,2134,15,776,1373,11,1384,0,1384,27,973,384,22.04.2019 00:45,187,20,Hmelnitsk
2368,2333,8,874,1487,7,1494,0,1494,37,1052,405,22.04.2019 00:15,187,20,Hmelnitsk
2240,2211,28,794,1427,19,1446,0,1446,46,1006,394,22.04.2019 00:26,187,20,Hmelnitsk
2384,2362,16,840,1531,13,1544,0,1544,22,1099,423,22.04.2019 00:17,187,20,Hmelnitsk
1677,1662,18,631,1033,13,1046,0,1046,36,737,273,22.04.2019 03:25,187,20,Hmelnitsk
2208,2196,13,742,1457,9,1466,0,1466,39,1013,414,22.04.2019 00:15,187,20,Hmelnitsk
1840,1836,13,693,1137,10,1147,0,1147,34,832,281,22.04.2019 00:40,187,20,Hmelnitsk
1920,1908,16,739,1170,11,1181,0,1181,29,850,302,22.04.2019 00:28,187,20,Hmelnitsk
1552,1516,44,637,894,21,915,0,915,34,624,257,22.04.2019 01:40,187,20,Hmelnitsk
1728,1707,58,625,1065,38,1103,0,1103,36,769,298,22.04.2019 00:05,187,20,Hmelnitsk
2256,2181,11,1159,1088,9,1097,0,1097,25,814,258,22.04.2019 00:26,187,20,Hmelnitsk
2112,2091,27,733,1368,11,1379,0,1379,50,917,412,22.04.2019 01:00,187,20,Hmelnitsk
2000,1988,26,829,1155,16,1171,0,1171,28,873,270,22.04.2019 00:25,187,20,Hmelnitsk
2048,2013,37,757,1267,24,1291,0,1291,27,934,330,22.04.2019 01:15,187,20,Hmelnitsk
1904,1891,27,713,1175,16,1191,0,1191,32,861,298,22.04.2019 00:30,187,20,Hmelnitsk
2352,2324,30,815,1517,20,1537,0,1537,37,1079,421,22.04.2019 00:30,187,20,Hmelnitsk
1968,1945,14,691,1269,8,1277,0,1277,31,905,341,22.04.2019 07:03,187,20,Hmelnitsk
1856,1851,17,647,1198,11,1209,0,1209,37,845,327,22.04.2019 00:22,187,20,Hmelnitsk
1600,1591,25,579,1002,19,1021,0,1021,36,720,265,22.04.2019 00:11,187,20,Hmelnitsk
1920,1924,26,643,1266,11,1277,0,1277,40,859,378,22.04.2019 00:30,187,20,Hmelnitsk
2080,2058,13,749,1321,10,1331,0,1331,42,868,421,22.04.2019 00:24,187,20,Hmelnitsk
1184,1193,16,369,802,13,815,0,815,32,540,243,22.04.2019 00:05,187,20,Hmelnitsk
2128,2112,28,760,1345,23,1368,0,1368,43,932,393,22.04.2019 00:25,187,20,Hmelnitsk
1952,1923,29,666,1266,20,1286,0,1286,39,861,386,22.04.2019 02:31,187,20,Hmelnitsk
2112,2094,27,721,1374,17,1391,0,1391,44,965,382,22.04.2019 00:45,187,20,Hmelnitsk
2176,2159,13,762,1404,10,1414,0,1414,42,1010,362,22.04.2019 00:25,187,20,Hmelnitsk
2096,2082,18,680,1406,10,1416,0,1416,41,956,419,22.04.2019 01:00,187,20,Hmelnitsk
2240,2223,14,797,1434,9,1443,0,1442,35,965,442,22.04.2019 00:30,187,20,Hmelnitsk
2048,2322,18,378,1657,13,1670,0,1670,55,1137,478,22.04.2019 00:30,187,20,Hmelnitsk
2000,1971,25,722,1261,17,1278,0,1277,35,859,383,22.04.2019 00:45,187,20,Hmelnitsk
1824,1798,47,660,1131,33,1164,0,1164,43,765,356,22.04.2019 02:10,187,20,Hmelnitsk
2464,2343,11,1025,1434,5,1439,0,1439,45,946,448,22.04.2019 00:05,187,20,Hmelnitsk
1712,1692,16,557,1145,10,1155,0,1155,34,827,294,22.04.2019 00:50,187,20,Hmelnitsk
2032,2000,32,727,1280,25,1305,0,1305,47,962,296,22.04.2019 00:18,187,20,Hmelnitsk
2128,2103,45,748,1347,33,1380,0,1380,46,988,346,22.04.2019 02:20,187,20,Hmelnitsk
2000,1990,42,682,1280,38,1318,0,1318,32,927,359,22.04.2019 00:45,187,20,Hmelnitsk
2336,2316,35,888,1417,31,1448,0,1448,33,1014,401,22.04.2019 00:12,187,20,Hmelnitsk
2128,2094,15,866,1252,10,1262,0,1262,26,915,321,22.04.2019 01:15,187,20,Hmelnitsk
2352,2305,21,897,1440,15,1455,0,1455,34,1066,355,22.04.2019 00:04,187,20,Hmelnitsk
2192,2169,25,720,1453,19,1472,0,1472,54,1024,394,22.04.2019 00:20,187,20,Hmelnitsk
2432,2405,22,785,1631,16,1647,0,1647,46,1055,546,22.04.2019 00:15,187,20,Hmelnitsk
2128,2078,22,704,1408,16,1424,0,1424,39,948,437,22.04.2019 00:40,187,20,Hmelnitsk
1600,1804,16,353,1237,10,1247,0,1247,29,865,353,22.04.2019 00:40,187,20,Hmelnitsk
2000,2213,26,554,1428,18,1446,0,1446,33,1020,393,22.04.2019 00:40,187,20,Hmelnitsk
2304,2283,22,835,1460,9,1469,43,1469,43,1026,400,22.04.2019 00:35,187,20,Hmelnitsk
2304,2284,13,753,1541,10,1551,0,1551,34,1054,463,22.04.2019 00:15,187,20,Hmelnitsk
2224,2184,15,886,1328,10,1338,0,1338,32,974,332,22.04.2019 00:15,187,20,Hmelnitsk
2112,2085,12,901,1205,6,1211,0,1211,35,876,300,22.04.2019 00:30,187,20,Hmelnitsk
2256,2224,41,738,1491,27,1518,0,1518,38,1132,348,22.04.2019 00:30,187,20,Hmelnitsk
2096,2068,24,768,1309,19,1328,0,1328,35,961,332,22.04.2019 02:06,187,20,Hmelnitsk
1968,1935,19,733,1220,15,1235,0,1235,46,942,247,22.04.2019 00:15,187,20,Hmelnitsk
2384,2291,13,896,1477,11,1488,0,1488,33,978,477,22.04.2019 01:15,187,20,Hmelnitsk
1824,1805,21,664,1145,15,1160,0,1160,34,853,273,22.04.2019 00:25,187,20,Hmelnitsk
2144,2084,23,748,1380,16,1396,0,1396,37,1021,338,22.04.2019 00:15,187,20,Hmelnitsk
1472,1460,8,466,998,8,1006,0,1006,20,720,266,22.04.2019 00:25,187,20,Hmelnitsk
1760,1729,9,674,1078,8,1086,0,1086,37,804,245,22.04.2019 00:40,187,20,Hmelnitsk
1552,1537,51,492,1021,39,1060,0,1060,16,819,225,22.04.2019 01:57,187,20,Hmelnitsk
384,20,0,369,15,0,15,0,15,0,10,5,22.04.2019 00:40,187,20,Hmelnitsk
176,21,21,158,0,18,18,0,18,1,15,2,22.04.2019 00:25,187,20,Hmelnitsk
720,129,100,613,22,85,107,0,107,3,88,16,22.04.2019 00:17,187,20,Hmelnitsk
224,74,0,160,64,0,64,1,64,1,49,14,22.04.2019 00:20,187,20,Hmelnitsk
256,4,0,252,4,0,4,0,4,0,2,2,22.04.2019 00:10,187,20,Hmelnitsk
352,71,13,284,55,13,68,0,68,4,50,14,22.04.2019 00:15,187,20,Hmelnitsk
80,17,0,63,17,0,17,0,17,1,14,2,22.04.2019 00:10,187,20,Hmelnitsk
816,274,252,633,20,163,183,0,183,8,140,35,22.04.2019 00:03,187,20,Hmelnitsk
112,4,0,108,4,0,4,0,4,0,3,1,22.04.2019 00:25,187,20,Hmelnitsk
176,29,6,163,9,4,13,0,13,0,11,2,22.04.2019 00:20,187,20,Hmelnitsk
1968,1922,7,617,1346,5,1351,0,1351,33,935,383,22.04.2019 00:30,187,20,Hmelnitsk
1664,1636,12,640,1018,6,1024,0,1024,30,794,200,22.04.2019 00:15,187,20,Hmelnitsk
432,420,52,140,245,47,292,0,292,2,173,117,22.04.2019 00:20,188,20,Hmelnitsk
336,328,46,117,180,39,219,0,219,5,169,45,22.04.2019 00:25,188,20,Hmelnitsk
304,289,22,82,200,22,222,0,222,4,155,63,22.04.2019 00:06,188,20,Hmelnitsk
112,100,9,41,64,7,71,0,71,5,47,19,21.04.2019 21:40,188,20,Hmelnitsk
256,247,28,90,140,26,166,0,166,2,116,48,22.04.2019 00:30,188,20,Hmelnitsk
208,194,29,57,128,23,151,0,151,1,100,50,22.04.2019 00:43,188,20,Hmelnitsk
688,667,27,255,411,22,433,0,433,13,311,109,22.04.2019 00:16,188,20,Hmelnitsk
128,124,8,40,82,6,88,0,88,2,57,29,22.04.2019 00:15,188,20,Hmelnitsk
240,229,35,47,163,30,193,0,193,2,124,67,22.04.2019 00:10,188,20,Hmelnitsk
752,734,54,229,476,47,523,0,523,7,372,144,22.04.2019 02:15,188,20,Hmelnitsk
1968,1949,21,772,1178,18,1196,0,1196,36,873,287,22.04.2019 00:55,188,20,Hmelnitsk
2096,2078,16,864,1218,14,1232,0,1232,25,926,281,22.04.2019 00:58,188,20,Hmelnitsk
1456,1438,9,612,835,9,844,0,844,20,657,167,22.04.2019 00:10,188,20,Hmelnitsk
2368,2335,12,1003,1357,8,1365,0,1365,39,963,363,22.04.2019 00:15,188,20,Hmelnitsk
2432,2397,8,1062,1362,8,1370,0,1370,43,991,336,22.04.2019 00:48,188,20,Hmelnitsk
2016,1999,9,871,1141,4,1145,0,1145,31,883,231,22.04.2019 00:20,188,20,Hmelnitsk
2176,2145,16,963,1204,9,1213,0,1213,42,906,265,22.04.2019 01:15,188,20,Hmelnitsk
448,439,22,200,230,18,248,0,248,1,208,39,22.04.2019 00:15,188,20,Hmelnitsk
448,441,47,149,262,37,299,0,299,6,217,76,22.04.2019 01:00,188,20,Hmelnitsk
304,294,24,111,172,21,193,0,193,4,142,47,22.04.2019 00:12,188,20,Hmelnitsk
320,301,21,119,184,17,201,0,201,4,139,58,22.04.2019 00:14,188,20,Hmelnitsk
416,405,70,129,221,66,287,0,287,8,222,57,22.04.2019 00:25,188,20,Hmelnitsk
288,284,43,107,142,39,181,0,181,7,134,40,22.04.2019 00:25,188,20,Hmelnitsk
144,132,14,34,97,13,110,0,110,2,61,47,22.04.2019 00:50,188,20,Hmelnitsk
176,176,25,34,118,24,142,0,142,6,98,38,22.04.2019 00:50,188,20,Hmelnitsk
368,349,37,107,224,37,261,0,261,7,199,55,22.04.2019 00:30,188,20,Hmelnitsk
448,433,76,133,243,72,315,0,315,3,246,66,22.04.2019 00:20,188,20,Hmelnitsk
672,656,37,228,409,35,444,0,444,11,343,90,22.04.2019 00:03,188,20,Hmelnitsk
544,528,54,142,353,49,402,0,402,10,297,95,22.04.2019 00:05,188,20,Hmelnitsk
272,267,23,98,152,22,174,0,174,2,133,39,22.04.2019 01:00,188,20,Hmelnitsk
1232,1206,29,465,741,26,767,0,767,16,578,173,22.04.2019 00:07,188,20,Hmelnitsk
656,636,16,271,370,15,385,0,385,5,301,79,22.04.2019 00:02,188,20,Hmelnitsk
672,670,59,221,394,57,451,0,451,4,373,74,22.04.2019 00:30,188,20,Hmelnitsk
320,303,33,128,159,33,192,0,192,2,143,47,22.04.2019 00:15,188,20,Hmelnitsk
528,513,28,174,327,27,354,0,354,4,225,125,22.04.2019 00:50,188,20,Hmelnitsk
192,192,23,55,114,23,137,0,137,1,95,41,22.04.2019 00:20,188,20,Hmelnitsk
432,433,21,128,285,19,304,0,304,7,237,60,22.04.2019 00:55,188,20,Hmelnitsk
560,557,53,180,331,49,380,0,380,7,305,68,22.04.2019 00:10,188,20,Hmelnitsk
1152,1136,55,403,700,49,749,0,749,21,465,263,22.04.2019 00:26,188,20,Hmelnitsk
752,748,65,302,388,62,450,0,450,7,314,129,22.04.2019 01:00,188,20,Hmelnitsk
144,140,16,50,80,14,94,0,94,1,73,20,22.04.2019 00:50,188,20,Hmelnitsk
176,173,17,59,102,15,117,0,117,1,88,28,22.04.2019 01:35,188,20,Hmelnitsk
368,347,42,150,178,40,218,0,218,5,165,48,22.04.2019 00:03,188,20,Hmelnitsk
208,195,18,85,107,16,123,0,123,4,84,35,22.04.2019 00:30,188,20,Hmelnitsk
64,56,13,24,27,13,40,0,40,1,30,9,22.04.2019 01:10,188,20,Hmelnitsk
320,306,32,122,170,28,198,0,198,4,151,43,22.04.2019 00:30,188,20,Hmelnitsk
96,95,6,34,56,6,62,0,62,2,34,26,22.04.2019 00:20,188,20,Hmelnitsk
224,209,20,99,109,16,125,0,125,4,80,41,22.04.2019 00:30,188,20,Hmelnitsk
64,68,8,18,41,5,46,0,46,0,27,19,22.04.2019 00:20,188,20,Hmelnitsk
1280,1263,106,459,723,98,821,0,821,19,547,255,22.04.2019 02:00,188,20,Hmelnitsk
656,639,38,277,343,36,379,0,379,10,286,83,22.04.2019 01:30,188,20,Hmelnitsk
176,167,6,60,112,4,116,0,116,2,74,40,22.04.2019 00:55,188,20,Hmelnitsk
80,71,16,21,44,15,59,0,59,0,45,14,22.04.2019 00:07,188,20,Hmelnitsk
304,300,39,37,232,35,267,0,267,0,215,52,21.04.2019 23:30,188,20,Hmelnitsk
144,136,16,31,102,11,113,0,113,5,91,17,22.04.2019 00:37,188,20,Hmelnitsk
96,85,8,28,61,7,68,0,68,1,52,15,22.04.2019 00:10,188,20,Hmelnitsk
368,348,48,139,184,45,229,0,229,2,155,72,22.04.2019 00:20,188,20,Hmelnitsk
256,256,18,66,173,17,190,0,190,1,140,49,22.04.2019 00:08,188,20,Hmelnitsk
80,80,9,18,55,7,62,0,62,0,47,15,22.04.2019 00:05,188,20,Hmelnitsk
256,243,24,76,160,20,180,0,180,3,126,51,22.04.2019 00:35,188,20,Hmelnitsk
112,106,23,22,67,23,90,0,90,2,74,14,22.04.2019 00:25,188,20,Hmelnitsk
720,709,51,258,413,49,462,0,462,5,386,71,22.04.2019 01:20,188,20,Hmelnitsk
416,408,18,150,249,17,266,0,266,4,219,43,22.04.2019 02:25,188,20,Hmelnitsk
64,61,10,21,33,10,43,0,43,1,29,13,22.04.2019 00:20,188,20,Hmelnitsk
416,405,40,143,233,40,273,0,273,9,192,72,22.04.2019 00:23,188,20,Hmelnitsk
192,191,24,79,93,20,113,0,113,3,72,38,22.04.2019 00:01,188,20,Hmelnitsk
160,159,16,41,105,14,119,0,119,1,86,32,22.04.2019 01:05,188,20,Hmelnitsk
368,367,51,85,235,48,283,0,283,3,231,49,22.04.2019 00:06,188,20,Hmelnitsk
320,317,31,103,186,31,217,0,217,6,171,40,22.04.2019 00:05,188,20,Hmelnitsk
368,357,33,97,240,31,271,0,271,6,204,61,22.04.2019 00:25,188,20,Hmelnitsk
224,215,55,71,104,49,153,0,153,5,111,37,22.04.2019 00:35,188,20,Hmelnitsk
288,275,20,135,135,18,153,0,153,2,97,54,22.04.2019 00:01,188,20,Hmelnitsk
224,209,35,77,112,35,147,0,147,3,88,56,22.04.2019 00:15,188,20,Hmelnitsk
448,437,45,162,246,40,286,0,286,7,211,68,22.04.2019 00:10,188,20,Hmelnitsk
64,62,12,20,35,9,44,0,44,1,26,17,22.04.2019 00:26,188,20,Hmelnitsk
240,236,27,67,148,25,173,0,173,0,129,44,22.04.2019 00:05,188,20,Hmelnitsk
160,151,29,48,84,28,112,0,112,2,70,40,22.04.2019 00:02,188,20,Hmelnitsk
544,536,41,213,296,35,331,0,331,7,234,90,22.04.2019 00:30,188,20,Hmelnitsk
512,505,76,152,293,67,360,0,360,4,278,78,22.04.2019 01:10,188,20,Hmelnitsk
368,364,76,82,216,70,286,0,286,6,185,95,22.04.2019 00:05,188,20,Hmelnitsk
448,436,23,142,285,21,306,0,306,7,239,60,22.04.2019 00:30,188,20,Hmelnitsk
368,356,31,141,196,31,227,0,227,8,171,48,22.04.2019 00:05,188,20,Hmelnitsk
336,323,45,102,190,44,234,0,234,4,185,45,21.04.2019 20:30,188,20,Hmelnitsk
448,447,55,154,242,52,294,0,294,1,219,74,22.04.2019 00:30,188,20,Hmelnitsk
288,274,23,111,154,23,177,0,177,4,125,48,22.04.2019 00:15,188,20,Hmelnitsk
1088,1065,11,444,633,11,644,0,644,23,501,120,22.04.2019 00:40,188,20,Hmelnitsk
288,282,22,103,164,21,185,0,185,3,143,39,22.04.2019 00:25,188,20,Hmelnitsk
192,187,17,92,83,17,100,0,100,0,73,27,22.04.2019 00:45,188,20,Hmelnitsk
176,161,15,77,84,15,99,0,99,0,60,39,22.04.2019 00:45,188,20,Hmelnitsk
720,710,12,284,426,10,436,0,436,13,318,105,22.04.2019 00:50,188,20,Hmelnitsk
368,352,44,142,189,37,226,0,226,5,160,61,21.04.2019 22:00,188,20,Hmelnitsk
336,322,16,110,210,16,226,0,226,3,172,51,21.04.2019 23:50,188,20,Hmelnitsk
1696,1663,32,650,1017,29,1046,0,1046,25,716,305,22.04.2019 00:03,188,20,Hmelnitsk
480,462,58,169,260,51,311,0,311,10,243,58,22.04.2019 00:05,188,20,Hmelnitsk
352,345,15,160,177,15,192,0,192,2,101,89,22.04.2019 00:49,188,20,Hmelnitsk
2416,2375,53,983,1384,49,1433,0,1433,25,1040,368,22.04.2019 00:42,188,20,Hmelnitsk
1552,1542,34,598,921,33,954,0,954,20,717,217,22.04.2019 00:30,188,20,Hmelnitsk
144,130,24,45,75,24,99,0,99,1,59,39,21.04.2019 21:20,188,20,Hmelnitsk
448,443,58,122,268,58,326,0,326,9,223,94,22.04.2019 00:05,188,20,Hmelnitsk
352,335,41,138,176,38,214,0,214,4,179,31,22.04.2019 00:01,188,20,Hmelnitsk
528,523,49,207,273,48,321,0,321,7,241,73,22.04.2019 00:25,188,20,Hmelnitsk
656,649,23,233,400,23,423,0,423,11,316,96,22.04.2019 02:05,188,20,Hmelnitsk
528,513,15,187,326,15,341,0,341,8,235,98,22.04.2019 00:30,188,20,Hmelnitsk
240,223,13,48,179,13,192,0,192,3,121,68,22.04.2019 00:00,188,20,Hmelnitsk
320,304,17,110,193,17,210,0,210,2,155,53,22.04.2019 00:01,188,20,Hmelnitsk
192,188,18,70,106,16,122,0,122,3,90,29,22.04.2019 00:05,188,20,Hmelnitsk
400,391,45,150,206,44,250,0,250,6,194,50,22.04.2019 00:05,188,20,Hmelnitsk
1088,1063,29,404,655,29,684,0,684,16,548,120,22.04.2019 00:07,188,20,Hmelnitsk
80,72,10,27,43,10,53,0,53,0,44,9,22.04.2019 00:10,188,20,Hmelnitsk
144,132,17,54,73,17,90,0,90,1,43,46,22.04.2019 00:05,188,20,Hmelnitsk
2016,1997,46,712,1263,41,1304,0,1304,13,1033,258,22.04.2019 00:06,188,20,Hmelnitsk
112,106,2,46,64,2,66,0,66,1,41,24,22.04.2019 00:10,188,20,Hmelnitsk
464,449,7,200,258,6,264,0,264,7,172,85,22.04.2019 00:15,188,20,Hmelnitsk
784,779,31,308,448,28,476,0,476,13,317,146,21.04.2019 22:35,188,20,Hmelnitsk
128,121,23,55,55,18,73,0,73,2,47,24,22.04.2019 00:03,188,20,Hmelnitsk
1344,1321,23,562,759,23,782,0,782,16,553,213,22.04.2019 00:30,188,20,Hmelnitsk
272,266,17,88,168,16,184,0,184,4,131,49,22.04.2019 00:10,188,20,Hmelnitsk
672,659,41,217,415,40,455,0,455,16,313,126,22.04.2019 01:40,188,20,Hmelnitsk
848,841,18,332,500,16,516,0,516,12,395,109,22.04.2019 00:15,188,20,Hmelnitsk
240,232,15,96,129,15,144,0,144,2,93,49,22.04.2019 00:15,188,20,Hmelnitsk
320,308,17,159,145,16,161,0,161,3,119,39,22.04.2019 00:10,188,20,Hmelnitsk
80,76,6,20,55,5,60,0,60,0,32,28,22.04.2019 00:02,188,20,Hmelnitsk
496,487,12,213,271,12,283,0,283,4,211,68,22.04.2019 00:39,188,20,Hmelnitsk
304,289,15,129,162,13,175,0,175,3,134,38,22.04.2019 00:20,188,20,Hmelnitsk
1968,1950,39,642,1291,35,1326,0,1326,19,1015,292,22.04.2019 00:10,188,20,Hmelnitsk
112,101,14,38,61,13,74,0,74,2,45,27,22.04.2019 00:01,188,20,Hmelnitsk
720,702,38,289,396,35,431,0,431,11,307,113,22.04.2019 00:12,188,20,Hmelnitsk
656,644,24,295,338,23,361,0,361,6,268,87,22.04.2019 00:15,188,20,Hmelnitsk
400,387,25,136,240,24,264,0,264,8,207,49,21.04.2019 23:52,188,20,Hmelnitsk
368,356,43,101,224,43,267,0,267,6,192,69,22.04.2019 00:10,188,20,Hmelnitsk
304,298,17,133,155,16,171,0,171,2,129,40,22.04.2019 00:20,188,20,Hmelnitsk
1056,1045,32,289,735,32,767,0,767,30,604,133,22.04.2019 00:50,188,20,Hmelnitsk
176,165,25,45,106,25,131,0,131,2,96,33,22.04.2019 00:10,188,20,Hmelnitsk
1152,1134,22,431,703,18,721,0,721,17,535,169,22.04.2019 00:10,188,20,Hmelnitsk
192,187,14,41,137,14,151,0,151,0,106,45,22.04.2019 00:30,188,20,Hmelnitsk
384,388,43,112,230,42,272,0,272,8,160,104,22.04.2019 00:15,188,20,Hmelnitsk
496,484,31,208,258,30,288,0,288,5,190,93,22.04.2019 00:05,188,20,Hmelnitsk
1024,1010,49,413,566,45,611,0,611,17,487,107,22.04.2019 00:32,188,20,Hmelnitsk
1184,1182,29,450,705,29,734,0,734,20,513,201,22.04.2019 00:30,188,20,Hmelnitsk
176,172,15,51,110,15,125,0,125,1,88,36,22.04.2019 00:35,188,20,Hmelnitsk
320,311,39,106,175,39,214,0,214,0,174,40,22.04.2019 00:35,188,20,Hmelnitsk
896,887,60,315,521,60,581,0,581,6,424,151,22.04.2019 00:12,188,20,Hmelnitsk
448,429,39,191,218,39,257,0,257,3,202,52,22.04.2019 00:14,188,20,Hmelnitsk
128,96,0,32,96,0,96,0,96,0,60,36,22.04.2019 00:15,188,20,Hmelnitsk
192,186,17,74,103,15,118,0,118,1,73,44,22.04.2019 00:17,188,20,Hmelnitsk
256,251,37,106,113,37,150,0,150,1,85,64,21.04.2019 21:15,188,20,Hmelnitsk
80,77,5,24,51,5,56,0,56,0,38,18,22.04.2019 00:02,188,20,Hmelnitsk
384,367,31,167,187,30,217,0,217,1,156,60,22.04.2019 00:05,188,20,Hmelnitsk
272,255,22,93,161,18,179,0,179,2,91,86,22.04.2019 00:30,188,20,Hmelnitsk
672,656,6,293,374,5,379,0,379,6,285,88,22.04.2019 00:10,188,20,Hmelnitsk
1824,1802,41,686,1098,40,1138,0,1138,25,876,237,22.04.2019 00:10,188,20,Hmelnitsk
320,313,19,115,188,17,205,0,205,7,133,65,21.04.2019 22:00,188,20,Hmelnitsk
496,488,36,183,277,36,313,0,313,6,235,72,22.04.2019 00:03,188,20,Hmelnitsk
96,22,6,75,15,6,21,0,21,1,18,2,22.04.2019 00:15,188,20,Hmelnitsk
320,128,37,193,90,37,127,0,127,6,86,35,22.04.2019 00:35,188,20,Hmelnitsk
160,44,5,121,34,5,39,0,39,2,30,7,22.04.2019 00:05,188,20,Hmelnitsk
1728,562,0,1166,562,0,562,0,562,35,498,29,22.04.2019 01:00,188,20,Hmelnitsk
1904,1882,8,760,1142,2,1144,0,1144,29,795,320,22.04.2019 00:40,188,20,Hmelnitsk
2384,2350,12,844,1533,7,1540,0,1540,32,1103,405,22.04.2019 00:25,188,20,Hmelnitsk
2416,2413,16,771,1635,10,1645,0,1645,59,1134,452,22.04.2019 00:05,188,20,Hmelnitsk
2288,2270,12,774,1506,8,1514,0,1514,49,1048,417,22.04.2019 00:50,188,20,Hmelnitsk
2352,2326,19,820,1520,12,1532,0,1532,36,1090,406,22.04.2019 00:50,188,20,Hmelnitsk
2208,2168,17,896,1299,13,1312,0,1312,34,954,324,22.04.2019 01:00,188,20,Hmelnitsk
2224,2208,9,907,1310,7,1317,0,1317,26,974,317,22.04.2019 00:55,188,20,Hmelnitsk
2432,2405,15,857,1563,12,1575,0,1575,37,1079,459,22.04.2019 00:20,188,20,Hmelnitsk
2128,2098,91,814,1236,78,1314,0,1314,37,917,360,22.04.2019 01:30,188,20,Hmelnitsk
1344,1321,20,517,811,16,827,0,827,31,555,241,22.04.2019 00:10,188,20,Hmelnitsk
1856,1836,10,681,1167,8,1175,0,1175,34,821,320,22.04.2019 01:20,188,20,Hmelnitsk
1936,1915,10,697,1231,8,1239,0,1239,35,870,334,22.04.2019 00:55,188,20,Hmelnitsk
2192,2170,19,852,1327,13,1340,0,1340,31,930,379,22.04.2019 00:08,188,20,Hmelnitsk
2256,2234,14,934,1313,9,1322,0,1322,42,997,283,22.04.2019 00:35,188,20,Hmelnitsk
1840,1824,11,638,1193,9,1202,0,1202,43,821,338,22.04.2019 01:01,188,20,Hmelnitsk
1760,1735,14,580,1169,11,1180,0,1180,24,836,320,22.04.2019 00:30,188,20,Hmelnitsk
2480,2438,7,847,1627,6,1633,0,1633,31,1168,434,22.04.2019 00:20,188,20,Hmelnitsk
2576,2566,8,828,1744,4,1748,0,1748,50,1222,476,22.04.2019 00:24,188,20,Hmelnitsk
2256,2240,21,784,1457,15,1472,0,1472,38,1052,382,22.04.2019 00:45,188,20,Hmelnitsk
2544,2522,3,961,1581,2,1583,0,1583,30,1088,465,22.04.2019 00:10,188,20,Hmelnitsk
1568,1558,15,525,1032,11,1043,0,1043,18,715,310,22.04.2019 00:15,188,20,Hmelnitsk
1776,1762,32,617,1137,22,1159,0,1159,25,812,322,22.04.2019 00:50,188,20,Hmelnitsk
2352,2352,14,828,1512,12,1524,0,1524,47,1059,418,22.04.2019 00:50,188,20,Hmelnitsk
2016,1995,16,628,1379,9,1388,0,1388,37,916,435,22.04.2019 00:30,188,20,Hmelnitsk
2032,2013,6,718,1312,2,1314,0,1314,37,921,356,22.04.2019 00:30,188,20,Hmelnitsk
2320,2293,6,849,1467,4,1471,0,1471,28,1020,423,22.04.2019 00:07,188,20,Hmelnitsk
2080,2051,11,753,1320,7,1327,0,1327,32,940,355,22.04.2019 00:38,188,20,Hmelnitsk
2512,2511,4,928,1580,4,1584,0,1584,38,1138,408,22.04.2019 00:33,188,20,Hmelnitsk
2064,2042,13,692,1365,7,1372,0,1372,41,945,386,21.04.2019 22:30,188,20,Hmelnitsk
1520,1482,12,555,954,11,965,0,965,17,654,294,22.04.2019 01:30,188,20,Hmelnitsk
1424,1405,18,513,896,15,911,0,911,21,669,221,22.04.2019 00:20,188,20,Hmelnitsk
1136,1101,54,466,623,47,670,0,670,7,476,187,22.04.2019 05:35,189,20,Hmelnitsk
2224,2191,38,904,1288,32,1320,0,1320,33,982,305,22.04.2019 01:15,189,20,Hmelnitsk
1040,1016,26,444,570,26,596,0,596,8,501,87,22.04.2019 00:48,189,20,Hmelnitsk
256,252,6,104,146,6,152,0,152,2,134,16,21.04.2019 23:15,189,20,Hmelnitsk
160,148,4,62,95,3,98,0,98,1,76,21,21.04.2019 21:00,189,20,Hmelnitsk
288,270,37,108,147,33,180,0,180,2,127,51,22.04.2019 00:55,189,20,Hmelnitsk
64,56,1,30,34,0,34,0,34,4,21,9,22.04.2019 00:25,189,20,Hmelnitsk
272,254,8,146,118,8,126,0,126,0,78,48,22.04.2019 00:30,189,20,Hmelnitsk
240,221,19,94,128,18,146,0,146,1,96,49,22.04.2019 00:20,189,20,Hmelnitsk
208,196,14,81,114,13,127,0,127,2,88,37,22.04.2019 00:27,189,20,Hmelnitsk
288,282,18,116,154,18,172,0,172,0,145,27,22.04.2019 00:24,189,20,Hmelnitsk
240,227,14,84,144,12,156,0,156,4,114,38,21.04.2019 23:45,189,20,Hmelnitsk
224,206,18,87,120,17,137,0,137,3,104,30,22.04.2019 00:20,189,20,Hmelnitsk
720,702,25,200,495,25,520,0,520,6,407,107,22.04.2019 01:00,189,20,Hmelnitsk
512,502,42,198,278,36,314,0,314,7,242,65,21.04.2019 21:30,189,20,Hmelnitsk
144,140,5,59,80,5,85,0,85,1,64,20,21.04.2019 22:05,189,20,Hmelnitsk
288,288,18,47,223,18,241,0,241,1,184,56,21.04.2019 22:19,189,20,Hmelnitsk
224,216,15,61,149,14,163,0,163,2,106,55,21.04.2019 21:41,189,20,Hmelnitsk
80,79,3,16,62,2,64,0,64,1,43,20,22.04.2019 01:30,189,20,Hmelnitsk
384,368,32,160,194,30,224,0,224,13,160,51,22.04.2019 00:15,189,20,Hmelnitsk
816,798,71,370,381,65,446,0,446,6,296,144,22.04.2019 00:18,189,20,Hmelnitsk
192,178,4,87,102,3,105,0,105,1,79,25,21.04.2019 22:10,189,20,Hmelnitsk
80,66,5,41,35,4,39,0,39,1,21,17,21.04.2019 22:55,189,20,Hmelnitsk
80,74,3,32,45,3,48,0,48,0,35,13,22.04.2019 00:15,189,20,Hmelnitsk
272,260,11,57,204,11,215,0,215,4,128,83,22.04.2019 01:05,189,20,Hmelnitsk
384,371,41,93,253,38,291,0,291,2,246,43,21.04.2019 23:58,189,20,Hmelnitsk
192,188,14,35,143,14,157,0,157,0,109,48,22.04.2019 00:30,189,20,Hmelnitsk
304,292,19,118,172,14,186,0,186,4,123,59,22.04.2019 02:25,189,20,Hmelnitsk
160,146,16,66,79,15,94,0,94,1,60,33,22.04.2019 00:01,189,20,Hmelnitsk
304,297,26,114,164,26,190,0,190,1,138,51,21.04.2019 22:00,189,20,Hmelnitsk
64,56,0,32,32,0,32,0,32,0,16,16,22.04.2019 02:36,189,20,Hmelnitsk
192,183,16,65,112,15,127,0,127,6,102,19,22.04.2019 00:18,189,20,Hmelnitsk
160,155,13,53,95,12,107,0,107,0,82,25,22.04.2019 01:00,189,20,Hmelnitsk
176,164,20,74,82,20,102,0,102,1,66,35,22.04.2019 01:15,189,20,Hmelnitsk
336,325,37,122,184,30,214,0,214,6,178,30,22.04.2019 00:35,189,20,Hmelnitsk
576,563,43,211,324,41,365,0,365,6,265,94,22.04.2019 00:52,189,20,Hmelnitsk
496,487,31,134,331,31,362,0,362,4,286,72,22.04.2019 01:40,189,20,Hmelnitsk
336,330,9,115,212,9,221,0,221,1,190,30,21.04.2019 22:15,189,20,Hmelnitsk
464,450,41,180,245,39,284,0,284,8,213,63,21.04.2019 22:30,189,20,Hmelnitsk
144,137,13,59,73,12,85,0,85,0,51,34,22.04.2019 00:15,189,20,Hmelnitsk
448,436,54,153,241,54,295,0,295,2,217,76,21.04.2019 23:58,189,20,Hmelnitsk
288,274,30,96,165,27,192,0,192,4,144,44,21.04.2019 21:10,189,20,Hmelnitsk
112,115,11,27,74,11,85,0,85,1,61,23,22.04.2019 00:45,189,20,Hmelnitsk
336,327,34,151,154,31,185,0,185,4,119,62,22.04.2019 00:45,189,20,Hmelnitsk
400,379,52,152,198,50,248,0,248,3,186,59,22.04.2019 00:05,189,20,Hmelnitsk
240,228,18,90,132,18,150,0,150,4,108,38,22.04.2019 00:35,189,20,Hmelnitsk
96,80,6,34,56,6,62,0,62,1,39,22,22.04.2019 01:15,189,20,Hmelnitsk
464,454,29,154,284,26,310,0,310,2,235,73,22.04.2019 02:40,189,20,Hmelnitsk
272,266,27,54,191,27,218,0,218,1,98,119,22.04.2019 00:50,189,20,Hmelnitsk
176,167,13,59,105,12,117,0,117,1,74,42,22.04.2019 00:15,189,20,Hmelnitsk
288,282,31,102,159,27,186,0,186,8,112,66,22.04.2019 00:22,189,20,Hmelnitsk
256,249,29,98,130,28,158,0,158,3,108,47,22.04.2019 00:17,189,20,Hmelnitsk
224,217,26,81,120,23,143,0,143,2,115,26,22.04.2019 00:50,189,20,Hmelnitsk
1440,1407,60,562,829,49,878,0,878,20,636,222,22.04.2019 01:15,189,20,Hmelnitsk
480,466,29,122,330,28,358,0,358,11,254,93,22.04.2019 00:25,189,20,Hmelnitsk
560,552,39,243,283,34,317,0,317,6,224,87,22.04.2019 00:45,189,20,Hmelnitsk
432,427,15,77,340,15,355,0,355,13,261,81,21.04.2019 22:20,189,20,Hmelnitsk
448,431,41,199,218,31,249,0,249,6,181,62,22.04.2019 06:00,189,20,Hmelnitsk
384,371,43,150,193,41,234,0,234,4,164,66,22.04.2019 00:32,189,20,Hmelnitsk
1152,1134,34,450,669,33,702,0,702,18,438,246,22.04.2019 01:30,189,20,Hmelnitsk
128,118,10,47,71,10,81,0,81,0,47,34,22.04.2019 00:15,189,20,Hmelnitsk
128,118,17,44,70,14,84,0,84,5,42,37,22.04.2019 01:40,189,20,Hmelnitsk
832,804,35,375,422,35,457,0,457,3,351,103,22.04.2019 00:30,189,20,Hmelnitsk
64,63,5,18,41,5,46,0,46,0,17,29,22.04.2019 05:55,189,20,Hmelnitsk
320,314,10,146,164,10,174,0,174,2,98,74,21.04.2019 21:24,189,20,Hmelnitsk
336,334,42,115,188,33,221,0,221,6,158,57,21.04.2019 23:57,189,20,Hmelnitsk
128,126,15,56,64,8,72,0,72,0,43,29,22.04.2019 05:45,189,20,Hmelnitsk
176,164,22,66,90,20,110,0,110,1,61,48,22.04.2019 01:20,189,20,Hmelnitsk
80,72,8,33,39,8,47,0,47,0,26,21,22.04.2019 01:00,189,20,Hmelnitsk
176,168,13,79,85,12,97,0,97,3,73,21,22.04.2019 02:00,189,20,Hmelnitsk
96,82,6,40,51,5,56,0,56,1,37,18,22.04.2019 01:10,189,20,Hmelnitsk
80,73,8,39,35,6,41,0,41,1,22,18,22.04.2019 00:16,189,20,Hmelnitsk
1120,1098,15,457,650,13,663,0,663,21,411,231,22.04.2019 03:55,189,20,Hmelnitsk
1792,1767,16,802,977,13,990,0,990,33,675,282,22.04.2019 00:24,189,20,Hmelnitsk
1392,1372,14,604,778,10,788,0,788,15,562,211,22.04.2019 02:15,189,20,Hmelnitsk
1600,1580,23,685,898,17,915,0,915,21,677,217,22.04.2019 01:45,189,20,Hmelnitsk
1232,1204,20,519,696,17,713,0,713,11,503,199,22.04.2019 00:15,189,20,Hmelnitsk
1376,1356,8,577,794,5,799,0,799,19,524,256,22.04.2019 00:18,189,20,Hmelnitsk
1824,1781,7,826,995,3,998,0,998,35,725,238,22.04.2019 00:05,189,20,Hmelnitsk
1232,1216,7,580,647,5,652,0,652,21,488,143,22.04.2019 00:30,189,20,Hmelnitsk
1408,1384,74,678,681,49,730,0,730,19,539,172,22.04.2019 00:55,189,20,Hmelnitsk
448,442,36,201,215,32,247,0,247,7,168,72,22.04.2019 00:47,189,20,Hmelnitsk
400,388,26,142,236,22,258,0,258,4,122,132,22.04.2019 00:24,189,20,Hmelnitsk
128,118,17,53,60,15,75,0,75,0,40,35,22.04.2019 00:15,189,20,Hmelnitsk
256,241,32,108,117,31,148,0,148,3,100,45,21.04.2019 22:15,189,20,Hmelnitsk
192,180,13,70,110,12,122,0,122,2,89,31,21.04.2019 23:10,189,20,Hmelnitsk
320,322,18,68,235,17,252,0,252,4,195,53,22.04.2019 01:45,189,20,Hmelnitsk
272,254,21,81,170,21,191,0,191,2,134,55,21.04.2019 23:00,189,20,Hmelnitsk
640,633,33,288,320,32,352,0,352,3,283,66,22.04.2019 00:30,189,20,Hmelnitsk
448,429,45,160,243,45,288,0,288,5,172,111,21.04.2019 23:58,189,20,Hmelnitsk
288,283,34,104,157,27,184,0,184,4,128,52,21.04.2019 21:00,189,20,Hmelnitsk
656,636,12,80,564,12,576,0,576,10,385,181,22.04.2019 00:34,189,20,Hmelnitsk
160,153,11,26,123,11,134,0,134,4,82,48,21.04.2019 23:20,189,20,Hmelnitsk
112,108,7,26,80,6,86,0,86,2,52,32,22.04.2019 00:11,189,20,Hmelnitsk
800,779,64,338,400,62,462,0,462,10,243,209,21.04.2019 22:05,189,20,Hmelnitsk
304,293,9,107,189,8,197,0,197,5,122,70,21.04.2019 23:58,189,20,Hmelnitsk
256,238,17,95,146,15,161,0,161,4,102,55,21.04.2019 23:59,189,20,Hmelnitsk
64,63,3,25,38,1,39,0,39,1,25,13,22.04.2019 01:50,189,20,Hmelnitsk
560,542,25,283,253,24,277,0,277,7,188,82,22.04.2019 00:23,189,20,Hmelnitsk
144,141,11,31,102,11,113,0,113,1,73,39,21.04.2019 21:00,189,20,Hmelnitsk
1088,1067,69,505,516,67,583,0,583,7,372,204,22.04.2019 05:15,189,20,Hmelnitsk
880,859,46,379,458,43,501,0,501,7,352,142,22.04.2019 02:10,189,20,Hmelnitsk
208,193,16,78,114,16,130,0,130,1,90,39,22.04.2019 00:25,189,20,Hmelnitsk
448,439,62,182,205,61,266,0,266,2,97,167,22.04.2019 00:20,189,20,Hmelnitsk
1104,1085,78,444,588,72,660,0,660,10,460,190,22.04.2019 01:14,189,20,Hmelnitsk
288,270,15,148,125,15,140,0,140,3,89,48,22.04.2019 03:00,189,20,Hmelnitsk
448,437,28,207,216,25,241,0,241,5,146,90,22.04.2019 00:30,189,20,Hmelnitsk
256,246,18,118,122,16,138,0,138,2,91,45,21.04.2019 23:00,189,20,Hmelnitsk
192,188,23,82,90,20,110,0,110,1,77,32,21.04.2019 23:00,189,20,Hmelnitsk
192,184,13,67,114,11,125,0,125,1,74,50,21.04.2019 23:00,189,20,Hmelnitsk
304,305,18,99,187,18,205,0,205,7,150,48,22.04.2019 00:30,189,20,Hmelnitsk
64,58,0,24,40,0,40,0,40,0,25,15,22.04.2019 00:05,189,20,Hmelnitsk
368,355,19,170,179,19,198,0,198,0,142,56,21.04.2019 22:05,189,20,Hmelnitsk
80,77,3,22,55,3,58,0,58,7,39,12,21.04.2019 23:00,189,20,Hmelnitsk
128,121,10,42,80,6,86,0,86,3,50,33,21.04.2019 23:00,189,20,Hmelnitsk
160,147,6,57,98,5,103,0,103,4,66,33,21.04.2019 22:30,189,20,Hmelnitsk
288,276,17,91,181,16,197,0,197,6,137,54,21.04.2019 23:30,189,20,Hmelnitsk
176,171,17,77,84,15,99,0,99,1,72,26,21.04.2019 23:15,189,20,Hmelnitsk
176,165,16,95,70,11,81,0,81,0,48,33,22.04.2019 01:35,189,20,Hmelnitsk
224,224,18,91,117,16,133,0,133,2,67,64,22.04.2019 01:40,189,20,Hmelnitsk
208,199,22,73,114,21,135,0,135,2,92,41,21.04.2019 22:30,189,20,Hmelnitsk
128,123,18,36,76,16,92,0,92,3,59,30,21.04.2019 21:20,189,20,Hmelnitsk
320,308,9,67,245,8,253,0,253,4,163,86,22.04.2019 00:15,189,20,Hmelnitsk
160,147,3,50,107,3,110,0,110,1,54,55,21.04.2019 23:20,189,20,Hmelnitsk
336,335,30,126,184,26,210,0,210,2,138,70,22.04.2019 01:10,189,20,Hmelnitsk
64,55,13,14,37,13,50,0,50,0,17,33,22.04.2019 02:00,189,20,Hmelnitsk
336,324,19,136,181,19,200,0,200,4,116,80,21.04.2019 22:05,189,20,Hmelnitsk
160,147,7,61,92,7,99,0,99,3,61,35,21.04.2019 21:10,189,20,Hmelnitsk
160,156,15,38,107,15,122,0,122,0,80,42,21.04.2019 22:06,189,20,Hmelnitsk
672,204,0,476,196,0,196,0,196,9,166,21,22.04.2019 00:13,189,20,Hmelnitsk
896,107,0,791,105,0,105,0,105,4,91,10,21.04.2019 22:45,189,20,Hmelnitsk
1664,1647,12,721,936,7,943,0,943,26,720,197,21.04.2019 23:18,189,20,Hmelnitsk
1456,1434,18,623,817,16,833,0,833,20,647,166,21.04.2019 22:15,189,20,Hmelnitsk
2208,2188,20,983,1209,16,1225,0,1225,43,931,251,21.04.2019 23:11,189,20,Hmelnitsk
2304,2268,26,933,1349,22,1371,0,1371,23,1053,295,22.04.2019 00:55,189,20,Hmelnitsk
1920,1908,23,760,1144,16,1160,0,1160,23,948,189,21.04.2019 22:30,189,20,Hmelnitsk
2064,2037,29,860,1181,23,1204,0,1204,32,914,258,21.04.2019 21:00,189,20,Hmelnitsk
1616,1592,22,673,926,17,943,0,943,26,718,199,22.04.2019 00:10,189,20,Hmelnitsk
1936,1932,15,812,1113,11,1124,0,1124,37,882,205,22.04.2019 00:10,189,20,Hmelnitsk
816,790,46,332,438,46,484,0,484,8,345,131,21.04.2019 22:22,189,20,Hmelnitsk
928,921,63,370,495,63,558,0,558,12,438,108,21.04.2019 22:29,189,20,Hmelnitsk
416,407,25,150,241,25,266,0,266,2,204,60,21.04.2019 22:30,189,20,Hmelnitsk
176,164,3,53,120,3,123,0,123,3,84,36,22.04.2019 00:30,189,20,Hmelnitsk
176,171,7,57,113,6,119,0,119,5,79,35,21.04.2019 22:10,189,20,Hmelnitsk
176,166,19,65,94,17,111,0,111,2,76,33,21.04.2019 22:50,189,20,Hmelnitsk
560,546,49,240,272,48,320,0,320,7,286,27,21.04.2019 21:15,189,20,Hmelnitsk
224,216,21,88,115,21,136,0,136,2,117,17,22.04.2019 00:10,189,20,Hmelnitsk
64,62,3,23,38,3,41,0,41,0,35,6,21.04.2019 22:45,189,20,Hmelnitsk
224,221,29,76,123,25,148,0,148,0,117,31,22.04.2019 02:10,189,20,Hmelnitsk
96,80,8,39,49,8,57,0,57,2,23,32,22.04.2019 00:45,189,20,Hmelnitsk
400,392,23,145,233,22,255,0,255,4,210,41,21.04.2019 21:55,189,20,Hmelnitsk
224,219,10,98,116,10,126,0,126,1,99,26,21.04.2019 21:00,189,20,Hmelnitsk
304,300,21,122,161,21,182,0,182,3,144,35,22.04.2019 00:56,189,20,Hmelnitsk
192,191,10,67,117,8,125,0,125,2,98,25,21.04.2019 21:00,189,20,Hmelnitsk
64,58,6,32,28,4,32,0,32,0,19,13,21.04.2019 22:58,189,20,Hmelnitsk
176,160,11,71,94,11,105,0,105,0,71,34,21.04.2019 21:00,189,20,Hmelnitsk
608,588,21,178,412,18,430,0,430,5,303,122,21.04.2019 21:20,189,20,Hmelnitsk
288,278,23,90,177,21,198,0,198,2,139,57,22.04.2019 00:20,189,20,Hmelnitsk
240,242,9,94,137,9,146,0,146,6,112,28,22.04.2019 00:30,189,20,Hmelnitsk
256,254,32,86,141,29,170,0,170,3,134,33,21.04.2019 21:40,189,20,Hmelnitsk
208,198,22,57,130,21,151,0,151,3,110,38,22.04.2019 00:05,189,20,Hmelnitsk
208,209,15,73,122,13,135,0,135,0,102,33,22.04.2019 00:12,189,20,Hmelnitsk
144,136,13,47,85,12,97,0,97,4,72,21,22.04.2019 02:27,189,20,Hmelnitsk
688,675,49,242,397,49,446,0,446,10,319,117,22.04.2019 00:40,189,20,Hmelnitsk
608,601,50,253,312,43,355,0,355,6,275,74,21.04.2019 22:49,189,20,Hmelnitsk
144,135,9,56,80,8,88,0,88,5,63,20,21.04.2019 23:00,189,20,Hmelnitsk
976,960,70,387,524,65,589,0,589,15,472,102,21.04.2019 23:00,189,20,Hmelnitsk
224,215,12,82,133,9,142,0,142,1,101,40,22.04.2019 00:00,189,20,Hmelnitsk
448,432,40,139,279,30,309,0,309,2,239,68,21.04.2019 22:20,189,20,Hmelnitsk
496,487,21,216,259,21,280,0,280,1,223,56,21.04.2019 22:30,189,20,Hmelnitsk
256,241,13,109,135,12,147,0,147,2,130,15,21.04.2019 21:27,189,20,Hmelnitsk
160,149,18,54,88,18,106,0,106,1,88,17,21.04.2019 22:00,189,20,Hmelnitsk
1104,1083,59,456,593,55,648,0,648,4,468,176,22.04.2019 00:10,189,20,Hmelnitsk
128,127,7,36,85,7,92,0,92,1,63,28,21.04.2019 21:35,189,20,Hmelnitsk
160,151,15,39,108,13,121,0,121,0,53,68,22.04.2019 01:50,189,20,Hmelnitsk
160,157,5,61,94,5,99,0,99,0,81,18,21.04.2019 21:49,189,20,Hmelnitsk
224,214,23,135,71,18,89,0,89,0,38,51,21.04.2019 22:45,189,20,Hmelnitsk
128,113,7,50,72,6,78,0,78,3,46,29,21.04.2019 22:00,189,20,Hmelnitsk
752,734,39,274,439,39,478,0,478,3,402,73,22.04.2019 00:02,189,20,Hmelnitsk
640,633,33,229,378,33,411,0,411,7,348,56,22.04.2019 00:30,189,20,Hmelnitsk
704,691,65,255,392,57,449,0,449,6,391,52,21.04.2019 22:30,189,20,Hmelnitsk
512,508,38,173,305,34,339,0,339,5,241,93,21.04.2019 22:35,189,20,Hmelnitsk
640,631,33,249,362,29,391,0,391,5,344,42,21.04.2019 23:35,189,20,Hmelnitsk
144,132,11,44,91,9,100,0,100,0,56,44,22.04.2019 00:15,189,20,Hmelnitsk
128,125,8,27,93,8,101,0,101,0,48,53,21.04.2019 21:55,189,20,Hmelnitsk
96,93,3,35,58,3,61,0,61,0,45,16,21.04.2019 21:22,189,20,Hmelnitsk
336,330,33,95,208,33,241,0,241,8,183,50,21.04.2019 21:45,189,20,Hmelnitsk
368,357,31,111,228,29,257,0,257,5,220,32,21.04.2019 22:15,189,20,Hmelnitsk
320,314,14,123,183,14,197,0,197,3,161,33,21.04.2019 22:30,189,20,Hmelnitsk
176,171,12,79,89,8,97,0,97,1,72,24,21.04.2019 22:15,189,20,Hmelnitsk
224,212,19,77,132,15,147,0,147,1,125,21,21.04.2019 23:00,189,20,Hmelnitsk
416,407,23,142,251,23,274,0,274,6,223,45,21.04.2019 21:30,189,20,Hmelnitsk
432,422,21,165,246,21,267,0,267,11,203,53,21.04.2019 21:05,189,20,Hmelnitsk
240,232,51,79,113,48,161,0,161,0,114,47,22.04.2019 01:00,189,20,Hmelnitsk
256,237,9,105,142,9,151,0,151,8,105,38,21.04.2019 21:00,189,20,Hmelnitsk
96,82,7,18,71,7,78,0,78,1,48,29,21.04.2019 21:00,189,20,Hmelnitsk
368,361,37,104,231,33,264,0,264,5,186,73,21.04.2019 21:00,189,20,Hmelnitsk
304,298,33,98,177,29,206,0,206,1,152,53,21.04.2019 21:00,189,20,Hmelnitsk
624,621,28,201,397,26,423,0,423,4,337,82,22.04.2019 00:45,189,20,Hmelnitsk
480,479,6,228,246,6,252,0,252,2,181,69,22.04.2019 00:10,189,20,Hmelnitsk
304,289,19,104,182,18,200,0,200,3,159,38,21.04.2019 21:05,189,20,Hmelnitsk
96,94,8,32,58,6,64,0,64,3,40,21,21.04.2019 20:50,189,20,Hmelnitsk
272,268,27,68,177,27,204,0,204,6,135,63,21.04.2019 21:50,189,20,Hmelnitsk
224,217,25,70,130,24,154,0,154,3,88,63,21.04.2019 21:00,189,20,Hmelnitsk
768,756,43,294,438,36,474,0,474,11,340,123,22.04.2019 00:01,189,20,Hmelnitsk
720,711,66,334,331,55,386,0,386,7,320,59,21.04.2019 21:00,189,20,Hmelnitsk
256,241,32,93,132,31,163,0,163,2,133,28,21.04.2019 21:12,189,20,Hmelnitsk
112,108,11,31,70,11,81,0,81,0,61,20,21.04.2019 21:00,189,20,Hmelnitsk
192,187,8,73,111,8,119,0,119,3,90,26,21.04.2019 20:20,189,20,Hmelnitsk
576,575,29,186,362,28,390,0,390,6,315,69,21.04.2019 23:40,189,20,Hmelnitsk
672,655,15,195,462,15,477,0,477,11,377,89,21.04.2019 21:58,189,20,Hmelnitsk
192,187,13,48,131,13,144,0,144,1,104,39,21.04.2019 21:00,189,20,Hmelnitsk
224,213,10,55,159,10,169,0,169,0,125,44,21.04.2019 20:50,189,20,Hmelnitsk
480,477,36,165,280,35,315,0,315,10,261,44,21.04.2019 21:20,189,20,Hmelnitsk
496,488,42,184,274,38,312,0,312,5,249,58,21.04.2019 20:45,189,20,Hmelnitsk
288,35,35,256,0,32,32,0,32,1,23,8,21.04.2019 20:30,189,20,Hmelnitsk
48,21,9,27,12,9,21,0,21,1,13,7,21.04.2019 21:00,189,20,Hmelnitsk
1376,1348,103,606,678,92,770,0,770,22,563,185,22.04.2019 01:30,189,20,Hmelnitsk
240,231,15,44,181,15,196,0,196,1,161,34,21.04.2019 21:40,189,20,Hmelnitsk
128,126,12,38,79,11,90,0,90,2,73,15,22.04.2019 00:31,189,20,Hmelnitsk
304,284,27,145,135,24,159,0,159,1,94,64,21.04.2019 23:25,189,20,Hmelnitsk
272,262,26,94,156,22,178,0,178,3,136,39,22.04.2019 00:50,189,20,Hmelnitsk
128,113,7,45,76,7,83,0,83,2,65,16,21.04.2019 22:55,189,20,Hmelnitsk
576,571,46,176,356,44,400,0,400,9,321,70,22.04.2019 01:09,189,20,Hmelnitsk
560,558,30,183,347,30,377,0,377,7,294,76,21.04.2019 23:59,189,20,Hmelnitsk
352,339,37,102,215,35,250,0,250,1,201,48,21.04.2019 23:59,189,20,Hmelnitsk
144,142,17,33,95,16,111,0,111,0,98,13,21.04.2019 22:10,189,20,Hmelnitsk
480,474,35,135,310,35,345,0,345,5,261,79,22.04.2019 00:30,189,20,Hmelnitsk
96,90,3,15,78,3,81,0,81,0,59,22,21.04.2019 23:49,189,20,Hmelnitsk
96,89,5,29,62,5,67,0,67,2,36,29,21.04.2019 23:19,189,20,Hmelnitsk
208,196,14,53,141,14,155,0,155,2,106,47,22.04.2019 00:08,189,20,Hmelnitsk
464,445,53,134,279,51,330,0,330,4,230,96,22.04.2019 02:08,189,20,Hmelnitsk
176,157,21,60,95,21,116,0,116,1,71,44,22.04.2019 00:25,189,20,Hmelnitsk
160,144,24,49,91,20,111,0,111,3,70,38,22.04.2019 00:25,189,20,Hmelnitsk
208,202,8,64,136,8,144,0,144,2,98,44,22.04.2019 00:08,189,20,Hmelnitsk
352,342,18,124,212,16,228,0,228,4,169,55,21.04.2019 23:20,189,20,Hmelnitsk
384,375,51,116,221,47,268,0,268,5,205,58,21.04.2019 21:30,189,20,Hmelnitsk
560,550,39,139,383,38,421,0,421,15,267,139,21.04.2019 21:06,189,20,Hmelnitsk
160,155,13,35,112,13,125,0,125,1,98,26,22.04.2019 00:50,189,20,Hmelnitsk
384,383,48,71,270,43,313,0,313,6,225,82,21.04.2019 23:13,189,20,Hmelnitsk
288,273,25,86,178,24,202,0,202,1,116,85,21.04.2019 20:21,189,20,Hmelnitsk
160,159,12,50,98,12,110,0,110,3,81,26,21.04.2019 21:00,189,20,Hmelnitsk
320,313,24,100,198,22,220,0,220,3,175,42,21.04.2019 22:00,189,20,Hmelnitsk
96,79,10,42,44,10,54,0,54,0,38,16,21.04.2019 21:35,189,20,Hmelnitsk
480,474,14,156,312,12,324,0,324,5,246,73,21.04.2019 22:00,189,20,Hmelnitsk
752,744,40,231,483,38,521,0,521,10,409,102,22.04.2019 00:50,189,20,Hmelnitsk
560,544,30,181,352,27,379,0,379,2,307,70,21.04.2019 22:45,189,20,Hmelnitsk
272,264,15,62,195,15,210,0,210,1,151,58,21.04.2019 23:10,189,20,Hmelnitsk
224,220,20,67,141,16,157,0,157,1,124,32,21.04.2019 23:05,189,20,Hmelnitsk
272,267,20,76,176,20,196,0,196,1,126,69,21.04.2019 22:00,189,20,Hmelnitsk
288,274,27,87,176,25,201,0,201,3,106,92,21.04.2019 21:00,189,20,Hmelnitsk
272,264,24,78,173,21,194,0,194,5,152,37,21.04.2019 20:50,189,20,Hmelnitsk
752,736,52,228,472,52,524,0,524,8,355,161,22.04.2019 00:10,189,20,Hmelnitsk
288,281,24,95,170,23,193,0,193,2,155,36,21.04.2019 22:50,189,20,Hmelnitsk
1616,1584,63,449,1106,61,1167,0,1167,31,842,294,21.04.2019 23:15,189,20,Hmelnitsk
480,475,16,67,397,16,413,0,413,9,257,147,21.04.2019 21:25,189,20,Hmelnitsk
224,212,18,59,149,16,165,0,165,2,105,58,22.04.2019 01:05,189,20,Hmelnitsk
1952,1926,42,717,1198,37,1235,0,1235,26,905,304,22.04.2019 01:15,189,20,Hmelnitsk
1728,1699,30,620,1081,27,1108,0,1108,15,793,300,22.04.2019 00:17,189,20,Hmelnitsk
1776,1740,22,655,1103,18,1121,0,1121,28,810,283,22.04.2019 00:50,189,20,Hmelnitsk
272,262,27,48,198,26,224,0,224,6,178,40,21.04.2019 20:45,189,20,Hmelnitsk
160,156,25,31,108,21,129,0,129,1,101,27,21.04.2019 21:50,189,20,Hmelnitsk
528,514,30,153,346,29,375,0,375,7,298,70,21.04.2019 22:35,189,20,Hmelnitsk
96,92,5,33,58,5,63,0,63,0,47,16,22.04.2019 00:53,189,20,Hmelnitsk
560,555,84,181,302,77,379,0,379,5,254,120,22.04.2019 00:10,189,20,Hmelnitsk
160,147,22,55,89,16,105,0,105,0,65,40,22.04.2019 01:30,189,20,Hmelnitsk
1312,1286,7,509,800,3,803,0,803,16,455,332,22.04.2019 01:50,189,20,Hmelnitsk
1168,1151,5,452,712,4,716,0,716,13,404,299,22.04.2019 00:10,189,20,Hmelnitsk
1200,1172,5,505,691,4,695,0,695,19,390,286,22.04.2019 00:40,189,20,Hmelnitsk
2160,2121,6,794,1361,5,1366,0,1366,34,752,580,21.04.2019 23:00,189,20,Hmelnitsk
2128,2087,8,831,1291,6,1297,0,1297,34,706,557,22.04.2019 01:15,189,20,Hmelnitsk
2048,2023,7,758,1285,5,1290,0,1290,31,679,580,22.04.2019 00:10,189,20,Hmelnitsk
1712,1688,8,669,1038,5,1043,0,1043,22,590,431,22.04.2019 00:30,189,20,Hmelnitsk
1904,1872,11,789,1108,7,1115,0,1115,26,646,443,22.04.2019 00:12,189,20,Hmelnitsk
1792,1762,11,704,1082,6,1088,0,1088,34,580,474,22.04.2019 00:48,189,20,Hmelnitsk
2112,2068,5,778,1330,4,1334,0,1334,35,770,529,22.04.2019 00:10,189,20,Hmelnitsk
2432,2396,7,909,1517,6,1523,0,1523,47,847,629,21.04.2019 21:36,189,20,Hmelnitsk
1600,1569,10,702,891,7,898,0,898,31,503,364,22.04.2019 00:12,189,20,Hmelnitsk
1488,1465,3,663,822,3,825,0,825,28,507,290,22.04.2019 00:50,189,20,Hmelnitsk
1424,1415,6,633,787,4,791,0,791,20,462,309,22.04.2019 02:00,189,20,Hmelnitsk
832,817,6,379,447,6,453,0,453,9,287,157,22.04.2019 01:10,189,20,Hmelnitsk
624,610,10,280,339,5,344,0,344,10,194,140,22.04.2019 00:03,189,20,Hmelnitsk
128,122,4,53,71,4,75,0,75,0,59,16,22.04.2019 00:30,189,20,Hmelnitsk
48,11,0,37,11,0,11,0,11,0,10,1,22.04.2019 00:10,190,20,Hmelnitsk
320,314,31,124,169,27,196,0,196,9,143,44,22.04.2019 00:50,190,20,Hmelnitsk
368,362,25,147,202,19,221,0,221,2,142,77,22.04.2019 00:40,190,20,Hmelnitsk
192,185,22,62,112,18,130,0,130,1,60,69,22.04.2019 00:50,190,20,Hmelnitsk
80,66,3,35,42,3,45,0,45,0,28,17,22.04.2019 00:10,190,20,Hmelnitsk
624,618,23,305,305,14,319,0,319,0,231,88,22.04.2019 00:45,190,20,Hmelnitsk
80,75,3,29,48,3,51,0,51,2,35,14,22.04.2019 03:40,190,20,Hmelnitsk
832,811,45,368,422,42,464,0,464,9,306,149,22.04.2019 00:10,190,20,Hmelnitsk
288,274,24,121,144,23,167,0,167,2,91,74,22.04.2019 00:30,190,20,Hmelnitsk
240,237,7,82,153,5,158,0,158,9,85,64,21.04.2019 22:20,190,20,Hmelnitsk
144,141,12,69,63,12,75,0,75,1,50,24,22.04.2019 00:30,190,20,Hmelnitsk
288,284,36,93,163,32,195,0,195,2,134,59,21.04.2019 22:00,190,20,Hmelnitsk
304,289,28,99,178,27,205,0,205,2,159,44,21.04.2019 22:00,190,20,Hmelnitsk
448,435,21,187,243,18,261,0,261,7,158,96,22.04.2019 00:30,190,20,Hmelnitsk
544,533,57,194,306,44,350,0,350,7,236,107,22.04.2019 00:20,190,20,Hmelnitsk
192,177,25,67,100,25,125,0,125,1,104,20,22.04.2019 00:15,190,20,Hmelnitsk
112,105,13,53,48,11,59,0,59,0,38,21,22.04.2019 00:30,190,20,Hmelnitsk
640,623,38,293,313,34,347,0,347,7,242,98,22.04.2019 00:20,190,20,Hmelnitsk
128,115,4,58,66,4,70,0,70,5,49,16,22.04.2019 04:45,190,20,Hmelnitsk
128,120,14,38,77,13,90,0,90,2,65,23,22.04.2019 02:00,190,20,Hmelnitsk
384,368,49,167,175,42,217,0,217,3,135,79,22.04.2019 00:25,190,20,Hmelnitsk
560,550,9,266,286,8,294,0,294,11,172,111,22.04.2019 01:22,190,20,Hmelnitsk
400,392,20,164,217,19,236,0,236,4,155,77,21.04.2019 22:16,190,20,Hmelnitsk
304,297,16,132,156,16,172,0,172,1,109,62,21.04.2019 21:20,190,20,Hmelnitsk
496,489,37,186,275,35,310,0,310,6,195,109,21.04.2019 20:55,190,20,Hmelnitsk
1200,1191,35,457,709,34,743,0,743,15,515,213,22.04.2019 01:40,190,20,Hmelnitsk
1216,1187,45,417,754,45,799,0,799,18,589,192,22.04.2019 01:30,190,20,Hmelnitsk
144,135,16,57,71,16,87,0,87,1,56,30,22.04.2019 00:12,190,20,Hmelnitsk
432,418,39,191,209,32,241,0,241,10,167,64,22.04.2019 01:10,190,20,Hmelnitsk
2352,2321,23,1034,1296,22,1318,0,1318,44,968,306,22.04.2019 00:50,190,20,Hmelnitsk
2416,2371,22,1184,1210,22,1232,0,1232,39,928,265,22.04.2019 01:55,190,20,Hmelnitsk
2416,2420,80,1077,1289,50,1339,0,1339,19,983,337,22.04.2019 02:20,190,20,Hmelnitsk
2432,2397,12,1231,1191,10,1201,0,1201,34,876,291,22.04.2019 01:15,190,20,Hmelnitsk
2000,1958,4,979,1018,3,1021,0,1021,28,737,256,22.04.2019 01:30,190,20,Hmelnitsk
2000,1983,26,881,1097,22,1119,0,1119,28,809,282,22.04.2019 00:15,190,20,Hmelnitsk
2080,2056,14,934,1132,14,1146,0,1146,29,853,264,22.04.2019 01:40,190,20,Hmelnitsk
1248,1226,8,629,613,6,619,0,619,18,456,145,22.04.2019 00:45,190,20,Hmelnitsk
256,255,1,100,156,0,156,0,156,1,104,51,22.04.2019 00:30,190,20,Hmelnitsk
1280,1259,20,625,642,13,655,0,655,18,468,169,22.04.2019 00:30,190,20,Hmelnitsk
1168,1152,17,559,595,14,609,0,609,22,451,136,22.04.2019 00:10,190,20,Hmelnitsk
1312,1285,26,640,648,24,672,0,672,14,512,146,22.04.2019 00:30,190,20,Hmelnitsk
944,938,19,426,499,19,518,0,518,10,376,132,22.04.2019 04:50,190,20,Hmelnitsk
432,422,5,227,201,4,205,0,205,5,179,21,22.04.2019 00:30,190,20,Hmelnitsk
576,555,32,285,263,28,291,0,291,2,222,67,22.04.2019 00:05,190,20,Hmelnitsk
128,124,1,54,73,1,74,0,74,2,55,17,21.04.2019 23:00,190,20,Hmelnitsk
560,537,45,242,280,38,318,0,318,13,202,103,22.04.2019 00:15,190,20,Hmelnitsk
256,249,28,70,160,26,186,0,186,1,136,49,22.04.2019 03:10,190,20,Hmelnitsk
144,141,5,69,70,5,75,0,75,1,49,25,22.04.2019 03:15,190,20,Hmelnitsk
192,175,9,63,121,8,129,0,129,0,81,48,22.04.2019 00:30,190,20,Hmelnitsk
192,177,13,89,90,13,103,0,103,2,66,35,22.04.2019 00:45,190,20,Hmelnitsk
368,351,42,166,168,34,202,0,202,8,131,63,22.04.2019 00:40,190,20,Hmelnitsk
240,235,35,92,116,32,148,0,148,4,82,62,22.04.2019 01:45,190,20,Hmelnitsk
416,403,39,150,227,39,266,0,266,8,168,90,22.04.2019 01:30,190,20,Hmelnitsk
336,331,19,125,195,16,211,0,211,2,154,55,21.04.2019 21:10,190,20,Hmelnitsk
304,288,20,111,174,19,193,0,193,4,135,54,22.04.2019 00:10,190,20,Hmelnitsk
320,304,36,127,163,30,193,0,193,7,118,68,22.04.2019 00:05,190,20,Hmelnitsk
336,329,28,118,194,24,218,0,218,2,142,74,22.04.2019 01:30,190,20,Hmelnitsk
224,214,26,63,139,22,161,0,161,1,96,64,22.04.2019 00:12,190,20,Hmelnitsk
368,357,27,110,234,24,258,0,258,2,148,108,22.04.2019 00:15,190,20,Hmelnitsk
256,244,22,109,125,22,147,0,147,2,86,59,22.04.2019 01:59,190,20,Hmelnitsk
368,351,18,143,209,16,225,0,225,5,119,101,22.04.2019 00:50,190,20,Hmelnitsk
896,876,62,396,448,52,500,0,500,9,271,220,22.04.2019 00:30,190,20,Hmelnitsk
144,140,12,58,76,10,86,0,86,1,47,38,22.04.2019 00:10,190,20,Hmelnitsk
144,129,10,62,74,8,82,0,82,1,61,20,22.04.2019 00:15,190,20,Hmelnitsk
288,283,21,131,139,18,157,0,157,1,86,70,21.04.2019 20:30,190,20,Hmelnitsk
432,413,62,171,202,59,261,0,261,2,161,98,22.04.2019 00:05,190,20,Hmelnitsk
368,354,33,133,203,32,235,0,235,3,165,67,22.04.2019 03:55,190,20,Hmelnitsk
288,277,19,101,170,17,187,0,187,1,115,71,22.04.2019 00:30,190,20,Hmelnitsk
608,588,38,202,374,32,406,0,406,9,209,188,22.04.2019 00:15,190,20,Hmelnitsk
176,161,21,75,86,15,101,0,101,3,70,28,21.04.2019 23:40,190,20,Hmelnitsk
432,414,44,164,225,43,268,0,268,5,153,110,22.04.2019 01:45,190,20,Hmelnitsk
384,378,22,143,219,22,241,0,241,5,132,104,22.04.2019 01:10,190,20,Hmelnitsk
128,115,8,63,58,7,65,0,65,1,34,30,22.04.2019 00:50,190,20,Hmelnitsk
544,526,20,190,336,18,354,0,354,3,208,143,22.04.2019 00:10,190,20,Hmelnitsk
480,464,24,185,275,20,295,0,295,7,204,84,22.04.2019 00:15,190,20,Hmelnitsk
336,326,30,131,180,25,205,0,205,3,147,55,22.04.2019 00:50,190,20,Hmelnitsk
112,98,11,56,46,10,56,0,56,0,34,22,22.04.2019 00:30,190,20,Hmelnitsk
320,312,30,120,178,22,200,0,200,8,110,82,22.04.2019 00:05,190,20,Hmelnitsk
608,593,20,203,385,20,405,0,405,6,271,128,22.04.2019 00:15,190,20,Hmelnitsk
320,309,20,135,171,14,185,0,185,8,118,59,22.04.2019 00:05,190,20,Hmelnitsk
240,232,51,57,134,49,183,0,183,1,113,69,21.04.2019 21:15,190,20,Hmelnitsk
656,648,73,307,293,56,349,0,349,10,205,134,22.04.2019 01:30,190,20,Hmelnitsk
160,146,7,63,90,7,97,0,97,1,63,33,22.04.2019 00:37,190,20,Hmelnitsk
112,101,8,43,61,8,69,0,69,2,48,19,22.04.2019 00:15,190,20,Hmelnitsk
352,348,17,131,205,16,221,0,221,3,135,83,22.04.2019 00:20,190,20,Hmelnitsk
256,242,16,69,171,16,187,0,187,3,107,77,22.04.2019 00:20,190,20,Hmelnitsk
400,393,55,150,200,50,250,0,250,10,180,60,22.04.2019 02:15,190,20,Hmelnitsk
112,113,7,33,76,3,79,0,79,1,51,27,22.04.2019 00:45,190,20,Hmelnitsk
160,154,13,39,108,13,121,0,121,3,69,49,22.04.2019 00:10,190,20,Hmelnitsk
384,366,37,113,238,33,271,0,271,9,158,104,22.04.2019 06:30,190,20,Hmelnitsk
320,302,27,165,130,25,155,0,155,2,80,73,22.04.2019 01:10,190,20,Hmelnitsk
352,338,35,118,199,35,234,0,234,8,118,108,22.04.2019 00:20,190,20,Hmelnitsk
256,253,15,100,144,12,156,0,156,3,106,47,22.04.2019 03:15,190,20,Hmelnitsk
320,317,39,112,176,32,208,0,208,6,114,88,22.04.2019 00:30,190,20,Hmelnitsk
256,249,26,87,145,24,169,0,169,4,79,86,22.04.2019 00:15,190,20,Hmelnitsk
192,179,18,47,130,15,145,0,145,3,94,48,22.04.2019 03:00,190,20,Hmelnitsk
1120,1119,82,360,685,75,760,0,760,25,468,267,22.04.2019 00:20,190,20,Hmelnitsk
192,179,19,79,95,18,113,0,113,2,76,35,22.04.2019 00:07,190,20,Hmelnitsk
528,516,63,149,321,58,379,0,379,6,237,136,22.04.2019 00:15,190,20,Hmelnitsk
1072,1044,59,492,529,51,580,0,580,3,421,156,22.04.2019 01:15,190,20,Hmelnitsk
144,130,19,36,89,19,108,0,108,2,60,46,22.04.2019 00:05,190,20,Hmelnitsk
256,237,49,108,110,38,148,0,148,1,79,68,22.04.2019 00:30,190,20,Hmelnitsk
288,277,23,121,148,19,167,0,167,1,88,78,22.04.2019 00:20,190,20,Hmelnitsk
128,119,8,55,65,8,73,0,73,2,39,32,22.04.2019 00:16,190,20,Hmelnitsk
128,123,20,42,68,18,86,0,86,1,42,43,22.04.2019 00:20,190,20,Hmelnitsk
128,124,15,6,107,15,122,0,122,0,45,77,22.04.2019 00:35,190,20,Hmelnitsk
384,230,14,154,219,11,230,0,230,5,171,54,21.04.2019 22:20,190,20,Hmelnitsk
192,188,5,71,117,4,121,0,121,0,73,48,22.04.2019 02:10,190,20,Hmelnitsk
1376,1292,61,567,750,59,809,0,809,15,602,192,22.04.2019 00:30,190,20,Hmelnitsk
448,442,27,186,235,27,262,0,262,5,178,79,21.04.2019 20:48,190,20,Hmelnitsk
336,327,23,136,177,23,200,0,200,3,161,36,21.04.2019 20:50,190,20,Hmelnitsk
320,307,20,133,167,20,187,0,187,6,102,79,21.04.2019 23:30,190,20,Hmelnitsk
96,94,7,32,57,7,64,0,64,1,32,31,21.04.2019 20:35,190,20,Hmelnitsk
96,91,8,33,55,8,63,0,63,0,33,30,21.04.2019 21:30,190,20,Hmelnitsk
464,454,9,248,207,9,216,0,216,2,149,65,21.04.2019 21:20,190,20,Hmelnitsk
400,388,23,215,162,23,185,0,185,4,115,66,22.04.2019 01:10,190,20,Hmelnitsk
304,286,32,135,138,31,169,0,169,4,91,74,21.04.2019 21:15,190,20,Hmelnitsk
352,338,16,164,172,16,188,0,188,2,126,60,22.04.2019 00:10,190,20,Hmelnitsk
80,79,1,32,47,1,48,0,48,0,26,22,22.04.2019 00:30,190,20,Hmelnitsk
176,174,16,68,92,16,108,0,108,0,65,43,21.04.2019 20:30,190,20,Hmelnitsk
128,127,0,42,86,0,86,0,86,3,55,28,22.04.2019 00:05,190,20,Hmelnitsk
368,352,5,171,192,5,197,0,197,4,137,56,22.04.2019 00:10,190,20,Hmelnitsk
1360,1330,62,547,751,62,813,0,813,37,531,245,22.04.2019 00:45,190,20,Hmelnitsk
272,257,3,116,153,3,156,0,156,3,102,51,22.04.2019 00:05,190,20,Hmelnitsk
320,306,27,126,167,27,194,0,194,3,153,38,22.04.2019 00:05,190,20,Hmelnitsk
1424,1390,67,632,733,59,792,0,792,10,592,190,22.04.2019 01:10,190,20,Hmelnitsk
1136,1108,49,465,625,46,671,0,671,13,466,192,22.04.2019 00:55,190,20,Hmelnitsk
192,185,5,73,114,5,119,0,119,2,86,31,22.04.2019 00:18,190,20,Hmelnitsk
512,500,32,210,270,32,302,0,302,2,196,104,22.04.2019 00:15,190,20,Hmelnitsk
448,431,37,184,227,37,264,0,264,7,150,107,21.04.2019 22:40,190,20,Hmelnitsk
256,245,14,103,139,14,153,0,153,3,87,63,22.04.2019 00:15,190,20,Hmelnitsk
736,711,55,323,362,51,413,0,413,11,237,165,22.04.2019 01:30,190,20,Hmelnitsk
304,299,29,57,218,29,247,0,247,2,186,59,22.04.2019 00:40,190,20,Hmelnitsk
720,697,37,282,401,37,438,0,438,11,265,162,22.04.2019 00:25,190,20,Hmelnitsk
512,501,24,193,296,23,319,0,319,8,184,127,22.04.2019 00:55,190,20,Hmelnitsk
256,249,12,88,156,12,168,0,168,1,120,47,22.04.2019 00:45,190,20,Hmelnitsk
128,121,17,60,54,14,68,0,68,2,35,31,22.04.2019 00:20,190,20,Hmelnitsk
1088,1072,32,546,513,29,542,0,542,13,409,120,22.04.2019 01:30,190,20,Hmelnitsk
112,110,6,46,60,6,66,0,66,1,37,28,22.04.2019 00:25,190,20,Hmelnitsk
240,228,20,98,123,19,142,0,142,1,112,29,22.04.2019 02:20,190,20,Hmelnitsk
80,63,5,25,50,5,55,0,55,3,42,10,21.04.2019 22:30,190,20,Hmelnitsk
32,17,2,22,8,2,10,0,10,0,7,3,22.04.2019 00:23,190,20,Hmelnitsk
304,294,6,129,172,3,175,0,175,8,120,47,21.04.2019 21:00,190,20,Hmelnitsk
48,56,4,12,32,4,36,0,36,0,22,14,22.04.2019 00:10,190,20,Hmelnitsk
528,506,6,306,216,6,222,0,222,2,174,46,21.04.2019 20:55,190,20,Hmelnitsk
688,675,34,290,367,31,398,0,398,12,229,157,21.04.2019 21:30,190,20,Hmelnitsk
304,290,17,126,161,17,178,0,178,0,129,49,21.04.2019 21:00,190,20,Hmelnitsk
784,761,24,343,420,21,441,0,441,8,300,133,22.04.2019 00:15,190,20,Hmelnitsk
240,231,13,43,184,13,197,0,197,1,83,113,22.04.2019 03:05,190,20,Hmelnitsk
160,149,5,55,100,5,105,0,105,4,64,37,21.04.2019 23:50,190,20,Hmelnitsk
208,186,21,81,106,21,127,0,127,1,58,68,21.04.2019 21:00,190,20,Hmelnitsk
80,73,6,29,45,6,51,0,51,2,25,24,21.04.2019 21:30,190,20,Hmelnitsk
80,76,0,46,34,0,34,0,34,2,16,16,21.04.2019 21:25,190,20,Hmelnitsk
128,124,8,43,77,8,85,0,85,2,37,46,22.04.2019 00:40,190,20,Hmelnitsk
160,151,10,65,86,9,95,0,95,0,51,44,22.04.2019 00:30,190,20,Hmelnitsk
96,86,8,45,43,8,51,0,51,1,23,27,21.04.2019 20:29,190,20,Hmelnitsk
64,59,1,29,34,1,35,0,35,0,22,13,21.04.2019 20:25,190,20,Hmelnitsk
528,510,46,200,282,46,328,0,328,10,194,124,22.04.2019 00:35,190,20,Hmelnitsk
96,80,9,44,43,9,52,0,52,1,34,17,21.04.2019 22:30,190,20,Hmelnitsk
1712,1669,10,867,836,9,845,0,845,26,581,238,22.04.2019 00:30,190,20,Hmelnitsk
1232,1195,15,565,654,13,667,0,667,20,413,234,22.04.2019 00:15,190,20,Hmelnitsk
736,722,4,370,362,4,366,0,366,8,241,117,22.04.2019 00:25,190,20,Hmelnitsk
416,414,6,195,215,6,221,0,221,9,139,73,22.04.2019 00:30,190,20,Hmelnitsk
192,185,11,83,98,11,109,0,109,1,81,27,22.04.2019 00:40,190,20,Hmelnitsk
512,495,1,228,283,1,284,0,284,6,191,87,22.04.2019 00:00,190,20,Hmelnitsk
144,136,14,61,69,14,83,0,83,0,57,26,22.04.2019 00:10,190,20,Hmelnitsk
528,511,33,205,290,33,323,0,323,3,221,99,22.04.2019 00:05,190,20,Hmelnitsk
384,363,18,163,203,18,221,0,221,6,132,83,21.04.2019 20:50,190,20,Hmelnitsk
496,475,33,205,260,31,291,0,291,4,176,111,22.04.2019 00:30,190,20,Hmelnitsk
96,97,23,28,45,23,68,0,68,1,29,38,22.04.2019 02:00,190,20,Hmelnitsk
848,829,24,186,638,24,662,0,662,9,458,195,22.04.2019 01:20,190,20,Hmelnitsk
544,485,8,62,474,8,482,0,482,40,408,34,21.04.2019 21:00,190,20,Hmelnitsk
1024,1026,4,427,594,3,597,0,597,18,444,135,22.04.2019 00:45,190,20,Hmelnitsk
1264,1227,12,590,663,11,674,0,674,16,489,169,22.04.2019 00:20,190,20,Hmelnitsk
1136,1114,13,518,606,12,618,0,618,14,497,107,22.04.2019 03:02,190,20,Hmelnitsk
1136,1115,10,513,614,9,623,0,623,18,444,161,22.04.2019 03:27,190,20,Hmelnitsk
2208,2190,31,919,1262,27,1289,0,1289,31,973,285,22.04.2019 00:50,190,20,Hmelnitsk
2032,2006,18,860,1158,14,1172,0,1172,44,873,255,22.04.2019 01:30,190,20,Hmelnitsk
2048,2029,14,883,1156,9,1165,0,1165,23,882,260,22.04.2019 00:30,190,20,Hmelnitsk
1424,1388,9,590,827,7,834,0,834,24,650,160,22.04.2019 02:00,190,20,Hmelnitsk
2304,2276,13,911,1381,12,1393,0,1393,48,1046,299,22.04.2019 00:40,190,20,Hmelnitsk
1344,1313,5,591,749,4,753,0,753,21,581,151,22.04.2019 00:21,190,20,Hmelnitsk
1280,1264,7,568,707,5,712,0,712,19,514,179,22.04.2019 00:10,190,20,Hmelnitsk
1024,1011,3,403,619,2,621,0,621,12,462,147,22.04.2019 00:15,190,20,Hmelnitsk
2288,2258,15,1019,1258,11,1269,0,1269,40,966,263,22.04.2019 00:15,190,20,Hmelnitsk
2032,2011,16,799,1217,16,1233,0,1233,39,923,271,22.04.2019 01:10,190,20,Hmelnitsk
1136,1127,15,436,689,11,700,0,700,22,516,162,22.04.2019 00:15,190,20,Hmelnitsk
1216,1199,11,540,666,10,676,0,676,18,535,123,22.04.2019 00:10,190,20,Hmelnitsk
1200,1200,15,525,660,15,675,0,675,20,516,139,22.04.2019 01:30,190,20,Hmelnitsk
288,48,35,252,14,22,36,0,36,1,28,7,21.04.2019 21:15,190,20,Hmelnitsk
1328,1294,4,650,677,1,678,0,678,16,525,137,22.04.2019 00:08,190,20,Hmelnitsk
1424,1402,9,775,645,4,649,0,649,23,469,157,22.04.2019 00:12,190,20,Hmelnitsk
1824,1788,4,782,1041,1,1042,0,1042,38,780,224,22.04.2019 00:15,190,20,Hmelnitsk
2176,2136,8,953,1218,5,1223,0,1223,30,921,272,22.04.2019 00:05,190,20,Hmelnitsk
2192,2146,12,923,1257,12,1269,0,1269,40,900,329,22.04.2019 00:48,190,20,Hmelnitsk
1648,1629,9,734,908,6,914,0,914,29,634,251,21.04.2019 21:45,190,20,Hmelnitsk
1904,1846,11,922,973,9,982,0,982,25,707,250,22.04.2019 00:30,190,20,Hmelnitsk
1712,1677,10,731,973,8,981,0,981,24,695,262,22.04.2019 00:25,190,20,Hmelnitsk
1680,1650,1,767,912,1,913,0,913,32,629,252,22.04.2019 00:30,190,20,Hmelnitsk
1856,1797,5,836,1016,4,1020,0,1020,23,788,209,22.04.2019 00:05,190,20,Hmelnitsk
2064,2027,16,927,1124,13,1137,0,1137,39,809,289,22.04.2019 01:35,190,20,Hmelnitsk
1600,1552,8,732,862,6,868,0,868,12,639,217,22.04.2019 00:50,190,20,Hmelnitsk
2080,2035,14,926,1144,10,1154,0,1154,41,799,314,22.04.2019 03:08,190,20,Hmelnitsk
1632,1624,7,748,877,7,884,0,884,24,622,238,22.04.2019 01:10,190,20,Hmelnitsk
1952,1925,33,948,978,26,1004,0,1004,33,727,244,22.04.2019 02:00,190,20,Hmelnitsk
1760,1709,9,827,926,7,933,0,933,25,669,239,22.04.2019 00:05,190,20,Hmelnitsk
1600,1566,6,751,843,6,849,0,849,26,612,211,22.04.2019 00:05,190,20,Hmelnitsk
1760,1625,13,883,867,10,877,0,877,20,630,227,21.04.2019 21:35,190,20,Hmelnitsk
880,830,2,394,484,2,486,0,486,13,355,118,22.04.2019 00:45,190,20,Hmelnitsk
320,62,50,265,12,43,55,0,55,2,45,8,22.04.2019 00:05,190,20,Hmelnitsk
96,19,0,77,19,0,19,0,19,0,15,4,22.04.2019 00:04,190,20,Hmelnitsk
176,162,14,86,77,13,90,0,90,2,71,17,22.04.2019 01:15,190,20,Hmelnitsk
656,647,50,209,397,50,447,0,447,4,302,141,22.04.2019 00:50,191,20,Hmelnitsk
1440,1421,21,557,863,20,883,0,883,30,586,267,22.04.2019 00:20,191,20,Hmelnitsk
1504,1487,15,682,808,14,822,0,822,29,585,208,22.04.2019 01:05,191,20,Hmelnitsk
912,907,6,382,524,6,530,0,530,17,367,146,22.04.2019 00:48,191,20,Hmelnitsk
976,950,6,413,557,6,563,0,563,11,406,146,22.04.2019 01:00,191,20,Hmelnitsk
112,108,2,52,58,2,60,0,60,0,47,13,22.04.2019 02:10,191,20,Hmelnitsk
384,382,19,147,219,18,237,0,237,2,151,84,22.04.2019 00:20,191,20,Hmelnitsk
624,606,26,255,343,26,369,0,369,7,268,94,22.04.2019 00:45,191,20,Hmelnitsk
432,421,20,75,337,20,357,0,357,2,275,80,22.04.2019 00:02,191,20,Hmelnitsk
160,144,0,75,85,0,85,0,85,2,56,27,22.04.2019 00:45,191,20,Hmelnitsk
336,331,24,134,179,23,202,0,202,5,150,47,22.04.2019 00:10,191,20,Hmelnitsk
256,257,26,94,137,25,162,0,162,9,85,68,22.04.2019 02:27,191,20,Hmelnitsk
400,397,46,88,266,46,312,0,312,2,162,148,22.04.2019 00:10,191,20,Hmelnitsk
880,870,18,378,485,17,502,0,502,7,367,128,22.04.2019 00:45,191,20,Hmelnitsk
736,725,69,307,360,69,429,0,429,10,334,85,22.04.2019 00:43,191,20,Hmelnitsk
192,181,28,49,115,28,143,0,143,1,99,43,22.04.2019 00:01,191,20,Hmelnitsk
1008,994,22,426,560,22,582,0,582,21,419,142,22.04.2019 00:02,191,20,Hmelnitsk
176,167,25,55,96,25,121,0,121,0,68,53,22.04.2019 00:10,191,20,Hmelnitsk
432,414,17,202,213,17,230,0,230,4,150,76,22.04.2019 00:30,191,20,Hmelnitsk
416,411,12,191,218,7,225,0,225,5,130,90,22.04.2019 00:10,191,20,Hmelnitsk
368,361,12,159,197,12,209,0,209,7,118,84,22.04.2019 01:35,191,20,Hmelnitsk
112,122,5,42,67,3,70,0,70,0,52,18,22.04.2019 00:53,191,20,Hmelnitsk
368,357,17,135,218,15,233,0,233,2,142,89,22.04.2019 00:35,191,20,Hmelnitsk
64,68,0,14,50,0,50,0,50,0,26,24,22.04.2019 01:25,191,20,Hmelnitsk
672,660,25,89,561,22,583,0,583,16,421,146,22.04.2019 00:15,191,20,Hmelnitsk
64,58,4,14,46,4,50,0,50,0,23,27,22.04.2019 00:10,191,20,Hmelnitsk
384,376,17,168,199,17,216,0,216,2,135,79,22.04.2019 01:15,191,20,Hmelnitsk
320,327,11,117,192,11,203,0,203,3,163,37,21.04.2019 21:00,191,20,Hmelnitsk
96,92,0,41,55,0,55,0,55,1,42,12,22.04.2019 00:40,191,20,Hmelnitsk
880,858,21,338,521,21,542,0,542,8,397,137,22.04.2019 02:05,191,20,Hmelnitsk
640,633,58,259,324,57,381,0,381,4,278,99,22.04.2019 01:05,191,20,Hmelnitsk
624,614,53,249,324,51,375,0,375,8,274,93,22.04.2019 00:10,191,20,Hmelnitsk
416,403,1,189,226,1,227,0,227,5,123,99,22.04.2019 00:20,191,20,Hmelnitsk
288,274,1,155,132,1,133,0,133,6,107,20,22.04.2019 00:25,191,20,Hmelnitsk
400,392,10,198,193,9,202,0,202,12,129,61,22.04.2019 00:20,191,20,Hmelnitsk
608,583,7,250,351,7,358,0,358,5,241,112,22.04.2019 00:02,191,20,Hmelnitsk
432,412,35,141,261,30,291,0,291,2,178,111,21.04.2019 21:30,191,20,Hmelnitsk
384,367,21,146,217,21,238,0,238,7,171,60,22.04.2019 00:30,191,20,Hmelnitsk
144,143,14,47,83,14,97,0,97,0,73,24,22.04.2019 00:10,191,20,Hmelnitsk
656,641,92,225,342,89,431,0,431,5,321,105,22.04.2019 00:12,191,20,Hmelnitsk
496,473,52,183,263,50,313,0,313,5,226,82,22.04.2019 00:25,191,20,Hmelnitsk
336,337,110,115,135,86,221,0,221,5,141,75,22.04.2019 00:20,191,20,Hmelnitsk
112,105,17,42,53,17,70,0,70,2,46,22,22.04.2019 01:15,191,20,Hmelnitsk
1008,978,43,467,503,38,541,0,541,15,382,144,22.04.2019 00:15,191,20,Hmelnitsk
848,837,41,397,413,38,451,0,451,5,319,127,22.04.2019 00:55,191,20,Hmelnitsk
128,129,8,60,60,8,68,0,68,1,39,28,22.04.2019 00:02,191,20,Hmelnitsk
160,161,9,51,100,9,109,0,109,1,55,53,22.04.2019 00:10,191,20,Hmelnitsk
432,414,55,165,216,51,267,0,267,3,204,60,22.04.2019 00:24,191,20,Hmelnitsk
336,324,26,152,160,24,184,0,184,11,97,76,22.04.2019 00:13,191,20,Hmelnitsk
32,41,4,2,26,4,30,0,30,0,8,22,22.04.2019 00:05,191,20,Hmelnitsk
256,258,31,89,138,29,167,0,167,3,106,58,22.04.2019 00:10,191,20,Hmelnitsk
1456,1432,7,609,840,7,847,0,847,22,620,205,22.04.2019 00:20,191,20,Hmelnitsk
1312,1289,10,538,767,7,774,0,774,22,583,169,22.04.2019 00:20,191,20,Hmelnitsk
1312,1290,4,597,711,4,715,0,715,21,510,184,22.04.2019 00:10,191,20,Hmelnitsk
2160,2130,16,857,1287,16,1303,0,1303,27,959,317,22.04.2019 01:15,191,20,Hmelnitsk
1568,1546,21,675,875,18,893,0,893,29,679,185,22.04.2019 00:05,191,20,Hmelnitsk
448,442,58,117,275,56,331,0,331,7,239,85,22.04.2019 00:30,191,20,Hmelnitsk
560,552,60,236,271,53,324,0,324,3,234,87,22.04.2019 00:50,191,20,Hmelnitsk
288,267,26,131,137,20,157,0,157,7,94,56,22.04.2019 00:20,191,20,Hmelnitsk
96,86,5,31,61,4,65,0,65,1,42,22,22.04.2019 00:05,191,20,Hmelnitsk
432,420,30,156,249,27,276,0,276,2,162,112,22.04.2019 00:15,191,20,Hmelnitsk
96,96,5,30,61,5,66,0,66,1,30,35,22.04.2019 00:15,191,20,Hmelnitsk
128,110,13,44,72,12,84,0,84,3,45,36,22.04.2019 00:25,191,20,Hmelnitsk
96,83,13,39,44,13,57,0,57,1,33,23,22.04.2019 00:57,191,20,Hmelnitsk
560,576,54,158,354,48,402,0,402,8,274,120,21.04.2019 22:00,191,20,Hmelnitsk
304,295,49,81,174,49,223,0,223,1,160,62,21.04.2019 20:40,191,20,Hmelnitsk
512,497,48,211,257,44,301,0,301,9,191,101,22.04.2019 05:30,191,20,Hmelnitsk
1088,1060,45,429,622,37,659,0,659,15,478,166,22.04.2019 02:05,191,20,Hmelnitsk
96,88,0,32,64,0,64,0,64,1,44,19,22.04.2019 00:30,191,20,Hmelnitsk
448,442,88,67,293,88,381,0,381,2,284,95,22.04.2019 00:05,191,20,Hmelnitsk
192,188,15,71,107,14,121,0,121,3,61,57,22.04.2019 00:20,191,20,Hmelnitsk
112,103,12,38,65,9,74,0,74,2,27,45,22.04.2019 01:10,191,20,Hmelnitsk
144,133,22,44,79,21,100,0,100,3,57,40,22.04.2019 00:15,191,20,Hmelnitsk
800,787,69,291,450,59,509,0,509,9,397,103,22.04.2019 02:25,191,20,Hmelnitsk
432,415,22,156,257,19,276,0,276,5,210,61,22.04.2019 01:55,191,20,Hmelnitsk
192,196,20,51,122,19,141,0,141,1,89,51,22.04.2019 00:45,191,20,Hmelnitsk
144,133,14,47,84,13,97,0,97,1,67,29,22.04.2019 00:05,191,20,Hmelnitsk
336,331,25,111,200,25,225,0,225,7,156,62,22.04.2019 00:05,191,20,Hmelnitsk
288,273,19,86,183,19,202,0,202,4,144,54,22.04.2019 00:30,191,20,Hmelnitsk
144,135,12,48,84,12,96,0,96,1,53,42,21.04.2019 20:35,191,20,Hmelnitsk
224,225,22,88,114,22,136,0,136,4,84,48,22.04.2019 00:07,191,20,Hmelnitsk
560,553,56,242,265,53,318,0,318,1,222,95,22.04.2019 00:01,191,20,Hmelnitsk
144,139,12,49,83,12,95,0,95,1,56,38,22.04.2019 04:20,191,20,Hmelnitsk
144,139,14,28,102,14,116,0,116,0,89,27,22.04.2019 00:30,191,20,Hmelnitsk
384,376,30,124,235,25,260,0,260,8,206,46,22.04.2019 00:30,191,20,Hmelnitsk
256,246,24,92,141,23,164,0,164,3,119,42,22.04.2019 01:22,191,20,Hmelnitsk
416,401,14,125,280,11,291,0,291,4,148,139,22.04.2019 00:15,191,20,Hmelnitsk
112,119,24,20,69,23,92,0,92,1,69,22,22.04.2019 00:10,191,20,Hmelnitsk
208,203,22,115,76,17,93,0,93,1,58,34,22.04.2019 00:15,191,20,Hmelnitsk
304,303,48,88,174,42,216,0,216,6,132,78,22.04.2019 00:15,191,20,Hmelnitsk
432,432,37,149,247,36,283,0,283,3,134,146,22.04.2019 00:03,191,20,Hmelnitsk
96,84,9,44,44,8,52,0,52,0,45,7,22.04.2019 00:10,191,20,Hmelnitsk
160,148,9,42,112,6,118,0,118,3,50,65,22.04.2019 00:20,191,20,Hmelnitsk
144,135,12,30,107,7,114,0,114,0,50,64,22.04.2019 00:04,191,20,Hmelnitsk
912,908,76,294,554,64,618,0,618,10,434,174,22.04.2019 01:10,191,20,Hmelnitsk
160,154,18,44,99,17,116,0,116,1,85,30,22.04.2019 00:15,191,20,Hmelnitsk
288,275,31,103,155,30,185,0,185,3,126,56,22.04.2019 00:40,191,20,Hmelnitsk
144,138,19,49,76,19,95,0,95,2,66,27,22.04.2019 00:35,191,20,Hmelnitsk
400,397,51,126,225,49,274,0,274,7,153,114,22.04.2019 01:00,191,20,Hmelnitsk
176,162,26,80,75,21,96,0,96,1,62,33,22.04.2019 01:53,191,20,Hmelnitsk
400,400,34,175,193,32,225,0,225,6,135,84,22.04.2019 00:20,191,20,Hmelnitsk
336,330,25,108,204,24,228,0,228,2,177,49,22.04.2019 00:20,191,20,Hmelnitsk
400,384,49,120,231,49,280,0,280,10,182,88,22.04.2019 00:45,191,20,Hmelnitsk
96,99,6,27,64,5,69,0,69,2,48,19,22.04.2019 01:15,191,20,Hmelnitsk
176,171,23,49,106,21,127,0,127,1,76,50,22.04.2019 00:15,191,20,Hmelnitsk
144,133,14,39,96,9,105,0,105,0,59,46,22.04.2019 00:10,191,20,Hmelnitsk
1648,1619,28,634,993,21,1014,0,1014,29,666,319,22.04.2019 00:30,191,20,Hmelnitsk
1968,1938,36,767,1173,28,1201,0,1201,41,779,381,22.04.2019 02:05,191,20,Hmelnitsk
1808,1797,34,680,1101,27,1128,0,1128,31,758,339,22.04.2019 01:20,191,20,Hmelnitsk
1008,1011,7,390,612,6,618,0,618,13,444,161,22.04.2019 02:10,191,20,Hmelnitsk
464,452,19,170,276,18,294,0,294,4,206,84,22.04.2019 01:20,191,20,Hmelnitsk
592,583,15,209,369,14,383,0,383,13,219,151,22.04.2019 00:30,191,20,Hmelnitsk
784,781,9,306,472,6,478,0,478,13,336,129,22.04.2019 00:57,191,20,Hmelnitsk
176,161,19,55,105,16,121,0,121,0,73,48,22.04.2019 00:05,191,20,Hmelnitsk
96,82,15,25,57,14,71,0,71,0,47,24,22.04.2019 01:30,191,20,Hmelnitsk
1056,1034,75,428,566,62,628,0,628,14,432,182,21.04.2019 23:35,191,20,Hmelnitsk
720,709,87,241,397,82,479,0,479,4,356,119,22.04.2019 02:40,191,20,Hmelnitsk
320,315,50,87,188,45,233,0,233,6,152,75,22.04.2019 01:40,191,20,Hmelnitsk
256,248,24,93,145,18,163,0,163,2,112,49,22.04.2019 00:15,191,20,Hmelnitsk
128,125,11,37,80,11,91,0,91,5,44,42,22.04.2019 00:30,191,20,Hmelnitsk
256,252,34,90,135,31,166,0,166,7,96,63,22.04.2019 00:15,191,20,Hmelnitsk
176,175,28,71,82,23,105,0,105,0,39,66,22.04.2019 01:15,191,20,Hmelnitsk
224,218,30,87,113,24,137,0,137,2,91,44,22.04.2019 00:15,191,20,Hmelnitsk
80,69,11,34,35,11,46,0,46,0,30,16,22.04.2019 00:01,191,20,Hmelnitsk
480,472,39,178,266,36,302,0,302,6,205,91,22.04.2019 02:40,191,20,Hmelnitsk
80,78,7,24,50,6,56,0,56,2,22,32,22.04.2019 00:16,191,20,Hmelnitsk
224,209,33,95,100,29,129,0,129,2,90,37,22.04.2019 01:05,191,20,Hmelnitsk
416,404,74,86,258,72,330,0,330,1,156,173,22.04.2019 00:20,191,20,Hmelnitsk
208,190,19,60,129,19,148,0,148,3,92,53,22.04.2019 00:10,191,20,Hmelnitsk
992,983,99,397,508,87,595,0,595,12,418,165,22.04.2019 01:30,191,20,Hmelnitsk
528,512,48,173,310,45,355,0,355,7,264,84,22.04.2019 01:40,191,20,Hmelnitsk
672,671,59,236,385,51,436,0,436,10,259,167,22.04.2019 00:03,191,20,Hmelnitsk
144,146,24,40,83,21,104,0,104,0,62,42,22.04.2019 00:40,191,20,Hmelnitsk
176,168,12,51,113,12,125,0,125,2,55,68,22.04.2019 00:15,191,20,Hmelnitsk
384,378,63,152,182,50,232,0,232,4,155,73,22.04.2019 02:00,191,20,Hmelnitsk
240,226,21,83,138,19,157,0,157,4,106,47,22.04.2019 01:30,191,20,Hmelnitsk
224,209,22,89,118,17,135,0,135,3,67,65,22.04.2019 00:50,191,20,Hmelnitsk
448,433,30,150,272,26,298,0,298,4,211,83,22.04.2019 01:15,191,20,Hmelnitsk
96,89,13,33,51,12,63,0,63,1,42,20,22.04.2019 00:15,191,20,Hmelnitsk
432,414,58,164,210,58,268,0,268,5,207,56,22.04.2019 00:05,191,20,Hmelnitsk
352,340,49,149,162,41,203,0,203,3,138,62,21.04.2019 21:00,191,20,Hmelnitsk
288,271,33,118,141,29,170,0,170,7,112,51,22.04.2019 00:20,191,20,Hmelnitsk
304,296,28,168,116,20,136,0,136,1,95,40,21.04.2019 21:20,191,20,Hmelnitsk
272,279,16,106,153,13,166,0,166,2,109,55,21.04.2019 20:30,191,20,Hmelnitsk
160,147,17,75,70,15,85,0,85,4,59,22,22.04.2019 00:15,191,20,Hmelnitsk
464,451,62,165,243,56,299,0,299,8,184,107,22.04.2019 01:15,191,20,Hmelnitsk
128,111,11,65,54,9,63,0,63,0,47,16,22.04.2019 00:06,191,20,Hmelnitsk
160,153,26,73,67,20,87,0,87,0,53,34,22.04.2019 00:10,191,20,Hmelnitsk
608,592,28,276,310,22,332,0,332,5,258,69,21.04.2019 21:40,191,20,Hmelnitsk
416,408,50,168,215,33,248,0,248,9,167,72,22.04.2019 00:15,191,20,Hmelnitsk
144,141,13,30,102,12,114,0,114,3,89,22,22.04.2019 00:50,191,20,Hmelnitsk
320,316,46,150,133,37,170,0,170,2,131,37,21.04.2019 22:35,191,20,Hmelnitsk
672,678,66,221,391,60,451,0,451,11,320,120,21.04.2019 21:35,191,20,Hmelnitsk
512,495,34,173,307,32,339,0,339,6,209,124,22.04.2019 00:10,191,20,Hmelnitsk
336,329,23,155,161,20,181,0,181,0,133,48,22.04.2019 00:40,191,20,Hmelnitsk
144,135,19,38,87,19,106,0,106,2,74,30,22.04.2019 01:20,191,20,Hmelnitsk
352,340,47,132,176,44,220,0,220,4,135,81,22.04.2019 00:07,191,20,Hmelnitsk
880,859,71,333,494,53,547,0,547,7,394,146,22.04.2019 00:50,191,20,Hmelnitsk
736,729,71,297,371,68,439,0,439,8,311,119,22.04.2019 00:02,191,20,Hmelnitsk
336,319,45,133,160,43,203,0,203,2,114,87,22.04.2019 00:10,191,20,Hmelnitsk
304,293,39,99,170,35,205,0,205,4,127,74,22.04.2019 01:59,191,20,Hmelnitsk
336,337,31,112,194,30,224,0,224,1,151,72,21.04.2019 21:00,191,20,Hmelnitsk
496,478,41,223,236,37,273,0,273,5,206,62,22.04.2019 00:10,191,20,Hmelnitsk
288,285,33,122,138,28,166,0,166,6,113,47,22.04.2019 00:50,191,20,Hmelnitsk
224,212,6,81,138,5,143,0,143,2,108,33,21.04.2019 20:32,191,20,Hmelnitsk
352,351,21,125,210,17,227,0,227,7,149,71,22.04.2019 01:20,191,20,Hmelnitsk
144,135,13,50,83,11,94,0,94,0,59,35,22.04.2019 00:30,191,20,Hmelnitsk
704,697,67,283,361,60,421,0,421,1,329,91,21.04.2019 21:50,191,20,Hmelnitsk
160,151,17,69,76,15,91,0,91,2,68,21,22.04.2019 00:15,191,20,Hmelnitsk
368,354,18,135,217,16,233,0,233,5,174,54,22.04.2019 00:15,191,20,Hmelnitsk
256,247,21,110,129,17,146,0,146,4,101,41,22.04.2019 00:55,191,20,Hmelnitsk
256,253,16,130,113,13,126,0,126,2,65,59,22.04.2019 00:15,191,20,Hmelnitsk
272,267,14,101,161,10,171,0,171,0,126,45,22.04.2019 00:20,191,20,Hmelnitsk
256,253,11,98,147,11,158,0,158,2,131,25,22.04.2019 00:03,191,20,Hmelnitsk
240,235,16,91,135,14,149,0,149,2,113,34,22.04.2019 00:06,191,20,Hmelnitsk
288,277,42,116,136,36,172,0,172,1,117,54,22.04.2019 00:15,191,20,Hmelnitsk
240,223,26,107,113,20,133,0,133,0,101,32,21.04.2019 21:00,191,20,Hmelnitsk
96,89,4,46,47,3,50,0,50,0,35,15,22.04.2019 00:10,191,20,Hmelnitsk
144,144,16,23,108,13,121,0,121,1,83,37,22.04.2019 00:17,191,20,Hmelnitsk
256,237,22,105,130,21,151,0,151,2,110,39,22.04.2019 00:20,191,20,Hmelnitsk
96,90,17,30,53,13,66,0,66,1,34,31,22.04.2019 00:05,191,20,Hmelnitsk
944,918,48,361,541,42,583,0,583,13,391,179,22.04.2019 00:40,191,20,Hmelnitsk
256,254,8,94,155,7,162,0,162,8,111,43,22.04.2019 00:03,191,20,Hmelnitsk
448,434,12,142,295,11,306,0,306,31,192,83,22.04.2019 01:10,191,20,Hmelnitsk
432,427,38,157,243,32,275,0,275,2,161,112,21.04.2019 22:00,191,20,Hmelnitsk
288,282,25,78,188,22,210,0,210,2,94,114,21.04.2019 21:30,191,20,Hmelnitsk
224,221,11,79,134,11,145,0,145,7,85,53,22.04.2019 00:30,191,20,Hmelnitsk
464,446,50,177,243,44,287,0,287,4,226,57,22.04.2019 00:05,191,20,Hmelnitsk
352,347,37,86,229,37,266,0,266,3,121,142,21.04.2019 22:00,191,20,Hmelnitsk
1248,1220,100,510,641,97,738,0,738,15,503,220,22.04.2019 01:00,191,20,Hmelnitsk
336,331,56,138,151,47,198,0,198,6,120,72,21.04.2019 23:00,191,20,Hmelnitsk
736,720,68,259,414,63,477,0,477,11,381,85,21.04.2019 21:20,191,20,Hmelnitsk
768,739,53,290,434,44,478,0,478,11,355,112,21.04.2019 21:35,191,20,Hmelnitsk
208,199,17,81,116,11,127,0,127,3,99,25,21.04.2019 22:55,191,20,Hmelnitsk
528,519,22,246,266,16,282,0,282,5,224,53,22.04.2019 00:10,191,20,Hmelnitsk
544,529,18,223,306,15,321,0,321,6,239,76,22.04.2019 00:05,191,20,Hmelnitsk
208,217,14,70,128,10,138,0,138,7,71,60,21.04.2019 21:26,191,20,Hmelnitsk
176,166,14,67,98,11,109,0,109,2,67,40,22.04.2019 00:10,191,20,Hmelnitsk
576,556,75,214,295,67,362,0,362,10,258,94,22.04.2019 00:35,191,20,Hmelnitsk
496,485,28,207,262,27,289,0,289,2,191,96,22.04.2019 00:15,191,20,Hmelnitsk
368,355,18,146,206,16,222,0,222,0,178,44,22.04.2019 03:20,191,20,Hmelnitsk
144,132,13,60,72,12,84,0,84,2,58,24,22.04.2019 01:03,191,20,Hmelnitsk
448,432,57,160,235,53,288,0,288,1,176,111,22.04.2019 00:30,191,20,Hmelnitsk
352,338,44,139,172,41,213,0,213,0,139,74,22.04.2019 00:50,191,20,Hmelnitsk
672,656,40,240,399,33,432,0,432,5,334,93,21.04.2019 21:05,191,20,Hmelnitsk
176,172,8,36,134,6,140,0,140,2,98,40,22.04.2019 00:15,191,20,Hmelnitsk
144,135,9,54,81,9,90,0,90,0,73,17,22.04.2019 00:05,191,20,Hmelnitsk
400,394,43,155,204,41,245,0,245,1,138,106,22.04.2019 00:15,191,20,Hmelnitsk
96,81,10,43,45,8,53,0,53,3,38,12,22.04.2019 00:08,191,20,Hmelnitsk
400,393,28,177,198,25,223,0,223,3,177,43,22.04.2019 00:30,191,20,Hmelnitsk
128,115,8,51,69,8,77,0,77,0,65,12,22.04.2019 00:20,191,20,Hmelnitsk
864,843,42,361,464,39,503,0,503,5,378,120,22.04.2019 00:15,191,20,Hmelnitsk
144,129,8,60,77,7,84,0,84,2,44,38,22.04.2019 00:05,191,20,Hmelnitsk
64,55,6,24,35,5,40,0,40,0,26,14,21.04.2019 20:20,191,20,Hmelnitsk
144,134,8,75,62,7,69,0,69,3,48,18,21.04.2019 20:40,191,20,Hmelnitsk
240,234,24,83,133,24,157,0,157,1,114,42,22.04.2019 01:00,191,20,Hmelnitsk
160,153,15,59,86,15,101,0,101,3,63,35,21.04.2019 22:20,191,20,Hmelnitsk
320,303,32,129,166,25,191,0,191,4,117,70,21.04.2019 20:30,191,20,Hmelnitsk
80,69,6,31,46,3,49,0,49,2,26,21,21.04.2019 20:45,191,20,Hmelnitsk
272,262,24,82,169,21,190,0,190,3,135,52,21.04.2019 23:50,191,20,Hmelnitsk
336,324,25,109,208,19,227,0,227,1,150,76,22.04.2019 00:30,191,20,Hmelnitsk
256,248,28,96,137,23,160,0,160,5,120,35,22.04.2019 00:15,191,20,Hmelnitsk
784,788,100,266,423,95,518,0,518,14,306,198,22.04.2019 00:30,191,20,Hmelnitsk
112,97,12,41,59,12,71,0,71,9,40,22,22.04.2019 00:35,191,20,Hmelnitsk
192,177,17,47,130,15,145,0,145,1,100,44,22.04.2019 00:10,191,20,Hmelnitsk
560,538,64,204,310,46,356,0,356,5,260,91,21.04.2019 22:15,191,20,Hmelnitsk
112,103,14,43,55,14,69,0,69,1,21,47,21.04.2019 21:10,191,20,Hmelnitsk
768,746,40,277,452,39,491,0,491,4,387,100,22.04.2019 00:30,191,20,Hmelnitsk
384,371,50,106,230,48,278,0,278,12,195,71,21.04.2019 22:10,191,20,Hmelnitsk
64,49,6,32,27,5,32,0,32,0,21,11,22.04.2019 00:50,191,20,Hmelnitsk
400,385,40,172,199,29,228,0,228,13,162,53,22.04.2019 00:15,191,20,Hmelnitsk
128,118,18,35,79,14,93,0,93,0,60,33,22.04.2019 00:45,191,20,Hmelnitsk
384,384,37,109,238,37,275,0,275,6,166,103,22.04.2019 01:05,191,20,Hmelnitsk
48,42,10,22,21,5,26,0,26,0,7,19,21.04.2019 20:30,191,20,Hmelnitsk
304,302,25,100,181,23,204,0,204,5,116,83,22.04.2019 00:10,191,20,Hmelnitsk
80,75,11,23,48,9,57,0,57,0,29,28,22.04.2019 00:03,191,20,Hmelnitsk
208,201,24,71,116,21,137,0,137,2,88,47,22.04.2019 00:05,191,20,Hmelnitsk
176,157,21,92,70,14,84,0,84,2,58,24,22.04.2019 00:10,191,20,Hmelnitsk
144,146,22,49,76,19,95,0,95,2,62,31,21.04.2019 21:30,191,20,Hmelnitsk
1152,1129,33,520,604,28,632,0,632,16,482,134,22.04.2019 00:30,191,20,Hmelnitsk
896,882,40,387,473,36,509,0,509,16,389,104,22.04.2019 04:00,191,20,Hmelnitsk
1328,1304,38,470,822,36,858,0,858,14,653,191,22.04.2019 02:30,191,20,Hmelnitsk
880,864,38,373,476,31,507,0,507,12,401,94,22.04.2019 00:15,191,20,Hmelnitsk
320,308,24,109,189,22,211,0,211,3,156,52,22.04.2019 00:30,191,20,Hmelnitsk
304,290,17,116,173,15,188,0,188,1,106,81,22.04.2019 00:20,191,20,Hmelnitsk
160,149,9,57,94,9,103,0,103,0,84,19,21.04.2019 20:45,191,20,Hmelnitsk
240,232,16,59,166,15,181,0,181,1,116,64,22.04.2019 00:50,191,20,Hmelnitsk
256,247,29,89,143,24,167,0,167,3,130,34,22.04.2019 00:05,191,20,Hmelnitsk
304,297,31,80,196,28,224,0,224,1,170,53,21.04.2019 21:25,191,20,Hmelnitsk
128,120,24,15,90,23,113,0,113,1,97,15,21.04.2019 21:00,191,20,Hmelnitsk
2080,2035,28,949,1110,21,1131,0,1131,25,833,273,22.04.2019 00:37,191,20,Hmelnitsk
2272,2200,29,912,1338,22,1360,0,1360,35,948,377,21.04.2019 22:40,191,20,Hmelnitsk
1472,1446,13,670,793,9,802,0,802,24,563,215,22.04.2019 00:10,191,20,Hmelnitsk
1744,1690,25,687,1044,13,1057,0,1057,26,706,325,21.04.2019 22:00,191,20,Hmelnitsk
1648,1623,13,596,1040,12,1052,0,1052,30,747,275,22.04.2019 00:15,191,20,Hmelnitsk
1072,1052,6,425,642,5,647,0,647,14,479,154,22.04.2019 00:15,191,20,Hmelnitsk
1520,1482,23,657,850,13,863,0,863,31,643,189,22.04.2019 00:35,191,20,Hmelnitsk
1408,1384,29,580,807,21,828,0,828,18,608,202,22.04.2019 00:40,191,20,Hmelnitsk
2112,2044,41,927,1163,22,1185,0,1185,31,911,243,22.04.2019 00:01,191,20,Hmelnitsk
1312,1280,30,533,756,23,779,0,779,26,612,141,22.04.2019 00:55,191,20,Hmelnitsk
1840,1808,67,760,1037,43,1080,0,1080,39,765,276,22.04.2019 00:25,191,20,Hmelnitsk
1600,1569,48,681,884,35,919,0,919,29,701,189,22.04.2019 01:32,191,20,Hmelnitsk
2048,1994,55,842,1176,30,1206,0,1206,37,903,266,22.04.2019 00:55,191,20,Hmelnitsk
2192,2145,62,877,1265,50,1315,0,1315,22,1033,260,22.04.2019 00:08,191,20,Hmelnitsk
2064,2018,64,848,1170,46,1216,0,1216,26,926,264,22.04.2019 00:20,191,20,Hmelnitsk
688,674,20,258,411,19,430,0,430,12,332,86,21.04.2019 21:56,191,20,Hmelnitsk
272,81,18,213,43,16,59,0,59,0,41,18,22.04.2019 00:20,191,20,Hmelnitsk
1744,1724,15,779,954,11,965,0,965,29,772,164,22.04.2019 01:00,192,20,Hmelnitsk
1632,1609,34,687,917,28,945,0,945,15,656,274,22.04.2019 01:45,192,20,Hmelnitsk
96,106,7,20,69,7,76,0,76,2,47,27,22.04.2019 00:15,192,20,Hmelnitsk
320,312,18,94,208,18,226,0,226,3,186,37,22.04.2019 01:30,192,20,Hmelnitsk
288,281,32,88,168,32,200,0,200,5,135,60,21.04.2019 23:58,192,20,Hmelnitsk
176,165,12,70,95,11,106,0,106,0,89,17,22.04.2019 00:20,192,20,Hmelnitsk
96,90,9,15,72,9,81,0,81,1,36,44,22.04.2019 00:50,192,20,Hmelnitsk
128,115,18,23,87,18,105,0,105,0,50,55,22.04.2019 00:10,192,20,Hmelnitsk
1024,1002,64,408,554,62,616,0,616,9,471,136,21.04.2019 22:18,192,20,Hmelnitsk
304,297,45,66,198,40,238,0,238,3,159,76,21.04.2019 20:25,192,20,Hmelnitsk
80,77,2,5,73,2,75,0,75,3,33,39,21.04.2019 20:20,192,20,Hmelnitsk
720,709,7,353,362,5,367,0,367,15,294,58,22.04.2019 00:30,192,20,Hmelnitsk
224,212,22,64,143,17,160,0,160,2,117,41,22.04.2019 00:10,192,20,Hmelnitsk
944,924,59,366,522,56,578,0,578,11,446,121,22.04.2019 00:30,192,20,Hmelnitsk
352,346,29,131,192,29,221,0,221,3,162,56,22.04.2019 00:10,192,20,Hmelnitsk
224,217,17,84,123,17,140,0,140,5,110,25,22.04.2019 00:05,192,20,Hmelnitsk
480,462,24,190,266,24,290,0,290,8,240,42,22.04.2019 00:16,192,20,Hmelnitsk
144,136,3,38,104,2,106,0,106,0,91,15,22.04.2019 00:09,192,20,Hmelnitsk
448,433,29,137,282,29,311,0,311,2,212,97,22.04.2019 01:30,192,20,Hmelnitsk
496,481,44,164,288,44,332,0,332,6,223,103,21.04.2019 21:15,192,20,Hmelnitsk
560,548,22,240,299,21,320,0,320,10,221,89,22.04.2019 00:10,192,20,Hmelnitsk
384,374,37,151,201,32,233,0,233,0,141,92,22.04.2019 00:55,192,20,Hmelnitsk
208,195,33,94,84,30,114,0,114,4,77,33,22.04.2019 00:10,192,20,Hmelnitsk
160,160,27,43,90,27,117,0,117,2,73,42,22.04.2019 00:05,192,20,Hmelnitsk
160,147,32,59,71,30,101,0,101,0,83,18,22.04.2019 00:10,192,20,Hmelnitsk
80,76,24,22,38,20,58,0,58,0,47,11,22.04.2019 00:45,192,20,Hmelnitsk
256,251,34,78,144,34,178,0,178,22,111,45,22.04.2019 01:45,192,20,Hmelnitsk
64,56,14,24,26,14,40,0,40,0,14,26,21.04.2019 20:30,192,20,Hmelnitsk
112,102,9,46,59,7,66,0,66,0,45,21,21.04.2019 21:00,192,20,Hmelnitsk
576,561,58,220,309,47,356,0,356,5,264,87,22.04.2019 00:30,192,20,Hmelnitsk
96,87,5,28,63,5,68,0,68,0,55,13,21.04.2019 20:22,192,20,Hmelnitsk
512,465,25,193,294,25,319,0,319,4,230,85,22.04.2019 00:20,192,20,Hmelnitsk
448,438,33,92,323,33,356,0,356,8,291,57,22.04.2019 00:30,192,20,Hmelnitsk
304,291,22,43,239,22,261,0,261,2,173,86,22.04.2019 00:10,192,20,Hmelnitsk
336,328,35,88,219,29,248,0,248,4,177,67,21.04.2019 21:45,192,20,Hmelnitsk
400,381,34,152,220,28,248,0,248,10,184,54,22.04.2019 00:41,192,20,Hmelnitsk
352,345,41,163,149,40,189,0,189,1,112,76,22.04.2019 01:12,192,20,Hmelnitsk
192,179,27,60,105,27,132,0,132,3,60,69,22.04.2019 02:30,192,20,Hmelnitsk
176,167,8,90,79,7,86,0,86,1,69,16,22.04.2019 00:05,192,20,Hmelnitsk
368,360,30,138,205,25,230,0,230,1,167,62,21.04.2019 23:30,192,20,Hmelnitsk
1472,1458,44,654,777,41,818,0,818,6,732,80,22.04.2019 01:00,192,20,Hmelnitsk
384,372,7,116,263,5,268,0,268,5,212,51,22.04.2019 00:15,192,20,Hmelnitsk
112,104,6,28,78,6,84,0,84,0,60,24,22.04.2019 00:55,192,20,Hmelnitsk
352,348,15,132,205,15,220,0,220,4,148,68,22.04.2019 00:20,192,20,Hmelnitsk
128,126,21,42,65,21,86,0,86,2,59,25,22.04.2019 01:10,192,20,Hmelnitsk
1600,1586,9,713,881,6,887,0,887,34,646,207,22.04.2019 00:11,192,20,Hmelnitsk
1920,1895,16,776,1132,12,1144,0,1144,26,795,323,22.04.2019 00:10,192,20,Hmelnitsk
1792,1769,21,646,1125,21,1146,0,1146,46,805,295,22.04.2019 00:12,192,20,Hmelnitsk
1760,1743,16,699,1045,16,1061,0,1061,34,770,257,22.04.2019 00:30,192,20,Hmelnitsk
2512,2492,22,918,1576,18,1594,0,1594,44,1151,399,22.04.2019 01:35,192,20,Hmelnitsk
2048,2034,52,780,1220,48,1268,0,1268,59,917,292,22.04.2019 00:05,192,20,Hmelnitsk
672,667,5,235,432,5,437,0,437,11,313,113,22.04.2019 00:50,192,20,Hmelnitsk
624,614,17,252,355,17,372,0,372,15,259,98,22.04.2019 00:30,192,20,Hmelnitsk
800,792,13,339,448,13,461,0,461,12,324,125,21.04.2019 22:00,192,20,Hmelnitsk
896,881,47,363,489,44,533,0,533,12,338,183,22.04.2019 02:40,192,20,Hmelnitsk
208,207,21,90,99,19,118,0,118,3,81,34,21.04.2019 21:15,192,20,Hmelnitsk
1024,1004,40,456,533,35,568,0,568,16,388,164,22.04.2019 00:15,192,20,Hmelnitsk
160,144,18,55,87,18,105,0,105,0,67,38,22.04.2019 00:10,192,20,Hmelnitsk
416,403,45,138,233,45,278,0,278,4,187,87,22.04.2019 00:20,192,20,Hmelnitsk
720,716,54,287,379,54,433,0,433,8,245,180,22.04.2019 02:55,192,20,Hmelnitsk
352,343,11,141,203,8,211,0,211,3,172,36,22.04.2019 00:48,192,20,Hmelnitsk
256,254,14,77,165,14,179,0,179,2,146,31,21.04.2019 21:05,192,20,Hmelnitsk
560,548,13,226,321,13,334,0,334,7,223,104,22.04.2019 00:05,192,20,Hmelnitsk
496,486,26,102,368,26,394,0,394,4,290,100,21.04.2019 21:00,192,20,Hmelnitsk
448,440,31,153,264,31,295,0,295,7,168,120,22.04.2019 00:40,192,20,Hmelnitsk
704,680,15,260,429,15,444,0,444,17,303,124,22.04.2019 00:24,192,20,Hmelnitsk
304,303,37,134,134,36,170,0,170,3,122,45,22.04.2019 00:30,192,20,Hmelnitsk
144,128,17,76,55,13,68,0,68,0,42,26,22.04.2019 00:31,192,20,Hmelnitsk
368,355,30,104,234,30,264,0,264,0,204,60,22.04.2019 00:20,192,20,Hmelnitsk
256,250,23,91,142,23,165,0,165,0,125,40,22.04.2019 00:20,192,20,Hmelnitsk
96,95,10,30,56,10,66,0,66,1,44,21,22.04.2019 00:35,192,20,Hmelnitsk
912,891,59,318,537,57,594,0,594,10,490,94,21.04.2019 20:55,192,20,Hmelnitsk
768,758,53,297,419,52,471,0,471,12,352,107,22.04.2019 00:10,192,20,Hmelnitsk
576,566,28,181,370,25,395,0,395,12,250,133,22.04.2019 00:10,192,20,Hmelnitsk
624,614,38,194,392,38,430,0,430,3,309,118,22.04.2019 00:10,192,20,Hmelnitsk
224,216,15,89,122,13,135,0,135,2,109,24,22.04.2019 01:40,192,20,Hmelnitsk
2320,2300,23,1080,1222,18,1240,0,1240,47,923,270,22.04.2019 00:40,192,20,Hmelnitsk
1200,1177,20,521,663,16,679,0,679,26,545,108,22.04.2019 00:50,192,20,Hmelnitsk
560,550,62,211,287,62,349,0,349,10,218,121,21.04.2019 23:50,192,20,Hmelnitsk
112,107,16,16,80,16,96,0,96,0,56,40,21.04.2019 22:45,192,20,Hmelnitsk
304,292,29,42,233,29,262,0,262,0,157,105,22.04.2019 00:45,192,20,Hmelnitsk
192,172,26,51,115,26,141,0,141,0,88,53,22.04.2019 00:10,192,20,Hmelnitsk
320,318,14,125,183,12,195,0,195,1,152,42,22.04.2019 00:05,192,20,Hmelnitsk
96,92,3,38,55,3,58,0,58,1,33,24,22.04.2019 00:15,192,20,Hmelnitsk
112,106,15,50,49,13,62,0,62,1,45,16,22.04.2019 00:40,192,20,Hmelnitsk
112,102,5,31,77,4,81,0,81,1,56,24,22.04.2019 00:20,192,20,Hmelnitsk
304,291,6,119,181,4,185,0,185,3,147,35,22.04.2019 00:20,192,20,Hmelnitsk
320,305,9,164,148,8,156,0,156,0,109,47,22.04.2019 00:30,192,20,Hmelnitsk
1056,1042,60,411,588,57,645,0,645,14,498,133,22.04.2019 00:15,192,20,Hmelnitsk
144,132,11,61,72,11,83,0,83,3,48,32,21.04.2019 21:10,192,20,Hmelnitsk
896,876,75,329,499,68,567,0,567,13,417,137,21.04.2019 22:30,192,20,Hmelnitsk
640,629,72,291,278,71,349,0,349,5,264,80,22.04.2019 00:32,192,20,Hmelnitsk
560,550,24,240,296,24,320,0,320,7,211,102,22.04.2019 00:04,192,20,Hmelnitsk
416,404,39,234,143,39,182,0,182,18,103,61,22.04.2019 00:17,192,20,Hmelnitsk
432,419,21,145,267,20,287,0,287,6,193,88,22.04.2019 00:10,192,20,Hmelnitsk
512,504,12,212,291,9,300,0,300,4,236,60,22.04.2019 00:05,192,20,Hmelnitsk
224,210,3,113,109,2,111,0,111,1,74,36,22.04.2019 00:05,192,20,Hmelnitsk
128,120,3,43,82,3,85,0,85,0,56,29,22.04.2019 00:09,192,20,Hmelnitsk
672,660,19,267,387,18,405,0,405,10,305,90,22.04.2019 00:20,192,20,Hmelnitsk
272,257,4,128,140,4,144,0,144,1,94,49,22.04.2019 00:05,192,20,Hmelnitsk
432,414,31,148,253,31,284,0,284,5,188,91,21.04.2019 22:12,192,20,Hmelnitsk
608,593,42,242,324,42,366,0,366,9,263,94,22.04.2019 00:07,192,20,Hmelnitsk
480,469,50,185,245,50,295,0,295,5,200,90,22.04.2019 00:15,192,20,Hmelnitsk
448,450,39,124,285,39,324,0,324,7,216,101,22.04.2019 00:16,192,20,Hmelnitsk
304,294,27,89,188,27,215,0,215,1,136,78,22.04.2019 00:50,192,20,Hmelnitsk
896,881,71,287,539,70,609,0,609,10,416,183,22.04.2019 00:20,192,20,Hmelnitsk
96,95,1,30,65,1,66,0,66,1,47,18,22.04.2019 00:15,192,20,Hmelnitsk
576,568,24,208,344,24,368,0,368,3,263,102,22.04.2019 00:30,192,20,Hmelnitsk
480,475,29,155,296,29,325,0,325,9,223,93,22.04.2019 00:26,192,20,Hmelnitsk
256,252,20,108,128,20,148,0,148,7,108,33,22.04.2019 00:15,192,20,Hmelnitsk
80,57,45,28,12,40,52,0,52,0,42,10,22.04.2019 00:20,192,20,Hmelnitsk
1216,1198,26,496,699,21,720,0,720,18,508,194,22.04.2019 01:05,192,20,Hmelnitsk
800,780,23,323,458,19,477,0,477,5,347,125,22.04.2019 02:40,192,20,Hmelnitsk
832,826,22,379,438,15,453,0,453,7,320,126,21.04.2019 23:55,192,20,Hmelnitsk
640,630,14,273,354,13,367,0,367,5,288,74,21.04.2019 23:58,192,20,Hmelnitsk
496,477,28,183,286,27,313,0,313,12,231,70,21.04.2019 23:15,192,20,Hmelnitsk
976,958,94,364,523,89,612,0,612,18,467,127,22.04.2019 00:40,192,20,Hmelnitsk
144,134,31,44,73,27,100,0,100,2,64,34,22.04.2019 01:30,192,20,Hmelnitsk
640,639,75,256,318,66,384,0,384,9,235,140,22.04.2019 00:10,192,20,Hmelnitsk
656,631,64,322,279,55,334,0,334,8,228,98,21.04.2019 23:56,192,20,Hmelnitsk
128,124,30,46,54,28,82,0,82,1,34,47,22.04.2019 02:30,192,20,Hmelnitsk
336,322,57,50,232,54,286,0,286,1,140,145,21.04.2019 21:00,192,20,Hmelnitsk
512,503,49,190,278,44,322,0,322,12,208,102,22.04.2019 00:15,192,20,Hmelnitsk
400,379,39,169,197,34,231,0,231,5,189,37,22.04.2019 00:01,192,20,Hmelnitsk
80,71,9,25,46,9,55,0,55,0,50,5,22.04.2019 00:05,192,20,Hmelnitsk
60,55,3,15,42,3,45,0,45,0,26,19,22.04.2019 00:35,192,20,Hmelnitsk
416,412,59,121,238,57,295,0,295,4,185,106,22.04.2019 00:05,192,20,Hmelnitsk
1072,1055,107,278,689,105,794,0,794,11,586,197,22.04.2019 01:30,192,20,Hmelnitsk
496,483,49,111,337,48,385,0,385,21,169,195,22.04.2019 01:45,192,20,Hmelnitsk
432,414,101,107,230,95,325,0,325,2,178,145,22.04.2019 00:29,192,20,Hmelnitsk
832,819,63,370,403,59,462,0,462,9,370,83,22.04.2019 01:30,192,20,Hmelnitsk
512,504,87,205,231,76,307,0,307,3,206,98,22.04.2019 01:45,192,20,Hmelnitsk
784,768,90,328,374,82,456,0,456,10,353,93,22.04.2019 00:05,192,20,Hmelnitsk
464,448,35,166,263,35,298,0,298,2,209,87,22.04.2019 00:35,192,20,Hmelnitsk
864,851,85,274,523,67,590,0,590,10,414,166,21.04.2019 23:01,192,20,Hmelnitsk
128,117,20,47,64,17,81,0,81,0,63,18,21.04.2019 22:30,192,20,Hmelnitsk
1120,1099,116,412,594,114,708,0,708,20,491,197,22.04.2019 00:11,192,20,Hmelnitsk
112,99,5,51,56,5,61,0,61,2,43,16,22.04.2019 03:20,192,20,Hmelnitsk
784,773,70,342,376,66,442,0,442,9,310,123,22.04.2019 00:35,192,20,Hmelnitsk
384,367,36,134,218,32,250,0,250,3,217,30,22.04.2019 00:05,192,20,Hmelnitsk
304,298,28,115,164,25,189,0,189,1,121,67,22.04.2019 02:10,192,20,Hmelnitsk
144,142,18,30,96,18,114,0,114,0,61,53,22.04.2019 00:25,192,20,Hmelnitsk
96,87,11,37,52,7,59,0,59,1,40,18,22.04.2019 00:30,192,20,Hmelnitsk
448,448,34,167,248,33,281,0,281,7,220,54,21.04.2019 23:10,192,20,Hmelnitsk
352,356,37,101,218,33,251,0,251,6,160,85,22.04.2019 00:40,192,20,Hmelnitsk
96,83,6,44,46,6,52,0,52,1,22,29,22.04.2019 00:30,192,20,Hmelnitsk
528,511,71,225,246,57,303,0,303,5,208,90,22.04.2019 00:28,192,20,Hmelnitsk
752,738,60,223,470,59,529,0,529,13,371,145,22.04.2019 00:15,192,20,Hmelnitsk
96,88,5,28,63,5,68,0,68,2,28,38,22.04.2019 00:30,192,20,Hmelnitsk
608,591,57,227,334,47,381,0,381,0,278,103,22.04.2019 00:20,192,20,Hmelnitsk
96,89,11,26,63,7,70,0,70,3,34,33,22.04.2019 00:20,192,20,Hmelnitsk
320,307,28,120,176,24,200,0,200,9,160,31,21.04.2019 22:30,192,20,Hmelnitsk
320,307,26,136,161,23,184,0,184,0,155,29,22.04.2019 00:30,192,20,Hmelnitsk
144,133,11,47,86,11,97,0,97,2,66,29,22.04.2019 00:30,192,20,Hmelnitsk
160,150,26,63,77,20,97,0,97,0,71,26,22.04.2019 00:25,192,20,Hmelnitsk
528,523,53,185,295,48,343,0,343,3,248,92,22.04.2019 00:15,192,20,Hmelnitsk
400,398,8,119,274,7,281,0,281,9,233,39,22.04.2019 02:25,192,20,Hmelnitsk
160,156,3,63,94,3,97,0,97,2,77,18,22.04.2019 00:20,192,20,Hmelnitsk
416,404,42,151,226,39,265,0,265,11,189,65,22.04.2019 00:15,192,20,Hmelnitsk
224,219,26,66,133,25,158,0,158,0,90,68,22.04.2019 02:05,192,20,Hmelnitsk
144,140,22,40,86,18,104,0,104,0,66,38,22.04.2019 00:20,192,20,Hmelnitsk
96,86,14,39,45,12,57,0,57,1,28,28,22.04.2019 00:10,192,20,Hmelnitsk
176,173,11,66,101,9,110,0,110,1,86,23,22.04.2019 00:30,192,20,Hmelnitsk
80,72,13,32,39,9,48,0,48,0,35,13,22.04.2019 00:30,192,20,Hmelnitsk
384,379,26,102,263,19,282,0,282,4,195,83,22.04.2019 00:20,192,20,Hmelnitsk
304,292,35,103,172,29,201,0,201,1,150,50,22.04.2019 00:16,192,20,Hmelnitsk
304,297,43,91,174,39,213,0,213,2,122,89,22.04.2019 00:20,192,20,Hmelnitsk
384,376,89,119,180,85,265,0,265,13,167,85,21.04.2019 20:25,192,20,Hmelnitsk
768,753,62,367,341,60,401,0,401,7,298,96,22.04.2019 00:12,192,20,Hmelnitsk
144,130,14,62,69,13,82,0,82,0,42,40,22.04.2019 00:30,192,20,Hmelnitsk
448,440,11,184,254,10,264,0,264,3,184,77,22.04.2019 02:50,192,20,Hmelnitsk
208,206,10,69,130,9,139,0,139,1,113,25,22.04.2019 00:05,192,20,Hmelnitsk
416,402,14,128,274,14,288,0,288,4,217,67,22.04.2019 02:04,192,20,Hmelnitsk
240,231,3,106,131,3,134,0,134,3,101,30,22.04.2019 00:10,192,20,Hmelnitsk
96,93,0,21,75,0,75,0,75,0,48,27,22.04.2019 00:05,192,20,Hmelnitsk
320,313,9,102,209,9,218,0,218,2,141,75,22.04.2019 00:25,192,20,Hmelnitsk
416,415,53,160,209,47,256,0,256,4,177,75,22.04.2019 00:45,192,20,Hmelnitsk
128,114,18,47,65,16,81,0,81,0,54,27,22.04.2019 01:00,192,20,Hmelnitsk
96,87,19,31,49,16,65,0,65,1,39,25,22.04.2019 00:20,192,20,Hmelnitsk
48,47,5,9,35,4,39,0,39,0,27,12,22.04.2019 01:30,192,20,Hmelnitsk
160,161,14,60,88,12,100,0,100,1,64,35,21.04.2019 23:00,192,20,Hmelnitsk
224,209,16,103,108,13,121,0,121,1,97,23,21.04.2019 23:00,192,20,Hmelnitsk
416,405,33,150,237,29,266,0,266,3,210,53,22.04.2019 02:30,192,20,Hmelnitsk
112,115,23,29,62,21,83,0,83,1,66,16,22.04.2019 00:20,192,20,Hmelnitsk
192,183,17,49,127,16,143,0,143,4,93,46,22.04.2019 00:10,192,20,Hmelnitsk
80,64,6,29,45,6,51,0,51,0,40,11,22.04.2019 00:38,192,20,Hmelnitsk
96,86,16,33,48,15,63,0,63,1,49,13,22.04.2019 00:15,192,20,Hmelnitsk
736,726,66,239,437,60,497,0,497,6,404,87,22.04.2019 00:15,192,20,Hmelnitsk
160,153,27,47,90,23,113,0,113,2,78,33,21.04.2019 21:07,192,20,Hmelnitsk
544,527,25,261,262,21,283,0,283,2,215,66,21.04.2019 20:54,192,20,Hmelnitsk
192,187,12,95,90,7,97,0,97,2,68,27,21.04.2019 23:00,192,20,Hmelnitsk
64,63,4,24,37,3,40,0,40,0,24,16,21.04.2019 20:40,192,20,Hmelnitsk
432,417,38,145,251,36,287,0,287,5,216,66,22.04.2019 00:45,192,20,Hmelnitsk
720,700,33,256,434,30,464,0,464,5,339,120,21.04.2019 23:50,192,20,Hmelnitsk
224,203,10,110,104,10,114,0,114,3,79,32,22.04.2019 00:20,192,20,Hmelnitsk
512,502,12,192,309,11,320,0,320,6,274,40,22.04.2019 01:20,192,20,Hmelnitsk
1184,1165,77,406,705,73,778,0,778,13,639,126,22.04.2019 01:15,192,20,Hmelnitsk
336,319,30,141,176,19,195,0,195,4,157,34,22.04.2019 00:20,192,20,Hmelnitsk
480,468,30,206,244,30,274,0,274,9,199,66,22.04.2019 00:30,192,20,Hmelnitsk
800,787,43,273,488,39,527,0,527,2,405,120,22.04.2019 00:31,192,20,Hmelnitsk
176,164,10,71,95,10,105,0,105,5,73,27,22.04.2019 00:07,192,20,Hmelnitsk
192,200,21,41,130,21,151,0,151,2,115,34,22.04.2019 02:00,192,20,Hmelnitsk
48,36,2,27,20,1,21,0,21,0,12,9,22.04.2019 02:10,192,20,Hmelnitsk
528,513,36,226,271,31,302,0,302,6,235,61,21.04.2019 21:00,192,20,Hmelnitsk
848,832,68,281,505,62,567,0,567,14,438,115,21.04.2019 21:40,192,20,Hmelnitsk
544,534,48,208,296,40,336,0,336,9,206,121,21.04.2019 23:50,192,20,Hmelnitsk
192,184,10,62,120,10,130,0,130,2,96,32,22.04.2019 00:15,192,20,Hmelnitsk
1680,1648,15,674,992,14,1006,0,1006,29,746,231,22.04.2019 00:05,192,20,Hmelnitsk
1264,1279,6,504,754,6,760,0,760,16,548,196,22.04.2019 00:35,192,20,Hmelnitsk
944,623,15,542,387,15,402,0,402,19,303,80,22.04.2019 00:40,192,20,Hmelnitsk
1712,1686,80,742,895,75,970,0,970,12,732,226,22.04.2019 00:55,193,20,Hmelnitsk
416,411,44,138,240,38,278,0,278,3,199,76,22.04.2019 01:30,193,20,Hmelnitsk
432,416,38,198,200,34,234,0,234,3,147,84,22.04.2019 00:30,193,20,Hmelnitsk
384,375,43,127,217,40,257,0,257,7,185,65,22.04.2019 00:05,193,20,Hmelnitsk
192,180,31,69,92,31,123,0,123,1,100,22,22.04.2019 00:10,193,20,Hmelnitsk
112,101,10,22,80,10,90,0,90,0,67,23,22.04.2019 00:20,193,20,Hmelnitsk
576,565,52,186,346,44,390,0,390,11,293,86,22.04.2019 00:20,193,20,Hmelnitsk
128,115,18,54,58,16,74,0,74,3,61,10,22.04.2019 00:35,193,20,Hmelnitsk
96,82,8,34,56,6,62,0,62,2,45,15,22.04.2019 00:06,193,20,Hmelnitsk
1360,1341,71,543,755,62,817,0,817,18,675,124,22.04.2019 00:55,193,20,Hmelnitsk
304,294,13,77,214,13,227,0,227,2,165,60,22.04.2019 01:10,193,20,Hmelnitsk
576,572,49,188,345,43,388,0,388,18,286,84,21.04.2019 22:18,193,20,Hmelnitsk
160,145,11,67,83,10,93,0,93,2,72,19,22.04.2019 00:15,193,20,Hmelnitsk
144,131,9,59,77,8,85,0,85,0,61,24,22.04.2019 00:30,193,20,Hmelnitsk
96,90,6,50,41,5,46,0,46,0,31,15,22.04.2019 00:15,193,20,Hmelnitsk
416,411,33,100,283,33,316,0,316,4,197,115,22.04.2019 00:05,193,20,Hmelnitsk
368,362,42,148,180,40,220,0,220,0,163,57,22.04.2019 00:35,193,20,Hmelnitsk
1760,1726,107,480,1187,93,1280,0,1280,33,901,346,22.04.2019 00:02,193,20,Hmelnitsk
1136,1117,82,461,597,78,675,0,675,14,500,161,22.04.2019 06:00,193,20,Hmelnitsk
512,511,36,164,316,32,348,0,348,8,221,119,22.04.2019 00:07,193,20,Hmelnitsk
560,545,13,180,370,10,380,0,380,10,281,89,22.04.2019 03:30,193,20,Hmelnitsk
96,93,9,39,48,9,57,0,57,2,50,5,22.04.2019 00:03,193,20,Hmelnitsk
272,258,18,117,138,17,155,0,155,2,119,34,22.04.2019 00:25,193,20,Hmelnitsk
240,234,28,99,113,28,141,0,141,5,110,26,22.04.2019 00:50,193,20,Hmelnitsk
1664,1630,32,719,917,28,945,0,945,38,681,226,22.04.2019 00:30,193,20,Hmelnitsk
2032,2008,35,927,1086,19,1105,0,1105,31,791,283,21.04.2019 21:40,193,20,Hmelnitsk
528,524,33,228,271,29,300,0,300,5,216,79,22.04.2019 00:30,193,20,Hmelnitsk
672,657,73,245,356,71,427,0,427,5,312,110,22.04.2019 01:25,193,20,Hmelnitsk
1056,1040,10,504,543,9,552,0,552,14,402,136,21.04.2019 22:30,193,20,Hmelnitsk
128,121,3,61,64,3,67,0,67,1,42,24,22.04.2019 00:25,193,20,Hmelnitsk
144,128,9,56,80,8,88,0,88,0,52,36,21.04.2019 21:10,193,20,Hmelnitsk
224,218,9,105,112,7,119,0,119,2,92,25,22.04.2019 01:20,193,20,Hmelnitsk
784,765,90,314,384,86,470,0,470,7,356,107,21.04.2019 21:35,193,20,Hmelnitsk
80,78,6,33,41,6,47,0,47,1,19,27,22.04.2019 04:45,193,20,Hmelnitsk
480,472,46,168,268,44,312,0,312,1,227,84,21.04.2019 23:15,193,20,Hmelnitsk
160,149,14,57,91,12,103,0,103,2,75,26,22.04.2019 00:40,193,20,Hmelnitsk
624,602,14,276,337,11,348,0,348,6,244,98,22.04.2019 00:10,193,20,Hmelnitsk
1344,1322,49,554,741,49,790,0,790,20,644,126,22.04.2019 01:10,193,20,Hmelnitsk
192,178,9,70,113,9,122,0,122,2,86,34,22.04.2019 00:40,193,20,Hmelnitsk
256,248,20,96,140,20,160,0,160,5,99,56,22.04.2019 02:50,193,20,Hmelnitsk
448,436,59,167,223,58,281,0,281,3,170,108,22.04.2019 00:05,193,20,Hmelnitsk
48,41,3,20,25,3,28,0,28,0,23,5,22.04.2019 00:10,193,20,Hmelnitsk
480,471,40,172,269,39,308,0,308,4,236,68,22.04.2019 00:40,193,20,Hmelnitsk
1808,1779,77,758,979,71,1050,0,1050,33,743,274,22.04.2019 00:40,193,20,Hmelnitsk
352,356,52,109,193,50,243,0,243,1,211,31,22.04.2019 01:00,193,20,Hmelnitsk
368,351,32,131,210,27,237,0,237,6,170,61,22.04.2019 00:20,193,20,Hmelnitsk
48,48,2,14,32,2,34,0,34,0,16,18,22.04.2019 01:30,193,20,Hmelnitsk
544,528,40,117,387,40,427,0,427,5,241,181,22.04.2019 00:05,193,20,Hmelnitsk
1440,1411,39,578,827,35,862,1,861,44,577,240,21.04.2019 23:00,193,20,Hmelnitsk
176,173,4,61,111,4,115,0,115,3,75,37,21.04.2019 22:30,193,20,Hmelnitsk
1088,1079,22,465,606,17,623,0,623,16,443,164,22.04.2019 00:25,193,20,Hmelnitsk
128,124,2,50,76,2,78,0,78,1,65,12,22.04.2019 03:56,193,20,Hmelnitsk
512,505,39,149,328,35,363,0,363,13,272,78,22.04.2019 04:42,193,20,Hmelnitsk
848,828,32,329,491,28,519,0,519,10,409,100,21.04.2019 21:40,193,20,Hmelnitsk
288,268,17,112,162,14,176,0,176,1,124,51,21.04.2019 23:00,193,20,Hmelnitsk
32,30,1,13,18,1,19,0,19,0,15,4,22.04.2019 00:03,193,20,Hmelnitsk
256,240,18,85,155,16,171,0,171,4,136,31,22.04.2019 00:30,193,20,Hmelnitsk
400,393,21,167,215,18,233,0,233,11,157,65,22.04.2019 00:20,193,20,Hmelnitsk
304,290,14,129,165,10,175,0,175,3,132,40,22.04.2019 05:50,193,20,Hmelnitsk
400,381,30,141,231,28,259,0,259,6,193,60,22.04.2019 00:45,193,20,Hmelnitsk
128,118,10,54,66,8,74,0,74,1,60,13,22.04.2019 00:28,193,20,Hmelnitsk
1024,1000,65,380,580,64,644,0,644,10,479,155,22.04.2019 02:20,193,20,Hmelnitsk
720,706,47,332,350,38,388,0,388,5,299,84,22.04.2019 01:30,193,20,Hmelnitsk
992,972,20,513,460,19,479,0,479,7,388,84,22.04.2019 00:30,193,20,Hmelnitsk
928,927,20,482,427,19,446,0,446,12,330,104,22.04.2019 00:15,193,20,Hmelnitsk
256,248,21,108,129,19,148,0,148,7,89,52,22.04.2019 00:10,193,20,Hmelnitsk
176,165,9,72,96,8,104,0,104,3,90,11,22.04.2019 02:07,193,20,Hmelnitsk
512,506,38,197,284,31,315,0,315,4,208,103,22.04.2019 00:05,193,20,Hmelnitsk
592,577,53,232,309,51,360,0,360,13,281,66,21.04.2019 22:45,193,20,Hmelnitsk
48,48,5,4,40,4,44,0,44,0,27,17,22.04.2019 00:40,193,20,Hmelnitsk
176,163,19,48,112,16,128,0,128,0,91,37,21.04.2019 20:45,193,20,Hmelnitsk
176,169,21,57,100,19,119,0,119,0,87,32,22.04.2019 00:10,193,20,Hmelnitsk
544,527,28,231,288,25,313,0,313,3,236,74,21.04.2019 23:10,193,20,Hmelnitsk
560,556,37,200,327,33,360,0,360,10,286,64,22.04.2019 00:20,193,20,Hmelnitsk
320,306,21,106,196,18,214,0,214,5,143,66,22.04.2019 00:25,193,20,Hmelnitsk
656,650,35,274,348,34,382,0,382,10,264,108,21.04.2019 22:36,193,20,Hmelnitsk
320,317,8,166,146,8,154,0,154,1,117,36,22.04.2019 00:15,193,20,Hmelnitsk
720,716,21,308,392,20,412,0,412,7,303,102,21.04.2019 21:30,193,20,Hmelnitsk
400,401,23,170,211,19,230,0,230,7,186,37,21.04.2019 21:15,193,20,Hmelnitsk
2112,2083,24,833,1256,23,1279,0,1279,24,916,339,22.04.2019 00:30,193,20,Hmelnitsk
368,360,30,151,187,30,217,0,217,4,162,51,22.04.2019 00:01,193,20,Hmelnitsk
1168,1158,56,495,619,54,673,0,673,15,494,164,22.04.2019 02:30,193,20,Hmelnitsk
128,125,9,50,69,9,78,0,78,1,52,25,22.04.2019 00:55,193,20,Hmelnitsk
112,101,9,48,55,9,64,0,64,0,44,20,22.04.2019 01:40,193,20,Hmelnitsk
512,495,25,156,331,25,356,0,356,14,267,75,22.04.2019 00:45,193,20,Hmelnitsk
80,74,3,28,49,3,52,0,52,0,38,14,22.04.2019 00:55,193,20,Hmelnitsk
112,104,7,41,64,7,71,0,71,3,54,14,22.04.2019 01:00,193,20,Hmelnitsk
352,340,41,158,163,31,194,0,194,5,152,37,22.04.2019 00:30,193,20,Hmelnitsk
432,415,23,159,256,17,273,0,273,3,202,68,22.04.2019 00:45,193,20,Hmelnitsk
528,509,42,253,240,35,275,0,275,3,207,65,22.04.2019 01:15,193,20,Hmelnitsk
592,580,54,202,339,51,390,0,390,2,337,51,22.04.2019 00:30,193,20,Hmelnitsk
96,94,5,38,54,4,58,0,58,0,53,5,22.04.2019 00:30,193,20,Hmelnitsk
384,376,22,126,238,20,258,0,258,3,235,20,22.04.2019 01:00,193,20,Hmelnitsk
288,279,25,87,176,25,201,0,201,3,145,53,22.04.2019 00:25,193,20,Hmelnitsk
640,624,31,242,367,31,398,0,398,9,284,105,22.04.2019 06:42,193,20,Hmelnitsk
496,487,36,180,283,33,316,0,316,11,231,74,22.04.2019 01:00,193,20,Hmelnitsk
528,518,20,239,269,20,289,0,289,2,203,84,22.04.2019 01:10,193,20,Hmelnitsk
384,375,16,193,175,16,191,0,191,9,136,46,22.04.2019 00:15,193,20,Hmelnitsk
112,105,5,47,60,5,65,0,65,2,47,16,22.04.2019 01:50,193,20,Hmelnitsk
160,147,21,47,94,19,113,0,113,2,83,28,22.04.2019 01:20,193,20,Hmelnitsk
336,313,33,135,175,26,201,0,201,7,124,70,22.04.2019 00:20,193,20,Hmelnitsk
176,162,4,66,106,4,110,0,110,1,52,57,22.04.2019 00:35,193,20,Hmelnitsk
256,257,26,95,135,26,161,0,161,3,99,59,22.04.2019 00:30,193,20,Hmelnitsk
2032,1992,18,817,1198,17,1215,0,1215,17,868,330,22.04.2019 00:20,193,20,Hmelnitsk
1552,1529,9,704,842,6,848,0,848,11,634,203,22.04.2019 01:45,193,20,Hmelnitsk
976,957,10,419,547,10,557,0,557,20,384,153,21.04.2019 22:00,193,20,Hmelnitsk
752,733,21,358,374,20,394,0,394,11,291,92,22.04.2019 01:10,193,20,Hmelnitsk
448,431,30,186,232,30,262,0,262,2,145,115,22.04.2019 02:15,193,20,Hmelnitsk
320,302,26,137,157,26,183,0,183,19,87,77,22.04.2019 00:30,193,20,Hmelnitsk
416,406,40,155,228,33,261,0,261,6,166,89,22.04.2019 01:25,193,20,Hmelnitsk
160,147,18,60,84,16,100,0,100,2,56,42,21.04.2019 23:30,193,20,Hmelnitsk
656,640,34,285,341,30,371,0,371,15,249,107,21.04.2019 20:55,193,20,Hmelnitsk
160,155,15,40,105,15,120,0,120,0,76,44,22.04.2019 00:05,193,20,Hmelnitsk
224,214,28,81,119,24,143,0,143,6,77,60,21.04.2019 21:04,193,20,Hmelnitsk
240,227,17,81,143,16,159,0,159,3,101,55,21.04.2019 20:40,193,20,Hmelnitsk
80,69,25,28,28,24,52,0,52,1,22,29,22.04.2019 00:15,193,20,Hmelnitsk
304,293,27,102,177,25,202,0,202,9,154,39,22.04.2019 00:10,193,20,Hmelnitsk
80,73,8,37,37,6,43,0,43,1,16,26,22.04.2019 00:20,193,20,Hmelnitsk
944,929,66,411,470,63,533,0,533,11,401,121,21.04.2019 21:06,193,20,Hmelnitsk
128,119,12,58,58,12,70,0,70,4,39,27,21.04.2019 21:00,193,20,Hmelnitsk
240,223,18,88,134,18,152,0,152,1,107,44,21.04.2019 23:45,193,20,Hmelnitsk
416,410,26,153,237,26,263,0,263,4,197,62,21.04.2019 23:00,193,20,Hmelnitsk
496,480,30,176,291,29,320,0,320,7,243,70,22.04.2019 00:05,193,20,Hmelnitsk
144,137,19,42,85,17,102,0,102,2,62,38,21.04.2019 21:20,193,20,Hmelnitsk
80,67,7,31,42,7,49,0,49,1,28,20,21.04.2019 20:35,193,20,Hmelnitsk
80,73,4,44,32,4,36,0,36,0,13,23,21.04.2019 22:45,193,20,Hmelnitsk
448,443,48,166,237,45,282,0,282,4,177,101,21.04.2019 21:10,193,20,Hmelnitsk
32,32,2,5,26,1,27,0,27,2,9,16,21.04.2019 23:00,193,20,Hmelnitsk
272,268,28,103,144,25,169,0,169,1,131,37,21.04.2019 23:30,193,20,Hmelnitsk
752,732,25,329,398,25,423,0,423,7,276,140,22.04.2019 00:40,193,20,Hmelnitsk
368,363,12,107,249,12,261,0,261,4,151,106,22.04.2019 00:15,193,20,Hmelnitsk
848,829,22,118,708,22,730,0,730,22,452,256,22.04.2019 01:45,193,20,Hmelnitsk
272,255,7,120,145,7,152,0,152,3,120,29,22.04.2019 00:08,193,20,Hmelnitsk
592,588,58,233,301,58,359,0,359,11,234,114,21.04.2019 21:30,193,20,Hmelnitsk
240,226,19,78,143,19,162,0,162,3,108,51,21.04.2019 21:00,193,20,Hmelnitsk
272,261,15,102,157,13,170,0,170,2,116,52,22.04.2019 00:35,193,20,Hmelnitsk
240,222,13,101,126,13,139,0,139,0,100,39,21.04.2019 21:20,193,20,Hmelnitsk
560,541,48,207,306,47,353,0,353,7,246,100,21.04.2019 22:00,193,20,Hmelnitsk
160,144,12,52,96,12,108,0,108,6,78,24,22.04.2019 00:15,193,20,Hmelnitsk
80,76,12,24,46,10,56,0,56,0,32,24,22.04.2019 00:15,193,20,Hmelnitsk
912,892,64,388,467,57,524,0,524,14,369,141,22.04.2019 01:10,193,20,Hmelnitsk
400,393,37,150,215,35,250,0,250,4,153,93,22.04.2019 00:45,193,20,Hmelnitsk
128,121,18,45,66,17,83,0,83,3,43,37,22.04.2019 00:03,193,20,Hmelnitsk
336,321,36,129,174,33,207,0,207,1,135,71,21.04.2019 21:33,193,20,Hmelnitsk
464,449,28,201,239,24,263,0,263,3,201,59,21.04.2019 21:30,193,20,Hmelnitsk
80,68,3,39,39,2,41,0,41,0,25,16,21.04.2019 20:30,193,20,Hmelnitsk
192,191,13,76,104,12,116,0,116,0,108,8,22.04.2019 00:05,193,20,Hmelnitsk
592,581,48,182,365,45,410,0,410,10,278,122,22.04.2019 00:20,193,20,Hmelnitsk
432,428,14,118,300,14,314,0,314,8,221,85,22.04.2019 00:10,193,20,Hmelnitsk
240,223,3,94,144,2,146,0,146,0,110,36,22.04.2019 02:45,193,20,Hmelnitsk
560,548,36,253,272,35,307,0,307,6,256,45,22.04.2019 00:10,193,20,Hmelnitsk
192,191,16,66,111,15,126,0,126,2,83,41,22.04.2019 00:15,193,20,Hmelnitsk
224,213,7,37,180,7,187,0,187,1,86,100,22.04.2019 00:20,193,20,Hmelnitsk
384,369,41,162,186,36,222,0,222,2,168,52,21.04.2019 21:30,193,20,Hmelnitsk
176,168,24,58,96,22,118,0,118,4,83,31,21.04.2019 23:30,193,20,Hmelnitsk
256,255,19,107,130,19,149,0,149,7,96,46,21.04.2019 20:46,193,20,Hmelnitsk
160,149,23,57,81,22,103,0,103,0,61,42,21.04.2019 22:00,193,20,Hmelnitsk
1152,1119,70,473,613,66,679,0,679,30,488,161,22.04.2019 00:30,193,20,Hmelnitsk
1392,1380,11,533,850,9,859,0,859,21,605,233,22.04.2019 00:15,193,20,Hmelnitsk
2128,2106,15,844,1271,13,1284,0,1284,32,929,323,22.04.2019 02:00,193,20,Hmelnitsk
2048,2018,19,855,1184,9,1193,0,1193,51,833,309,22.04.2019 01:10,193,20,Hmelnitsk
1744,1718,7,717,1021,6,1027,0,1027,33,749,245,22.04.2019 01:32,193,20,Hmelnitsk
2096,2070,18,935,1151,10,1161,0,1161,31,864,266,21.04.2019 23:04,193,20,Hmelnitsk
2192,2156,9,887,1301,4,1305,0,1305,39,968,298,22.04.2019 00:30,193,20,Hmelnitsk
1872,1846,6,749,1119,4,1123,0,1123,31,765,327,22.04.2019 00:20,193,20,Hmelnitsk
1504,1474,13,608,887,9,896,0,896,27,684,185,22.04.2019 00:30,193,20,Hmelnitsk
1136,1099,3,830,303,3,306,0,306,4,235,67,22.04.2019 00:20,193,20,Hmelnitsk
1840,1799,19,760,1065,15,1080,0,1080,27,764,289,22.04.2019 00:32,193,20,Hmelnitsk
1536,1518,27,609,902,25,927,0,927,22,658,247,22.04.2019 01:45,193,20,Hmelnitsk
1440,1425,12,642,788,10,798,0,798,20,555,223,22.04.2019 00:50,193,20,Hmelnitsk
1984,1952,25,857,1105,22,1127,0,1127,26,843,258,22.04.2019 00:10,193,20,Hmelnitsk
1248,1246,9,480,763,5,768,0,768,28,539,201,22.04.2019 00:06,193,20,Hmelnitsk
1488,1459,5,540,946,2,948,0,948,33,676,239,22.04.2019 00:09,193,20,Hmelnitsk
1856,1853,17,711,1139,6,1145,0,1145,29,792,324,22.04.2019 02:10,193,20,Hmelnitsk
2160,2137,20,875,1275,10,1285,0,1285,34,899,352,22.04.2019 01:30,193,20,Hmelnitsk
1536,1517,22,583,933,20,953,0,953,26,651,276,22.04.2019 00:12,193,20,Hmelnitsk
1056,1024,8,524,526,6,532,0,532,16,389,127,22.04.2019 00:35,193,20,Hmelnitsk
1424,1389,21,648,758,18,776,0,776,15,551,210,22.04.2019 02:30,193,20,Hmelnitsk
1456,1431,19,590,856,10,866,0,866,18,630,218,22.04.2019 00:45,193,20,Hmelnitsk
1664,1664,15,730,923,11,934,0,934,27,636,271,22.04.2019 00:10,193,20,Hmelnitsk
1808,1776,59,731,1022,55,1077,0,1077,25,754,298,21.04.2019 23:05,193,20,Hmelnitsk
1072,1323,4,186,882,4,886,0,886,22,584,280,22.04.2019 01:20,193,20,Hmelnitsk
128,56,41,76,15,37,52,0,52,3,28,21,22.04.2019 02:10,193,20,Hmelnitsk
288,41,9,258,21,9,30,0,30,0,22,8,22.04.2019 01:25,193,20,Hmelnitsk
448,369,0,79,369,0,369,0,369,8,345,16,22.04.2019 00:05,194,21,Cherkassy
2176,2203,29,739,1416,21,1437,0,1437,53,978,406,22.04.2019 00:15,194,21,Cherkassy
1744,1709,10,690,1045,9,1054,0,1054,35,762,257,22.04.2019 00:15,194,21,Cherkassy
2128,2134,25,762,1347,19,1366,0,1366,34,960,372,22.04.2019 00:45,194,21,Cherkassy
2320,2313,29,846,1459,15,1474,0,1474,54,1034,386,22.04.2019 00:15,194,21,Cherkassy
2336,2307,18,844,1477,15,1492,0,1492,30,1042,420,22.04.2019 00:46,194,21,Cherkassy
1232,1218,9,458,766,8,774,0,774,23,570,181,22.04.2019 00:45,194,21,Cherkassy
1248,1284,21,434,803,11,814,0,814,28,564,222,22.04.2019 00:05,194,21,Cherkassy
1952,1934,14,726,1218,8,1226,0,1226,38,867,321,22.04.2019 00:05,194,21,Cherkassy
2240,2221,21,854,1372,14,1386,0,1386,40,1020,326,22.04.2019 01:30,194,21,Cherkassy
1680,1695,11,535,1136,9,1145,0,1145,41,817,287,22.04.2019 00:45,194,21,Cherkassy
1616,1597,9,546,1064,6,1070,0,1070,26,741,303,22.04.2019 00:10,194,21,Cherkassy
2256,2225,15,939,1308,9,1317,0,1317,42,989,286,22.04.2019 00:40,194,21,Cherkassy
2160,2132,11,891,1261,8,1269,0,1269,57,882,330,22.04.2019 00:17,194,21,Cherkassy
1584,1565,16,571,1000,13,1013,0,1013,25,729,259,22.04.2019 00:30,194,21,Cherkassy
1952,1927,12,705,1238,9,1247,0,1247,45,938,264,22.04.2019 00:10,194,21,Cherkassy
2224,2206,13,893,1321,10,1331,0,1331,44,965,322,22.04.2019 02:30,194,21,Cherkassy
2336,2323,13,851,1475,10,1485,0,1485,47,1088,350,22.04.2019 00:21,194,21,Cherkassy
1936,1916,8,787,1145,4,1149,0,1149,39,840,270,22.04.2019 00:26,194,21,Cherkassy
2112,2095,15,819,1280,13,1293,0,1293,44,938,311,22.04.2019 00:10,194,21,Cherkassy
2288,2274,26,909,1362,17,1379,0,1379,43,1042,294,22.04.2019 00:15,194,21,Cherkassy
1808,1802,8,678,1124,6,1130,0,1130,32,807,291,22.04.2019 00:20,194,21,Cherkassy
1376,1363,2,512,863,1,864,0,864,25,665,174,22.04.2019 02:22,194,21,Cherkassy
2080,2047,4,1017,1060,3,1063,0,1063,27,828,208,22.04.2019 01:40,194,21,Cherkassy
2112,2093,13,1092,1009,11,1020,0,1020,23,812,185,22.04.2019 00:40,194,21,Cherkassy
2064,2039,12,723,1333,8,1341,0,1341,47,967,327,22.04.2019 00:02,194,21,Cherkassy
1696,1677,8,613,1077,6,1083,0,1083,19,814,250,22.04.2019 00:21,194,21,Cherkassy
1968,1972,7,775,1187,6,1193,0,1193,45,848,300,22.04.2019 00:02,194,21,Cherkassy
1968,1945,13,704,1257,7,1264,0,1264,46,880,338,22.04.2019 01:28,194,21,Cherkassy
1936,1921,10,698,1229,9,1238,0,1238,32,903,303,22.04.2019 00:58,194,21,Cherkassy
1744,1726,4,686,1055,3,1058,0,1058,40,789,229,22.04.2019 01:45,194,21,Cherkassy
2224,2212,11,874,1342,8,1350,0,1350,34,1008,308,22.04.2019 00:35,194,21,Cherkassy
2160,2133,20,823,1323,14,1337,0,1337,45,986,306,22.04.2019 00:50,194,21,Cherkassy
2160,2135,13,822,1328,10,1338,0,1338,43,984,311,22.04.2019 01:30,194,21,Cherkassy
2400,2382,10,985,1409,6,1415,0,1415,45,1055,315,22.04.2019 00:50,194,21,Cherkassy
1280,1265,8,532,742,6,748,0,748,15,581,152,22.04.2019 00:45,194,21,Cherkassy
1712,1672,13,700,999,13,1012,0,1012,25,744,243,22.04.2019 00:06,194,21,Cherkassy
1344,1342,9,478,859,7,866,0,866,17,659,190,22.04.2019 00:40,194,21,Cherkassy
2240,2210,21,955,1275,10,1285,0,1285,35,998,252,22.04.2019 00:02,194,21,Cherkassy
848,847,8,325,516,7,523,0,523,20,387,116,22.04.2019 00:10,194,21,Cherkassy
1600,1579,14,593,994,13,1007,0,1007,38,698,271,22.04.2019 00:20,194,21,Cherkassy
2288,2273,11,918,1361,9,1370,0,1370,38,1087,245,22.04.2019 00:35,194,21,Cherkassy
1600,1595,8,634,960,6,966,0,966,24,727,215,22.04.2019 05:20,194,21,Cherkassy
2336,2315,11,855,1474,7,1481,0,1481,50,974,457,22.04.2019 00:30,194,21,Cherkassy
2208,2226,12,745,1456,7,1463,0,1463,41,1016,406,22.04.2019 00:35,194,21,Cherkassy
2254,2230,8,830,1418,6,1424,0,1424,54,1008,362,22.04.2019 03:00,194,21,Cherkassy
2192,2193,4,816,1374,2,1376,0,1376,40,963,373,22.04.2019 00:02,194,21,Cherkassy
2384,2374,7,832,1548,4,1552,0,1552,37,1121,394,22.04.2019 00:10,194,21,Cherkassy
2160,2155,13,751,1401,8,1409,0,1409,45,1013,351,22.04.2019 00:15,194,21,Cherkassy
2464,2457,11,876,1583,5,1588,0,1588,49,1118,421,22.04.2019 01:58,194,21,Cherkassy
2256,2246,4,774,1480,2,1482,0,1482,47,1029,405,22.04.2019 01:10,194,21,Cherkassy
1984,1956,5,766,1213,5,1218,0,1218,42,900,276,22.04.2019 00:05,194,21,Cherkassy
2432,2402,6,853,1576,3,1579,0,1579,39,1082,458,22.04.2019 00:06,194,21,Cherkassy
64,31,0,35,29,0,29,0,29,0,22,7,22.04.2019 00:05,194,21,Cherkassy
128,38,38,91,0,37,37,0,37,1,31,5,22.04.2019 00:05,194,21,Cherkassy
928,632,0,298,630,0,630,0,630,56,519,55,22.04.2019 00:10,194,21,Cherkassy
2000,1989,6,861,1135,4,1139,0,1139,42,868,229,22.04.2019 00:17,194,21,Cherkassy
2208,2181,10,862,1338,8,1346,0,1346,44,997,305,22.04.2019 00:10,194,21,Cherkassy
2096,2078,27,818,1256,22,1278,0,1278,38,952,288,22.04.2019 00:10,194,21,Cherkassy
1744,1717,7,688,1050,6,1056,0,1056,11,794,251,22.04.2019 00:15,194,21,Cherkassy
1600,1591,16,698,892,10,902,0,902,22,712,168,22.04.2019 00:40,194,21,Cherkassy
2096,2063,9,919,1169,8,1177,0,1177,41,896,240,22.04.2019 00:58,194,21,Cherkassy
1600,1572,12,614,976,10,986,0,986,19,751,216,22.04.2019 00:07,194,21,Cherkassy
1696,1663,18,740,943,13,956,0,956,23,705,228,22.04.2019 00:15,194,21,Cherkassy
2192,2154,5,877,1311,4,1315,0,1315,32,982,301,22.04.2019 00:50,194,21,Cherkassy
2240,2218,7,951,1287,2,1289,0,1289,29,1025,235,22.04.2019 00:15,194,21,Cherkassy
1984,1962,3,725,1256,3,1259,0,1259,31,945,283,22.04.2019 00:10,194,21,Cherkassy
1472,1454,11,605,860,7,867,0,867,18,653,196,22.04.2019 00:33,194,21,Cherkassy
1232,1207,2,494,737,1,738,0,738,23,537,178,22.04.2019 00:59,194,21,Cherkassy
2112,2087,3,940,1170,2,1172,0,1172,28,930,214,22.04.2019 00:25,194,21,Cherkassy
2192,2161,4,933,1256,3,1259,0,1259,35,976,248,22.04.2019 00:41,194,21,Cherkassy
1984,1960,9,767,1209,8,1217,0,1217,30,942,245,22.04.2019 00:17,194,21,Cherkassy
1728,1708,8,718,1002,8,1010,0,1010,29,784,197,22.04.2019 02:09,194,21,Cherkassy
80,14,0,73,7,0,7,0,7,0,7,0,22.04.2019 00:01,194,21,Cherkassy
128,30,25,100,6,22,28,0,28,0,25,3,22.04.2019 00:05,194,21,Cherkassy
528,78,6,450,72,6,78,0,78,4,62,12,22.04.2019 03:20,194,21,Cherkassy
176,74,0,124,52,0,52,0,52,1,37,14,22.04.2019 00:05,194,21,Cherkassy
576,255,109,369,142,65,207,0,207,6,153,48,22.04.2019 00:30,194,21,Cherkassy
128,19,0,109,19,0,19,0,19,1,18,0,22.04.2019 00:15,194,21,Cherkassy
416,42,28,394,8,14,22,0,22,0,16,6,22.04.2019 00:10,194,21,Cherkassy
864,223,115,663,94,107,201,0,201,7,157,37,22.04.2019 00:47,194,21,Cherkassy
224,103,14,123,87,14,101,0,101,0,72,29,22.04.2019 02:07,194,21,Cherkassy
448,123,123,331,0,117,117,0,117,3,94,20,22.04.2019 00:15,194,21,Cherkassy
2128,2083,7,746,1379,3,1382,0,1382,38,992,352,22.04.2019 00:15,194,21,Cherkassy
432,421,34,143,257,32,289,0,289,7,239,43,22.04.2019 00:40,195,21,Cherkassy
800,796,24,391,389,20,409,0,409,4,317,88,22.04.2019 00:17,195,21,Cherkassy
1216,1191,84,426,710,80,790,0,790,14,643,133,22.04.2019 00:15,195,21,Cherkassy
96,87,12,36,49,11,60,0,60,1,45,14,22.04.2019 00:06,195,21,Cherkassy
464,450,39,147,280,37,317,0,317,4,231,82,22.04.2019 00:30,195,21,Cherkassy
992,982,59,407,538,47,585,0,585,13,500,72,22.04.2019 01:15,195,21,Cherkassy
464,446,68,172,230,62,292,0,292,10,223,59,22.04.2019 02:06,195,21,Cherkassy
192,190,17,43,132,17,149,0,149,1,120,28,22.04.2019 00:10,195,21,Cherkassy
800,784,68,326,409,65,474,0,474,8,364,102,22.04.2019 00:03,195,21,Cherkassy
656,643,80,291,294,71,365,0,365,7,279,79,22.04.2019 01:05,195,21,Cherkassy
560,548,46,223,295,42,337,0,337,8,242,87,22.04.2019 00:50,195,21,Cherkassy
176,159,15,40,121,15,136,0,136,0,104,32,22.04.2019 00:48,195,21,Cherkassy
1184,1175,85,492,619,73,692,0,692,19,571,102,22.04.2019 03:15,195,21,Cherkassy
512,491,30,200,284,28,312,0,312,7,261,44,22.04.2019 00:25,195,21,Cherkassy
272,272,28,87,158,27,185,0,185,6,151,28,22.04.2019 00:10,195,21,Cherkassy
432,429,37,180,224,28,252,0,252,7,202,43,22.04.2019 00:37,195,21,Cherkassy
560,543,33,216,313,31,344,0,344,7,272,65,22.04.2019 00:10,195,21,Cherkassy
544,530,9,210,329,5,334,0,334,6,258,70,22.04.2019 01:45,195,21,Cherkassy
304,291,16,121,168,15,183,0,183,2,141,40,22.04.2019 01:15,195,21,Cherkassy
464,447,15,161,290,13,303,0,303,2,252,49,22.04.2019 00:26,195,21,Cherkassy
176,169,22,23,131,22,153,0,153,0,102,51,22.04.2019 00:25,195,21,Cherkassy
336,332,30,91,220,25,245,0,245,6,199,40,22.04.2019 00:50,195,21,Cherkassy
160,148,11,73,78,9,87,0,87,1,70,16,22.04.2019 00:28,195,21,Cherkassy
288,281,10,130,148,10,158,0,158,5,128,25,22.04.2019 00:30,195,21,Cherkassy
496,482,51,219,231,46,277,0,277,8,210,59,22.04.2019 01:00,195,21,Cherkassy
656,639,47,106,503,47,550,0,550,6,467,77,22.04.2019 00:10,195,21,Cherkassy
816,790,32,308,482,26,508,0,508,9,420,79,22.04.2019 00:20,195,21,Cherkassy
192,189,8,61,123,8,131,0,131,2,101,28,22.04.2019 00:10,195,21,Cherkassy
688,674,48,243,398,47,445,0,445,5,345,95,22.04.2019 00:25,195,21,Cherkassy
176,163,0,65,111,0,111,0,111,0,92,19,22.04.2019 00:45,195,21,Cherkassy
288,281,18,89,182,17,199,0,199,3,169,27,22.04.2019 00:30,195,21,Cherkassy
560,557,42,179,341,40,381,0,381,7,297,77,22.04.2019 00:27,195,21,Cherkassy
784,769,33,334,420,30,450,0,450,4,368,78,22.04.2019 00:10,195,21,Cherkassy
304,297,20,107,181,16,197,0,197,3,162,32,22.04.2019 00:10,195,21,Cherkassy
208,198,7,91,112,5,117,0,117,1,96,20,22.04.2019 00:05,195,21,Cherkassy
672,654,57,262,357,53,410,0,410,3,313,94,22.04.2019 01:44,195,21,Cherkassy
384,376,14,129,244,11,255,0,255,1,210,44,22.04.2019 00:20,195,21,Cherkassy
544,530,60,169,317,58,375,0,375,7,327,41,22.04.2019 02:20,195,21,Cherkassy
1120,1114,30,410,683,27,710,0,710,24,572,114,22.04.2019 00:20,195,21,Cherkassy
464,446,7,197,260,7,267,0,267,10,228,29,22.04.2019 00:30,195,21,Cherkassy
2160,2128,67,1099,1001,60,1061,0,1061,31,820,210,22.04.2019 02:00,195,21,Cherkassy
1344,1325,99,529,743,72,815,0,815,12,672,131,22.04.2019 00:25,195,21,Cherkassy
496,481,29,211,259,26,285,0,285,5,242,38,22.04.2019 00:20,195,21,Cherkassy
128,123,8,58,62,8,70,0,70,0,63,7,21.04.2019 22:05,195,21,Cherkassy
720,698,55,276,397,47,444,0,444,15,372,57,22.04.2019 00:15,195,21,Cherkassy
864,849,23,439,404,21,425,0,425,11,316,98,22.04.2019 00:47,195,21,Cherkassy
160,151,34,66,63,31,94,0,94,3,75,16,22.04.2019 00:20,195,21,Cherkassy
480,478,42,231,213,36,249,0,249,4,208,37,22.04.2019 00:30,195,21,Cherkassy
448,438,32,183,236,29,265,0,265,6,206,53,22.04.2019 00:05,195,21,Cherkassy
416,406,25,146,247,23,270,0,270,2,245,23,22.04.2019 00:01,195,21,Cherkassy
976,955,66,446,467,63,530,0,530,8,402,120,22.04.2019 00:35,195,21,Cherkassy
144,139,34,67,47,30,77,0,77,0,50,27,22.04.2019 00:30,195,21,Cherkassy
688,679,68,269,362,57,419,0,419,13,336,70,22.04.2019 00:10,195,21,Cherkassy
528,510,60,224,255,49,304,0,304,4,244,56,22.04.2019 01:15,195,21,Cherkassy
1840,1813,28,811,1001,28,1029,0,1029,16,876,137,21.04.2019 21:45,195,21,Cherkassy
736,711,17,348,372,16,388,0,388,6,324,58,22.04.2019 00:05,195,21,Cherkassy
864,855,22,464,378,22,400,0,400,9,322,69,22.04.2019 00:02,195,21,Cherkassy
512,502,39,202,280,30,310,0,310,2,212,96,22.04.2019 00:05,195,21,Cherkassy
1536,1500,39,687,813,36,849,0,849,15,641,193,22.04.2019 00:20,195,21,Cherkassy
768,748,71,309,400,59,459,0,459,22,329,108,22.04.2019 00:10,195,21,Cherkassy
848,835,46,358,448,42,490,0,490,10,372,108,22.04.2019 00:15,195,21,Cherkassy
464,458,28,197,243,24,267,0,267,6,217,44,22.04.2019 01:30,195,21,Cherkassy
2160,2136,66,988,1109,63,1172,0,1172,40,916,216,22.04.2019 01:50,195,21,Cherkassy
1440,1417,16,627,801,12,813,0,813,23,661,129,22.04.2019 00:20,195,21,Cherkassy
1504,1477,18,775,716,13,729,0,729,18,604,107,22.04.2019 00:50,195,21,Cherkassy
1792,1735,4,916,873,3,876,0,876,20,726,130,22.04.2019 00:20,195,21,Cherkassy
176,42,11,141,27,8,35,0,35,0,27,8,21.04.2019 22:32,195,21,Cherkassy
1264,1229,9,513,742,9,751,0,751,18,588,145,22.04.2019 00:50,195,21,Cherkassy
1536,1512,15,583,940,13,953,0,953,32,739,182,22.04.2019 00:20,195,21,Cherkassy
1760,1733,21,676,1063,21,1084,0,1084,26,843,215,22.04.2019 00:10,195,21,Cherkassy
1408,1381,13,548,847,13,860,0,860,21,680,159,22.04.2019 00:20,195,21,Cherkassy
752,749,24,270,459,23,482,0,482,13,369,100,22.04.2019 00:20,195,21,Cherkassy
288,280,6,137,147,4,151,0,151,3,127,21,22.04.2019 00:15,195,21,Cherkassy
1104,1071,47,470,589,45,634,0,634,16,538,80,22.04.2019 00:15,195,21,Cherkassy
816,801,46,332,440,44,484,0,484,10,412,62,22.04.2019 00:17,195,21,Cherkassy
960,964,86,326,550,84,634,0,634,17,533,84,22.04.2019 01:00,195,21,Cherkassy
928,919,35,357,537,34,571,0,571,8,469,94,22.04.2019 00:10,195,21,Cherkassy
288,285,11,110,167,11,178,0,178,4,146,28,22.04.2019 03:07,195,21,Cherkassy
880,861,35,291,554,35,589,0,589,11,502,76,21.04.2019 23:32,195,21,Cherkassy
1136,1109,78,389,670,77,747,0,747,15,640,92,22.04.2019 00:15,195,21,Cherkassy
496,487,15,222,259,15,274,0,274,5,211,58,22.04.2019 00:10,195,21,Cherkassy
288,277,28,124,136,28,164,0,164,2,141,21,21.04.2019 23:59,195,21,Cherkassy
256,246,12,111,134,11,145,0,145,1,122,22,22.04.2019 00:30,195,21,Cherkassy
544,547,50,187,307,50,357,0,357,5,286,66,21.04.2019 21:10,195,21,Cherkassy
208,188,12,79,118,11,129,0,129,1,111,17,22.04.2019 00:30,195,21,Cherkassy
64,63,1,19,44,1,45,0,45,1,33,11,22.04.2019 00:05,195,21,Cherkassy
144,136,10,34,100,10,110,0,110,2,88,20,22.04.2019 01:55,195,21,Cherkassy
1632,1590,28,711,895,26,921,0,921,25,719,177,22.04.2019 01:10,195,21,Cherkassy
768,754,59,304,406,58,464,0,464,7,403,54,22.04.2019 00:30,195,21,Cherkassy
128,128,23,25,80,23,103,0,103,2,50,51,21.04.2019 21:00,195,21,Cherkassy
480,470,17,150,313,17,330,0,330,3,276,51,22.04.2019 02:45,195,21,Cherkassy
464,451,44,98,322,44,366,0,366,7,321,38,22.04.2019 00:20,195,21,Cherkassy
992,977,66,340,586,66,652,0,652,15,539,98,22.04.2019 00:10,195,21,Cherkassy
496,485,27,188,283,25,308,0,308,8,238,62,22.04.2019 00:15,195,21,Cherkassy
528,513,48,172,309,47,356,0,356,4,279,73,22.04.2019 00:40,195,21,Cherkassy
800,787,19,262,523,15,538,0,538,7,475,56,22.04.2019 00:17,195,21,Cherkassy
816,807,44,296,479,41,520,0,520,9,450,61,21.04.2019 20:48,195,21,Cherkassy
576,566,45,164,367,45,412,0,412,6,345,61,22.04.2019 00:10,195,21,Cherkassy
544,539,23,195,326,23,349,0,349,7,297,45,22.04.2019 00:10,195,21,Cherkassy
80,74,2,34,44,2,46,0,46,2,34,10,22.04.2019 00:10,195,21,Cherkassy
992,981,22,419,555,18,573,0,573,17,473,83,22.04.2019 00:24,195,21,Cherkassy
160,153,27,62,73,25,98,0,98,1,89,8,22.04.2019 00:10,195,21,Cherkassy
192,182,22,90,82,20,102,0,102,0,70,32,22.04.2019 00:30,195,21,Cherkassy
176,167,16,62,98,16,114,0,114,2,90,22,22.04.2019 00:15,195,21,Cherkassy
224,212,12,71,141,12,153,0,153,0,131,22,22.04.2019 00:25,195,21,Cherkassy
576,560,26,224,326,26,352,0,352,6,314,32,22.04.2019 00:05,195,21,Cherkassy
256,248,2,99,155,2,157,0,157,1,125,31,22.04.2019 00:12,195,21,Cherkassy
752,736,30,271,452,29,481,0,481,12,378,91,22.04.2019 02:15,195,21,Cherkassy
544,535,49,174,321,49,370,0,370,13,293,64,22.04.2019 00:30,195,21,Cherkassy
240,230,17,65,158,17,175,0,175,3,147,25,22.04.2019 00:10,195,21,Cherkassy
1120,1087,17,463,640,17,657,0,657,7,503,147,22.04.2019 00:45,195,21,Cherkassy
640,620,47,202,392,46,438,0,438,12,355,71,22.04.2019 00:27,195,21,Cherkassy
336,322,24,119,193,24,217,0,217,3,160,54,21.04.2019 22:45,195,21,Cherkassy
736,724,72,269,399,68,467,0,467,11,396,60,21.04.2019 23:30,195,21,Cherkassy
400,390,5,140,255,5,260,0,260,6,229,25,22.04.2019 00:45,195,21,Cherkassy
864,847,9,418,437,9,446,0,446,4,389,53,22.04.2019 00:05,195,21,Cherkassy
208,204,12,60,137,11,148,0,148,0,118,30,22.04.2019 00:35,195,21,Cherkassy
64,61,13,12,39,13,52,0,52,2,28,22,22.04.2019 00:26,195,21,Cherkassy
384,372,84,195,105,84,189,0,189,6,132,51,22.04.2019 00:03,195,21,Cherkassy
192,20,7,175,13,4,17,0,17,0,11,6,22.04.2019 00:12,195,21,Cherkassy
1408,865,19,543,847,18,865,0,865,24,637,204,22.04.2019 00:10,195,21,Cherkassy
2080,2049,13,943,1125,12,1137,0,1137,54,843,240,22.04.2019 00:09,195,21,Cherkassy
1456,1431,6,584,866,6,872,0,872,28,630,214,22.04.2019 00:10,195,21,Cherkassy
1936,1920,8,923,1008,5,1013,0,1013,34,758,221,22.04.2019 00:38,195,21,Cherkassy
2192,2151,6,837,1349,6,1355,0,1355,44,1041,270,22.04.2019 00:42,195,21,Cherkassy
2176,2158,13,772,1393,11,1404,0,1404,40,1029,335,22.04.2019 00:10,195,21,Cherkassy
2048,2010,14,840,1204,4,1208,0,1208,37,916,255,22.04.2019 00:32,195,21,Cherkassy
2208,2161,27,934,1260,14,1274,0,1274,39,945,290,22.04.2019 00:30,195,21,Cherkassy
1760,1738,5,649,1107,4,1111,0,1111,35,832,244,22.04.2019 01:00,195,21,Cherkassy
1712,1690,8,635,1070,7,1077,0,1077,40,789,248,22.04.2019 01:09,195,21,Cherkassy
2048,2037,9,729,1313,6,1319,0,1319,40,952,327,22.04.2019 00:10,195,21,Cherkassy
2352,2342,7,811,1537,4,1541,0,1541,44,1130,367,22.04.2019 00:40,195,21,Cherkassy
2208,2184,4,1007,1199,2,1201,0,1201,39,908,254,22.04.2019 00:18,195,21,Cherkassy
2256,2223,11,851,1395,10,1405,0,1405,51,1026,328,22.04.2019 00:30,195,21,Cherkassy
2176,2128,13,820,1343,13,1356,0,1356,28,1011,317,22.04.2019 00:35,195,21,Cherkassy
2016,1985,8,742,1267,7,1274,0,1274,32,937,305,22.04.2019 00:30,195,21,Cherkassy
2224,2208,12,874,1342,8,1350,0,1350,46,991,313,22.04.2019 00:10,195,21,Cherkassy
2016,2009,7,699,1312,5,1317,0,1317,38,959,320,22.04.2019 00:30,195,21,Cherkassy
1968,1939,8,802,1158,8,1166,0,1166,34,865,267,22.04.2019 00:25,195,21,Cherkassy
1376,1351,3,595,778,3,781,0,781,16,577,188,22.04.2019 00:35,195,21,Cherkassy
2064,2037,9,771,1285,8,1293,0,1293,36,960,297,22.04.2019 00:20,195,21,Cherkassy
2176,2147,4,850,1323,3,1326,0,1326,42,971,313,22.04.2019 00:19,195,21,Cherkassy
960,952,0,278,682,0,682,0,682,22,523,137,22.04.2019 00:01,195,21,Cherkassy
1296,1290,8,522,770,4,774,0,774,23,540,211,22.04.2019 00:45,195,21,Cherkassy
1838,1826,15,654,1175,9,1184,0,1184,33,815,336,22.04.2019 05:05,195,21,Cherkassy
2256,2234,19,829,1414,13,1427,0,1427,46,1015,366,22.04.2019 00:10,195,21,Cherkassy
2336,2316,15,946,1380,10,1390,0,1390,37,936,417,22.04.2019 00:38,195,21,Cherkassy
1440,1383,6,638,799,3,802,0,802,13,587,202,22.04.2019 00:10,195,21,Cherkassy
880,862,21,350,509,21,530,0,530,14,428,88,22.04.2019 00:10,196,21,Cherkassy
1664,1636,43,723,911,30,941,0,941,18,777,146,22.04.2019 00:08,196,21,Cherkassy
1712,1696,34,768,915,29,944,0,944,16,772,156,22.04.2019 00:15,196,21,Cherkassy
128,122,5,43,80,5,85,0,85,0,65,20,22.04.2019 00:10,196,21,Cherkassy
1536,1509,11,687,839,10,849,0,849,19,650,180,22.04.2019 01:45,196,21,Cherkassy
880,855,8,385,487,8,495,0,495,10,404,81,22.04.2019 00:23,196,21,Cherkassy
832,811,54,298,480,54,534,0,534,10,441,83,22.04.2019 00:12,196,21,Cherkassy
304,292,31,145,132,27,159,0,159,2,115,42,21.04.2019 21:00,196,21,Cherkassy
1200,1185,28,487,685,28,713,0,713,12,569,132,21.04.2019 21:15,196,21,Cherkassy
576,557,23,264,289,23,312,0,312,3,265,44,21.04.2019 22:00,196,21,Cherkassy
1232,1202,53,495,689,48,737,0,737,12,619,106,22.04.2019 00:01,196,21,Cherkassy
720,710,77,293,351,76,427,0,427,9,346,72,22.04.2019 00:50,196,21,Cherkassy
896,873,30,449,418,29,447,0,447,8,347,92,22.04.2019 01:20,196,21,Cherkassy
544,528,44,177,328,39,367,0,367,8,295,64,22.04.2019 00:15,196,21,Cherkassy
416,408,47,133,240,43,283,0,283,11,236,36,22.04.2019 00:23,196,21,Cherkassy
896,880,41,395,469,32,501,0,501,12,376,113,21.04.2019 22:40,196,21,Cherkassy
432,410,16,174,242,16,258,0,258,6,202,50,21.04.2019 23:59,196,21,Cherkassy
400,386,25,152,223,25,248,0,248,2,196,50,22.04.2019 03:00,196,21,Cherkassy
448,433,46,125,277,46,323,0,323,2,277,44,22.04.2019 00:20,196,21,Cherkassy
288,282,15,122,154,12,166,0,166,5,133,28,21.04.2019 21:30,196,21,Cherkassy
1120,1104,22,530,568,22,590,0,590,10,481,99,22.04.2019 00:45,196,21,Cherkassy
1024,1006,17,498,509,17,526,0,526,10,447,69,22.04.2019 00:27,196,21,Cherkassy
432,413,60,186,192,54,246,0,246,5,184,57,21.04.2019 23:15,196,21,Cherkassy
496,483,75,134,287,75,362,0,362,8,293,61,22.04.2019 00:05,196,21,Cherkassy
1744,1702,72,808,864,72,936,0,936,27,770,139,21.04.2019 21:15,196,21,Cherkassy
288,277,52,138,110,40,150,0,150,0,124,26,21.04.2019 21:30,196,21,Cherkassy
208,204,17,83,110,15,125,0,125,1,104,20,21.04.2019 20:15,196,21,Cherkassy
896,871,54,406,448,42,490,0,490,10,408,72,21.04.2019 21:30,196,21,Cherkassy
144,140,13,61,74,9,83,0,83,2,64,17,21.04.2019 20:23,196,21,Cherkassy
608,589,28,246,335,27,362,0,362,8,295,59,21.04.2019 21:39,196,21,Cherkassy
256,240,18,89,150,17,167,0,167,1,149,17,22.04.2019 00:02,196,21,Cherkassy
96,91,9,36,52,8,60,0,60,2,49,9,21.04.2019 22:00,196,21,Cherkassy
464,455,49,182,239,43,282,0,282,2,239,41,22.04.2019 00:30,196,21,Cherkassy
224,214,26,88,110,26,136,0,136,6,108,22,21.04.2019 20:30,196,21,Cherkassy
208,206,20,84,111,13,124,0,124,1,96,27,22.04.2019 01:15,196,21,Cherkassy
176,173,14,73,93,10,103,0,103,2,77,24,21.04.2019 20:40,196,21,Cherkassy
112,104,7,41,64,7,71,0,71,1,55,15,22.04.2019 00:45,196,21,Cherkassy
688,671,32,316,340,32,372,0,372,6,300,66,21.04.2019 21:00,196,21,Cherkassy
288,286,6,121,162,5,167,0,167,0,143,24,22.04.2019 00:10,196,21,Cherkassy
448,439,12,215,223,10,233,0,233,8,195,30,21.04.2019 23:55,196,21,Cherkassy
320,310,18,146,157,17,174,0,174,4,135,35,21.04.2019 20:40,196,21,Cherkassy
144,133,1,60,83,1,84,0,84,2,67,15,21.04.2019 21:20,196,21,Cherkassy
352,338,40,127,189,36,225,0,225,3,184,38,22.04.2019 00:08,196,21,Cherkassy
432,424,26,99,307,26,333,0,333,8,285,40,22.04.2019 00:10,196,21,Cherkassy
528,515,47,219,264,45,309,0,309,1,229,79,22.04.2019 01:45,196,21,Cherkassy
160,145,21,41,98,21,119,0,119,4,95,20,22.04.2019 00:20,196,21,Cherkassy
288,274,11,116,161,11,172,0,172,3,146,23,22.04.2019 00:20,196,21,Cherkassy
192,176,26,83,84,25,109,0,109,0,84,25,21.04.2019 21:15,196,21,Cherkassy
384,365,15,164,205,15,220,0,220,5,160,55,22.04.2019 00:15,196,21,Cherkassy
336,324,32,141,165,30,195,0,195,4,137,54,22.04.2019 00:02,196,21,Cherkassy
1472,1444,10,636,829,7,836,0,836,12,737,87,22.04.2019 01:45,196,21,Cherkassy
1696,1665,12,777,907,12,919,0,919,24,775,120,22.04.2019 00:40,196,21,Cherkassy
464,457,18,185,262,17,279,0,279,2,227,50,22.04.2019 00:15,196,21,Cherkassy
1712,1677,25,728,964,20,984,0,984,20,826,138,22.04.2019 00:45,196,21,Cherkassy
1376,1339,11,615,750,11,761,0,761,18,643,100,22.04.2019 01:30,196,21,Cherkassy
1184,1161,13,516,655,13,668,0,668,17,554,97,22.04.2019 00:59,196,21,Cherkassy
288,269,4,108,176,4,180,0,180,3,138,39,22.04.2019 01:10,196,21,Cherkassy
384,367,15,138,233,13,246,0,246,2,219,25,21.04.2019 21:30,196,21,Cherkassy
1360,1325,145,594,667,99,766,0,766,8,585,173,21.04.2019 21:50,196,21,Cherkassy
640,625,68,238,334,68,402,0,402,7,347,48,21.04.2019 20:30,196,21,Cherkassy
448,437,67,115,266,67,333,0,333,7,256,70,21.04.2019 20:25,196,21,Cherkassy
560,550,42,229,290,41,331,0,331,6,254,71,22.04.2019 00:25,196,21,Cherkassy
240,237,8,89,143,8,151,0,151,4,125,22,22.04.2019 02:10,196,21,Cherkassy
352,331,26,151,179,22,201,0,201,7,149,45,21.04.2019 20:52,196,21,Cherkassy
544,542,43,183,318,43,361,0,361,8,291,62,21.04.2019 22:10,196,21,Cherkassy
144,132,10,55,79,10,89,0,89,6,80,3,22.04.2019 00:50,196,21,Cherkassy
384,375,27,144,213,27,240,0,240,5,202,33,21.04.2019 21:02,196,21,Cherkassy
336,320,24,102,212,22,234,0,234,5,182,47,22.04.2019 00:20,196,21,Cherkassy
1184,1153,61,598,525,61,586,0,586,10,501,75,22.04.2019 01:20,196,21,Cherkassy
1696,1663,32,649,1021,26,1047,0,1047,32,775,240,22.04.2019 00:30,196,21,Cherkassy
784,769,28,294,468,22,490,0,490,11,377,102,22.04.2019 00:05,196,21,Cherkassy
1344,1319,28,500,821,23,844,0,844,19,661,164,22.04.2019 00:29,196,21,Cherkassy
1952,1910,35,808,1117,27,1144,0,1144,29,875,240,22.04.2019 00:21,196,21,Cherkassy
1856,1829,31,767,1062,27,1089,0,1089,22,835,232,22.04.2019 02:10,196,21,Cherkassy
1936,1905,35,771,1140,25,1165,0,1165,50,880,234,21.04.2019 21:50,196,21,Cherkassy
1696,1665,35,734,932,30,962,0,962,20,752,190,22.04.2019 01:04,196,21,Cherkassy
1312,1287,28,550,735,27,762,0,762,18,607,137,22.04.2019 01:15,196,21,Cherkassy
1248,1216,59,454,741,53,794,0,794,15,678,101,22.04.2019 01:20,196,21,Cherkassy
272,273,20,79,174,19,193,0,193,0,167,26,21.04.2019 23:15,196,21,Cherkassy
928,905,20,420,490,18,508,0,508,12,400,96,21.04.2019 23:00,196,21,Cherkassy
560,541,16,241,305,14,319,0,319,9,262,48,22.04.2019 00:10,196,21,Cherkassy
496,486,22,164,314,18,332,0,332,10,258,64,22.04.2019 00:20,196,21,Cherkassy
320,316,58,104,161,55,216,0,216,2,153,61,21.04.2019 23:50,196,21,Cherkassy
352,352,35,114,205,33,238,0,238,8,181,49,22.04.2019 00:10,196,21,Cherkassy
368,348,56,102,213,53,266,0,266,2,219,45,21.04.2019 21:15,196,21,Cherkassy
208,190,10,85,114,9,123,0,123,3,103,17,22.04.2019 00:14,196,21,Cherkassy
384,377,31,135,220,29,249,0,249,7,193,49,22.04.2019 00:40,196,21,Cherkassy
608,590,56,190,369,49,418,0,418,5,326,87,21.04.2019 23:40,196,21,Cherkassy
512,494,77,175,263,74,337,0,337,10,254,73,21.04.2019 22:10,196,21,Cherkassy
912,897,68,383,476,53,529,0,529,14,408,107,22.04.2019 01:30,196,21,Cherkassy
544,528,44,233,275,36,311,0,311,5,233,73,22.04.2019 00:10,196,21,Cherkassy
416,412,48,127,246,43,289,0,289,6,217,66,22.04.2019 01:53,196,21,Cherkassy
128,118,6,37,85,6,91,0,91,0,72,19,21.04.2019 20:50,196,21,Cherkassy
112,109,17,34,61,17,78,0,78,3,49,26,21.04.2019 22:20,196,21,Cherkassy
240,223,29,89,123,28,151,0,151,1,101,49,22.04.2019 00:20,196,21,Cherkassy
384,367,48,105,234,45,279,0,279,10,208,61,22.04.2019 01:10,196,21,Cherkassy
224,220,8,110,107,7,114,0,114,2,87,25,22.04.2019 00:50,196,21,Cherkassy
112,100,9,43,60,9,69,0,69,4,51,14,21.04.2019 21:45,196,21,Cherkassy
304,289,32,100,176,28,204,0,204,6,168,30,22.04.2019 00:30,196,21,Cherkassy
256,250,26,90,141,25,166,0,166,4,137,25,22.04.2019 00:40,196,21,Cherkassy
864,861,73,299,497,68,565,0,565,27,424,114,21.04.2019 23:05,196,21,Cherkassy
608,619,76,174,364,70,434,0,434,5,362,67,22.04.2019 00:15,196,21,Cherkassy
320,310,26,129,166,25,191,0,191,3,144,44,22.04.2019 00:20,196,21,Cherkassy
432,419,22,149,261,22,283,0,283,6,246,31,22.04.2019 00:10,196,21,Cherkassy
256,240,17,97,145,14,159,0,159,3,109,47,21.04.2019 22:40,196,21,Cherkassy
96,96,10,30,56,10,66,0,66,0,51,15,22.04.2019 00:27,196,21,Cherkassy
992,974,127,368,509,115,624,0,624,10,470,144,21.04.2019 21:27,196,21,Cherkassy
1072,1045,78,355,648,69,717,0,717,10,571,136,21.04.2019 21:00,196,21,Cherkassy
192,193,22,46,128,18,146,0,146,0,118,28,21.04.2019 21:05,196,21,Cherkassy
96,99,4,41,51,4,55,0,55,0,47,8,21.04.2019 20:53,196,21,Cherkassy
512,493,30,208,276,28,304,0,304,7,252,45,21.04.2019 23:15,196,21,Cherkassy
160,145,22,52,89,19,108,0,108,0,99,9,21.04.2019 21:20,196,21,Cherkassy
288,287,32,103,156,29,185,0,185,6,142,37,22.04.2019 00:10,196,21,Cherkassy
528,523,44,204,286,38,324,0,324,8,215,101,22.04.2019 00:30,196,21,Cherkassy
256,240,27,101,128,27,155,0,155,3,122,30,22.04.2019 00:20,196,21,Cherkassy
160,151,14,42,104,14,118,0,118,4,60,54,22.04.2019 00:10,196,21,Cherkassy
480,466,35,202,248,30,278,0,278,2,225,51,22.04.2019 00:12,196,21,Cherkassy
592,579,38,239,319,34,353,0,353,8,262,83,22.04.2019 00:05,196,21,Cherkassy
80,69,6,42,32,6,38,0,38,0,29,9,22.04.2019 00:05,196,21,Cherkassy
240,33,19,210,14,16,30,0,30,0,19,11,22.04.2019 00:05,196,21,Cherkassy
400,389,20,146,234,20,254,0,254,3,182,69,21.04.2019 23:30,196,21,Cherkassy
224,215,13,76,135,13,148,0,148,3,108,37,21.04.2019 21:05,196,21,Cherkassy
608,593,26,251,333,24,357,0,357,3,277,77,21.04.2019 21:30,196,21,Cherkassy
128,121,7,66,55,7,62,0,62,0,52,10,22.04.2019 00:27,196,21,Cherkassy
928,903,68,377,496,55,551,0,551,6,407,138,21.04.2019 20:55,196,21,Cherkassy
160,147,11,50,101,9,110,0,110,5,70,35,21.04.2019 20:44,196,21,Cherkassy
272,270,19,103,158,11,169,0,169,4,125,40,21.04.2019 21:05,196,21,Cherkassy
576,579,15,139,422,15,437,0,437,5,348,84,21.04.2019 21:15,196,21,Cherkassy
192,183,5,76,111,5,116,0,116,2,85,29,21.04.2019 23:30,196,21,Cherkassy
416,406,5,141,270,5,275,0,275,8,179,88,21.04.2019 20:22,196,21,Cherkassy
480,474,13,200,267,13,280,0,280,5,218,57,22.04.2019 00:30,196,21,Cherkassy
464,446,14,199,251,14,265,0,265,7,200,58,21.04.2019 20:45,196,21,Cherkassy
544,536,1,203,340,1,341,0,341,6,290,45,22.04.2019 00:40,196,21,Cherkassy
720,703,21,313,386,21,407,0,407,5,320,82,22.04.2019 00:35,196,21,Cherkassy
528,511,11,228,289,11,300,0,300,9,209,82,22.04.2019 00:05,196,21,Cherkassy
336,324,0,122,214,0,214,0,214,3,154,57,22.04.2019 00:10,196,21,Cherkassy
224,211,0,99,125,0,125,0,125,0,91,34,21.04.2019 23:58,196,21,Cherkassy
496,486,13,217,266,13,279,0,279,3,233,43,22.04.2019 00:30,196,21,Cherkassy
496,514,11,169,316,11,327,0,327,4,184,139,22.04.2019 00:18,196,21,Cherkassy
80,71,1,28,51,1,52,0,52,1,39,12,22.04.2019 01:10,196,21,Cherkassy
704,680,2,351,351,2,353,0,353,9,293,51,21.04.2019 21:35,196,21,Cherkassy
480,462,29,227,224,29,253,0,253,3,208,42,22.04.2019 01:30,196,21,Cherkassy
1440,1415,7,692,743,5,748,0,748,17,598,133,22.04.2019 00:10,196,21,Cherkassy
192,178,0,86,106,0,106,0,106,1,73,32,22.04.2019 00:10,196,21,Cherkassy
512,492,0,208,304,0,304,0,304,4,254,46,22.04.2019 01:50,196,21,Cherkassy
80,71,0,28,52,0,52,0,52,0,40,12,21.04.2019 23:59,196,21,Cherkassy
448,438,16,179,253,16,269,0,269,4,219,46,22.04.2019 00:05,196,21,Cherkassy
416,412,9,159,248,9,257,0,257,7,196,54,22.04.2019 00:20,196,21,Cherkassy
400,389,5,145,251,4,255,0,255,9,201,45,22.04.2019 00:40,196,21,Cherkassy
80,74,0,45,35,0,35,0,35,1,26,8,22.04.2019 00:25,196,21,Cherkassy
160,158,1,69,91,0,91,0,91,0,78,13,22.04.2019 01:20,196,21,Cherkassy
880,847,11,355,516,9,525,0,525,12,393,120,22.04.2019 00:10,196,21,Cherkassy
288,275,4,146,138,4,142,0,142,5,82,55,22.04.2019 00:25,196,21,Cherkassy
1616,1583,29,662,933,21,954,0,954,14,819,121,22.04.2019 00:25,196,21,Cherkassy
1088,1066,21,480,590,18,608,0,608,23,489,96,22.04.2019 00:40,196,21,Cherkassy
432,427,25,202,205,25,230,0,230,5,169,56,21.04.2019 20:42,196,21,Cherkassy
528,509,67,228,239,61,300,0,300,13,226,61,21.04.2019 23:54,196,21,Cherkassy
1088,1067,94,405,601,82,683,0,683,3,553,127,22.04.2019 00:10,196,21,Cherkassy
368,360,27,151,194,23,217,0,217,3,183,31,22.04.2019 00:31,196,21,Cherkassy
144,128,12,58,75,11,86,0,86,3,67,16,21.04.2019 20:35,196,21,Cherkassy
624,610,47,231,349,44,393,0,393,6,325,62,21.04.2019 21:00,196,21,Cherkassy
608,608,44,254,315,39,354,0,354,14,269,71,22.04.2019 02:50,196,21,Cherkassy
1024,1006,72,426,530,68,598,0,598,10,476,112,22.04.2019 00:10,196,21,Cherkassy
848,842,64,284,512,52,564,0,564,8,447,109,22.04.2019 00:05,196,21,Cherkassy
816,811,89,353,380,83,463,0,463,9,356,98,22.04.2019 02:30,196,21,Cherkassy
912,898,85,311,530,71,601,0,601,3,463,135,22.04.2019 00:30,196,21,Cherkassy
160,155,8,62,90,8,98,0,98,1,64,33,21.04.2019 22:30,196,21,Cherkassy
768,760,81,267,424,77,501,0,501,8,395,98,21.04.2019 20:40,196,21,Cherkassy
848,835,82,346,434,68,502,0,502,6,375,121,21.04.2019 21:20,196,21,Cherkassy
944,920,72,443,437,64,501,0,501,14,386,101,22.04.2019 00:15,196,21,Cherkassy
400,389,54,120,235,45,280,0,280,6,224,50,21.04.2019 23:00,196,21,Cherkassy
320,313,16,107,200,13,213,0,213,1,147,65,21.04.2019 20:20,196,21,Cherkassy
192,183,14,86,96,10,106,0,106,3,82,21,22.04.2019 00:20,196,21,Cherkassy
480,469,45,127,311,42,353,0,353,4,299,50,22.04.2019 02:15,196,21,Cherkassy
368,359,30,131,210,27,237,0,237,1,184,52,22.04.2019 00:35,196,21,Cherkassy
416,411,62,157,200,59,259,0,259,4,214,41,22.04.2019 00:10,196,21,Cherkassy
640,626,58,268,322,50,372,0,372,2,311,59,22.04.2019 00:45,196,21,Cherkassy
560,551,64,224,277,59,336,0,336,9,221,106,22.04.2019 00:30,196,21,Cherkassy
576,561,58,220,304,52,356,0,356,5,291,60,22.04.2019 00:25,196,21,Cherkassy
320,305,20,136,166,18,184,0,184,5,140,39,21.04.2019 20:50,196,21,Cherkassy
256,56,14,206,37,13,50,0,50,3,40,7,21.04.2019 23:01,196,21,Cherkassy
672,647,12,284,376,12,388,0,388,6,337,45,22.04.2019 00:15,196,21,Cherkassy
576,560,33,204,341,31,372,0,372,6,311,55,21.04.2019 20:50,197,21,Cherkassy
240,237,28,62,150,28,178,0,178,17,144,17,22.04.2019 00:05,197,21,Cherkassy
336,337,36,111,192,33,225,0,225,1,173,51,21.04.2019 20:45,197,21,Cherkassy
624,610,49,260,326,38,364,0,364,4,315,45,21.04.2019 21:25,197,21,Cherkassy
320,318,24,107,191,22,213,0,213,4,195,14,21.04.2019 20:50,197,21,Cherkassy
912,910,98,340,487,85,572,0,572,8,424,140,21.04.2019 22:00,197,21,Cherkassy
752,738,60,275,423,54,477,0,477,9,359,109,21.04.2019 21:00,197,21,Cherkassy
1712,1680,67,670,985,57,1042,0,1042,43,857,142,22.04.2019 00:20,197,21,Cherkassy
1296,1262,38,498,761,37,798,0,798,21,631,146,21.04.2019 21:05,197,21,Cherkassy
800,779,33,351,419,30,449,0,449,6,353,90,22.04.2019 00:05,197,21,Cherkassy
928,916,57,341,541,46,587,0,587,10,406,171,22.04.2019 00:45,197,21,Cherkassy
288,279,27,70,191,27,218,0,218,4,142,72,22.04.2019 00:35,197,21,Cherkassy
880,869,85,276,522,82,604,0,604,13,518,73,21.04.2019 21:15,197,21,Cherkassy
64,64,12,19,35,10,45,0,45,1,42,2,21.04.2019 20:05,197,21,Cherkassy
1600,1592,105,590,910,100,1010,0,1010,22,769,219,21.04.2019 23:30,197,21,Cherkassy
816,809,80,292,451,73,524,0,524,6,434,84,21.04.2019 20:26,197,21,Cherkassy
592,578,63,219,318,55,373,0,373,10,292,71,22.04.2019 00:09,197,21,Cherkassy
208,194,13,73,125,10,135,0,135,4,121,10,22.04.2019 00:10,197,21,Cherkassy
336,323,39,57,244,35,279,0,279,0,262,17,21.04.2019 21:20,197,21,Cherkassy
352,343,36,49,267,36,303,0,303,5,226,72,22.04.2019 00:53,197,21,Cherkassy
80,68,3,23,54,3,57,0,57,0,43,14,21.04.2019 21:40,197,21,Cherkassy
432,417,28,166,239,27,266,0,266,7,209,50,22.04.2019 00:05,197,21,Cherkassy
176,175,32,69,82,25,107,0,107,3,70,34,22.04.2019 00:07,197,21,Cherkassy
880,860,69,305,513,62,575,0,575,8,436,131,22.04.2019 00:20,197,21,Cherkassy
288,288,25,93,177,18,195,0,195,5,149,41,21.04.2019 22:00,197,21,Cherkassy
416,413,28,165,223,28,251,0,251,8,189,54,22.04.2019 03:40,197,21,Cherkassy
832,828,79,279,478,75,553,0,553,18,426,109,22.04.2019 00:40,197,21,Cherkassy
176,167,23,75,85,16,101,0,101,1,82,18,21.04.2019 21:23,197,21,Cherkassy
432,431,29,150,257,25,282,0,282,4,190,88,21.04.2019 21:30,197,21,Cherkassy
720,707,65,311,349,60,409,0,409,10,332,67,21.04.2019 21:13,197,21,Cherkassy
416,411,8,173,236,7,243,0,243,6,214,23,22.04.2019 00:25,197,21,Cherkassy
192,178,5,91,96,5,101,0,101,3,77,21,21.04.2019 22:55,197,21,Cherkassy
416,394,37,166,218,32,250,0,250,18,178,54,22.04.2019 00:31,197,21,Cherkassy
464,449,44,156,267,41,308,0,308,8,241,59,21.04.2019 21:40,197,21,Cherkassy
1488,1456,43,728,720,40,760,0,760,16,639,105,21.04.2019 21:30,197,21,Cherkassy
1248,1230,24,586,639,23,662,0,662,8,600,54,21.04.2019 21:10,197,21,Cherkassy
128,116,12,52,64,12,76,0,76,2,63,11,21.04.2019 21:05,197,21,Cherkassy
368,363,14,168,190,10,200,0,200,3,154,43,21.04.2019 20:50,197,21,Cherkassy
432,426,48,157,231,44,275,0,275,5,199,71,22.04.2019 05:55,197,21,Cherkassy
384,378,29,125,231,28,259,0,259,5,210,44,21.04.2019 21:10,197,21,Cherkassy
176,176,24,45,107,24,131,0,131,3,114,14,22.04.2019 00:02,197,21,Cherkassy
464,457,29,180,258,26,284,0,284,5,229,50,22.04.2019 00:05,197,21,Cherkassy
432,419,41,174,225,33,258,0,258,2,193,63,21.04.2019 22:00,197,21,Cherkassy
144,150,20,59,69,16,85,0,85,1,71,13,21.04.2019 20:30,197,21,Cherkassy
688,680,41,285,362,41,403,0,403,7,302,94,21.04.2019 20:47,197,21,Cherkassy
160,156,16,63,81,16,97,0,97,1,82,14,21.04.2019 20:55,197,21,Cherkassy
208,202,13,89,108,11,119,0,119,7,82,30,22.04.2019 00:25,197,21,Cherkassy
480,479,13,182,286,12,298,0,298,4,231,63,22.04.2019 00:30,197,21,Cherkassy
832,841,53,302,486,44,530,0,530,21,442,67,21.04.2019 22:30,197,21,Cherkassy
272,253,11,127,137,8,145,0,145,3,112,30,22.04.2019 00:10,197,21,Cherkassy
192,189,9,86,99,7,106,0,106,0,97,9,22.04.2019 00:05,197,21,Cherkassy
304,298,23,106,177,21,198,0,198,1,140,57,21.04.2019 22:15,197,21,Cherkassy
240,236,26,65,149,26,175,0,175,2,132,41,22.04.2019 02:01,197,21,Cherkassy
160,161,12,67,81,12,93,0,93,0,68,25,22.04.2019 00:05,197,21,Cherkassy
1056,1032,47,431,585,40,625,0,625,10,550,65,22.04.2019 02:10,197,21,Cherkassy
576,562,18,301,258,17,275,0,275,8,232,35,22.04.2019 01:20,197,21,Cherkassy
720,706,14,336,372,12,384,0,384,3,313,68,22.04.2019 00:20,197,21,Cherkassy
144,132,10,78,57,9,66,0,66,1,56,9,22.04.2019 00:20,197,21,Cherkassy
336,333,20,130,188,18,206,0,206,6,143,57,22.04.2019 00:50,197,21,Cherkassy
208,201,10,95,103,10,113,0,113,0,106,7,22.04.2019 00:02,197,21,Cherkassy
80,82,10,26,46,8,54,0,54,2,39,13,22.04.2019 00:30,197,21,Cherkassy
96,97,14,35,50,11,61,0,61,0,54,7,22.04.2019 00:10,197,21,Cherkassy
256,251,12,94,152,10,162,0,162,6,120,36,22.04.2019 03:15,197,21,Cherkassy
528,515,60,207,265,56,321,0,321,3,263,55,22.04.2019 01:35,197,21,Cherkassy
192,205,10,91,92,9,101,0,101,3,82,16,22.04.2019 00:20,197,21,Cherkassy
224,222,4,102,119,3,122,0,122,4,103,15,21.04.2019 22:35,197,21,Cherkassy
400,391,32,180,194,26,220,0,220,5,182,33,22.04.2019 00:10,197,21,Cherkassy
256,245,10,85,161,10,171,0,171,2,139,30,22.04.2019 00:45,197,21,Cherkassy
272,277,35,113,126,33,159,0,159,2,121,36,22.04.2019 00:35,197,21,Cherkassy
96,98,9,36,53,7,60,0,60,1,43,16,22.04.2019 00:30,197,21,Cherkassy
1488,1472,55,509,924,55,979,0,979,14,836,129,22.04.2019 00:10,197,21,Cherkassy
688,686,36,254,401,33,434,0,434,12,322,100,22.04.2019 00:15,197,21,Cherkassy
1360,1333,19,529,814,17,831,0,831,16,596,219,22.04.2019 00:05,197,21,Cherkassy
640,628,75,223,357,60,417,0,417,9,352,56,21.04.2019 21:30,197,21,Cherkassy
1776,1750,10,891,876,9,885,0,885,19,733,133,22.04.2019 00:09,197,21,Cherkassy
1872,1833,17,809,1052,11,1063,0,1063,20,890,153,21.04.2019 23:30,197,21,Cherkassy
2400,2361,35,896,1479,25,1504,0,1504,34,1175,295,22.04.2019 00:50,197,21,Cherkassy
2400,2354,33,1038,1332,30,1362,0,1362,39,1045,278,22.04.2019 01:05,197,21,Cherkassy
2080,2043,35,856,1192,32,1224,0,1224,21,956,247,22.04.2019 02:28,197,21,Cherkassy
192,177,2,75,116,1,117,0,117,1,88,28,22.04.2019 00:15,197,21,Cherkassy
496,488,33,194,273,29,302,0,302,4,249,49,22.04.2019 00:10,197,21,Cherkassy
960,949,64,402,500,58,558,0,558,7,446,105,22.04.2019 01:55,197,21,Cherkassy
432,418,21,178,237,17,254,0,254,5,209,40,21.04.2019 23:20,197,21,Cherkassy
288,270,29,108,151,29,180,0,180,7,141,32,21.04.2019 21:30,197,21,Cherkassy
1360,1348,25,607,729,24,753,0,753,18,623,112,22.04.2019 05:28,197,21,Cherkassy
2080,2043,28,841,1214,25,1239,0,1239,18,1041,180,22.04.2019 00:40,197,21,Cherkassy
2128,2094,25,832,1273,23,1296,0,1296,24,1074,198,22.04.2019 00:10,197,21,Cherkassy
128,112,2,77,49,2,51,0,51,0,44,7,21.04.2019 21:39,197,21,Cherkassy
2368,2343,20,1102,1252,14,1266,0,1266,30,1030,206,22.04.2019 00:30,197,21,Cherkassy
1728,1697,26,710,994,24,1018,0,1018,24,827,167,22.04.2019 04:25,197,21,Cherkassy
2384,2307,30,1014,1342,28,1370,0,1370,39,1086,245,22.04.2019 00:10,197,21,Cherkassy
1728,1699,25,613,1092,23,1115,0,1115,22,873,220,22.04.2019 00:05,197,21,Cherkassy
2192,2154,48,826,1329,37,1366,0,1366,36,1105,225,22.04.2019 00:15,197,21,Cherkassy
1888,1875,40,725,1130,33,1163,0,1163,29,946,188,22.04.2019 00:25,197,21,Cherkassy
2144,2109,48,846,1253,45,1298,0,1298,27,1030,241,22.04.2019 00:10,197,21,Cherkassy
1872,1872,16,696,1164,12,1176,0,1176,49,842,285,22.04.2019 01:35,197,21,Cherkassy
1792,1766,10,653,1129,10,1139,0,1139,34,848,257,22.04.2019 00:20,197,21,Cherkassy
2112,2092,23,862,1232,18,1250,0,1250,34,1002,214,22.04.2019 00:07,197,21,Cherkassy
2336,2291,35,905,1400,31,1431,0,1431,43,1134,254,22.04.2019 00:40,197,21,Cherkassy
1792,1763,15,678,1100,14,1114,0,1114,30,847,237,22.04.2019 00:10,197,21,Cherkassy
1792,1767,27,819,949,24,973,0,973,22,785,166,21.04.2019 21:05,197,21,Cherkassy
2336,2305,20,971,1346,19,1365,0,1365,28,1031,306,22.04.2019 00:30,197,21,Cherkassy
1632,1608,11,702,921,9,930,0,930,17,758,155,22.04.2019 00:20,197,21,Cherkassy
1696,1668,10,740,951,5,956,0,956,19,737,200,22.04.2019 02:40,197,21,Cherkassy
2016,1986,11,952,1053,11,1064,0,1064,22,823,219,22.04.2019 00:25,197,21,Cherkassy
1920,1897,3,902,1015,3,1018,0,1018,25,792,201,22.04.2019 00:13,197,21,Cherkassy
224,28,7,202,16,6,22,0,22,0,17,5,22.04.2019 00:03,197,21,Cherkassy
2144,1946,7,967,1175,2,1177,0,1177,40,876,261,22.04.2019 00:30,197,21,Cherkassy
1552,1526,4,659,891,2,893,0,893,17,640,236,22.04.2019 00:20,197,21,Cherkassy
816,805,3,318,496,2,498,0,498,11,380,107,22.04.2019 00:20,197,21,Cherkassy
1184,1148,6,423,755,6,761,0,761,27,541,193,22.04.2019 00:15,197,21,Cherkassy
1344,1332,9,486,853,5,858,0,858,27,611,220,22.04.2019 00:45,197,21,Cherkassy
1952,1941,16,777,1162,13,1175,0,1175,36,907,232,22.04.2019 00:14,197,21,Cherkassy
2320,2312,5,838,1479,3,1482,0,1482,51,982,449,21.04.2019 23:00,197,21,Cherkassy
736,724,14,342,382,12,394,0,394,6,314,74,22.04.2019 00:30,198,21,Cherkassy
1520,1500,13,688,819,13,832,0,832,19,647,166,22.04.2019 00:15,198,21,Cherkassy
1552,1531,16,627,912,13,925,0,925,26,737,162,22.04.2019 00:50,198,21,Cherkassy
1200,1191,12,528,663,9,672,0,672,16,533,123,22.04.2019 00:30,198,21,Cherkassy
1216,1188,14,526,678,12,690,0,690,15,510,165,22.04.2019 00:03,198,21,Cherkassy
1120,1103,20,431,673,16,689,0,689,9,565,115,22.04.2019 00:40,198,21,Cherkassy
800,779,10,306,485,9,494,0,494,11,371,112,22.04.2019 00:27,198,21,Cherkassy
1328,1307,18,582,732,14,746,0,746,21,582,143,22.04.2019 00:45,198,21,Cherkassy
1376,1345,22,611,745,20,765,0,765,21,610,134,22.04.2019 00:25,198,21,Cherkassy
592,570,41,301,259,32,291,0,291,4,203,84,22.04.2019 01:20,198,21,Cherkassy
416,399,38,156,224,36,260,0,260,4,197,59,21.04.2019 22:00,198,21,Cherkassy
720,698,12,340,370,10,380,0,380,10,295,75,22.04.2019 00:15,198,21,Cherkassy
784,772,61,332,392,60,452,0,452,5,314,133,22.04.2019 00:10,198,21,Cherkassy
304,297,22,93,191,20,211,0,211,0,166,45,22.04.2019 00:05,198,21,Cherkassy
288,278,29,140,123,25,148,0,148,2,124,22,22.04.2019 00:20,198,21,Cherkassy
448,433,21,182,245,21,266,0,266,2,226,38,22.04.2019 00:10,198,21,Cherkassy
1072,1059,64,474,539,59,598,0,598,18,483,97,22.04.2019 01:30,198,21,Cherkassy
144,140,11,67,67,10,77,0,77,0,57,20,22.04.2019 00:05,198,21,Cherkassy
400,394,14,171,216,13,229,0,229,5,184,40,22.04.2019 00:30,198,21,Cherkassy
176,166,7,86,83,7,90,0,90,3,66,21,22.04.2019 00:30,198,21,Cherkassy
144,133,2,71,71,2,73,0,73,2,54,17,22.04.2019 00:35,198,21,Cherkassy
416,407,34,197,185,34,219,0,219,3,140,76,22.04.2019 00:15,198,21,Cherkassy
1472,1460,55,657,764,51,815,0,815,11,685,119,22.04.2019 00:15,198,21,Cherkassy
256,241,14,115,129,12,141,0,141,2,92,47,21.04.2019 22:52,198,21,Cherkassy
64,54,10,28,26,10,36,0,36,0,32,4,21.04.2019 20:50,198,21,Cherkassy
832,811,90,296,451,85,536,0,536,3,431,102,21.04.2019 21:16,198,21,Cherkassy
112,108,10,34,68,10,78,0,78,0,64,14,22.04.2019 00:10,198,21,Cherkassy
752,735,43,269,445,38,483,0,483,2,429,52,22.04.2019 00:05,198,21,Cherkassy
400,387,34,176,194,30,224,0,224,0,180,44,22.04.2019 00:15,198,21,Cherkassy
544,536,47,237,263,44,307,0,307,11,263,33,22.04.2019 00:30,198,21,Cherkassy
1024,1013,29,474,522,28,550,0,550,4,451,95,21.04.2019 22:20,198,21,Cherkassy
560,551,19,192,350,18,368,0,368,6,311,51,21.04.2019 23:55,198,21,Cherkassy
848,831,44,343,471,34,505,0,505,11,422,72,22.04.2019 00:15,198,21,Cherkassy
1520,1490,13,717,790,13,803,0,803,18,670,115,22.04.2019 00:20,198,21,Cherkassy
1408,1383,34,595,779,34,813,0,813,17,661,135,22.04.2019 00:20,198,21,Cherkassy
608,591,11,297,300,11,311,0,311,6,259,46,22.04.2019 00:05,198,21,Cherkassy
448,436,27,176,245,27,272,0,272,8,236,28,22.04.2019 00:20,198,21,Cherkassy
1776,1741,26,801,953,22,975,0,975,30,820,125,22.04.2019 00:58,198,21,Cherkassy
368,356,24,119,225,24,249,0,249,1,209,39,22.04.2019 00:10,198,21,Cherkassy
80,72,8,35,38,7,45,0,45,3,34,8,21.04.2019 23:40,198,21,Cherkassy
240,225,5,96,139,5,144,0,144,4,114,26,22.04.2019 00:03,198,21,Cherkassy
464,458,25,221,219,24,243,0,243,5,186,52,22.04.2019 00:15,198,21,Cherkassy
496,492,27,188,284,24,308,0,308,8,244,56,22.04.2019 00:05,198,21,Cherkassy
2096,2056,19,929,1151,16,1167,0,1167,12,980,175,22.04.2019 00:05,198,21,Cherkassy
1056,1043,9,449,598,9,607,0,607,11,498,98,22.04.2019 00:17,198,21,Cherkassy
1264,1241,13,506,746,12,758,0,758,15,560,183,22.04.2019 00:10,198,21,Cherkassy
512,496,17,238,257,17,274,0,274,5,204,65,21.04.2019 23:47,198,21,Cherkassy
912,902,70,348,497,67,564,0,564,10,460,94,21.04.2019 23:50,198,21,Cherkassy
208,201,21,58,129,21,150,0,150,1,126,23,21.04.2019 22:30,198,21,Cherkassy
480,460,33,231,218,31,249,0,249,5,199,45,21.04.2019 23:00,198,21,Cherkassy
672,665,24,280,368,24,392,0,392,7,319,66,22.04.2019 00:10,198,21,Cherkassy
448,429,50,188,214,46,260,0,260,7,195,58,22.04.2019 00:50,198,21,Cherkassy
912,885,13,263,636,13,649,0,649,18,498,133,22.04.2019 00:30,198,21,Cherkassy
624,605,49,245,332,47,379,0,379,20,298,61,22.04.2019 00:12,198,21,Cherkassy
672,642,19,346,308,18,326,0,326,4,263,59,22.04.2019 00:07,198,21,Cherkassy
352,338,20,156,176,20,196,0,196,1,138,57,22.04.2019 00:32,198,21,Cherkassy
208,198,6,71,131,6,137,0,137,0,114,23,22.04.2019 00:20,198,21,Cherkassy
624,604,71,278,277,69,346,0,346,11,272,63,22.04.2019 01:40,198,21,Cherkassy
416,399,18,169,229,18,247,0,247,7,194,46,21.04.2019 20:40,198,21,Cherkassy
192,176,9,52,131,9,140,0,140,2,125,13,21.04.2019 22:00,198,21,Cherkassy
704,693,71,292,347,65,412,0,412,8,307,97,22.04.2019 00:50,198,21,Cherkassy
64,64,0,18,46,0,46,0,46,0,39,7,21.04.2019 23:15,198,21,Cherkassy
1600,1590,109,683,821,96,917,0,917,12,698,207,22.04.2019 01:10,198,21,Cherkassy
352,345,26,123,203,26,229,0,229,3,187,39,22.04.2019 00:10,198,21,Cherkassy
400,383,30,165,208,27,235,0,235,4,179,52,21.04.2019 21:05,198,21,Cherkassy
480,472,31,137,312,31,343,0,343,4,292,47,22.04.2019 00:10,198,21,Cherkassy
912,901,56,352,504,56,560,0,560,18,429,113,22.04.2019 00:30,198,21,Cherkassy
640,626,42,305,294,41,335,0,335,5,270,60,21.04.2019 20:45,198,21,Cherkassy
560,541,43,233,286,41,327,0,327,5,283,39,22.04.2019 00:10,198,21,Cherkassy
736,723,28,342,368,26,394,0,394,6,296,92,22.04.2019 00:15,198,21,Cherkassy
688,664,14,328,348,12,360,0,360,9,269,82,22.04.2019 00:25,198,21,Cherkassy
1408,1381,9,712,688,8,696,0,696,13,571,112,22.04.2019 00:10,198,21,Cherkassy
1888,1861,21,899,974,15,989,0,989,28,811,150,22.04.2019 00:15,198,21,Cherkassy
1888,1854,14,941,939,8,947,0,947,17,803,127,22.04.2019 00:05,198,21,Cherkassy
1535,1512,11,790,735,10,745,0,745,17,630,98,22.04.2019 00:06,198,21,Cherkassy
1888,1854,18,769,1107,12,1119,0,1119,21,852,246,22.04.2019 00:10,198,21,Cherkassy
688,683,24,281,384,23,407,0,407,11,322,74,21.04.2019 21:20,198,21,Cherkassy
1680,1657,28,679,973,28,1001,0,1001,12,782,207,22.04.2019 00:20,198,21,Cherkassy
1520,1488,36,661,825,34,859,0,859,31,713,115,22.04.2019 00:05,198,21,Cherkassy
544,539,32,241,272,31,303,0,303,6,234,63,22.04.2019 00:05,198,21,Cherkassy
176,166,5,83,88,5,93,0,93,4,58,31,22.04.2019 00:15,198,21,Cherkassy
1344,1325,15,532,800,12,812,0,812,14,645,153,22.04.2019 00:12,198,21,Cherkassy
2000,1964,23,778,1202,20,1222,0,1222,38,914,270,22.04.2019 00:45,198,21,Cherkassy
1200,1187,7,519,678,3,681,0,681,22,513,146,21.04.2019 23:00,198,21,Cherkassy
1248,1231,20,597,637,14,651,0,651,19,546,86,21.04.2019 23:59,198,21,Cherkassy
2112,2075,22,940,1157,15,1172,0,1172,42,937,193,22.04.2019 00:15,198,21,Cherkassy
512,497,4,256,252,4,256,0,256,4,195,57,21.04.2019 20:57,198,21,Cherkassy
1568,1536,14,769,787,12,799,0,799,19,650,130,22.04.2019 00:15,198,21,Cherkassy
896,883,11,370,517,9,526,0,526,9,435,82,22.04.2019 01:10,198,21,Cherkassy
2064,2019,42,877,1156,31,1187,0,1187,39,945,203,22.04.2019 03:00,198,21,Cherkassy
1904,1870,15,862,1030,12,1042,0,1042,30,803,209,22.04.2019 00:05,198,21,Cherkassy
2224,2195,12,906,1308,10,1318,0,1318,32,1022,264,22.04.2019 00:50,198,21,Cherkassy
1888,1861,9,802,1077,9,1086,0,1086,27,873,186,22.04.2019 00:30,198,21,Cherkassy
2208,2179,13,851,1344,13,1357,0,1357,31,1096,230,22.04.2019 01:15,198,21,Cherkassy
1632,1601,6,608,1019,5,1024,0,1024,19,819,186,22.04.2019 01:30,198,21,Cherkassy
736,720,15,256,465,15,480,0,480,9,396,75,22.04.2019 00:45,198,21,Cherkassy
272,24,4,248,20,4,24,0,24,0,21,3,22.04.2019 00:02,198,21,Cherkassy
1424,1400,20,588,821,15,836,0,836,24,668,144,22.04.2019 00:25,198,21,Cherkassy
1296,1270,49,506,744,46,790,0,790,31,629,130,22.04.2019 00:30,198,21,Cherkassy
1808,1766,15,707,1087,14,1101,0,1101,26,870,205,22.04.2019 00:25,198,21,Cherkassy
2048,1993,19,774,1258,16,1274,0,1274,41,1016,217,22.04.2019 00:15,198,21,Cherkassy
1568,1538,33,603,942,23,965,0,965,20,790,155,21.04.2019 22:25,198,21,Cherkassy
1968,1944,33,713,1227,28,1255,0,1255,41,969,245,22.04.2019 00:20,198,21,Cherkassy
1152,1081,11,454,689,9,698,0,698,16,545,137,22.04.2019 00:05,198,21,Cherkassy
896,879,12,363,524,9,533,0,533,9,419,105,22.04.2019 01:00,198,21,Cherkassy
1456,1419,47,615,802,39,841,0,841,19,665,157,22.04.2019 00:34,198,21,Cherkassy
1584,1556,15,586,983,15,998,0,998,30,768,200,22.04.2019 00:20,198,21,Cherkassy
1792,1751,12,775,1005,12,1017,0,1017,32,826,159,22.04.2019 00:05,198,21,Cherkassy
1520,1498,9,603,909,8,917,0,917,26,711,180,21.04.2019 21:55,198,21,Cherkassy
2032,2007,18,884,1132,16,1148,0,1148,22,932,194,22.04.2019 00:45,198,21,Cherkassy
1248,1228,13,502,736,10,746,0,746,21,587,138,22.04.2019 00:10,198,21,Cherkassy
1136,1117,11,581,545,10,555,0,555,17,455,83,22.04.2019 00:05,198,21,Cherkassy
1104,1085,19,447,642,15,657,0,657,24,528,105,22.04.2019 00:10,198,21,Cherkassy
2032,1984,5,936,1092,4,1096,0,1096,23,842,231,22.04.2019 00:02,198,21,Cherkassy
1840,1811,10,719,1111,10,1121,0,1121,21,896,204,22.04.2019 00:30,198,21,Cherkassy
2096,2045,3,839,1256,1,1257,0,1257,47,978,232,22.04.2019 00:30,198,21,Cherkassy
1568,1517,14,702,852,14,866,0,866,23,680,163,22.04.2019 00:15,198,21,Cherkassy
1200,1173,13,466,723,11,734,0,734,23,571,140,22.04.2019 00:02,198,21,Cherkassy
1552,1527,10,569,973,10,983,0,983,21,773,189,22.04.2019 00:20,198,21,Cherkassy
992,973,11,402,581,9,590,0,590,16,472,102,22.04.2019 00:10,198,21,Cherkassy
1840,1795,26,790,1028,22,1050,0,1050,27,843,180,22.04.2019 00:20,198,21,Cherkassy
1600,1556,5,617,979,4,983,0,983,25,776,182,22.04.2019 00:30,198,21,Cherkassy
1728,1698,5,739,985,4,989,0,989,31,794,164,22.04.2019 00:05,198,21,Cherkassy
2080,2032,7,909,1164,7,1171,0,1171,34,933,204,22.04.2019 00:15,198,21,Cherkassy
2080,2023,4,845,1231,4,1235,0,1235,36,991,208,22.04.2019 00:15,198,21,Cherkassy
1344,1304,13,634,697,13,710,0,710,12,601,97,22.04.2019 00:05,198,21,Cherkassy
1664,1634,25,666,975,23,998,0,998,21,847,130,21.04.2019 21:55,198,21,Cherkassy
1392,1361,14,608,772,12,784,0,784,26,628,130,22.04.2019 04:20,198,21,Cherkassy
1472,1468,17,657,800,15,815,0,815,19,667,129,22.04.2019 00:05,198,21,Cherkassy
752,744,16,233,505,14,519,0,519,16,411,92,22.04.2019 00:30,198,21,Cherkassy
752,403,95,485,179,88,267,0,267,24,186,57,22.04.2019 00:20,198,21,Cherkassy
320,49,36,279,13,28,41,0,41,0,30,11,22.04.2019 00:05,198,21,Cherkassy
192,32,15,163,16,13,29,0,29,1,23,5,22.04.2019 00:10,198,21,Cherkassy
80,14,0,68,12,0,12,0,12,0,10,2,22.04.2019 00:02,198,21,Cherkassy
2368,2339,11,930,1428,10,1438,0,1438,39,1092,307,22.04.2019 00:20,199,21,Cherkassy
2048,2004,9,979,1062,7,1069,0,1069,38,799,232,22.04.2019 00:45,199,21,Cherkassy
2368,2332,14,988,1376,4,1380,0,1380,35,1026,319,22.04.2019 00:10,199,21,Cherkassy
2400,2370,6,1039,1355,6,1361,0,1361,29,1053,279,22.04.2019 00:40,199,21,Cherkassy
1168,1157,10,482,679,7,686,0,686,15,551,120,22.04.2019 00:22,199,21,Cherkassy
624,606,59,119,453,52,505,0,505,12,434,59,21.04.2019 22:30,199,21,Cherkassy
304,297,22,105,177,22,199,0,199,5,127,67,21.04.2019 20:40,199,21,Cherkassy
224,224,21,67,136,21,157,0,157,1,108,48,22.04.2019 00:15,199,21,Cherkassy
736,731,66,304,391,41,432,0,432,7,340,85,21.04.2019 22:35,199,21,Cherkassy
544,542,35,208,304,32,336,0,336,4,244,88,22.04.2019 00:03,199,21,Cherkassy
400,384,40,116,246,38,284,0,284,6,169,109,22.04.2019 01:30,199,21,Cherkassy
448,431,37,147,267,34,301,0,301,5,217,79,22.04.2019 00:35,199,21,Cherkassy
512,511,42,131,342,39,381,0,381,6,296,79,21.04.2019 23:40,199,21,Cherkassy
416,400,22,169,225,22,247,0,247,7,194,46,21.04.2019 21:28,199,21,Cherkassy
112,101,11,45,56,11,67,0,67,0,44,23,21.04.2019 21:30,199,21,Cherkassy
128,127,13,26,89,13,102,0,102,5,83,14,22.04.2019 00:20,199,21,Cherkassy
448,436,43,173,235,40,275,0,275,8,203,64,21.04.2019 21:05,199,21,Cherkassy
656,640,48,214,398,44,442,0,442,5,361,76,22.04.2019 00:10,199,21,Cherkassy
160,153,12,43,106,11,117,0,117,1,61,55,22.04.2019 00:50,199,21,Cherkassy
800,782,73,307,433,60,493,0,493,14,367,112,22.04.2019 00:07,199,21,Cherkassy
464,456,46,154,274,36,310,0,310,8,234,68,21.04.2019 20:35,199,21,Cherkassy
544,525,36,211,300,33,333,0,333,8,257,68,22.04.2019 00:15,199,21,Cherkassy
640,627,68,237,335,68,403,0,403,11,315,77,21.04.2019 20:45,199,21,Cherkassy
528,527,46,179,309,40,349,0,349,5,239,105,21.04.2019 20:50,199,21,Cherkassy
544,527,76,173,296,75,371,0,371,2,302,67,21.04.2019 20:20,199,21,Cherkassy
752,735,40,316,399,37,436,0,436,12,310,114,22.04.2019 00:07,199,21,Cherkassy
352,360,54,90,220,42,262,0,262,6,164,92,21.04.2019 22:00,199,21,Cherkassy
1472,1461,60,552,868,52,920,0,920,18,719,183,22.04.2019 00:40,199,21,Cherkassy
928,914,52,360,523,45,568,0,568,7,422,139,21.04.2019 21:16,199,21,Cherkassy
704,687,62,233,415,56,471,0,471,3,373,95,21.04.2019 21:40,199,21,Cherkassy
848,837,68,332,448,68,516,0,516,9,400,107,22.04.2019 00:40,199,21,Cherkassy
880,867,74,411,399,70,469,0,469,6,320,143,22.04.2019 00:20,199,21,Cherkassy
432,433,47,177,210,45,255,0,255,5,153,97,21.04.2019 21:10,199,21,Cherkassy
512,502,43,216,259,37,296,0,296,12,217,67,22.04.2019 00:04,199,21,Cherkassy
368,364,34,136,201,31,232,0,232,7,189,36,21.04.2019 22:00,199,21,Cherkassy
176,70,5,118,54,4,58,0,58,0,48,10,22.04.2019 00:10,199,21,Cherkassy
1376,1351,7,562,810,4,814,0,814,16,633,165,21.04.2019 21:12,199,21,Cherkassy
2096,2063,13,865,1218,13,1231,0,1231,27,1000,204,22.04.2019 00:10,199,21,Cherkassy
2160,2143,97,850,1215,95,1310,0,1310,34,1070,206,21.04.2019 23:40,199,21,Cherkassy
272,255,7,117,148,7,155,0,155,6,126,23,21.04.2019 20:40,199,21,Cherkassy
512,499,2,237,273,2,275,0,275,4,243,28,21.04.2019 20:50,199,21,Cherkassy
176,171,13,43,122,11,133,0,133,3,100,30,21.04.2019 20:40,199,21,Cherkassy
208,198,14,67,127,14,141,0,141,2,101,38,22.04.2019 04:05,199,21,Cherkassy
528,516,88,150,298,80,378,0,378,9,288,81,22.04.2019 00:28,199,21,Cherkassy
480,441,46,154,280,46,326,0,326,8,278,40,21.04.2019 21:07,199,21,Cherkassy
336,332,10,96,230,10,240,0,240,4,194,42,21.04.2019 22:40,199,21,Cherkassy
208,194,0,90,118,0,118,0,118,4,99,15,21.04.2019 21:58,199,21,Cherkassy
128,120,0,60,68,0,68,0,68,3,53,12,21.04.2019 23:40,199,21,Cherkassy
608,605,35,217,357,34,391,0,391,8,299,84,22.04.2019 00:45,199,21,Cherkassy
944,926,44,294,606,44,650,0,650,14,548,88,22.04.2019 00:21,199,21,Cherkassy
576,562,18,224,334,18,352,0,352,10,269,73,21.04.2019 23:40,199,21,Cherkassy
656,627,49,283,327,46,373,0,373,6,294,73,21.04.2019 22:20,199,21,Cherkassy
160,164,11,46,103,11,114,0,114,0,99,15,22.04.2019 00:10,199,21,Cherkassy
656,644,58,249,349,58,407,0,407,10,306,91,22.04.2019 01:30,199,21,Cherkassy
1072,1060,23,376,673,23,696,0,696,15,496,185,21.04.2019 23:50,199,21,Cherkassy
544,524,65,206,285,53,338,0,338,2,251,85,21.04.2019 21:30,199,21,Cherkassy
64,63,9,13,43,8,51,0,51,0,33,18,22.04.2019 00:15,199,21,Cherkassy
464,450,40,106,318,40,358,0,358,4,269,85,21.04.2019 20:30,199,21,Cherkassy
1200,1176,44,558,606,36,642,0,642,23,458,161,22.04.2019 00:20,199,21,Cherkassy
768,754,53,297,420,51,471,0,471,10,351,110,21.04.2019 20:55,199,21,Cherkassy
480,465,36,238,206,36,242,0,242,6,162,74,21.04.2019 22:10,199,21,Cherkassy
160,147,14,56,90,14,104,0,104,1,65,38,21.04.2019 20:40,199,21,Cherkassy
320,310,34,120,171,29,200,0,200,6,154,40,21.04.2019 20:40,199,21,Cherkassy
592,576,54,213,327,52,379,0,379,10,223,146,22.04.2019 00:15,199,21,Cherkassy
304,297,5,114,186,4,190,0,190,0,165,25,22.04.2019 01:40,199,21,Cherkassy
288,280,23,108,160,20,180,0,180,4,144,32,22.04.2019 00:10,199,21,Cherkassy
160,156,7,53,100,7,107,0,107,1,73,33,22.04.2019 00:30,199,21,Cherkassy
272,276,15,75,183,14,197,0,197,6,145,46,22.04.2019 00:10,199,21,Cherkassy
32,29,2,13,17,2,19,0,19,0,14,5,22.04.2019 00:15,199,21,Cherkassy
368,356,28,139,204,25,229,0,229,5,176,48,21.04.2019 21:15,199,21,Cherkassy
256,247,12,95,149,12,161,0,161,2,129,30,22.04.2019 00:20,199,21,Cherkassy
240,235,13,83,145,12,157,0,157,2,111,44,21.04.2019 20:50,199,21,Cherkassy
432,416,31,140,264,28,292,0,292,7,198,87,21.04.2019 21:20,199,21,Cherkassy
144,128,14,58,72,14,86,0,86,3,61,22,21.04.2019 22:20,199,21,Cherkassy
192,188,18,66,108,18,126,0,126,2,91,33,22.04.2019 00:10,199,21,Cherkassy
480,468,23,189,271,20,291,0,291,12,179,100,21.04.2019 20:50,199,21,Cherkassy
80,75,7,26,47,7,54,0,54,0,30,24,21.04.2019 20:26,199,21,Cherkassy
448,432,44,120,289,39,328,0,328,10,247,71,21.04.2019 20:30,199,21,Cherkassy
80,64,6,34,40,6,46,0,46,2,34,10,22.04.2019 00:50,199,21,Cherkassy
464,449,17,157,290,17,307,0,307,6,257,44,22.04.2019 00:05,199,21,Cherkassy
400,384,24,148,231,21,252,0,252,6,174,72,22.04.2019 00:10,199,21,Cherkassy
1408,1414,60,619,734,55,789,0,789,18,576,195,22.04.2019 02:00,199,21,Cherkassy
1968,1936,24,813,1131,24,1155,0,1155,37,883,235,22.04.2019 00:40,199,21,Cherkassy
864,860,20,314,532,18,550,0,550,24,414,112,22.04.2019 00:15,199,21,Cherkassy
336,330,12,131,193,12,205,0,205,5,173,27,22.04.2019 00:35,199,21,Cherkassy
432,418,31,182,220,30,250,0,250,5,172,73,22.04.2019 00:05,199,21,Cherkassy
864,844,70,286,516,62,578,0,578,7,423,148,21.04.2019 20:40,199,21,Cherkassy
1200,1199,37,470,699,31,730,0,730,9,560,161,21.04.2019 21:10,199,21,Cherkassy
624,610,59,215,356,53,409,0,409,9,333,67,22.04.2019 02:20,199,21,Cherkassy
320,319,31,134,157,29,186,0,186,0,138,48,22.04.2019 00:20,199,21,Cherkassy
656,642,46,208,408,40,448,0,448,7,382,59,21.04.2019 21:30,199,21,Cherkassy
480,475,49,172,265,43,308,0,308,9,249,50,22.04.2019 00:15,199,21,Cherkassy
480,470,17,223,241,16,257,0,257,7,173,77,22.04.2019 00:45,199,21,Cherkassy
256,256,34,77,146,33,179,0,179,4,112,63,22.04.2019 00:15,199,21,Cherkassy
1232,1210,29,506,703,23,726,0,726,10,576,140,22.04.2019 00:30,199,21,Cherkassy
560,557,52,184,329,47,376,0,376,12,251,113,22.04.2019 00:30,199,21,Cherkassy
288,275,17,103,169,16,185,0,185,18,144,23,22.04.2019 00:15,199,21,Cherkassy
688,677,51,249,392,47,439,0,439,0,331,108,22.04.2019 00:55,199,21,Cherkassy
496,479,47,194,263,39,302,0,302,5,247,50,22.04.2019 00:05,199,21,Cherkassy
960,940,25,380,558,22,580,0,580,18,467,95,22.04.2019 00:40,199,21,Cherkassy
704,784,52,175,483,46,529,0,529,11,410,108,21.04.2019 22:10,199,21,Cherkassy
384,372,41,170,180,34,214,0,214,2,135,77,22.04.2019 00:15,199,21,Cherkassy
288,276,31,103,154,31,185,0,185,12,136,37,22.04.2019 00:15,199,21,Cherkassy
128,122,7,39,82,7,89,0,89,2,58,29,21.04.2019 22:15,199,21,Cherkassy
592,588,29,243,325,24,349,0,349,5,288,56,22.04.2019 00:30,199,21,Cherkassy
48,44,4,17,28,3,31,0,31,0,26,5,21.04.2019 21:10,199,21,Cherkassy
640,625,2,333,305,2,307,0,307,6,246,55,21.04.2019 21:30,199,21,Cherkassy
1168,1149,7,430,731,7,738,0,738,26,570,142,22.04.2019 02:00,199,21,Cherkassy
1200,1174,5,515,682,3,685,0,685,19,519,147,22.04.2019 01:10,199,21,Cherkassy
816,802,5,333,478,5,483,0,483,16,353,114,22.04.2019 00:15,199,21,Cherkassy
688,679,4,284,400,4,404,0,404,13,289,102,21.04.2019 20:30,199,21,Cherkassy
352,346,24,141,188,23,211,0,211,2,173,36,22.04.2019 00:40,199,21,Cherkassy
1392,1364,11,616,770,6,776,0,776,18,611,147,22.04.2019 01:05,199,21,Cherkassy
1280,1248,5,611,664,5,669,0,669,41,533,95,22.04.2019 00:50,199,21,Cherkassy
272,267,3,143,126,3,129,0,129,4,113,12,22.04.2019 00:10,199,21,Cherkassy
688,678,29,298,361,29,390,0,390,13,325,52,22.04.2019 00:05,200,21,Cherkassy
752,737,1,331,420,1,421,0,421,8,309,104,22.04.2019 00:01,200,21,Cherkassy
368,356,9,159,201,8,209,0,209,5,182,22,22.04.2019 01:05,200,21,Cherkassy
384,383,36,158,196,30,226,0,226,8,173,45,22.04.2019 00:45,200,21,Cherkassy
1648,1623,71,787,792,69,861,0,861,18,681,162,22.04.2019 00:35,200,21,Cherkassy
592,577,46,201,346,45,391,0,391,12,268,111,22.04.2019 00:43,200,21,Cherkassy
192,183,11,61,124,7,131,0,131,5,97,29,22.04.2019 00:45,200,21,Cherkassy
128,119,6,41,82,5,87,0,87,1,46,40,22.04.2019 00:00,200,21,Cherkassy
576,557,40,247,294,35,329,0,329,5,265,59,22.04.2019 00:35,200,21,Cherkassy
1136,1118,66,400,677,59,736,0,736,18,558,160,22.04.2019 00:20,200,21,Cherkassy
752,740,45,326,381,45,426,0,426,8,324,94,22.04.2019 01:15,200,21,Cherkassy
864,852,67,326,478,60,538,0,538,13,355,170,22.04.2019 01:05,200,21,Cherkassy
1664,1634,81,627,959,78,1037,0,1037,21,835,181,22.04.2019 00:26,200,21,Cherkassy
640,625,58,220,368,52,420,0,420,6,347,67,22.04.2019 00:38,200,21,Cherkassy
368,360,11,117,241,10,251,0,251,4,180,67,22.04.2019 00:44,200,21,Cherkassy
752,739,84,258,420,74,494,0,494,13,374,107,22.04.2019 01:31,200,21,Cherkassy
176,177,28,43,106,27,133,0,133,8,112,13,22.04.2019 00:50,200,21,Cherkassy
1120,1105,38,553,532,35,567,0,567,9,389,169,22.04.2019 00:05,200,21,Cherkassy
368,357,26,140,205,23,228,0,228,5,179,44,22.04.2019 00:02,200,21,Cherkassy
128,115,13,43,72,13,85,0,85,0,56,29,22.04.2019 00:34,200,21,Cherkassy
160,148,9,78,73,9,82,0,82,0,71,11,22.04.2019 00:30,200,21,Cherkassy
656,650,39,246,374,36,410,0,410,11,270,129,22.04.2019 00:51,200,21,Cherkassy
1120,1098,38,459,625,36,661,0,661,15,507,139,22.04.2019 00:52,200,21,Cherkassy
608,603,40,177,395,36,431,0,431,12,334,85,22.04.2019 00:20,200,21,Cherkassy
624,614,55,154,419,51,470,0,470,9,351,110,22.04.2019 00:15,200,21,Cherkassy
1712,1682,82,761,881,70,951,0,951,31,644,276,22.04.2019 01:00,200,21,Cherkassy
320,314,37,134,155,31,186,0,186,6,152,28,22.04.2019 00:40,200,21,Cherkassy
752,747,50,262,442,48,490,0,490,7,374,109,22.04.2019 04:36,200,21,Cherkassy
272,252,17,81,175,16,191,0,191,6,135,50,22.04.2019 00:30,200,21,Cherkassy
1232,1219,73,382,780,70,850,0,850,18,606,226,22.04.2019 00:15,200,21,Cherkassy
592,581,30,240,327,25,352,0,352,4,259,89,22.04.2019 00:10,200,21,Cherkassy
1072,1053,35,410,627,35,662,0,662,17,499,146,22.04.2019 00:50,200,21,Cherkassy
256,242,20,115,124,17,141,0,141,2,124,15,22.04.2019 01:02,200,21,Cherkassy
464,459,37,171,260,33,293,0,293,1,240,52,22.04.2019 01:00,200,21,Cherkassy
256,240,5,127,125,4,129,0,129,2,91,36,22.04.2019 03:01,200,21,Cherkassy
112,110,4,44,64,4,68,0,68,2,47,19,22.04.2019 00:20,200,21,Cherkassy
592,584,48,197,349,46,395,0,395,7,326,62,22.04.2019 00:06,200,21,Cherkassy
320,300,23,125,173,22,195,0,195,3,125,67,22.04.2019 00:41,200,21,Cherkassy
1344,1326,7,550,790,4,794,0,794,29,586,179,22.04.2019 00:55,200,21,Cherkassy
1488,1460,7,562,919,7,926,0,926,20,712,194,22.04.2019 00:45,200,21,Cherkassy
464,448,30,182,254,28,282,0,282,5,199,78,22.04.2019 00:05,200,21,Cherkassy
208,198,16,73,119,16,135,0,135,2,131,2,22.04.2019 00:15,200,21,Cherkassy
608,599,26,258,334,16,350,0,350,2,268,80,22.04.2019 00:37,200,21,Cherkassy
1248,1225,61,530,662,56,718,0,718,17,572,129,22.04.2019 00:42,200,21,Cherkassy
256,257,25,104,130,22,152,0,152,0,123,29,22.04.2019 00:30,200,21,Cherkassy
864,852,29,364,476,24,500,0,500,7,415,78,22.04.2019 00:55,200,21,Cherkassy
160,143,19,82,64,14,78,0,78,3,50,25,22.04.2019 00:33,200,21,Cherkassy
608,598,45,196,368,44,412,0,412,7,299,106,22.04.2019 01:05,200,21,Cherkassy
688,677,61,312,317,59,376,0,376,11,239,126,22.04.2019 00:30,200,21,Cherkassy
432,423,40,154,242,36,278,0,278,3,219,56,22.04.2019 00:05,200,21,Cherkassy
368,356,35,149,189,30,219,0,219,3,157,59,22.04.2019 00:10,200,21,Cherkassy
528,520,35,229,268,31,299,0,299,7,236,56,22.04.2019 00:06,200,21,Cherkassy
384,372,12,140,236,8,244,0,244,6,184,54,22.04.2019 00:24,200,21,Cherkassy
672,657,57,228,389,55,444,0,444,12,311,121,22.04.2019 04:25,200,21,Cherkassy
608,591,15,264,331,13,344,0,344,4,281,59,22.04.2019 00:39,200,21,Cherkassy
880,840,1,50,829,1,830,0,830,29,714,87,22.04.2019 00:33,200,21,Cherkassy
2416,2382,14,910,1492,14,1506,0,1506,30,1156,320,22.04.2019 03:22,200,21,Cherkassy
2304,2260,34,1099,1179,26,1205,0,1205,33,942,230,22.04.2019 00:30,200,21,Cherkassy
2048,2017,14,904,1134,10,1144,0,1144,34,893,217,22.04.2019 04:16,200,21,Cherkassy
1216,1193,36,526,662,28,690,0,690,15,535,140,22.04.2019 03:14,200,21,Cherkassy
832,816,9,419,406,7,413,0,413,10,326,77,22.04.2019 03:06,200,21,Cherkassy
1008,979,13,462,535,11,546,0,546,11,431,104,22.04.2019 02:25,200,21,Cherkassy
112,95,11,45,56,11,67,0,67,0,55,12,22.04.2019 00:11,200,21,Cherkassy
272,257,30,102,146,24,170,0,170,0,109,61,22.04.2019 00:03,200,21,Cherkassy
80,80,1,35,44,1,45,0,45,1,30,14,22.04.2019 01:40,200,21,Cherkassy
400,391,35,127,239,34,273,0,273,3,219,51,22.04.2019 07:22,200,21,Cherkassy
160,147,9,59,93,8,101,0,101,1,58,42,22.04.2019 03:20,200,21,Cherkassy
736,722,59,336,352,48,400,0,400,8,300,92,22.04.2019 01:10,200,21,Cherkassy
864,858,29,333,505,26,531,0,531,14,427,90,22.04.2019 03:30,200,21,Cherkassy
480,484,62,181,237,62,299,0,299,6,239,54,22.04.2019 00:35,200,21,Cherkassy
192,184,6,67,119,6,125,0,125,1,101,23,22.04.2019 00:30,200,21,Cherkassy
256,240,1,98,157,1,158,0,158,1,132,25,22.04.2019 00:37,200,21,Cherkassy
464,469,27,80,357,27,384,0,384,4,325,55,22.04.2019 02:01,200,21,Cherkassy
688,672,30,212,452,24,476,0,476,5,400,71,22.04.2019 00:06,200,21,Cherkassy
1024,995,46,466,524,34,558,0,558,9,429,120,22.04.2019 00:35,200,21,Cherkassy
288,273,20,122,148,18,166,0,166,3,113,50,22.04.2019 00:30,200,21,Cherkassy
352,336,31,98,225,29,254,0,254,2,218,34,22.04.2019 02:06,200,21,Cherkassy
480,463,47,155,281,44,325,0,325,8,235,82,22.04.2019 06:33,200,21,Cherkassy
64,70,5,13,47,4,51,0,51,0,37,14,22.04.2019 07:06,200,21,Cherkassy
528,519,45,211,272,45,317,0,317,2,250,65,22.04.2019 00:36,200,21,Cherkassy
608,590,34,271,306,31,337,0,337,5,280,52,22.04.2019 05:30,200,21,Cherkassy
1504,1488,15,559,935,10,945,0,945,26,686,233,22.04.2019 00:35,200,21,Cherkassy
1552,1548,71,585,906,61,967,0,967,29,714,224,22.04.2019 00:30,200,21,Cherkassy
1488,1463,12,598,881,9,890,0,890,25,601,264,22.04.2019 01:30,200,21,Cherkassy
2224,2206,34,847,1351,26,1377,0,1377,33,1038,306,22.04.2019 02:50,200,21,Cherkassy
2128,2110,58,794,1287,47,1334,0,1334,42,1030,262,22.04.2019 03:05,200,21,Cherkassy
2240,2210,16,816,1413,11,1424,0,1424,38,1077,309,22.04.2019 03:10,200,21,Cherkassy
2128,2082,45,834,1260,34,1294,0,1294,39,963,292,22.04.2019 03:15,200,21,Cherkassy
1872,1854,38,730,1112,30,1142,0,1142,37,892,213,22.04.2019 02:20,200,21,Cherkassy
1552,1526,34,615,910,27,937,0,937,26,720,191,22.04.2019 03:05,200,21,Cherkassy
1584,1536,26,684,879,21,900,0,900,27,648,225,22.04.2019 03:20,200,21,Cherkassy
1888,1863,33,706,1156,26,1182,0,1182,46,866,270,22.04.2019 03:26,200,21,Cherkassy
1600,1567,13,718,871,11,882,0,882,31,668,183,22.04.2019 00:10,200,21,Cherkassy
1472,1459,25,591,871,10,881,0,881,37,647,197,22.04.2019 04:33,200,21,Cherkassy
1424,1419,57,537,843,44,887,0,887,26,687,174,22.04.2019 03:48,200,21,Cherkassy
1696,1672,29,625,1051,20,1071,0,1071,23,739,309,22.04.2019 04:11,200,21,Cherkassy
1760,1743,30,594,1138,28,1166,0,1166,27,840,299,22.04.2019 03:14,200,21,Cherkassy
1792,1767,43,669,1093,30,1123,0,1123,30,853,240,22.04.2019 03:40,200,21,Cherkassy
2032,2000,33,769,1238,25,1263,0,1263,51,920,292,22.04.2019 03:36,200,21,Cherkassy
1536,1582,21,540,984,12,996,0,996,30,707,259,22.04.2019 03:37,200,21,Cherkassy
2176,2147,37,904,1245,27,1272,0,1272,48,966,258,22.04.2019 04:30,200,21,Cherkassy
1504,1495,21,550,935,19,954,0,954,19,737,198,22.04.2019 00:30,200,21,Cherkassy
1856,1829,32,743,1085,28,1113,0,1113,35,835,243,22.04.2019 03:58,200,21,Cherkassy
2240,2204,41,938,1269,33,1302,0,1302,26,1014,262,22.04.2019 04:30,200,21,Cherkassy
2000,1974,29,831,1146,23,1169,0,1169,31,872,266,22.04.2019 04:44,200,21,Cherkassy
1728,1709,28,667,1041,20,1061,0,1061,29,783,249,22.04.2019 04:51,200,21,Cherkassy
1952,1932,36,899,1028,25,1053,0,1053,35,789,229,22.04.2019 04:07,200,21,Cherkassy
1984,1956,27,761,1208,15,1223,0,1223,46,926,251,22.04.2019 03:57,200,21,Cherkassy
1984,1953,12,801,1176,7,1183,0,1183,31,862,290,22.04.2019 01:52,200,21,Cherkassy
2208,2167,26,843,1353,12,1365,0,1365,35,1023,307,22.04.2019 04:04,200,21,Cherkassy
1456,1441,20,661,784,11,795,0,795,23,607,165,22.04.2019 00:21,200,21,Cherkassy
1664,1642,13,756,905,3,908,0,908,24,659,225,22.04.2019 05:00,200,21,Cherkassy
1984,1945,8,833,1146,5,1151,0,1151,21,891,239,22.04.2019 04:00,200,21,Cherkassy
1648,1632,17,659,976,13,989,0,989,33,738,218,22.04.2019 04:39,200,21,Cherkassy
416,62,28,357,32,27,59,0,59,3,41,15,22.04.2019 00:03,200,21,Cherkassy
512,120,0,398,114,0,114,0,114,1,105,8,22.04.2019 00:15,200,21,Cherkassy
272,46,19,232,25,15,40,0,40,0,37,3,22.04.2019 00:01,200,21,Cherkassy
240,226,0,15,225,0,225,0,225,5,143,77,21.04.2019 23:56,201,22,Chernovtsy
1792,1766,14,766,1016,10,1026,0,1026,21,736,269,22.04.2019 00:04,201,22,Chernovtsy
2256,2225,19,1000,1242,14,1256,0,1256,32,911,313,22.04.2019 00:20,201,22,Chernovtsy
2448,2398,9,1535,908,5,913,0,913,26,666,221,22.04.2019 00:38,201,22,Chernovtsy
2016,1999,10,910,1096,10,1106,0,1106,38,816,252,22.04.2019 00:35,201,22,Chernovtsy
2016,1995,16,898,1105,13,1118,0,1118,39,760,319,22.04.2019 00:34,201,22,Chernovtsy
816,806,9,319,490,7,497,0,497,19,314,164,22.04.2019 00:05,201,22,Chernovtsy
880,866,9,355,516,9,525,0,525,16,363,146,22.04.2019 00:04,201,22,Chernovtsy
912,899,6,348,559,5,564,0,564,26,378,160,22.04.2019 00:05,201,22,Chernovtsy
1072,1057,9,431,635,6,641,0,641,19,429,193,22.04.2019 00:35,201,22,Chernovtsy
1056,1035,7,449,601,6,607,0,607,17,425,165,22.04.2019 00:26,201,22,Chernovtsy
1680,1654,9,692,981,7,988,0,988,33,635,320,22.04.2019 00:06,201,22,Chernovtsy
2048,2022,13,838,1200,10,1210,0,1210,39,818,353,21.04.2019 22:05,201,22,Chernovtsy
1488,1465,12,622,856,10,866,0,866,20,625,221,22.04.2019 00:30,201,22,Chernovtsy
2000,1969,5,822,1175,3,1178,0,1178,29,808,341,22.04.2019 00:10,201,22,Chernovtsy
2272,2245,15,802,1457,13,1470,0,1470,53,1079,338,22.04.2019 00:25,201,22,Chernovtsy
2288,2235,5,944,1340,4,1344,0,1344,25,904,415,21.04.2019 22:50,201,22,Chernovtsy
1744,1720,4,803,939,2,941,0,941,21,657,263,22.04.2019 00:05,201,22,Chernovtsy
2416,2395,12,949,1459,8,1467,0,1467,39,1032,396,22.04.2019 00:05,201,22,Chernovtsy
1168,1163,3,468,698,2,700,0,700,20,452,228,22.04.2019 00:30,201,22,Chernovtsy
2432,2407,7,1147,1282,3,1285,0,1285,27,945,313,21.04.2019 21:25,201,22,Chernovtsy
1952,1914,5,881,1070,1,1071,0,1071,25,746,300,22.04.2019 00:21,201,22,Chernovtsy
2112,2086,7,843,1263,6,1269,0,1269,24,859,386,22.04.2019 01:17,201,22,Chernovtsy
2128,2103,8,885,1235,8,1243,0,1243,31,850,362,22.04.2019 00:40,201,22,Chernovtsy
2272,2155,12,1132,1131,9,1140,0,1140,21,787,332,22.04.2019 00:20,201,22,Chernovtsy
2048,2031,7,872,1171,5,1176,0,1176,29,837,310,22.04.2019 04:00,201,22,Chernovtsy
2240,2217,10,908,1325,7,1332,0,1332,39,883,410,22.04.2019 02:30,201,22,Chernovtsy
2320,2283,8,923,1392,5,1397,0,1397,28,967,402,22.04.2019 00:02,201,22,Chernovtsy
1168,1148,4,539,625,4,629,0,629,11,495,123,22.04.2019 00:07,201,22,Chernovtsy
2176,2152,11,949,1217,10,1227,0,1227,25,886,316,22.04.2019 00:05,201,22,Chernovtsy
640,29,18,618,8,14,22,0,22,0,20,2,22.04.2019 00:25,201,22,Chernovtsy
480,82,48,409,34,37,71,0,71,1,55,15,22.04.2019 00:10,201,22,Chernovtsy
160,60,50,102,10,48,58,0,58,1,48,9,22.04.2019 00:02,201,22,Chernovtsy
400,21,0,381,19,0,19,0,19,1,9,9,21.04.2019 22:07,201,22,Chernovtsy
224,76,2,156,66,2,68,0,68,4,46,18,22.04.2019 00:15,201,22,Chernovtsy
2176,2145,26,1057,1093,26,1119,0,1119,14,740,365,22.04.2019 00:15,201,22,Chernovtsy
2320,2292,10,1157,1155,8,1163,0,1163,21,886,256,22.04.2019 00:17,201,22,Chernovtsy
2480,2450,13,1095,1376,9,1385,0,1385,34,971,380,22.04.2019 00:53,201,22,Chernovtsy
2096,2074,20,966,1118,12,1130,0,1130,37,701,392,22.04.2019 00:30,201,22,Chernovtsy
2448,2414,24,1078,1348,22,1370,0,1370,37,882,451,22.04.2019 00:15,201,22,Chernovtsy
144,133,53,27,71,46,117,0,117,11,52,54,22.04.2019 00:12,201,22,Chernovtsy
96,19,2,79,15,2,17,0,17,0,11,6,21.04.2019 23:25,201,22,Chernovtsy
1456,1488,4,555,899,2,901,0,901,23,570,308,21.04.2019 23:54,201,22,Chernovtsy
1725,1816,8,697,1022,6,1028,0,1028,31,733,264,22.04.2019 00:40,201,22,Chernovtsy
1555,1413,7,727,825,3,828,0,828,23,584,221,22.04.2019 00:03,201,22,Chernovtsy
2064,2041,13,894,1161,9,1170,0,1170,33,781,356,22.04.2019 00:55,201,22,Chernovtsy
1744,1747,7,689,1050,5,1055,0,1055,32,680,343,22.04.2019 00:32,201,22,Chernovtsy
1568,1564,12,721,835,12,847,0,847,17,609,221,22.04.2019 00:06,201,22,Chernovtsy
976,977,2,395,580,1,581,0,581,11,411,159,22.04.2019 00:07,201,22,Chernovtsy
2000,1988,10,755,1237,8,1245,0,1245,39,827,379,22.04.2019 00:02,201,22,Chernovtsy
2224,2213,9,995,1223,6,1229,0,1229,29,886,314,22.04.2019 00:50,201,22,Chernovtsy
2048,2028,16,815,1221,12,1233,0,1233,43,845,345,22.04.2019 03:03,201,22,Chernovtsy
2272,2236,11,952,1311,9,1320,0,1320,43,876,401,22.04.2019 00:07,201,22,Chernovtsy
2352,2344,8,916,1431,5,1436,0,1436,50,987,399,22.04.2019 00:55,201,22,Chernovtsy
2288,2246,4,1232,1054,2,1056,0,1056,32,744,280,22.04.2019 03:00,201,22,Chernovtsy
2336,2285,0,1231,1105,0,1105,0,1105,43,775,287,22.04.2019 00:05,201,22,Chernovtsy
1344,1318,5,646,693,5,698,0,698,12,476,210,22.04.2019 00:12,201,22,Chernovtsy
2112,2105,20,875,1222,15,1237,0,1237,35,918,284,22.04.2019 00:25,201,22,Chernovtsy
2176,2160,19,824,1337,15,1352,0,1352,46,932,374,21.04.2019 22:30,201,22,Chernovtsy
2112,2086,8,1002,1103,7,1110,0,1110,27,775,308,22.04.2019 00:05,201,22,Chernovtsy
2112,2112,13,842,1258,12,1270,0,1270,49,865,356,22.04.2019 00:25,201,22,Chernovtsy
1856,1845,10,765,1084,7,1091,0,1091,25,735,331,22.04.2019 00:02,201,22,Chernovtsy
1840,1824,7,863,974,3,977,0,977,29,654,294,22.04.2019 01:30,201,22,Chernovtsy
1968,1962,7,719,1244,5,1249,0,1249,45,814,390,22.04.2019 00:15,201,22,Chernovtsy
1920,1907,5,791,1127,2,1129,0,1129,41,734,354,22.04.2019 01:30,201,22,Chernovtsy
2272,2249,10,947,1316,9,1325,0,1325,32,924,369,22.04.2019 01:57,201,22,Chernovtsy
2160,2160,11,873,1280,7,1287,0,1287,39,869,379,22.04.2019 00:16,201,22,Chernovtsy
2224,2215,8,858,1359,7,1366,0,1366,34,963,369,22.04.2019 00:10,201,22,Chernovtsy
2240,2214,11,864,1368,8,1376,0,1376,52,879,445,22.04.2019 01:21,201,22,Chernovtsy
2128,2092,9,861,1260,7,1267,0,1267,39,833,395,22.04.2019 00:20,201,22,Chernovtsy
1840,1817,5,790,1047,3,1050,0,1050,42,708,300,22.04.2019 00:02,201,22,Chernovtsy
1776,1770,6,666,1104,6,1110,0,1110,39,738,333,22.04.2019 00:35,201,22,Chernovtsy
2240,2215,6,964,1271,5,1276,0,1276,34,831,411,22.04.2019 00:46,201,22,Chernovtsy
992,981,4,399,589,4,593,0,593,23,399,171,22.04.2019 00:40,201,22,Chernovtsy
896,887,0,331,565,0,565,0,565,13,343,209,22.04.2019 01:05,201,22,Chernovtsy
2160,2143,17,830,1319,11,1330,0,1330,46,913,371,22.04.2019 00:30,201,22,Chernovtsy
2160,2137,10,941,1211,8,1219,0,1219,34,864,320,22.04.2019 00:50,201,22,Chernovtsy
2080,2062,5,805,1273,2,1275,0,1275,31,887,357,22.04.2019 00:30,201,22,Chernovtsy
1328,1320,8,549,771,8,779,0,779,18,520,241,22.04.2019 00:10,201,22,Chernovtsy
2192,2170,12,875,1310,7,1317,0,1317,39,877,401,22.04.2019 01:15,201,22,Chernovtsy
2336,2334,9,888,1440,8,1448,0,1448,49,951,448,22.04.2019 00:48,201,22,Chernovtsy
2192,2171,4,880,1309,3,1312,0,1312,34,879,399,22.04.2019 00:30,201,22,Chernovtsy
2336,2314,9,948,1382,6,1388,0,1388,42,961,385,22.04.2019 00:50,201,22,Chernovtsy
2160,2138,6,876,1279,5,1284,0,1284,29,900,355,22.04.2019 00:30,201,22,Chernovtsy
1984,1985,4,952,1030,2,1032,0,1032,19,749,264,22.04.2019 00:10,201,22,Chernovtsy
1344,1330,6,626,716,2,718,0,718,21,501,196,22.04.2019 00:10,201,22,Chernovtsy
1232,1212,2,596,634,2,636,0,636,14,457,165,22.04.2019 01:00,201,22,Chernovtsy
2224,2195,6,998,1221,5,1226,0,1226,27,826,373,22.04.2019 00:34,201,22,Chernovtsy
1552,1535,5,703,844,5,849,0,849,25,611,213,22.04.2019 00:25,201,22,Chernovtsy
1456,1426,5,626,827,3,830,0,830,23,638,169,22.04.2019 00:15,201,22,Chernovtsy
912,900,1,517,394,1,395,0,395,14,313,68,22.04.2019 00:30,201,22,Chernovtsy
2288,2290,21,933,1343,12,1355,0,1355,34,959,362,22.04.2019 00:15,201,22,Chernovtsy
2016,2001,11,861,1144,11,1155,0,1155,34,832,289,22.04.2019 01:40,201,22,Chernovtsy
1728,1708,4,924,800,4,804,0,804,12,642,150,22.04.2019 00:45,201,22,Chernovtsy
1712,1697,5,739,969,4,973,0,973,36,651,286,21.04.2019 23:00,201,22,Chernovtsy
544,37,0,510,34,0,34,0,34,2,23,9,22.04.2019 00:23,201,22,Chernovtsy
240,40,12,205,24,11,35,0,35,0,28,7,22.04.2019 00:17,201,22,Chernovtsy
192,21,12,172,9,11,20,0,20,1,13,6,22.04.2019 00:12,201,22,Chernovtsy
64,18,0,48,16,0,16,0,16,0,10,6,22.04.2019 00:03,201,22,Chernovtsy
192,38,34,173,2,17,19,0,19,1,14,4,22.04.2019 00:21,201,22,Chernovtsy
224,20,17,205,3,16,19,0,19,0,11,8,21.04.2019 23:45,201,22,Chernovtsy
192,23,0,173,19,0,19,0,19,0,15,4,22.04.2019 00:07,201,22,Chernovtsy
80,2,0,78,2,0,2,0,2,0,2,0,22.04.2019 00:10,201,22,Chernovtsy
176,50,0,129,47,0,47,0,47,5,36,6,22.04.2019 00:08,201,22,Chernovtsy
1328,1311,4,592,734,2,736,0,736,14,493,229,22.04.2019 00:30,201,22,Chernovtsy
1440,1432,6,587,850,3,853,0,853,31,539,283,22.04.2019 00:25,201,22,Chernovtsy
2272,2253,17,936,1323,13,1336,0,1336,26,975,335,22.04.2019 00:05,201,22,Chernovtsy
2208,2228,8,866,1335,7,1342,0,1342,40,874,428,22.04.2019 01:20,201,22,Chernovtsy
48,24,0,24,24,0,24,0,24,0,6,18,22.04.2019 00:10,202,22,Chernovtsy
1072,1056,26,511,537,24,561,0,561,18,398,145,22.04.2019 00:07,202,22,Chernovtsy
1232,1201,23,522,688,22,710,0,710,13,490,207,22.04.2019 00:10,202,22,Chernovtsy
1088,1074,32,479,580,29,609,0,609,17,442,150,22.04.2019 01:15,202,22,Chernovtsy
1088,1078,24,506,558,24,582,0,582,10,421,151,22.04.2019 00:50,202,22,Chernovtsy
1440,1414,22,683,737,20,757,0,757,12,564,181,22.04.2019 01:38,202,22,Chernovtsy
1520,1502,25,745,755,20,775,0,775,20,601,154,22.04.2019 00:50,202,22,Chernovtsy
320,307,24,174,122,24,146,0,146,0,127,19,22.04.2019 00:15,202,22,Chernovtsy
2448,2417,34,1203,1212,33,1245,0,1245,48,915,282,22.04.2019 01:05,202,22,Chernovtsy
2208,2197,28,1159,1021,28,1049,0,1049,26,742,281,22.04.2019 00:55,202,22,Chernovtsy
1536,1502,47,818,673,45,718,0,718,16,554,148,22.04.2019 00:45,202,22,Chernovtsy
1120,1102,3,620,497,3,500,0,500,9,413,78,22.04.2019 00:30,202,22,Chernovtsy
944,929,39,402,503,39,542,0,542,13,426,103,22.04.2019 00:45,202,22,Chernovtsy
1552,1519,16,786,750,16,766,0,766,13,551,202,21.04.2019 23:55,202,22,Chernovtsy
1568,1541,10,798,761,9,770,0,770,16,560,194,22.04.2019 00:20,202,22,Chernovtsy
464,456,3,204,258,2,260,0,260,5,135,120,22.04.2019 00:45,202,22,Chernovtsy
1088,1068,46,491,551,46,597,0,597,17,432,148,22.04.2019 00:10,202,22,Chernovtsy
512,490,24,209,280,23,303,0,303,0,266,37,21.04.2019 23:15,202,22,Chernovtsy
608,581,32,263,315,30,345,0,345,5,273,67,22.04.2019 00:10,202,22,Chernovtsy
896,897,56,344,499,53,552,0,552,18,400,134,22.04.2019 00:09,202,22,Chernovtsy
1584,1559,57,748,779,57,836,0,836,20,658,158,22.04.2019 00:10,202,22,Chernovtsy
2416,2388,83,1068,1265,83,1348,0,1348,36,1014,298,22.04.2019 02:15,202,22,Chernovtsy
1216,1196,32,506,678,32,710,0,710,13,576,121,22.04.2019 01:25,202,22,Chernovtsy
176,169,14,73,89,14,103,0,103,4,70,29,22.04.2019 00:23,202,22,Chernovtsy
1520,1506,77,746,698,76,774,0,774,6,542,226,21.04.2019 21:35,202,22,Chernovtsy
480,475,31,213,236,31,267,0,267,4,192,71,22.04.2019 00:25,202,22,Chernovtsy
528,519,44,278,206,44,250,0,250,9,157,84,22.04.2019 00:17,202,22,Chernovtsy
1696,1684,80,798,821,77,898,0,898,15,609,274,22.04.2019 00:30,202,22,Chernovtsy
672,664,54,288,330,54,384,0,384,6,244,134,21.04.2019 22:40,202,22,Chernovtsy
688,669,41,320,330,38,368,0,368,15,289,64,22.04.2019 00:10,202,22,Chernovtsy
1296,1265,51,611,636,49,685,0,685,21,548,116,22.04.2019 00:10,202,22,Chernovtsy
480,474,29,258,195,27,222,0,222,5,163,54,22.04.2019 00:25,202,22,Chernovtsy
560,545,31,268,264,28,292,0,292,7,201,84,22.04.2019 00:10,202,22,Chernovtsy
1952,1937,80,944,931,77,1008,0,1008,12,772,224,22.04.2019 00:15,202,22,Chernovtsy
976,958,64,445,467,64,531,0,531,9,423,99,22.04.2019 00:10,202,22,Chernovtsy
496,492,36,233,227,36,263,0,263,2,207,54,22.04.2019 00:20,202,22,Chernovtsy
1744,1719,53,684,1007,53,1060,0,1060,25,779,256,22.04.2019 01:20,202,22,Chernovtsy
448,444,8,168,272,8,280,0,280,6,197,77,22.04.2019 00:15,202,22,Chernovtsy
160,148,12,74,74,12,86,0,86,4,57,25,22.04.2019 00:20,202,22,Chernovtsy
688,687,46,315,330,43,373,0,373,8,303,62,22.04.2019 00:20,202,22,Chernovtsy
944,934,29,461,455,28,483,0,483,6,380,97,22.04.2019 00:01,202,22,Chernovtsy
2320,2285,58,1109,1155,56,1211,0,1211,36,978,197,22.04.2019 02:07,202,22,Chernovtsy
2256,2216,24,998,1235,23,1258,0,1258,30,820,408,21.04.2019 22:20,202,22,Chernovtsy
1344,1328,43,606,698,40,738,0,738,22,472,244,22.04.2019 01:25,202,22,Chernovtsy
1968,1942,63,846,1067,55,1122,0,1122,33,756,333,22.04.2019 01:50,202,22,Chernovtsy
2144,2104,85,845,1217,82,1299,0,1299,25,865,409,22.04.2019 00:07,202,22,Chernovtsy
1584,1563,56,662,868,54,922,0,922,22,539,361,22.04.2019 00:45,202,22,Chernovtsy
1872,1857,71,889,915,68,983,0,983,17,684,282,22.04.2019 00:51,202,22,Chernovtsy
768,751,39,328,402,38,440,0,440,7,319,114,21.04.2019 21:25,202,22,Chernovtsy
720,705,34,223,464,33,497,0,497,7,358,132,22.04.2019 00:20,202,22,Chernovtsy
272,269,16,74,186,12,198,0,198,4,152,42,22.04.2019 00:05,202,22,Chernovtsy
656,643,31,283,342,31,373,0,373,8,261,104,22.04.2019 00:05,202,22,Chernovtsy
512,511,19,189,308,15,323,0,323,6,219,98,22.04.2019 00:20,202,22,Chernovtsy
1168,1148,60,576,537,55,592,0,592,11,352,229,21.04.2019 22:00,202,22,Chernovtsy
1520,1494,82,612,832,76,908,0,908,21,648,239,22.04.2019 00:25,202,22,Chernovtsy
256,244,14,86,156,14,170,0,170,4,139,27,22.04.2019 00:10,202,22,Chernovtsy
640,632,29,258,353,29,382,0,382,11,274,97,22.04.2019 00:45,202,22,Chernovtsy
496,477,19,191,286,19,305,0,305,9,229,67,22.04.2019 00:30,202,22,Chernovtsy
192,181,3,113,76,3,79,0,79,3,60,16,22.04.2019 00:10,202,22,Chernovtsy
480,469,66,195,222,63,285,0,285,8,169,108,22.04.2019 00:40,202,22,Chernovtsy
1184,1173,71,508,611,65,676,0,676,25,510,141,22.04.2019 00:35,202,22,Chernovtsy
880,863,57,373,454,53,507,0,507,6,399,102,22.04.2019 00:15,202,22,Chernovtsy
336,331,13,182,141,13,154,0,154,1,132,21,22.04.2019 00:15,202,22,Chernovtsy
1216,1210,52,574,590,52,642,0,642,24,511,107,22.04.2019 00:40,202,22,Chernovtsy
160,152,5,57,98,5,103,0,103,0,81,22,22.04.2019 00:55,202,22,Chernovtsy
832,809,35,403,396,33,429,0,429,10,296,123,22.04.2019 00:00,202,22,Chernovtsy
1856,1844,18,878,960,18,978,0,978,37,579,362,22.04.2019 00:10,202,22,Chernovtsy
416,400,22,211,183,22,205,0,205,5,147,53,22.04.2019 00:02,202,22,Chernovtsy
1008,999,38,296,676,36,712,0,712,18,529,165,21.04.2019 21:10,202,22,Chernovtsy
256,240,13,120,123,13,136,0,136,4,100,32,22.04.2019 00:11,202,22,Chernovtsy
1024,1004,46,461,517,46,563,0,563,9,400,154,22.04.2019 00:40,202,22,Chernovtsy
1984,2008,70,921,995,68,1063,0,1063,28,649,386,22.04.2019 00:15,202,22,Chernovtsy
1248,1216,47,596,606,46,652,0,652,12,482,158,22.04.2019 00:55,202,22,Chernovtsy
784,774,28,324,432,28,460,0,460,11,328,121,22.04.2019 00:10,202,22,Chernovtsy
1280,1246,30,644,606,30,636,0,636,14,458,164,21.04.2019 22:00,202,22,Chernovtsy
912,892,66,380,466,66,532,0,532,13,377,142,21.04.2019 21:40,202,22,Chernovtsy
2080,2053,82,896,1102,82,1184,0,1184,28,794,362,22.04.2019 00:05,202,22,Chernovtsy
1808,1788,46,848,918,42,960,0,960,15,679,266,22.04.2019 00:10,202,22,Chernovtsy
1200,1174,53,552,595,53,648,0,648,14,444,190,22.04.2019 00:15,202,22,Chernovtsy
880,857,52,384,445,51,496,0,496,8,386,102,22.04.2019 00:13,202,22,Chernovtsy
1360,1338,85,627,657,76,733,0,733,10,520,203,22.04.2019 00:17,202,22,Chernovtsy
1760,1733,93,688,979,93,1072,0,1072,17,858,197,21.04.2019 21:45,202,22,Chernovtsy
1584,1551,52,638,894,52,946,0,946,23,621,302,22.04.2019 01:35,202,22,Chernovtsy
1568,1551,90,602,878,88,966,0,966,20,639,307,22.04.2019 00:30,202,22,Chernovtsy
224,212,13,71,140,13,153,0,153,0,87,66,22.04.2019 00:05,202,22,Chernovtsy
816,799,33,305,480,31,511,0,511,2,332,177,22.04.2019 00:37,202,22,Chernovtsy
1552,1532,56,719,781,52,833,0,833,17,566,250,22.04.2019 00:11,202,22,Chernovtsy
1376,1334,42,587,750,39,789,0,789,22,505,262,22.04.2019 00:10,202,22,Chernovtsy
480,462,38,228,217,35,252,0,252,6,160,86,22.04.2019 00:55,202,22,Chernovtsy
2400,2375,104,1024,1276,100,1376,0,1376,20,862,494,22.04.2019 01:20,202,22,Chernovtsy
1232,1206,93,449,694,89,783,0,783,23,574,186,22.04.2019 00:15,202,22,Chernovtsy
880,865,47,442,397,41,438,0,438,14,295,129,22.04.2019 00:25,202,22,Chernovtsy
288,89,0,211,77,0,77,0,77,2,51,24,22.04.2019 00:20,202,22,Chernovtsy
2176,2157,52,986,1149,41,1190,0,1190,30,985,175,22.04.2019 01:10,202,22,Chernovtsy
992,976,28,463,502,27,529,0,529,11,457,61,21.04.2019 22:50,202,22,Chernovtsy
448,442,30,157,261,30,291,0,291,8,264,19,22.04.2019 00:30,202,22,Chernovtsy
336,321,36,39,261,36,297,0,297,0,217,80,22.04.2019 01:23,202,22,Chernovtsy
1088,1065,77,447,567,74,641,0,641,7,559,75,22.04.2019 00:05,202,22,Chernovtsy
400,392,50,165,189,46,235,0,235,5,197,33,22.04.2019 00:05,202,22,Chernovtsy
1264,1249,84,558,630,76,706,0,706,10,612,84,22.04.2019 00:15,202,22,Chernovtsy
384,377,32,174,180,30,210,0,210,3,168,39,22.04.2019 00:21,202,22,Chernovtsy
1248,1224,92,551,608,89,697,0,697,17,578,102,22.04.2019 01:10,202,22,Chernovtsy
352,327,38,190,129,33,162,0,162,4,132,26,22.04.2019 01:00,202,22,Chernovtsy
512,500,34,237,246,29,275,0,275,6,225,44,22.04.2019 01:00,202,22,Chernovtsy
528,504,52,224,256,48,304,0,304,10,271,23,21.04.2019 20:10,202,22,Chernovtsy
544,522,28,250,268,26,294,0,294,6,252,36,22.04.2019 04:10,202,22,Chernovtsy
336,324,33,185,120,31,151,0,151,2,124,25,22.04.2019 00:10,202,22,Chernovtsy
768,760,58,294,426,48,474,0,474,17,367,90,22.04.2019 02:10,202,22,Chernovtsy
672,661,48,276,354,42,396,0,396,10,317,69,22.04.2019 00:15,202,22,Chernovtsy
160,160,16,79,66,15,81,0,81,1,72,8,22.04.2019 00:23,202,22,Chernovtsy
1520,1500,89,660,782,78,860,0,860,20,612,228,22.04.2019 01:50,202,22,Chernovtsy
1280,1245,75,614,592,74,666,0,666,18,488,160,22.04.2019 01:10,202,22,Chernovtsy
304,295,26,159,119,26,145,0,145,1,118,26,22.04.2019 00:10,202,22,Chernovtsy
976,942,66,452,467,57,524,0,524,13,454,57,22.04.2019 00:20,202,22,Chernovtsy
288,269,30,76,183,29,212,0,212,1,185,26,22.04.2019 00:10,202,22,Chernovtsy
304,293,18,141,146,17,163,0,163,3,137,23,22.04.2019 01:30,202,22,Chernovtsy
800,779,56,353,398,49,447,0,447,6,367,74,22.04.2019 00:30,202,22,Chernovtsy
608,590,36,276,305,27,332,0,332,7,275,50,22.04.2019 00:20,202,22,Chernovtsy
272,258,25,116,131,25,156,0,156,4,128,24,21.04.2019 20:40,202,22,Chernovtsy
96,75,7,58,33,5,38,0,38,1,29,8,22.04.2019 00:15,202,22,Chernovtsy
720,697,51,258,411,51,462,0,462,13,394,55,22.04.2019 00:45,202,22,Chernovtsy
80,77,1,25,54,1,55,0,55,2,44,9,22.04.2019 00:30,202,22,Chernovtsy
2320,2308,16,1066,1241,13,1254,0,1254,33,956,265,22.04.2019 00:15,202,22,Chernovtsy
2208,2172,22,958,1231,19,1250,0,1250,23,919,308,22.04.2019 00:15,202,22,Chernovtsy
1536,1518,13,793,731,12,743,0,743,27,569,147,22.04.2019 00:15,202,22,Chernovtsy
1744,1717,10,880,858,6,864,0,864,25,691,148,22.04.2019 00:05,202,22,Chernovtsy
2128,2108,7,1084,1038,6,1044,0,1044,25,822,197,22.04.2019 03:00,202,22,Chernovtsy
1664,1637,5,958,701,5,706,0,706,20,616,70,22.04.2019 02:35,202,22,Chernovtsy
2464,2448,30,1546,888,30,918,0,918,39,826,53,22.04.2019 00:10,202,22,Chernovtsy
2480,2455,8,1630,842,8,850,0,850,43,749,58,22.04.2019 01:45,202,22,Chernovtsy
2464,2428,35,1561,870,33,903,0,903,46,831,26,22.04.2019 00:13,202,22,Chernovtsy
2288,2265,71,1092,1132,64,1196,0,1196,33,839,324,22.04.2019 00:10,202,22,Chernovtsy
256,242,14,127,116,13,129,0,129,0,87,42,22.04.2019 01:30,202,22,Chernovtsy
512,509,27,241,246,25,271,0,271,8,187,76,22.04.2019 00:05,202,22,Chernovtsy
1360,1333,95,693,581,86,667,0,667,8,528,131,22.04.2019 00:10,202,22,Chernovtsy
1056,1038,54,544,458,54,512,0,512,17,461,34,22.04.2019 00:45,202,22,Chernovtsy
1696,1672,22,930,745,21,766,0,766,11,720,35,22.04.2019 01:10,202,22,Chernovtsy
1296,1282,34,754,513,29,542,0,542,18,470,54,22.04.2019 00:12,202,22,Chernovtsy
1344,1320,58,763,528,53,581,0,581,7,456,118,22.04.2019 00:45,202,22,Chernovtsy
1088,1073,18,733,340,15,355,0,355,2,309,44,22.04.2019 00:05,202,22,Chernovtsy
1248,1225,45,683,520,45,565,0,565,9,476,80,22.04.2019 00:30,202,22,Chernovtsy
2421,2412,25,1605,795,21,816,0,816,21,747,48,22.04.2019 01:30,202,22,Chernovtsy
1776,1750,33,1198,548,30,578,0,578,18,490,70,22.04.2019 00:40,202,22,Chernovtsy
896,883,40,446,416,34,450,0,450,7,370,73,22.04.2019 00:20,202,22,Chernovtsy
832,816,37,386,411,35,446,0,446,5,275,166,22.04.2019 00:45,202,22,Chernovtsy
496,484,23,256,218,22,240,0,240,1,153,86,22.04.2019 00:15,202,22,Chernovtsy
640,630,35,302,306,32,338,0,338,5,266,67,22.04.2019 00:08,202,22,Chernovtsy
720,708,30,311,382,27,409,0,409,10,290,109,22.04.2019 00:10,202,22,Chernovtsy
576,561,34,295,247,34,281,0,281,4,218,59,22.04.2019 00:20,202,22,Chernovtsy
2448,2429,24,1420,1006,22,1028,0,1028,20,956,52,22.04.2019 00:05,202,22,Chernovtsy
656,646,17,400,241,15,256,0,256,7,217,32,22.04.2019 00:51,202,22,Chernovtsy
1088,1066,148,462,497,129,626,0,626,10,448,168,22.04.2019 01:10,202,22,Chernovtsy
592,576,52,247,295,50,345,0,345,9,287,49,22.04.2019 00:30,202,22,Chernovtsy
2096,2065,51,968,1086,42,1128,0,1128,30,881,217,22.04.2019 01:20,202,22,Chernovtsy
704,697,52,300,355,49,404,0,404,12,321,71,22.04.2019 00:15,202,22,Chernovtsy
688,673,74,353,274,61,335,0,335,1,275,59,22.04.2019 00:50,202,22,Chernovtsy
432,413,38,230,166,36,202,0,202,5,160,37,22.04.2019 00:01,202,22,Chernovtsy
640,631,18,333,290,17,307,0,307,5,223,79,22.04.2019 00:10,202,22,Chernovtsy
1680,1651,55,898,730,52,782,0,782,12,576,194,22.04.2019 00:28,202,22,Chernovtsy
720,705,41,358,322,40,362,0,362,6,276,80,22.04.2019 00:30,202,22,Chernovtsy
576,561,43,246,287,43,330,0,330,3,222,105,22.04.2019 00:15,202,22,Chernovtsy
608,602,26,286,296,26,322,0,322,6,271,45,22.04.2019 00:30,202,22,Chernovtsy
1056,1035,45,504,508,44,552,0,552,7,483,62,22.04.2019 00:10,202,22,Chernovtsy
2512,2495,22,1532,961,19,980,0,980,28,837,115,22.04.2019 01:25,202,22,Chernovtsy
1632,1596,5,1015,612,5,617,0,617,20,563,34,22.04.2019 00:40,202,22,Chernovtsy
128,129,0,23,105,0,105,0,105,1,78,26,22.04.2019 00:30,202,22,Chernovtsy
128,50,50,101,0,27,27,0,27,1,23,3,22.04.2019 00:15,202,22,Chernovtsy
32,24,0,20,12,0,12,0,12,1,6,5,22.04.2019 00:05,203,22,Chernovtsy
1728,1724,1,920,807,1,808,0,808,14,713,81,22.04.2019 03:09,203,22,Chernovtsy
1472,1457,66,673,737,62,799,0,799,22,738,39,22.04.2019 00:20,203,22,Chernovtsy
544,536,29,283,232,29,261,0,261,5,232,24,22.04.2019 00:03,203,22,Chernovtsy
704,695,44,337,323,44,367,0,367,6,347,14,22.04.2019 00:15,203,22,Chernovtsy
1008,994,52,459,497,52,549,0,549,9,492,48,22.04.2019 00:15,203,22,Chernovtsy
464,446,19,232,214,18,232,0,232,8,201,23,22.04.2019 00:12,203,22,Chernovtsy
1296,1278,41,607,649,40,689,0,689,9,650,30,22.04.2019 00:10,203,22,Chernovtsy
672,670,8,302,363,7,370,0,370,4,357,9,22.04.2019 00:20,203,22,Chernovtsy
944,931,36,454,455,35,490,0,490,7,440,43,22.04.2019 00:30,203,22,Chernovtsy
432,426,18,183,231,18,249,0,249,1,208,40,22.04.2019 00:10,203,22,Chernovtsy
608,593,24,300,287,21,308,0,308,7,281,20,22.04.2019 00:15,203,22,Chernovtsy
576,560,30,259,288,29,317,0,317,13,269,35,22.04.2019 00:05,203,22,Chernovtsy
624,612,14,294,316,14,330,0,330,2,301,27,22.04.2019 00:15,203,22,Chernovtsy
736,728,25,384,328,24,352,0,352,10,325,17,22.04.2019 00:15,203,22,Chernovtsy
480,471,21,239,220,21,241,0,241,4,223,14,21.04.2019 20:50,203,22,Chernovtsy
1632,1613,29,809,796,27,823,0,823,22,753,48,22.04.2019 00:05,203,22,Chernovtsy
1504,1490,41,779,684,41,725,0,725,18,670,37,22.04.2019 00:09,203,22,Chernovtsy
1664,1646,44,897,725,42,767,0,767,25,684,58,22.04.2019 00:05,203,22,Chernovtsy
1616,1608,138,546,935,135,1070,0,1070,20,975,75,22.04.2019 00:50,203,22,Chernovtsy
2256,2232,37,1317,904,35,939,0,939,27,842,70,22.04.2019 00:05,203,22,Chernovtsy
912,895,66,494,354,64,418,0,418,8,380,30,22.04.2019 00:05,203,22,Chernovtsy
1584,1561,87,821,682,81,763,0,763,14,724,25,22.04.2019 02:50,203,22,Chernovtsy
816,802,1,333,482,1,483,0,483,21,441,21,22.04.2019 00:25,203,22,Chernovtsy
400,392,0,135,265,0,265,0,265,7,192,66,22.04.2019 00:11,203,22,Chernovtsy
368,367,0,167,201,0,201,0,201,3,182,16,22.04.2019 00:15,203,22,Chernovtsy
1872,1857,43,906,932,34,966,0,966,40,671,255,22.04.2019 02:25,203,22,Chernovtsy
1904,1869,36,1015,866,23,889,0,889,16,680,193,22.04.2019 00:10,203,22,Chernovtsy
1664,1639,17,740,908,16,924,0,924,26,668,230,22.04.2019 01:30,203,22,Chernovtsy
1584,1564,38,781,774,29,803,0,803,11,548,244,22.04.2019 00:20,203,22,Chernovtsy
1056,1048,55,656,356,44,400,0,400,19,307,74,22.04.2019 02:05,203,22,Chernovtsy
1456,1444,32,759,666,31,697,0,697,18,560,119,22.04.2019 01:20,203,22,Chernovtsy
1488,1472,67,801,620,67,687,0,687,20,624,43,22.04.2019 01:15,203,22,Chernovtsy
2464,2443,53,1261,1153,50,1203,0,1203,50,1103,50,22.04.2019 00:05,203,22,Chernovtsy
928,913,39,416,480,32,512,0,512,14,480,18,22.04.2019 00:05,203,22,Chernovtsy
1776,1750,112,829,837,110,947,0,947,15,891,41,22.04.2019 00:20,203,22,Chernovtsy
2288,2274,50,1084,1155,49,1204,0,1204,27,896,281,22.04.2019 00:25,203,22,Chernovtsy
2480,2449,41,1338,1106,36,1142,0,1142,57,845,240,22.04.2019 00:20,203,22,Chernovtsy
1584,1566,70,747,768,69,837,0,837,25,777,35,22.04.2019 00:55,203,22,Chernovtsy
2560,2531,35,1325,1203,32,1235,0,1235,14,985,236,22.04.2019 00:15,203,22,Chernovtsy
1280,1258,82,724,483,73,556,0,556,14,463,79,22.04.2019 00:30,203,22,Chernovtsy
2000,1990,71,1117,819,64,883,0,883,18,818,47,22.04.2019 00:04,203,22,Chernovtsy
1088,1064,42,487,559,42,601,0,601,19,477,105,22.04.2019 00:10,203,22,Chernovtsy
320,309,11,189,120,11,131,0,131,4,102,25,22.04.2019 00:05,203,22,Chernovtsy
512,499,40,225,249,38,287,0,287,6,172,109,22.04.2019 03:05,203,22,Chernovtsy
464,455,45,211,214,39,253,0,253,5,155,93,22.04.2019 00:35,203,22,Chernovtsy
1728,1712,30,888,810,30,840,0,840,25,709,106,22.04.2019 00:30,203,22,Chernovtsy
1248,1238,23,621,610,17,627,0,627,23,529,75,22.04.2019 01:40,203,22,Chernovtsy
1840,1823,46,991,805,44,849,0,849,24,775,50,22.04.2019 00:15,203,22,Chernovtsy
400,402,24,182,196,22,218,0,218,7,161,50,22.04.2019 00:30,203,22,Chernovtsy
688,670,41,282,369,37,406,0,406,12,353,41,22.04.2019 00:10,203,22,Chernovtsy
320,316,18,110,192,18,210,0,210,6,173,31,22.04.2019 01:15,203,22,Chernovtsy
1088,1076,16,576,496,16,512,0,512,5,456,51,22.04.2019 00:20,203,22,Chernovtsy
1088,1082,15,604,469,15,484,0,484,16,396,72,22.04.2019 00:30,203,22,Chernovtsy
1520,1495,72,676,776,68,844,0,844,11,592,241,22.04.2019 00:10,203,22,Chernovtsy
96,84,6,43,47,6,53,0,53,1,40,12,22.04.2019 00:25,203,22,Chernovtsy
944,928,26,343,575,26,601,0,601,17,424,160,22.04.2019 00:10,203,22,Chernovtsy
1344,1326,37,664,645,35,680,0,680,11,635,34,22.04.2019 00:05,203,22,Chernovtsy
448,438,27,168,257,23,280,0,280,8,210,62,22.04.2019 00:20,203,22,Chernovtsy
544,533,26,240,279,25,304,0,304,6,286,12,22.04.2019 00:05,203,22,Chernovtsy
272,262,13,91,168,13,181,0,181,7,156,18,22.04.2019 00:10,203,22,Chernovtsy
784,777,37,383,364,37,401,0,401,6,336,59,21.04.2019 21:30,203,22,Chernovtsy
992,984,40,524,432,36,468,0,468,7,400,61,21.04.2019 21:10,203,22,Chernovtsy
2176,2163,107,948,1128,100,1228,0,1228,32,1060,136,22.04.2019 00:15,203,22,Chernovtsy
688,681,35,313,344,31,375,0,375,14,279,82,21.04.2019 21:30,203,22,Chernovtsy
1328,1313,71,651,611,66,677,0,677,17,559,101,22.04.2019 00:15,203,22,Chernovtsy
368,358,17,140,212,16,228,0,228,6,205,17,22.04.2019 00:10,203,22,Chernovtsy
2144,2123,37,994,1117,33,1150,0,1150,34,846,270,22.04.2019 00:01,203,22,Chernovtsy
1760,1737,39,886,838,36,874,0,874,25,671,178,22.04.2019 00:10,203,22,Chernovtsy
1552,1524,99,684,784,84,868,0,868,20,629,219,22.04.2019 03:20,203,22,Chernovtsy
224,221,10,74,140,10,150,0,150,7,96,47,22.04.2019 00:05,203,22,Chernovtsy
2432,2418,50,1197,1193,42,1235,0,1235,37,983,215,22.04.2019 00:05,203,22,Chernovtsy
1840,1821,40,925,881,34,915,0,915,18,732,165,22.04.2019 00:20,203,22,Chernovtsy
1968,1936,34,1070,875,23,898,0,898,32,755,111,22.04.2019 00:23,203,22,Chernovtsy
1024,1005,70,449,505,70,575,0,575,12,480,83,22.04.2019 00:30,203,22,Chernovtsy
544,533,18,315,211,18,229,0,229,8,169,52,22.04.2019 00:15,203,22,Chernovtsy
1936,1926,13,1092,833,11,844,0,844,25,756,63,22.04.2019 00:37,203,22,Chernovtsy
1744,1718,5,917,822,5,827,0,827,28,786,13,22.04.2019 00:55,203,22,Chernovtsy
2128,2145,91,1125,940,63,1003,0,1003,26,921,56,22.04.2019 00:05,203,22,Chernovtsy
2368,2376,115,1254,1016,98,1114,0,1114,44,975,95,22.04.2019 00:11,203,22,Chernovtsy
672,656,42,363,272,37,309,0,309,8,258,43,22.04.2019 00:20,203,22,Chernovtsy
1776,1759,40,979,765,32,797,0,797,14,748,35,22.04.2019 00:20,203,22,Chernovtsy
512,506,28,283,210,19,229,0,229,5,154,70,22.04.2019 00:05,203,22,Chernovtsy
1504,1488,59,773,683,48,731,0,731,22,594,115,22.04.2019 01:03,203,22,Chernovtsy
1520,1497,85,832,615,73,688,0,688,27,630,31,22.04.2019 00:12,203,22,Chernovtsy
2208,2185,58,1220,939,49,988,0,988,38,820,130,22.04.2019 00:30,203,22,Chernovtsy
2224,2203,24,969,1231,24,1255,0,1255,22,1198,35,22.04.2019 00:15,203,22,Chernovtsy
1824,1806,14,959,851,14,865,0,865,23,792,50,22.04.2019 00:15,203,22,Chernovtsy
1040,1027,17,608,415,17,432,0,432,14,379,39,22.04.2019 00:05,203,22,Chernovtsy
1904,1908,26,1056,822,26,848,0,848,14,749,85,22.04.2019 00:20,203,22,Chernovtsy
864,837,3,469,392,3,395,0,395,6,361,28,22.04.2019 00:05,203,22,Chernovtsy
2432,2401,38,1324,1073,35,1108,0,1108,51,986,71,22.04.2019 03:04,203,22,Chernovtsy
1760,1736,29,901,834,25,859,0,859,28,786,45,22.04.2019 00:15,203,22,Chernovtsy
896,884,35,295,566,35,601,0,601,17,530,54,22.04.2019 00:20,203,22,Chernovtsy
1664,1644,116,677,881,106,987,0,987,21,743,223,22.04.2019 00:15,203,22,Chernovtsy
1952,1933,55,952,950,50,1000,0,1000,19,942,39,22.04.2019 00:03,203,22,Chernovtsy
784,782,73,264,450,70,520,0,520,13,415,92,22.04.2019 00:05,203,22,Chernovtsy
240,233,19,77,146,17,163,0,163,5,127,31,22.04.2019 00:15,203,22,Chernovtsy
1888,1846,25,907,956,25,981,0,981,15,760,206,22.04.2019 00:04,203,22,Chernovtsy
1920,1900,37,1061,827,32,859,0,859,19,773,67,22.04.2019 00:10,203,22,Chernovtsy
1024,1000,26,569,430,25,455,0,455,14,365,76,22.04.2019 00:10,203,22,Chernovtsy
1376,1350,71,653,655,68,723,0,723,15,649,59,21.04.2019 21:00,203,22,Chernovtsy
1264,1246,71,549,644,71,715,0,715,17,638,60,22.04.2019 00:10,203,22,Chernovtsy
1920,1895,81,1133,717,70,787,0,787,42,706,39,22.04.2019 00:20,203,22,Chernovtsy
2112,2078,47,1256,812,44,856,0,856,29,791,36,22.04.2019 00:15,203,22,Chernovtsy
1760,1743,33,668,1059,33,1092,0,1092,14,683,395,22.04.2019 00:20,203,22,Chernovtsy
1536,1523,22,728,786,22,808,0,808,14,533,261,22.04.2019 00:10,203,22,Chernovtsy
656,643,53,327,276,53,329,0,329,9,287,33,22.04.2019 00:15,203,22,Chernovtsy
1696,1681,26,1014,663,19,682,0,682,10,657,15,22.04.2019 00:10,203,22,Chernovtsy
1808,1783,25,989,795,24,819,0,819,39,613,167,22.04.2019 00:25,203,22,Chernovtsy
544,540,26,279,241,24,265,0,265,8,209,48,22.04.2019 00:05,203,22,Chernovtsy
1136,1114,56,595,487,54,541,0,541,10,487,44,22.04.2019 00:10,203,22,Chernovtsy
1216,1199,12,426,778,12,790,0,790,20,724,46,22.04.2019 00:17,203,22,Chernovtsy
1408,1392,11,719,678,11,689,0,689,21,512,156,22.04.2019 00:05,203,22,Chernovtsy
2080,2055,78,1043,966,71,1037,0,1037,37,732,268,22.04.2019 00:25,203,22,Chernovtsy
1888,1864,86,889,934,65,999,0,999,33,704,262,22.04.2019 01:20,203,22,Chernovtsy
1424,1415,34,706,689,29,718,0,718,15,515,188,22.04.2019 00:15,203,22,Chernovtsy
1376,1362,46,687,651,38,689,0,689,9,543,137,22.04.2019 00:20,203,22,Chernovtsy
1296,1283,32,598,666,32,698,0,698,4,490,204,21.04.2019 21:00,203,22,Chernovtsy
1824,1803,33,770,1024,30,1054,0,1054,30,760,264,22.04.2019 00:10,203,22,Chernovtsy
1552,1519,73,883,613,56,669,0,669,22,613,34,22.04.2019 04:18,203,22,Chernovtsy
1072,1065,58,597,421,54,475,0,475,17,424,34,22.04.2019 04:15,203,22,Chernovtsy
1248,1232,79,616,558,74,632,0,632,14,438,180,22.04.2019 01:40,203,22,Chernovtsy
192,184,13,72,107,13,120,0,120,0,102,18,22.04.2019 01:05,203,22,Chernovtsy
1440,1421,52,678,712,50,762,0,762,29,596,137,22.04.2019 02:30,203,22,Chernovtsy
1264,1257,45,591,629,44,673,0,673,14,514,145,22.04.2019 00:45,203,22,Chernovtsy
2480,2447,23,1202,1263,15,1278,0,1278,26,870,382,22.04.2019 00:30,203,22,Chernovtsy
1504,1478,22,703,786,15,801,0,801,16,547,238,22.04.2019 01:15,203,22,Chernovtsy
2112,2074,15,884,1220,8,1228,0,1228,41,813,374,22.04.2019 00:15,203,22,Chernovtsy
1664,1654,16,810,841,13,854,0,854,16,588,250,22.04.2019 00:15,203,22,Chernovtsy
1584,1554,10,738,837,9,846,0,846,17,611,218,22.04.2019 00:34,203,22,Chernovtsy
2480,2432,16,1180,1286,14,1300,0,1300,24,908,368,22.04.2019 00:05,203,22,Chernovtsy
1376,1366,17,562,800,14,814,0,814,17,558,239,22.04.2019 01:20,203,22,Chernovtsy
1264,1241,32,575,663,26,689,0,689,15,623,51,22.04.2019 00:15,203,22,Chernovtsy
608,592,47,306,257,45,302,0,302,6,189,107,22.04.2019 00:10,204,22,Chernovtsy
752,741,37,392,323,37,360,0,360,14,212,134,21.04.2019 21:30,204,22,Chernovtsy
416,414,20,129,267,20,287,0,287,12,197,78,22.04.2019 00:47,204,22,Chernovtsy
256,250,6,96,154,6,160,0,160,2,130,28,22.04.2019 00:01,204,22,Chernovtsy
784,767,44,343,398,43,441,0,441,8,325,108,21.04.2019 22:30,204,22,Chernovtsy
1168,1158,36,470,666,32,698,0,698,14,410,274,21.04.2019 20:48,204,22,Chernovtsy
704,692,33,271,403,30,433,0,433,2,249,182,21.04.2019 21:30,204,22,Chernovtsy
208,199,8,96,104,8,112,0,112,6,70,36,21.04.2019 20:44,204,22,Chernovtsy
1984,1956,13,1034,940,10,950,0,950,19,726,205,22.04.2019 00:20,204,22,Chernovtsy
1072,1055,33,522,525,25,550,0,550,17,435,98,22.04.2019 01:35,204,22,Chernovtsy
528,522,6,251,272,5,277,0,277,11,234,32,21.04.2019 21:00,204,22,Chernovtsy
736,724,45,347,346,43,389,0,389,8,287,94,22.04.2019 01:30,204,22,Chernovtsy
240,234,14,110,116,14,130,0,130,0,102,28,21.04.2019 20:30,204,22,Chernovtsy
1056,1045,81,407,568,81,649,0,649,13,518,118,21.04.2019 22:35,204,22,Chernovtsy
608,597,9,283,316,9,325,0,325,7,240,78,21.04.2019 21:05,204,22,Chernovtsy
944,922,63,476,413,55,468,0,468,7,388,73,21.04.2019 22:10,204,22,Chernovtsy
768,761,54,367,348,53,401,0,401,8,331,62,21.04.2019 21:00,204,22,Chernovtsy
416,413,38,170,209,37,246,0,246,1,185,60,22.04.2019 01:38,204,22,Chernovtsy
848,832,57,330,461,57,518,0,518,9,382,127,21.04.2019 20:40,204,22,Chernovtsy
2208,2154,13,1139,1056,13,1069,0,1069,19,915,135,21.04.2019 21:10,204,22,Chernovtsy
624,613,71,239,316,69,385,0,385,7,222,156,21.04.2019 21:35,204,22,Chernovtsy
368,369,27,133,208,27,235,0,235,4,148,83,21.04.2019 22:00,204,22,Chernovtsy
144,142,7,37,100,7,107,0,107,0,94,13,22.04.2019 00:05,204,22,Chernovtsy
1600,1581,53,868,684,48,732,0,732,13,594,125,22.04.2019 00:43,204,22,Chernovtsy
880,867,43,378,459,43,502,0,502,7,431,64,21.04.2019 20:55,204,22,Chernovtsy
992,982,87,363,544,85,629,0,629,10,523,96,21.04.2019 21:38,204,22,Chernovtsy
320,317,7,128,185,7,192,0,192,8,130,54,22.04.2019 00:10,204,22,Chernovtsy
1568,1536,72,943,568,57,625,0,625,13,517,95,21.04.2019 22:20,204,22,Chernovtsy
576,569,30,265,282,29,311,0,311,12,225,74,22.04.2019 00:15,204,22,Chernovtsy
272,270,30,97,146,29,175,0,175,2,146,27,21.04.2019 21:00,204,22,Chernovtsy
1520,1488,78,912,544,64,608,0,608,13,514,81,21.04.2019 21:20,204,22,Chernovtsy
1392,1352,45,680,667,45,712,0,712,12,583,117,21.04.2019 23:10,204,22,Chernovtsy
272,270,8,54,210,8,218,0,218,2,162,54,21.04.2019 20:30,204,22,Chernovtsy
1024,1002,10,513,501,10,511,0,511,4,460,47,22.04.2019 00:55,204,22,Chernovtsy
464,453,38,193,237,34,271,0,271,10,223,38,21.04.2019 22:00,204,22,Chernovtsy
144,142,0,63,81,0,81,0,81,1,75,5,21.04.2019 20:30,204,22,Chernovtsy
1168,1145,38,564,575,29,604,0,604,11,508,85,21.04.2019 21:25,204,22,Chernovtsy
1328,1309,7,371,950,7,957,0,957,25,913,19,21.04.2019 20:48,204,22,Chernovtsy
1104,1074,52,470,586,48,634,0,634,10,540,84,21.04.2019 21:30,204,22,Chernovtsy
1264,248,0,1018,246,0,246,0,246,20,179,47,21.04.2019 21:50,204,22,Chernovtsy
2336,2314,29,1153,1157,26,1183,0,1183,28,948,207,21.04.2019 23:58,204,22,Chernovtsy
1936,1922,10,888,1039,9,1048,0,1048,39,750,259,22.04.2019 00:20,204,22,Chernovtsy
1568,1532,20,761,792,15,807,0,807,22,618,167,22.04.2019 00:40,204,22,Chernovtsy
688,661,20,269,400,19,419,0,419,7,333,79,22.04.2019 00:40,204,22,Chernovtsy
496,483,7,216,274,6,280,0,280,3,249,28,21.04.2019 23:15,204,22,Chernovtsy
688,690,24,170,494,24,518,0,518,16,413,89,22.04.2019 00:20,204,22,Chernovtsy
96,90,4,42,50,4,54,0,54,0,34,20,21.04.2019 20:38,204,22,Chernovtsy
1312,1295,35,639,644,29,673,0,673,15,578,80,21.04.2019 22:10,204,22,Chernovtsy
448,444,9,201,239,8,247,0,247,2,179,66,21.04.2019 21:30,204,22,Chernovtsy
304,299,6,135,164,5,169,0,169,3,138,28,21.04.2019 21:00,204,22,Chernovtsy
1584,1564,52,553,979,52,1031,0,1031,24,879,128,21.04.2019 20:58,204,22,Chernovtsy
720,704,40,315,369,36,405,0,405,10,286,109,21.04.2019 22:30,204,22,Chernovtsy
1088,1073,27,534,531,23,554,0,554,10,464,80,21.04.2019 21:05,204,22,Chernovtsy
1168,1156,22,485,661,22,683,0,683,14,555,114,22.04.2019 00:10,204,22,Chernovtsy
1040,1019,11,435,594,11,605,0,605,16,523,66,21.04.2019 23:50,204,22,Chernovtsy
976,959,62,449,470,57,527,0,527,13,455,59,21.04.2019 21:30,204,22,Chernovtsy
1520,1492,16,781,723,16,739,0,739,14,598,127,21.04.2019 22:30,204,22,Chernovtsy
1600,1572,13,911,677,12,689,0,689,13,566,110,21.04.2019 21:25,204,22,Chernovtsy
1552,1530,23,883,648,21,669,0,669,7,560,102,21.04.2019 22:40,204,22,Chernovtsy
1760,1744,12,956,792,12,804,0,804,17,725,62,21.04.2019 20:45,204,22,Chernovtsy
2080,2066,8,947,1125,8,1133,0,1133,22,1023,88,21.04.2019 22:10,204,22,Chernovtsy
112,105,2,31,80,1,81,0,81,0,61,20,22.04.2019 00:10,204,22,Chernovtsy
1168,1154,102,489,585,94,679,0,679,19,503,157,21.04.2019 21:30,204,22,Chernovtsy
736,727,32,205,499,32,531,0,531,7,420,104,22.04.2019 00:15,204,22,Chernovtsy
352,353,16,136,202,14,216,0,216,2,197,17,21.04.2019 21:00,204,22,Chernovtsy
2368,2350,13,1219,1136,13,1149,0,1149,35,880,234,22.04.2019 00:15,204,22,Chernovtsy
448,428,5,199,244,5,249,0,249,4,220,25,21.04.2019 21:45,204,22,Chernovtsy
656,647,57,188,411,57,468,0,468,18,400,50,21.04.2019 21:00,204,22,Chernovtsy
1680,1655,25,930,730,20,750,0,750,17,628,105,21.04.2019 21:10,204,22,Chernovtsy
592,576,5,259,328,5,333,0,333,4,259,70,21.04.2019 22:40,204,22,Chernovtsy
768,752,59,345,369,54,423,0,423,7,340,76,21.04.2019 21:30,204,22,Chernovtsy
1152,1132,14,619,521,12,533,0,533,8,416,109,21.04.2019 23:30,204,22,Chernovtsy
1248,1231,2,711,535,2,537,0,537,11,449,77,22.04.2019 00:30,204,22,Chernovtsy
288,274,18,114,159,15,174,0,174,1,151,22,21.04.2019 22:30,204,22,Chernovtsy
640,634,25,277,338,25,363,0,363,13,301,49,21.04.2019 21:00,204,22,Chernovtsy
1120,1109,42,521,559,40,599,0,599,19,437,143,21.04.2019 22:15,204,22,Chernovtsy
992,981,5,483,504,5,509,0,509,9,421,79,21.04.2019 23:45,204,22,Chernovtsy
2176,2161,124,938,1123,115,1238,0,1238,28,1066,144,21.04.2019 23:00,204,22,Chernovtsy
1264,1242,8,604,652,8,660,0,660,2,538,120,21.04.2019 23:40,204,22,Chernovtsy
752,737,33,310,411,31,442,0,442,17,371,54,21.04.2019 20:45,204,22,Chernovtsy
208,48,18,166,25,17,42,0,42,0,40,2,21.04.2019 20:45,204,22,Chernovtsy
1600,1575,21,616,970,14,984,0,984,30,737,217,22.04.2019 00:30,205,23,Chernigov
1456,1429,13,525,921,10,931,0,931,32,682,217,22.04.2019 00:07,205,23,Chernigov
1680,1669,18,532,1135,13,1148,0,1148,43,827,278,22.04.2019 00:05,205,23,Chernigov
1456,1457,9,473,974,9,983,0,983,28,701,254,22.04.2019 00:15,205,23,Chernigov
1376,1424,6,312,1058,6,1064,0,1064,29,831,204,22.04.2019 00:11,205,23,Chernigov
1472,1449,18,499,960,13,973,0,973,30,731,212,21.04.2019 23:45,205,23,Chernigov
1568,1575,11,508,1052,8,1060,0,1060,37,762,261,22.04.2019 00:50,205,23,Chernigov
2080,2059,15,632,1440,8,1448,0,1448,30,1118,300,22.04.2019 00:10,205,23,Chernigov
1744,1711,10,618,1117,9,1126,0,1126,37,864,225,22.04.2019 01:10,205,23,Chernigov
1728,1707,8,564,1158,6,1164,0,1164,23,862,279,22.04.2019 00:07,205,23,Chernigov
1760,1732,15,577,1170,13,1183,0,1183,37,856,290,22.04.2019 00:07,205,23,Chernigov
2352,2347,5,784,1564,4,1568,0,1568,56,1163,349,22.04.2019 01:05,205,23,Chernigov
1792,1769,12,643,1140,9,1149,0,1149,44,831,274,22.04.2019 00:17,205,23,Chernigov
2272,2400,4,858,1413,1,1414,0,1414,27,1102,285,22.04.2019 00:23,205,23,Chernigov
2064,2025,6,646,1414,4,1418,0,1418,48,1060,310,22.04.2019 00:25,205,23,Chernigov
2144,2117,8,767,1371,6,1377,0,1377,40,1017,320,22.04.2019 00:18,205,23,Chernigov
1152,1127,3,432,718,2,720,0,720,17,579,124,22.04.2019 00:02,205,23,Chernigov
1680,1670,18,595,1071,14,1085,0,1085,31,841,213,22.04.2019 00:15,205,23,Chernigov
2032,2012,14,704,1314,14,1328,0,1328,34,1026,268,22.04.2019 00:04,205,23,Chernigov
2160,2141,14,736,1411,13,1424,0,1424,41,1120,263,22.04.2019 00:30,205,23,Chernigov
2208,2196,6,743,1460,5,1465,0,1465,33,1136,296,22.04.2019 00:30,205,23,Chernigov
1888,1868,17,612,1260,16,1276,0,1276,28,1027,221,22.04.2019 01:10,205,23,Chernigov
2272,2239,14,748,1514,10,1524,0,1524,56,1196,272,21.04.2019 23:00,205,23,Chernigov
1920,1909,9,603,1310,7,1317,0,1317,30,1056,231,22.04.2019 00:10,205,23,Chernigov
2080,2046,10,645,1427,8,1435,0,1435,32,1104,299,22.04.2019 00:30,205,23,Chernigov
1968,1964,13,615,1341,12,1353,0,1353,29,1032,292,22.04.2019 00:16,205,23,Chernigov
2144,2138,26,691,1436,17,1453,0,1453,36,1102,315,22.04.2019 00:20,205,23,Chernigov
2272,2251,18,717,1542,13,1555,0,1555,47,1244,264,22.04.2019 00:15,205,23,Chernigov
1824,1774,29,633,1170,21,1191,0,1191,18,912,261,22.04.2019 00:03,205,23,Chernigov
2416,2397,5,767,1645,4,1649,0,1649,52,1139,458,22.04.2019 00:05,205,23,Chernigov
2000,1932,10,763,1227,10,1237,0,1237,31,924,282,22.04.2019 00:30,205,23,Chernigov
1920,1912,22,663,1241,16,1257,0,1257,31,942,284,21.04.2019 23:50,205,23,Chernigov
1504,1462,3,554,948,2,950,0,950,16,790,144,22.04.2019 00:10,205,23,Chernigov
1568,1563,19,560,992,16,1008,0,1008,17,770,221,22.04.2019 00:20,205,23,Chernigov
2080,2054,13,681,1390,9,1399,0,1399,47,1053,299,22.04.2019 01:10,205,23,Chernigov
2112,2076,24,743,1350,19,1369,0,1369,32,1062,275,22.04.2019 00:15,205,23,Chernigov
2176,2146,9,688,1480,8,1488,0,1488,39,1139,310,22.04.2019 00:26,205,23,Chernigov
2208,2191,14,749,1446,13,1459,0,1459,47,1138,274,22.04.2019 00:15,205,23,Chernigov
1360,1348,5,462,893,5,898,0,898,16,726,156,22.04.2019 00:20,205,23,Chernigov
2192,2178,18,753,1427,12,1439,0,1439,46,1076,317,22.04.2019 01:00,205,23,Chernigov
2128,2106,10,707,1413,8,1421,0,1421,34,1127,260,22.04.2019 00:15,205,23,Chernigov
2208,2190,4,747,1458,3,1461,0,1461,38,1133,290,22.04.2019 00:20,205,23,Chernigov
1872,1859,2,588,1282,2,1284,0,1284,25,992,267,22.04.2019 02:10,205,23,Chernigov
2064,2047,16,697,1357,10,1367,0,1367,33,1052,282,22.04.2019 00:02,205,23,Chernigov
2288,2264,7,738,1546,4,1550,0,1550,32,1245,273,22.04.2019 01:20,205,23,Chernigov
1776,1770,2,563,1211,2,1213,0,1213,30,855,328,22.04.2019 00:10,205,23,Chernigov
1856,1836,8,616,1234,6,1240,0,1240,26,951,263,22.04.2019 01:10,205,23,Chernigov
2080,2051,4,718,1361,1,1362,0,1362,37,1020,305,22.04.2019 00:03,205,23,Chernigov
1696,1672,10,573,1118,5,1123,0,1123,36,831,256,22.04.2019 00:24,205,23,Chernigov
2336,2305,9,801,1530,5,1535,0,1535,56,1156,323,22.04.2019 00:25,205,23,Chernigov
2336,2312,9,852,1475,9,1484,0,1484,44,1142,298,22.04.2019 00:15,205,23,Chernigov
2224,2190,21,792,1416,16,1432,0,1432,36,1096,300,22.04.2019 00:10,205,23,Chernigov
2128,2091,10,784,1340,4,1344,0,1344,31,1059,254,22.04.2019 00:02,205,23,Chernigov
1920,1906,2,708,1211,1,1212,0,1212,34,940,238,22.04.2019 00:15,205,23,Chernigov
2224,2184,9,754,1468,2,1470,0,1470,33,1189,248,22.04.2019 00:20,205,23,Chernigov
2176,2124,5,801,1370,5,1375,0,1375,46,1019,310,22.04.2019 00:08,205,23,Chernigov
2432,2377,3,811,1619,2,1621,0,1621,34,1222,365,22.04.2019 00:02,205,23,Chernigov
2272,2223,12,831,1433,8,1441,0,1441,39,1061,341,22.04.2019 00:05,205,23,Chernigov
2304,2275,8,838,1461,5,1466,0,1466,44,1206,216,22.04.2019 00:50,205,23,Chernigov
2256,2244,14,722,1525,9,1534,0,1534,46,1194,294,21.04.2019 23:20,205,23,Chernigov
1952,1929,5,725,1224,3,1227,0,1227,27,957,243,22.04.2019 00:50,205,23,Chernigov
400,35,20,368,13,19,32,0,32,0,26,6,22.04.2019 00:15,205,23,Chernigov
384,48,37,338,10,36,46,0,46,0,35,11,21.04.2019 21:32,205,23,Chernigov
96,22,1,74,21,1,22,0,22,0,17,5,22.04.2019 00:05,205,23,Chernigov
608,246,136,396,97,115,212,0,212,7,167,38,22.04.2019 00:07,205,23,Chernigov
288,45,23,244,23,21,44,0,44,0,33,11,22.04.2019 00:59,205,23,Chernigov
224,66,1,161,62,1,63,0,63,2,54,7,22.04.2019 00:03,205,23,Chernigov
688,225,119,468,103,117,220,0,220,7,180,33,22.04.2019 00:07,205,23,Chernigov
128,10,0,119,9,0,9,0,9,1,6,2,22.04.2019 00:04,205,23,Chernigov
368,88,50,287,35,46,81,0,81,2,75,4,22.04.2019 00:16,205,23,Chernigov
112,18,0,94,18,0,18,0,18,0,15,3,22.04.2019 00:02,205,23,Chernigov
560,79,4,484,73,3,76,0,76,2,61,13,22.04.2019 00:10,205,23,Chernigov
1456,1442,19,551,890,15,905,0,905,20,687,198,21.04.2019 23:40,205,23,Chernigov
2144,2116,23,770,1355,19,1374,0,1374,33,1045,296,22.04.2019 00:06,205,23,Chernigov
1920,1862,20,722,1182,16,1198,0,1198,26,931,241,22.04.2019 00:15,205,23,Chernigov
2112,2077,9,746,1360,6,1366,0,1366,44,1066,256,22.04.2019 00:02,205,23,Chernigov
416,389,0,29,387,0,387,0,387,21,349,17,22.04.2019 00:10,206,23,Chernigov
1088,1065,60,467,565,56,621,0,621,6,573,42,22.04.2019 00:45,206,23,Chernigov
1072,1059,37,501,540,31,571,0,571,4,533,34,22.04.2019 00:10,206,23,Chernigov
144,137,25,53,74,17,91,0,91,2,79,10,22.04.2019 00:10,206,23,Chernigov
1328,1299,52,597,693,38,731,0,731,11,569,151,22.04.2019 01:10,206,23,Chernigov
1728,1693,99,805,838,85,923,0,923,10,775,138,22.04.2019 00:20,206,23,Chernigov
432,416,47,216,179,37,216,0,216,2,173,41,22.04.2019 01:15,206,23,Chernigov
160,151,23,66,75,19,94,0,94,0,72,22,22.04.2019 00:25,206,23,Chernigov
1920,1876,55,804,1065,51,1116,0,1116,18,828,270,22.04.2019 00:35,206,23,Chernigov
1952,1903,42,849,1071,32,1103,0,1103,26,849,228,22.04.2019 00:30,206,23,Chernigov
1856,1823,46,874,942,40,982,0,982,17,760,205,22.04.2019 00:20,206,23,Chernigov
432,412,39,176,218,38,256,0,256,3,192,61,22.04.2019 01:56,206,23,Chernigov
192,185,35,65,97,30,127,0,127,3,94,30,21.04.2019 20:45,206,23,Chernigov
80,78,12,32,37,11,48,0,48,0,37,11,21.04.2019 20:25,206,23,Chernigov
576,565,65,276,241,59,300,0,300,4,261,35,22.04.2019 00:42,206,23,Chernigov
336,328,45,125,170,41,211,0,211,4,168,39,21.04.2019 21:07,206,23,Chernigov
352,350,33,131,197,24,221,0,221,6,147,68,21.04.2019 23:00,206,23,Chernigov
192,178,14,86,94,12,106,0,106,1,71,34,21.04.2019 21:28,206,23,Chernigov
384,364,68,158,164,62,226,0,226,10,176,40,22.04.2019 00:33,206,23,Chernigov
320,318,97,136,114,70,184,0,184,8,143,33,22.04.2019 00:35,206,23,Chernigov
208,196,22,89,99,20,119,0,119,3,95,21,22.04.2019 00:05,206,23,Chernigov
160,153,36,65,65,30,95,0,95,1,57,37,22.04.2019 00:30,206,23,Chernigov
80,70,15,25,41,14,55,0,55,1,36,18,22.04.2019 02:30,206,23,Chernigov
352,334,70,152,145,55,200,0,200,1,139,60,21.04.2019 23:50,206,23,Chernigov
352,341,74,117,167,68,235,0,235,5,159,71,22.04.2019 00:15,206,23,Chernigov
288,280,34,143,118,27,145,0,145,3,115,27,22.04.2019 00:20,206,23,Chernigov
128,124,37,50,50,28,78,0,78,2,65,11,22.04.2019 00:15,206,23,Chernigov
128,124,31,38,66,24,90,0,90,0,70,20,22.04.2019 00:15,206,23,Chernigov
176,171,26,34,118,24,142,0,142,2,114,26,22.04.2019 00:10,206,23,Chernigov
240,225,31,113,104,23,127,0,127,1,106,20,21.04.2019 20:37,206,23,Chernigov
352,333,80,134,147,71,218,0,218,0,155,63,21.04.2019 21:08,206,23,Chernigov
208,194,44,46,126,36,162,0,162,2,135,25,22.04.2019 00:15,206,23,Chernigov
160,155,22,51,91,18,109,0,109,3,66,40,22.04.2019 00:10,206,23,Chernigov
384,372,47,211,129,44,173,0,173,2,128,43,21.04.2019 22:00,206,23,Chernigov
176,166,48,52,85,39,124,0,124,2,91,31,21.04.2019 22:05,206,23,Chernigov
512,506,81,204,231,77,308,0,308,3,254,51,22.04.2019 00:30,206,23,Chernigov
208,197,15,88,105,15,120,0,120,1,84,35,22.04.2019 00:40,206,23,Chernigov
512,497,64,208,249,55,304,0,304,2,261,41,22.04.2019 00:20,206,23,Chernigov
624,612,73,270,291,63,354,0,354,4,280,70,22.04.2019 03:05,206,23,Chernigov
240,227,44,88,112,40,152,0,152,1,134,17,21.04.2019 22:05,206,23,Chernigov
144,133,37,54,53,37,90,0,90,0,63,27,22.04.2019 00:03,206,23,Chernigov
320,304,75,112,146,62,208,0,208,3,157,48,21.04.2019 21:20,206,23,Chernigov
368,357,66,118,191,59,250,0,250,2,198,50,22.04.2019 00:15,206,23,Chernigov
112,101,40,51,34,27,61,0,61,0,52,9,22.04.2019 00:45,206,23,Chernigov
192,178,51,84,70,38,108,0,108,2,77,29,22.04.2019 00:07,206,23,Chernigov
288,284,34,98,157,33,190,0,190,2,156,32,21.04.2019 21:00,206,23,Chernigov
128,118,28,47,55,26,81,0,81,1,66,14,22.04.2019 00:04,206,23,Chernigov
224,215,54,73,104,47,151,0,151,2,125,24,22.04.2019 00:10,206,23,Chernigov
272,269,33,93,151,28,179,0,179,2,147,30,22.04.2019 00:05,206,23,Chernigov
176,174,32,61,89,26,115,0,115,0,90,25,22.04.2019 00:05,206,23,Chernigov
576,560,9,261,309,6,315,0,315,4,193,118,22.04.2019 00:10,206,23,Chernigov
992,969,94,426,476,90,566,0,566,11,429,126,22.04.2019 00:20,206,23,Chernigov
304,287,25,119,160,25,185,0,185,1,133,51,21.04.2019 23:00,206,23,Chernigov
272,256,46,94,134,44,178,0,178,1,142,35,22.04.2019 00:03,206,23,Chernigov
400,390,24,142,234,24,258,0,258,9,186,63,21.04.2019 21:01,206,23,Chernigov
608,600,22,211,375,22,397,0,397,7,320,70,22.04.2019 00:22,206,23,Chernigov
112,99,14,35,64,13,77,0,77,0,57,20,21.04.2019 20:20,206,23,Chernigov
608,603,17,254,337,17,354,0,354,6,273,75,22.04.2019 00:15,206,23,Chernigov
128,114,7,63,58,7,65,0,65,3,46,16,22.04.2019 00:55,206,23,Chernigov
992,984,3,438,553,1,554,0,554,12,428,114,21.04.2019 23:00,206,23,Chernigov
1104,1088,4,440,660,4,664,0,664,21,447,196,22.04.2019 00:02,206,23,Chernigov
1040,999,1,466,573,1,574,0,574,14,413,147,22.04.2019 00:07,206,23,Chernigov
432,424,31,187,214,31,245,0,245,6,188,51,22.04.2019 00:10,206,23,Chernigov
208,199,34,72,104,32,136,0,136,1,113,22,22.04.2019 00:05,206,23,Chernigov
480,459,36,199,246,35,281,0,281,5,192,84,22.04.2019 00:20,206,23,Chernigov
176,178,20,73,84,19,103,0,103,3,73,27,21.04.2019 22:30,206,23,Chernigov
224,220,23,101,101,22,123,0,123,4,92,27,22.04.2019 03:35,206,23,Chernigov
464,449,23,247,196,21,217,0,217,2,178,37,21.04.2019 23:40,206,23,Chernigov
1264,1262,53,497,716,51,767,0,767,10,613,144,22.04.2019 00:15,206,23,Chernigov
1120,1107,37,430,655,35,690,0,690,17,561,112,21.04.2019 22:25,206,23,Chernigov
336,319,2,121,214,1,215,0,215,3,170,42,22.04.2019 00:05,206,23,Chernigov
608,592,15,308,288,12,300,0,300,14,202,84,22.04.2019 00:10,206,23,Chernigov
896,883,32,364,502,30,532,0,532,9,301,222,22.04.2019 00:15,206,23,Chernigov
144,133,9,55,80,9,89,0,89,3,30,56,22.04.2019 00:05,206,23,Chernigov
2288,2255,15,905,1369,14,1383,0,1383,36,1090,257,22.04.2019 00:03,206,23,Chernigov
496,487,37,161,298,37,335,0,335,12,263,60,22.04.2019 02:05,206,23,Chernigov
1040,1012,4,490,546,4,550,0,550,15,440,95,22.04.2019 00:05,206,23,Chernigov
848,828,45,331,474,43,517,0,517,10,391,116,22.04.2019 00:02,206,23,Chernigov
528,516,49,205,274,49,323,0,323,3,234,86,22.04.2019 00:15,206,23,Chernigov
128,119,16,59,54,15,69,0,69,1,45,23,21.04.2019 22:15,206,23,Chernigov
80,75,10,20,50,10,60,0,60,2,44,14,21.04.2019 21:00,206,23,Chernigov
432,421,19,177,238,17,255,0,255,5,205,45,22.04.2019 00:48,206,23,Chernigov
464,460,32,170,266,28,294,0,294,5,200,89,22.04.2019 00:30,206,23,Chernigov
240,223,26,82,134,24,158,0,158,4,123,31,22.04.2019 00:05,206,23,Chernigov
240,223,11,106,124,10,134,0,134,5,100,29,21.04.2019 22:40,206,23,Chernigov
336,331,26,136,176,24,200,0,200,8,145,47,21.04.2019 21:30,206,23,Chernigov
2320,2285,34,939,1351,30,1381,0,1381,36,1125,220,22.04.2019 00:19,206,23,Chernigov
368,364,50,122,198,48,246,0,246,7,163,76,21.04.2019 20:49,206,23,Chernigov
496,487,53,221,226,49,275,0,275,8,200,67,21.04.2019 20:40,206,23,Chernigov
1360,1351,39,540,796,24,820,0,820,20,600,200,22.04.2019 00:15,206,23,Chernigov
288,275,18,108,163,17,180,0,180,2,143,35,22.04.2019 00:15,206,23,Chernigov
752,732,47,294,411,47,458,0,458,8,321,129,21.04.2019 22:00,206,23,Chernigov
800,787,36,333,431,36,467,0,467,10,348,109,22.04.2019 00:43,206,23,Chernigov
736,713,56,255,431,50,481,0,481,4,352,125,22.04.2019 00:10,206,23,Chernigov
144,141,10,65,73,6,79,0,79,0,72,7,21.04.2019 21:37,206,23,Chernigov
304,298,30,104,170,30,200,0,200,6,131,63,21.04.2019 23:50,206,23,Chernigov
112,100,9,61,44,7,51,0,51,0,40,11,21.04.2019 23:25,206,23,Chernigov
432,411,24,194,214,24,238,0,238,1,203,34,22.04.2019 00:45,206,23,Chernigov
320,314,33,153,136,31,167,0,167,3,123,41,21.04.2019 22:20,206,23,Chernigov
1040,1025,19,368,655,17,672,0,672,14,506,152,22.04.2019 00:30,206,23,Chernigov
816,802,18,248,550,18,568,0,568,12,452,104,22.04.2019 00:30,206,23,Chernigov
352,351,16,103,235,14,249,0,249,7,173,69,22.04.2019 00:10,206,23,Chernigov
560,543,30,194,336,30,366,0,366,7,286,73,22.04.2019 00:10,206,23,Chernigov
144,136,15,71,61,12,73,0,73,3,51,19,21.04.2019 20:22,206,23,Chernigov
816,807,57,313,452,51,503,0,503,15,393,95,22.04.2019 00:30,206,23,Chernigov
992,959,35,435,526,31,557,0,557,22,428,107,22.04.2019 00:20,206,23,Chernigov
400,389,20,202,180,18,198,0,198,5,148,45,21.04.2019 21:05,206,23,Chernigov
224,203,18,71,138,15,153,0,153,1,104,48,21.04.2019 21:06,206,23,Chernigov
192,190,26,75,99,18,117,0,117,1,82,34,21.04.2019 22:30,206,23,Chernigov
480,464,39,212,237,31,268,0,268,1,224,43,21.04.2019 22:30,206,23,Chernigov
416,409,61,143,215,58,273,0,273,1,192,80,21.04.2019 22:20,206,23,Chernigov
496,491,41,157,301,38,339,0,339,7,261,71,22.04.2019 00:15,206,23,Chernigov
112,100,18,49,47,16,63,0,63,0,46,17,21.04.2019 23:35,206,23,Chernigov
2256,2255,48,806,1409,41,1450,0,1450,37,1127,286,22.04.2019 01:10,206,23,Chernigov
320,305,17,122,182,16,198,0,198,3,150,45,21.04.2019 22:10,206,23,Chernigov
240,235,27,92,125,23,148,0,148,6,121,21,21.04.2019 20:46,206,23,Chernigov
160,159,3,61,96,3,99,0,99,3,76,20,21.04.2019 20:45,206,23,Chernigov
560,553,21,147,392,21,413,0,413,13,341,59,21.04.2019 22:10,206,23,Chernigov
656,644,26,206,425,25,450,0,450,5,390,55,21.04.2019 21:28,206,23,Chernigov
784,776,28,344,412,28,440,0,440,5,348,87,21.04.2019 21:20,206,23,Chernigov
224,210,17,85,124,15,139,0,139,4,102,33,21.04.2019 21:17,206,23,Chernigov
528,512,31,196,302,30,332,0,332,4,262,66,21.04.2019 22:15,206,23,Chernigov
480,475,16,140,324,16,340,0,340,3,253,84,21.04.2019 22:55,206,23,Chernigov
256,249,17,105,134,17,151,0,151,2,112,37,21.04.2019 22:00,206,23,Chernigov
288,280,19,115,155,18,173,0,173,2,135,36,21.04.2019 22:35,206,23,Chernigov
272,267,5,120,148,4,152,0,152,4,117,31,21.04.2019 20:51,206,23,Chernigov
480,459,44,133,307,40,347,0,347,6,213,128,22.04.2019 01:15,206,23,Chernigov
352,337,15,143,194,15,209,0,209,4,164,41,21.04.2019 23:40,206,23,Chernigov
128,116,10,51,67,10,77,0,77,0,65,12,21.04.2019 20:25,206,23,Chernigov
704,279,10,475,219,10,229,0,229,10,160,59,22.04.2019 00:17,206,23,Chernigov
1952,1932,24,742,1189,21,1210,0,1210,35,910,265,22.04.2019 00:20,206,23,Chernigov
1392,1381,11,487,896,9,905,0,905,26,692,187,21.04.2019 23:30,206,23,Chernigov
1520,1495,12,661,849,10,859,0,859,16,717,126,22.04.2019 00:05,206,23,Chernigov
2048,2016,12,794,1246,8,1254,0,1254,35,981,238,22.04.2019 01:17,206,23,Chernigov
1648,1640,1,725,922,1,923,0,923,37,740,146,22.04.2019 00:05,206,23,Chernigov
2080,2050,9,763,1311,6,1317,0,1317,22,1057,238,22.04.2019 00:25,206,23,Chernigov
2320,2284,12,874,1435,11,1446,0,1446,43,1118,285,21.04.2019 23:50,206,23,Chernigov
2192,2166,20,817,1357,18,1375,0,1375,33,1127,215,22.04.2019 00:15,206,23,Chernigov
2272,2239,9,912,1352,8,1360,0,1359,33,1099,227,22.04.2019 05:55,206,23,Chernigov
2096,2083,13,786,1300,10,1310,0,1310,30,1014,266,22.04.2019 00:10,206,23,Chernigov
2256,2234,27,792,1445,19,1464,0,1464,41,1099,324,22.04.2019 00:30,206,23,Chernigov
1760,1737,31,623,1114,23,1137,0,1137,42,849,246,22.04.2019 01:45,206,23,Chernigov
2032,2012,10,740,1286,6,1292,0,1292,26,1024,242,22.04.2019 00:05,206,23,Chernigov
1568,1547,18,565,989,14,1003,0,1003,18,777,208,22.04.2019 00:05,206,23,Chernigov
1808,1793,15,757,1038,13,1051,0,1051,26,826,199,22.04.2019 00:10,206,23,Chernigov
2176,2152,15,780,1387,9,1396,0,1396,42,1065,289,22.04.2019 05:30,206,23,Chernigov
1936,1933,17,658,1264,14,1278,0,1278,26,952,300,22.04.2019 00:10,206,23,Chernigov
1184,930,4,472,709,3,712,0,712,16,541,155,22.04.2019 00:05,206,23,Chernigov
2240,2218,17,811,1414,15,1429,0,1429,34,1104,291,22.04.2019 00:03,206,23,Chernigov
1648,1617,12,594,1045,9,1054,0,1054,21,818,215,22.04.2019 00:20,206,23,Chernigov
2176,2171,7,680,1490,6,1496,0,1496,41,1101,354,22.04.2019 00:15,206,23,Chernigov
2032,2017,16,643,1374,15,1389,0,1389,40,1036,313,22.04.2019 00:15,206,23,Chernigov
2192,2165,21,750,1425,17,1442,0,1442,47,1089,306,22.04.2019 00:02,206,23,Chernigov
1424,1400,14,528,887,9,896,0,896,22,672,202,21.04.2019 21:30,206,23,Chernigov
416,405,240,19,160,237,397,0,397,14,171,212,22.04.2019 00:15,206,23,Chernigov
2336,2323,14,751,1573,12,1585,0,1585,33,1237,315,22.04.2019 00:00,206,23,Chernigov
1872,1835,19,652,1204,16,1220,0,1220,33,966,221,22.04.2019 02:05,206,23,Chernigov
2464,2448,12,886,1568,10,1578,0,1578,39,1262,277,22.04.2019 00:35,206,23,Chernigov
2032,1986,11,696,1327,9,1336,0,1336,25,1064,247,22.04.2019 02:21,206,23,Chernigov
2256,2231,24,769,1467,20,1487,0,1487,40,1169,278,22.04.2019 00:02,206,23,Chernigov
2016,1996,6,735,1278,3,1281,0,1281,34,994,253,22.04.2019 00:05,206,23,Chernigov
2240,2205,18,859,1366,15,1381,0,1381,29,1100,252,22.04.2019 00:07,206,23,Chernigov
2080,2045,14,683,1387,10,1397,0,1397,29,1126,242,22.04.2019 00:05,206,23,Chernigov
2480,2334,10,1011,1464,5,1469,0,1469,33,1131,305,22.04.2019 00:52,206,23,Chernigov
2384,2348,6,764,1615,5,1620,0,1620,41,1262,317,22.04.2019 00:15,206,23,Chernigov
2336,2304,8,841,1489,6,1495,0,1495,47,1161,287,21.04.2019 22:40,206,23,Chernigov
2336,2324,10,775,1554,7,1561,0,1561,39,1198,324,22.04.2019 00:15,206,23,Chernigov
64,10,0,55,9,0,9,0,9,1,6,2,21.04.2019 21:15,206,23,Chernigov
144,73,9,96,41,7,48,0,48,1,40,7,22.04.2019 04:07,206,23,Chernigov
176,136,0,43,133,0,133,0,133,2,125,6,22.04.2019 00:22,206,23,Chernigov
48,15,0,34,14,0,14,0,14,0,14,0,21.04.2019 21:30,207,23,Chernigov
1952,1919,44,760,1158,34,1192,0,1192,25,980,187,22.04.2019 00:17,207,23,Chernigov
816,795,60,417,347,52,399,0,399,5,341,53,21.04.2019 21:50,207,23,Chernigov
112,102,12,51,50,11,61,0,61,1,50,10,22.04.2019 00:17,207,23,Chernigov
224,211,22,76,126,22,148,0,148,2,114,32,22.04.2019 00:10,207,23,Chernigov
176,164,17,75,88,13,101,0,101,0,86,15,22.04.2019 00:20,207,23,Chernigov
176,171,10,76,90,10,100,0,100,0,79,21,22.04.2019 00:05,207,23,Chernigov
128,114,11,70,50,8,58,0,58,0,43,15,22.04.2019 00:55,207,23,Chernigov
240,224,29,104,107,29,136,0,136,2,108,26,22.04.2019 00:07,207,23,Chernigov
320,312,46,109,170,41,211,0,211,1,165,45,22.04.2019 01:08,207,23,Chernigov
672,663,47,369,263,40,303,0,303,6,247,50,22.04.2019 00:15,207,23,Chernigov
288,266,58,127,112,49,161,0,161,1,114,46,22.04.2019 00:15,207,23,Chernigov
256,246,36,110,114,32,146,0,146,3,115,28,22.04.2019 01:38,207,23,Chernigov
336,330,28,120,195,21,216,0,216,8,149,59,21.04.2019 21:13,207,23,Chernigov
160,153,14,80,69,11,80,0,80,2,72,6,22.04.2019 00:15,207,23,Chernigov
304,292,32,106,168,30,198,0,198,2,177,19,22.04.2019 00:25,207,23,Chernigov
320,304,28,129,168,23,191,0,191,5,159,27,22.04.2019 00:20,207,23,Chernigov
544,534,87,227,240,77,317,0,317,4,239,74,22.04.2019 00:35,207,23,Chernigov
192,187,31,54,115,23,138,0,138,2,98,38,22.04.2019 01:42,207,23,Chernigov
352,346,42,151,169,32,201,0,201,2,177,22,22.04.2019 00:01,207,23,Chernigov
320,312,38,107,180,33,213,0,213,2,189,22,21.04.2019 21:05,207,23,Chernigov
256,243,26,130,107,19,126,0,126,2,98,26,21.04.2019 22:00,207,23,Chernigov
144,129,15,63,67,14,81,0,81,1,71,9,21.04.2019 20:40,207,23,Chernigov
400,386,45,88,269,43,312,0,312,1,271,40,22.04.2019 00:20,207,23,Chernigov
432,427,43,167,226,39,265,0,265,5,220,40,21.04.2019 20:35,207,23,Chernigov
256,252,33,99,128,29,157,0,157,2,134,21,21.04.2019 21:10,207,23,Chernigov
1408,1371,106,652,668,88,756,0,756,14,623,119,22.04.2019 00:30,207,23,Chernigov
336,329,17,153,170,13,183,0,183,4,142,37,22.04.2019 00:10,207,23,Chernigov
464,449,35,179,256,29,285,0,285,6,232,47,22.04.2019 00:05,207,23,Chernigov
240,226,22,100,121,19,140,0,140,3,121,16,21.04.2019 20:30,207,23,Chernigov
176,27,13,151,12,13,25,0,25,1,18,6,22.04.2019 00:20,207,23,Chernigov
1008,985,34,468,508,32,540,0,540,9,431,100,21.04.2019 21:25,207,23,Chernigov
768,754,85,365,331,72,403,0,403,5,328,70,22.04.2019 00:10,207,23,Chernigov
208,191,27,94,87,27,114,0,114,2,76,36,21.04.2019 20:49,207,23,Chernigov
112,110,17,38,58,16,74,0,74,2,55,17,21.04.2019 21:16,207,23,Chernigov
320,301,37,128,158,34,192,0,192,5,158,29,22.04.2019 00:35,207,23,Chernigov
880,866,48,374,462,44,506,0,506,12,388,106,22.04.2019 00:30,207,23,Chernigov
560,545,63,241,259,60,319,0,319,4,232,83,21.04.2019 21:38,207,23,Chernigov
304,287,39,120,148,36,184,0,184,4,127,53,22.04.2019 00:10,207,23,Chernigov
384,370,29,156,203,25,228,0,228,4,180,44,22.04.2019 00:25,207,23,Chernigov
240,224,29,81,131,28,159,0,159,5,113,41,22.04.2019 00:17,207,23,Chernigov
1024,1008,83,419,532,73,605,0,605,10,444,151,22.04.2019 00:05,207,23,Chernigov
512,504,52,226,239,47,286,0,286,2,233,51,22.04.2019 00:05,207,23,Chernigov
432,418,75,164,193,75,268,0,268,4,210,54,22.04.2019 00:35,207,23,Chernigov
464,444,28,199,237,28,265,0,265,9,209,47,22.04.2019 00:30,207,23,Chernigov
192,193,13,66,113,13,126,0,126,2,101,23,22.04.2019 00:10,207,23,Chernigov
96,85,8,38,51,7,58,0,58,2,35,21,21.04.2019 20:36,207,23,Chernigov
384,369,45,148,196,40,236,0,236,7,180,49,22.04.2019 01:05,207,23,Chernigov
1296,1274,23,455,821,20,841,0,841,20,684,137,22.04.2019 00:20,207,23,Chernigov
1312,1284,8,468,838,6,844,0,844,24,658,162,22.04.2019 00:20,207,23,Chernigov
1568,1548,25,608,939,21,960,0,960,17,824,119,22.04.2019 00:30,207,23,Chernigov
2400,2349,28,950,1427,23,1450,0,1450,30,1244,176,22.04.2019 00:13,207,23,Chernigov
1504,1468,25,587,897,20,917,0,917,20,777,120,22.04.2019 00:25,207,23,Chernigov
2352,2297,31,965,1358,29,1387,0,1387,24,1205,158,22.04.2019 00:30,207,23,Chernigov
1024,990,45,454,532,38,570,0,570,9,441,120,22.04.2019 00:50,207,23,Chernigov
1088,1047,15,468,608,12,620,0,620,12,492,116,22.04.2019 00:15,207,23,Chernigov
384,378,21,141,223,20,243,0,243,0,208,35,22.04.2019 00:04,207,23,Chernigov
368,309,40,178,153,37,190,0,190,4,145,41,21.04.2019 20:45,207,23,Chernigov
288,278,21,142,129,17,146,0,146,1,113,32,22.04.2019 00:10,207,23,Chernigov
240,229,30,98,115,27,142,0,142,3,101,38,21.04.2019 22:20,207,23,Chernigov
272,256,20,120,133,19,152,0,152,5,108,39,22.04.2019 00:20,207,23,Chernigov
832,824,24,485,331,16,347,0,347,14,259,74,22.04.2019 00:10,207,23,Chernigov
1104,1069,53,506,556,42,598,0,598,12,490,96,22.04.2019 00:10,207,23,Chernigov
400,390,58,176,175,49,224,0,224,4,177,43,21.04.2019 20:55,207,23,Chernigov
144,135,8,52,84,8,92,0,92,0,69,23,21.04.2019 21:05,207,23,Chernigov
576,566,79,211,302,63,365,0,365,8,281,76,22.04.2019 00:15,207,23,Chernigov
512,498,7,240,266,6,272,0,272,5,233,34,22.04.2019 00:15,207,23,Chernigov
560,539,43,217,308,35,343,0,343,2,281,60,22.04.2019 00:21,207,23,Chernigov
368,353,26,148,196,24,220,0,220,2,197,21,22.04.2019 01:05,207,23,Chernigov
208,196,14,92,104,12,116,0,116,3,78,35,22.04.2019 00:30,207,23,Chernigov
432,409,20,224,189,19,208,0,208,4,172,32,22.04.2019 00:10,207,23,Chernigov
352,337,22,158,177,17,194,0,194,4,136,54,22.04.2019 01:06,207,23,Chernigov
704,682,19,284,402,18,420,0,420,7,321,92,22.04.2019 00:10,207,23,Chernigov
272,258,31,126,118,28,146,0,146,5,118,23,22.04.2019 00:20,207,23,Chernigov
240,221,21,96,126,18,144,0,144,0,119,25,22.04.2019 00:10,207,23,Chernigov
160,150,17,72,73,15,88,0,88,2,77,9,22.04.2019 00:40,207,23,Chernigov
256,244,30,74,155,27,182,0,182,7,132,43,22.04.2019 00:30,207,23,Chernigov
208,42,22,170,19,19,38,0,38,0,35,3,22.04.2019 00:13,207,23,Chernigov
64,57,7,28,30,6,36,0,36,0,21,15,22.04.2019 00:15,207,23,Chernigov
528,520,46,175,314,39,353,0,353,4,272,77,22.04.2019 00:15,207,23,Chernigov
432,420,30,85,320,27,347,0,347,7,317,23,22.04.2019 00:30,207,23,Chernigov
432,424,40,101,297,34,331,0,331,2,267,62,22.04.2019 00:20,207,23,Chernigov
336,315,29,130,178,28,206,0,206,4,180,22,21.04.2019 23:48,207,23,Chernigov
320,305,49,132,146,42,188,0,188,1,150,37,22.04.2019 00:15,207,23,Chernigov
912,900,77,432,412,68,480,0,480,12,440,28,22.04.2019 00:30,207,23,Chernigov
352,350,32,142,182,28,210,0,210,3,165,42,22.04.2019 00:10,207,23,Chernigov
112,107,16,48,51,13,64,0,64,0,43,21,21.04.2019 21:30,207,23,Chernigov
272,267,24,77,174,21,195,0,195,7,150,38,21.04.2019 20:50,207,23,Chernigov
224,213,10,71,145,8,153,0,153,2,136,15,21.04.2019 23:50,207,23,Chernigov
96,90,8,17,71,8,79,0,79,0,64,15,21.04.2019 21:10,207,23,Chernigov
80,68,11,30,41,9,50,0,50,1,31,18,22.04.2019 00:15,207,23,Chernigov
224,208,14,92,120,12,132,0,132,5,106,21,21.04.2019 21:25,207,23,Chernigov
208,192,34,94,85,29,114,0,114,0,100,14,22.04.2019 00:02,207,23,Chernigov
224,222,10,80,135,9,144,0,144,1,109,34,22.04.2019 00:20,207,23,Chernigov
80,73,3,21,56,3,59,0,59,1,47,11,21.04.2019 20:20,207,23,Chernigov
240,220,41,88,118,34,152,0,152,1,137,14,22.04.2019 00:30,207,23,Chernigov
192,189,20,57,117,18,135,0,135,4,106,25,22.04.2019 00:50,207,23,Chernigov
288,281,42,113,138,37,175,0,175,1,145,29,22.04.2019 00:15,207,23,Chernigov
176,168,7,74,96,6,102,0,102,4,72,26,22.04.2019 00:20,207,23,Chernigov
160,153,10,70,84,6,90,0,90,1,77,12,22.04.2019 00:03,207,23,Chernigov
208,194,16,74,118,16,134,0,134,2,108,24,22.04.2019 00:20,207,23,Chernigov
192,189,25,77,94,21,115,0,115,0,95,20,22.04.2019 00:05,207,23,Chernigov
624,599,56,258,317,49,366,0,366,7,311,48,21.04.2019 23:00,207,23,Chernigov
80,78,5,47,30,3,33,0,33,0,24,9,22.04.2019 00:10,207,23,Chernigov
416,417,29,131,258,27,285,0,285,6,255,24,21.04.2019 23:57,207,23,Chernigov
272,263,22,69,181,22,203,0,203,2,166,35,21.04.2019 20:30,207,23,Chernigov
352,345,25,119,210,23,233,0,233,0,188,45,21.04.2019 23:00,207,23,Chernigov
80,74,7,29,45,6,51,0,51,0,48,3,21.04.2019 21:00,207,23,Chernigov
2320,2302,38,900,1391,29,1420,0,1420,32,1196,192,22.04.2019 00:30,207,23,Chernigov
2304,2238,34,939,1336,29,1365,0,1365,26,1191,148,22.04.2019 00:30,207,23,Chernigov
1920,1884,58,786,1087,47,1134,0,1134,36,963,135,22.04.2019 02:10,207,23,Chernigov
1504,1483,28,590,890,24,914,0,914,22,800,92,21.04.2019 22:15,207,23,Chernigov
144,26,24,118,2,24,26,0,26,0,24,2,22.04.2019 00:42,207,23,Chernigov
144,103,0,42,102,0,102,0,102,4,95,3,21.04.2019 20:15,207,23,Chernigov
1312,1276,27,563,727,22,749,0,749,11,640,98,22.04.2019 00:45,207,23,Chernigov
2240,2183,26,1016,1203,21,1224,0,1224,16,1033,175,22.04.2019 00:32,207,23,Chernigov
848,835,16,388,446,14,460,0,460,8,397,55,22.04.2019 00:15,207,23,Chernigov
560,553,7,269,286,5,291,0,291,1,256,34,21.04.2019 21:39,207,23,Chernigov
128,118,0,86,42,0,42,0,42,0,33,9,21.04.2019 21:00,207,23,Chernigov
160,146,6,75,81,4,85,0,85,2,64,19,21.04.2019 20:15,207,23,Chernigov
160,146,1,78,81,1,82,0,82,2,51,29,21.04.2019 21:00,207,23,Chernigov
224,203,7,111,106,7,113,0,113,1,98,14,22.04.2019 00:20,207,23,Chernigov
736,721,57,309,372,55,427,0,427,7,367,53,22.04.2019 00:45,207,23,Chernigov
352,347,37,129,186,37,223,0,223,4,194,25,21.04.2019 21:37,207,23,Chernigov
208,202,15,83,113,12,125,0,125,2,106,17,22.04.2019 00:10,207,23,Chernigov
128,126,15,44,72,12,84,0,84,3,73,8,22.04.2019 00:07,207,23,Chernigov
496,478,34,168,296,32,328,0,328,3,298,27,22.04.2019 00:06,207,23,Chernigov
208,196,21,82,107,19,126,0,126,2,113,11,21.04.2019 20:35,207,23,Chernigov
176,155,7,83,87,6,93,0,93,2,70,21,21.04.2019 20:58,207,23,Chernigov
160,143,21,74,68,18,86,0,86,2,70,14,21.04.2019 20:28,207,23,Chernigov
496,487,63,182,251,63,314,0,314,2,258,54,22.04.2019 00:45,207,23,Chernigov
144,128,14,60,70,14,84,0,84,0,57,27,22.04.2019 01:50,207,23,Chernigov
112,106,14,38,60,14,74,0,74,2,53,19,22.04.2019 01:25,207,23,Chernigov
352,334,31,164,165,23,188,0,188,1,148,39,21.04.2019 23:30,207,23,Chernigov
96,89,5,42,49,5,54,0,54,0,41,13,21.04.2019 21:05,207,23,Chernigov
304,284,20,130,154,20,174,0,174,2,162,10,21.04.2019 21:03,207,23,Chernigov
224,222,25,113,87,24,111,0,111,1,100,10,22.04.2019 00:10,207,23,Chernigov
224,215,16,107,102,15,117,0,117,0,102,15,22.04.2019 00:05,207,23,Chernigov
128,122,11,61,57,10,67,0,67,0,58,9,21.04.2019 22:00,207,23,Chernigov
288,277,8,133,149,6,155,0,155,3,132,20,21.04.2019 23:40,207,23,Chernigov
128,22,3,108,18,2,20,0,20,1,13,6,22.04.2019 00:50,207,23,Chernigov
1888,1853,31,752,1114,22,1136,0,1136,24,910,202,22.04.2019 01:30,207,23,Chernigov
1888,1846,26,776,1086,26,1112,0,1112,27,920,165,22.04.2019 01:50,207,23,Chernigov
1744,1701,21,713,1013,18,1031,0,1031,16,876,139,22.04.2019 01:00,207,23,Chernigov
160,154,11,45,105,10,115,0,115,1,97,17,22.04.2019 00:10,207,23,Chernigov
1008,979,20,480,516,12,528,0,528,8,441,79,22.04.2019 00:15,207,23,Chernigov
208,199,3,73,132,3,135,0,135,1,120,14,22.04.2019 00:30,207,23,Chernigov
128,115,6,53,71,4,75,0,75,1,66,8,22.04.2019 00:17,207,23,Chernigov
272,270,19,115,140,17,157,0,157,2,136,19,22.04.2019 00:15,207,23,Chernigov
144,126,4,70,70,4,74,0,74,2,57,15,22.04.2019 00:15,207,23,Chernigov
448,440,61,131,256,61,317,0,317,5,252,60,22.04.2019 00:20,207,23,Chernigov
432,416,26,190,220,22,242,0,242,7,176,59,22.04.2019 00:15,207,23,Chernigov
592,581,31,233,333,26,359,0,359,5,301,53,22.04.2019 00:50,207,23,Chernigov
80,79,15,15,53,12,65,0,65,2,50,13,22.04.2019 00:05,207,23,Chernigov
336,325,43,112,182,42,224,0,224,6,178,40,22.04.2019 00:25,207,23,Chernigov
128,120,19,39,75,14,89,0,89,0,65,24,22.04.2019 01:00,207,23,Chernigov
320,311,27,107,194,19,213,0,213,4,180,29,22.04.2019 00:15,207,23,Chernigov
192,183,23,70,101,21,122,0,122,1,103,18,21.04.2019 20:40,207,23,Chernigov
160,149,13,72,79,9,88,0,88,3,76,9,21.04.2019 21:00,207,23,Chernigov
464,458,49,159,260,45,305,0,305,9,223,73,22.04.2019 01:10,207,23,Chernigov
560,547,70,183,318,59,377,0,377,7,278,92,21.04.2019 22:00,207,23,Chernigov
320,313,45,115,164,41,205,0,205,1,151,53,21.04.2019 20:50,207,23,Chernigov
112,101,7,52,53,7,60,0,60,1,38,21,22.04.2019 00:05,207,23,Chernigov
208,193,15,83,111,14,125,0,125,0,81,44,22.04.2019 00:30,207,23,Chernigov
160,145,23,44,93,23,116,0,116,0,101,15,22.04.2019 00:10,207,23,Chernigov
384,368,20,151,219,14,233,0,233,3,194,36,22.04.2019 00:15,207,23,Chernigov
48,46,7,10,32,6,38,0,38,0,34,4,22.04.2019 00:20,207,23,Chernigov
672,649,49,251,381,40,421,0,421,7,359,55,22.04.2019 00:15,207,23,Chernigov
560,544,41,155,365,40,405,0,405,6,329,70,22.04.2019 00:40,207,23,Chernigov
112,42,15,73,25,14,39,0,39,1,33,5,22.04.2019 00:05,207,23,Chernigov
1552,1533,14,683,857,12,869,0,869,14,713,142,22.04.2019 00:55,207,23,Chernigov
1472,1440,12,676,788,8,796,0,796,20,647,129,22.04.2019 00:45,207,23,Chernigov
2208,2161,25,929,1265,14,1279,0,1279,17,1084,178,22.04.2019 00:45,207,23,Chernigov
640,624,7,287,348,5,353,0,353,5,275,73,22.04.2019 00:10,207,23,Chernigov
384,382,18,171,197,16,213,0,213,2,162,49,22.04.2019 00:51,207,23,Chernigov
128,127,12,39,77,12,89,0,89,2,73,14,22.04.2019 00:35,207,23,Chernigov
192,190,17,75,105,12,117,0,117,2,89,26,22.04.2019 00:15,207,23,Chernigov
224,213,22,84,120,20,140,0,140,1,93,46,22.04.2019 00:15,207,23,Chernigov
352,340,24,148,185,19,204,0,204,0,177,27,22.04.2019 00:34,207,23,Chernigov
128,121,0,64,64,0,64,0,64,1,46,17,22.04.2019 00:10,207,23,Chernigov
912,896,50,410,461,41,502,0,502,11,424,67,22.04.2019 00:07,207,23,Chernigov
656,640,35,303,321,32,353,0,353,9,281,63,22.04.2019 00:42,207,23,Chernigov
128,116,11,55,64,9,73,0,73,0,52,21,22.04.2019 00:05,207,23,Chernigov
320,298,27,127,168,25,193,0,193,8,138,47,22.04.2019 01:10,207,23,Chernigov
720,707,43,349,332,39,371,0,371,13,307,51,21.04.2019 21:00,207,23,Chernigov
448,438,30,184,235,29,264,0,264,3,207,54,22.04.2019 01:30,207,23,Chernigov
560,551,31,248,281,31,312,0,312,0,233,79,22.04.2019 00:10,207,23,Chernigov
176,171,12,93,76,7,83,0,83,1,67,15,22.04.2019 00:05,207,23,Chernigov
240,233,23,118,105,17,122,0,122,0,100,22,22.04.2019 00:21,207,23,Chernigov
448,427,8,240,202,6,208,0,208,0,177,31,22.04.2019 01:07,207,23,Chernigov
320,309,12,189,119,12,131,0,131,3,112,16,22.04.2019 00:15,207,23,Chernigov
480,465,36,119,327,34,361,0,361,9,292,60,22.04.2019 00:17,207,23,Chernigov
656,638,48,282,326,48,374,0,374,13,273,88,22.04.2019 00:30,207,23,Chernigov
368,362,27,195,156,17,173,0,173,2,143,28,22.04.2019 00:10,207,23,Chernigov
128,127,4,41,85,2,87,0,87,6,60,21,22.04.2019 00:04,207,23,Chernigov
192,26,11,167,14,11,25,0,25,0,18,7,22.04.2019 00:15,207,23,Chernigov
2096,2051,23,833,1243,20,1263,0,1263,31,1063,169,22.04.2019 01:40,208,23,Chernigov
1088,1077,13,511,568,9,577,0,577,17,462,98,22.04.2019 00:55,208,23,Chernigov
864,848,23,395,449,20,469,0,469,7,414,48,22.04.2019 00:12,208,23,Chernigov
1968,1933,15,780,1177,11,1188,0,1188,32,956,200,22.04.2019 00:15,208,23,Chernigov
2176,2139,18,878,1280,18,1298,0,1298,27,1078,193,22.04.2019 00:10,208,23,Chernigov
400,382,1,187,212,1,213,0,213,4,180,29,22.04.2019 00:55,208,23,Chernigov
1552,1521,20,609,928,15,943,0,943,23,780,140,22.04.2019 00:30,208,23,Chernigov
1088,1072,45,479,573,36,609,0,609,15,497,97,22.04.2019 00:25,208,23,Chernigov
1344,1309,20,608,718,18,736,0,736,13,594,129,22.04.2019 00:20,208,23,Chernigov
2320,2292,27,901,1399,20,1419,0,1419,30,1166,223,22.04.2019 00:13,208,23,Chernigov
896,872,44,405,450,41,491,0,491,5,363,123,22.04.2019 00:20,208,23,Chernigov
720,696,44,355,325,40,365,0,365,3,287,75,22.04.2019 00:25,208,23,Chernigov
160,148,20,54,86,20,106,0,106,0,62,44,22.04.2019 01:15,208,23,Chernigov
848,835,41,336,473,39,512,0,512,6,424,82,22.04.2019 00:03,208,23,Chernigov
416,414,21,175,226,15,241,0,241,2,201,38,22.04.2019 00:10,208,23,Chernigov
752,741,46,286,427,39,466,0,466,10,367,89,22.04.2019 00:30,208,23,Chernigov
192,191,26,49,117,26,143,0,143,0,95,48,22.04.2019 00:10,208,23,Chernigov
256,243,24,101,135,20,155,0,155,5,98,52,22.04.2019 00:50,208,23,Chernigov
464,459,58,136,276,52,328,0,328,5,270,53,22.04.2019 00:06,208,23,Chernigov
480,479,59,131,299,50,349,0,349,6,244,99,22.04.2019 00:25,208,23,Chernigov
640,620,58,269,320,51,371,0,371,3,271,97,22.04.2019 00:40,208,23,Chernigov
192,183,16,36,142,14,156,0,156,1,97,58,22.04.2019 00:04,208,23,Chernigov
704,692,86,200,421,83,504,0,504,13,400,91,22.04.2019 00:20,208,23,Chernigov
192,186,21,49,123,20,143,0,143,3,123,17,22.04.2019 00:20,208,23,Chernigov
464,457,29,192,245,27,272,0,272,1,232,39,21.04.2019 21:17,208,23,Chernigov
720,708,100,285,357,78,435,0,435,8,337,90,21.04.2019 22:10,208,23,Chernigov
640,630,52,285,313,42,355,0,355,9,253,93,22.04.2019 00:30,208,23,Chernigov
864,856,50,373,450,41,491,0,491,12,382,97,22.04.2019 00:08,208,23,Chernigov
1104,1072,53,430,628,46,674,0,674,8,547,119,22.04.2019 00:09,208,23,Chernigov
816,791,60,353,406,57,463,0,463,16,367,80,22.04.2019 00:09,208,23,Chernigov
656,646,104,231,336,89,425,0,425,7,326,92,22.04.2019 01:03,208,23,Chernigov
144,136,12,50,85,9,94,0,94,2,70,22,22.04.2019 00:35,208,23,Chernigov
368,359,23,152,204,12,216,0,216,3,172,41,22.04.2019 00:30,208,23,Chernigov
608,591,56,207,349,52,401,0,401,4,312,85,22.04.2019 00:30,208,23,Chernigov
240,234,30,94,117,29,146,0,146,3,112,31,22.04.2019 00:07,208,23,Chernigov
384,376,51,155,189,40,229,0,229,5,160,64,22.04.2019 00:25,208,23,Chernigov
208,195,28,77,105,26,131,0,131,3,83,45,22.04.2019 01:30,208,23,Chernigov
640,616,80,216,354,70,424,0,424,9,323,92,22.04.2019 02:01,208,23,Chernigov
1232,1206,60,564,613,55,668,0,668,6,543,119,22.04.2019 00:25,208,23,Chernigov
640,627,107,251,296,93,389,0,389,8,268,113,22.04.2019 00:15,208,23,Chernigov
928,909,88,410,452,66,518,0,518,9,428,81,22.04.2019 00:10,208,23,Chernigov
240,49,18,201,25,14,39,0,39,3,29,7,22.04.2019 00:20,208,23,Chernigov
2224,2176,65,921,1253,50,1303,0,1303,35,1007,261,22.04.2019 00:30,208,23,Chernigov
2223,2196,85,957,1201,65,1266,0,1266,20,1026,220,22.04.2019 02:00,208,23,Chernigov
384,367,37,176,173,35,208,0,208,2,151,55,22.04.2019 00:15,208,23,Chernigov
928,906,16,489,426,13,439,0,439,13,352,74,22.04.2019 00:10,208,23,Chernigov
544,533,33,198,314,32,346,0,346,3,278,65,22.04.2019 00:40,208,23,Chernigov
864,844,74,405,397,62,459,0,459,12,307,140,22.04.2019 00:15,208,23,Chernigov
944,932,57,349,545,50,595,0,595,8,474,113,22.04.2019 00:20,208,23,Chernigov
304,298,27,113,169,22,191,0,191,3,139,49,22.04.2019 00:15,208,23,Chernigov
128,125,10,61,57,10,67,0,67,1,53,13,22.04.2019 00:15,208,23,Chernigov
640,621,49,296,307,37,344,0,344,3,297,44,22.04.2019 00:15,208,23,Chernigov
80,77,9,18,53,9,62,0,62,0,48,14,22.04.2019 00:10,208,23,Chernigov
512,497,45,192,285,35,320,0,320,10,246,64,22.04.2019 00:15,208,23,Chernigov
448,432,27,219,204,25,229,0,229,4,196,29,22.04.2019 00:05,208,23,Chernigov
512,497,17,258,240,14,254,0,254,5,200,49,21.04.2019 22:35,208,23,Chernigov
224,219,27,62,138,24,162,0,162,2,116,44,22.04.2019 00:20,208,23,Chernigov
464,459,48,156,264,44,308,0,308,4,251,53,22.04.2019 00:05,208,23,Chernigov
768,770,96,259,426,83,509,0,509,13,337,159,22.04.2019 00:50,208,23,Chernigov
352,343,51,144,163,45,208,0,208,4,142,62,22.04.2019 00:12,208,23,Chernigov
240,238,9,65,167,8,175,0,175,4,137,34,22.04.2019 00:10,208,23,Chernigov
368,350,20,148,209,11,220,0,220,2,172,46,22.04.2019 00:10,208,23,Chernigov
128,121,12,48,70,10,80,0,80,0,52,28,22.04.2019 01:15,208,23,Chernigov
464,455,25,186,259,19,278,0,278,9,227,42,22.04.2019 02:22,208,23,Chernigov
48,49,6,22,23,3,26,0,26,1,17,8,22.04.2019 03:00,208,23,Chernigov
496,494,50,185,267,44,311,0,311,7,231,73,22.04.2019 00:15,208,23,Chernigov
176,163,25,75,81,20,101,0,101,3,77,21,22.04.2019 00:11,208,23,Chernigov
288,283,28,87,174,27,201,0,201,0,141,60,22.04.2019 00:20,208,23,Chernigov
320,313,31,50,245,25,270,0,270,3,216,51,22.04.2019 00:05,208,23,Chernigov
352,339,46,122,190,40,230,0,230,3,176,51,22.04.2019 01:34,208,23,Chernigov
288,273,38,107,147,34,181,0,181,1,130,50,22.04.2019 00:15,208,23,Chernigov
688,669,79,313,308,67,375,0,375,11,229,135,22.04.2019 00:40,208,23,Chernigov
848,829,69,368,424,56,480,0,480,7,373,100,22.04.2019 00:10,208,23,Chernigov
256,253,43,76,142,38,180,0,180,3,134,43,22.04.2019 01:10,208,23,Chernigov
192,36,19,161,16,15,31,0,31,0,21,10,22.04.2019 00:50,208,23,Chernigov
1376,1358,24,651,705,20,725,0,725,11,593,121,22.04.2019 01:45,208,23,Chernigov
464,447,31,200,238,26,264,0,264,9,204,51,22.04.2019 00:05,208,23,Chernigov
656,639,28,348,292,16,308,0,308,4,204,100,22.04.2019 00:20,208,23,Chernigov
288,270,28,116,145,27,172,0,172,4,126,42,22.04.2019 02:02,208,23,Chernigov
160,161,19,57,84,19,103,0,103,2,62,39,22.04.2019 00:15,208,23,Chernigov
704,684,53,293,359,52,411,0,411,9,309,93,22.04.2019 00:16,208,23,Chernigov
224,50,37,174,13,37,50,0,50,2,38,10,22.04.2019 00:55,208,23,Chernigov
2256,2214,27,910,1319,27,1346,0,1346,23,1041,282,22.04.2019 00:50,208,23,Chernigov
2192,2162,43,837,1318,37,1355,0,1355,18,1017,320,22.04.2019 01:00,208,23,Chernigov
784,772,62,303,425,56,481,0,481,10,352,119,22.04.2019 00:20,208,23,Chernigov
368,360,61,121,188,59,247,0,247,8,157,82,21.04.2019 22:02,208,23,Chernigov
640,631,55,176,414,50,464,0,464,6,365,93,22.04.2019 00:17,208,23,Chernigov
896,874,56,334,515,47,562,0,562,17,400,145,22.04.2019 00:03,208,23,Chernigov
512,497,38,280,201,31,232,0,232,4,167,61,22.04.2019 00:10,208,23,Chernigov
624,610,68,163,401,60,461,0,461,11,287,163,22.04.2019 00:10,208,23,Chernigov
736,726,78,250,411,75,486,0,486,10,356,120,22.04.2019 00:40,208,23,Chernigov
448,443,34,178,242,28,270,0,270,5,184,81,22.04.2019 00:30,208,23,Chernigov
592,622,81,171,350,71,421,0,421,4,332,85,22.04.2019 00:20,208,23,Chernigov
720,707,88,254,397,69,466,0,466,3,342,121,22.04.2019 02:50,208,23,Chernigov
368,367,37,145,192,31,223,0,223,3,170,50,22.04.2019 00:28,208,23,Chernigov
160,22,9,144,13,3,16,0,16,0,12,4,22.04.2019 00:15,208,23,Chernigov
2256,2199,42,856,1367,33,1400,0,1400,36,1112,252,22.04.2019 02:40,208,23,Chernigov
1216,1193,22,489,708,19,727,0,727,18,608,101,22.04.2019 02:47,208,23,Chernigov
864,848,42,361,465,38,503,0,503,7,384,112,22.04.2019 00:20,208,23,Chernigov
848,835,44,364,441,43,484,0,484,8,394,82,22.04.2019 00:10,208,23,Chernigov
256,241,20,99,138,19,157,0,157,3,118,36,22.04.2019 01:45,208,23,Chernigov
640,621,57,220,368,52,420,0,420,7,309,104,21.04.2019 23:45,208,23,Chernigov
544,526,41,230,283,31,314,0,314,10,228,76,22.04.2019 00:20,208,23,Chernigov
112,107,7,33,72,7,79,0,79,0,54,25,22.04.2019 00:10,208,23,Chernigov
208,197,21,65,122,21,143,0,143,2,95,46,22.04.2019 00:10,208,23,Chernigov
368,361,43,150,182,36,218,0,218,7,168,43,22.04.2019 02:40,208,23,Chernigov
128,108,7,63,60,5,65,0,65,1,50,14,22.04.2019 00:20,208,23,Chernigov
384,370,44,151,192,41,233,0,233,4,169,60,22.04.2019 00:15,208,23,Chernigov
848,844,50,323,482,43,525,0,525,11,419,95,22.04.2019 00:30,208,23,Chernigov
304,220,0,87,217,0,217,0,217,10,198,9,22.04.2019 00:54,208,23,Chernigov
288,271,39,85,170,33,203,0,203,6,159,38,22.04.2019 00:57,208,23,Chernigov
288,279,39,109,146,33,179,0,179,2,133,44,22.04.2019 00:08,208,23,Chernigov
592,575,16,259,320,13,333,0,333,4,247,82,22.04.2019 00:15,208,23,Chernigov
496,481,46,211,245,40,285,0,285,2,224,59,22.04.2019 00:01,208,23,Chernigov
240,219,16,94,131,15,146,0,146,3,100,43,21.04.2019 23:30,208,23,Chernigov
192,183,21,85,89,18,107,0,107,1,76,30,22.04.2019 00:30,208,23,Chernigov
144,141,20,41,85,18,103,0,103,1,77,25,22.04.2019 00:15,208,23,Chernigov
144,138,10,59,79,6,85,0,85,6,61,18,22.04.2019 00:10,208,23,Chernigov
80,78,18,25,39,16,55,0,55,1,23,31,22.04.2019 00:05,208,23,Chernigov
96,86,11,28,58,10,68,0,68,0,60,8,22.04.2019 00:15,208,23,Chernigov
208,191,10,57,141,10,151,0,151,1,121,29,22.04.2019 00:25,208,23,Chernigov
496,482,44,165,293,38,331,0,331,3,259,69,22.04.2019 00:30,208,23,Chernigov
128,121,25,51,58,19,77,0,77,0,55,22,22.04.2019 00:09,208,23,Chernigov
80,67,9,34,38,8,46,0,46,0,29,17,22.04.2019 00:05,208,23,Chernigov
336,320,29,163,150,23,173,0,173,1,126,46,22.04.2019 00:25,208,23,Chernigov
96,92,10,32,54,10,64,0,64,0,51,13,22.04.2019 00:58,208,23,Chernigov
352,346,19,114,224,14,238,0,238,4,188,46,22.04.2019 00:15,208,23,Chernigov
160,155,6,49,105,6,111,0,111,0,72,39,22.04.2019 00:10,208,23,Chernigov
416,408,48,101,274,41,315,0,315,3,270,42,22.04.2019 00:15,208,23,Chernigov
160,147,7,64,89,7,96,0,96,0,83,13,22.04.2019 00:10,208,23,Chernigov
192,180,25,64,106,22,128,0,128,7,94,27,22.04.2019 01:16,208,23,Chernigov
1584,1537,40,670,883,31,914,0,914,24,700,190,22.04.2019 00:20,208,23,Chernigov
672,661,32,270,373,29,402,0,402,6,307,89,22.04.2019 00:04,208,23,Chernigov
960,938,21,397,544,19,563,0,563,12,488,63,22.04.2019 01:20,208,23,Chernigov
96,22,9,74,13,9,22,0,22,0,18,4,22.04.2019 00:08,208,23,Chernigov
2208,2182,26,767,1420,21,1441,0,1441,34,1138,269,21.04.2019 21:15,209,23,Chernigov
2128,2069,15,814,1302,12,1314,0,1314,39,981,294,21.04.2019 22:10,209,23,Chernigov
384,377,39,120,229,35,264,0,264,4,184,76,22.04.2019 00:20,209,23,Chernigov
192,190,22,49,123,20,143,0,143,1,102,40,22.04.2019 00:15,209,23,Chernigov
160,157,13,28,120,12,132,0,132,6,86,40,21.04.2019 21:35,209,23,Chernigov
672,670,67,174,434,64,498,0,498,5,432,61,22.04.2019 02:30,209,23,Chernigov
240,228,24,85,131,24,155,0,155,5,117,33,22.04.2019 00:40,209,23,Chernigov
2176,2124,109,870,1223,83,1306,0,1306,25,1065,216,21.04.2019 21:56,209,23,Chernigov
96,97,11,24,61,11,72,0,72,1,48,23,22.04.2019 00:05,209,23,Chernigov
272,267,22,96,155,21,176,0,176,3,139,34,22.04.2019 00:20,209,23,Chernigov
240,236,24,100,116,24,140,0,140,2,91,47,21.04.2019 21:20,209,23,Chernigov
288,273,25,97,166,25,191,0,191,1,162,28,21.04.2019 21:10,209,23,Chernigov
128,116,10,45,74,9,83,0,83,3,62,18,22.04.2019 06:20,209,23,Chernigov
896,886,102,313,484,99,583,0,583,6,497,80,22.04.2019 01:35,209,23,Chernigov
416,406,25,149,245,22,267,0,267,1,223,43,21.04.2019 22:15,209,23,Chernigov
384,365,22,143,223,18,241,0,241,5,178,58,21.04.2019 22:10,209,23,Chernigov
112,29,12,87,15,10,25,0,25,0,20,5,22.04.2019 00:05,209,23,Chernigov
800,766,3,353,444,3,447,0,447,9,376,62,22.04.2019 00:31,209,23,Chernigov
96,87,14,38,47,11,58,0,58,1,48,9,22.04.2019 00:05,209,23,Chernigov
288,280,33,106,155,27,182,0,182,5,112,65,22.04.2019 01:20,209,23,Chernigov
112,108,21,34,61,17,78,0,78,2,46,30,22.04.2019 00:05,209,23,Chernigov
448,432,47,166,244,38,282,0,282,4,209,69,22.04.2019 00:15,209,23,Chernigov
240,231,23,132,88,20,108,0,108,0,78,30,22.04.2019 03:46,209,23,Chernigov
496,486,31,248,228,20,248,0,248,7,169,72,22.04.2019 00:00,209,23,Chernigov
592,590,26,236,333,23,356,0,356,6,313,37,22.04.2019 00:05,209,23,Chernigov
224,213,19,88,120,16,136,0,136,2,107,27,22.04.2019 00:13,209,23,Chernigov
624,617,46,276,310,38,348,0,348,7,256,85,22.04.2019 01:00,209,23,Chernigov
384,389,26,159,202,23,225,0,225,9,154,62,22.04.2019 00:50,209,23,Chernigov
720,697,34,373,315,32,347,0,347,5,249,93,22.04.2019 00:15,209,23,Chernigov
624,620,34,287,305,32,337,0,337,8,271,58,22.04.2019 00:00,209,23,Chernigov
432,424,43,178,218,36,254,0,254,4,170,80,22.04.2019 00:05,209,23,Chernigov
96,89,22,26,48,22,70,0,70,3,42,25,22.04.2019 00:30,209,23,Chernigov
96,81,13,32,54,10,64,0,64,0,56,8,22.04.2019 00:10,209,23,Chernigov
592,579,90,290,221,81,302,0,302,1,215,86,22.04.2019 00:05,209,23,Chernigov
432,425,44,159,232,41,273,0,273,3,175,95,21.04.2019 20:40,209,23,Chernigov
352,346,36,122,202,28,230,0,230,2,159,69,22.04.2019 00:30,209,23,Chernigov
176,168,24,50,104,22,126,0,126,0,100,26,22.04.2019 00:55,209,23,Chernigov
320,306,36,175,112,33,145,0,145,3,99,43,21.04.2019 20:55,209,23,Chernigov
128,128,13,33,85,10,95,0,95,1,54,40,22.04.2019 00:50,209,23,Chernigov
320,313,49,146,133,41,174,0,174,1,120,53,21.04.2019 21:15,209,23,Chernigov
128,116,4,68,56,4,60,0,60,1,36,23,21.04.2019 20:20,209,23,Chernigov
1648,1627,22,598,1028,22,1050,0,1050,18,873,159,22.04.2019 01:35,209,23,Chernigov
1536,1513,40,684,814,38,852,0,852,12,716,124,22.04.2019 00:35,209,23,Chernigov
1040,1011,68,534,453,53,506,0,506,13,396,97,22.04.2019 00:01,209,23,Chernigov
160,158,16,44,100,16,116,0,116,2,75,39,22.04.2019 00:05,209,23,Chernigov
112,107,11,29,72,11,83,0,83,6,54,23,21.04.2019 22:20,209,23,Chernigov
256,243,15,85,157,14,171,0,171,7,129,35,22.04.2019 00:04,209,23,Chernigov
512,515,30,108,374,30,404,0,404,5,281,118,22.04.2019 00:10,209,23,Chernigov
416,408,41,86,295,35,330,0,330,4,229,97,22.04.2019 00:10,209,23,Chernigov
1056,1032,38,479,545,32,577,0,577,11,474,92,22.04.2019 00:02,209,23,Chernigov
864,849,23,361,482,21,503,0,503,7,376,120,21.04.2019 22:35,209,23,Chernigov
864,843,27,405,435,24,459,0,459,5,408,46,22.04.2019 01:10,209,23,Chernigov
352,334,47,129,179,44,223,0,223,1,169,53,22.04.2019 00:05,209,23,Chernigov
240,231,7,90,143,7,150,0,150,1,116,33,22.04.2019 00:25,209,23,Chernigov
208,192,28,86,95,27,122,0,122,0,73,49,22.04.2019 00:10,209,23,Chernigov
288,286,28,50,211,27,238,0,238,1,189,48,22.04.2019 00:05,209,23,Chernigov
480,468,52,122,307,51,358,0,358,2,263,93,22.04.2019 00:20,209,23,Chernigov
544,532,62,223,262,59,321,0,321,3,262,56,22.04.2019 00:05,209,23,Chernigov
992,978,12,424,556,12,568,0,568,17,462,89,21.04.2019 23:00,209,23,Chernigov
480,469,5,193,282,5,287,0,287,4,241,42,22.04.2019 00:01,209,23,Chernigov
544,538,59,206,282,56,338,0,338,6,247,85,22.04.2019 00:15,209,23,Chernigov
256,246,3,80,173,3,176,0,176,2,121,53,22.04.2019 00:15,209,23,Chernigov
192,191,18,54,120,18,138,0,138,2,99,37,21.04.2019 22:05,209,23,Chernigov
320,321,25,121,175,24,199,0,199,4,132,63,21.04.2019 21:00,209,23,Chernigov
224,222,16,108,101,15,116,0,116,3,83,30,22.04.2019 00:05,209,23,Chernigov
944,922,68,345,536,63,599,0,599,15,420,164,22.04.2019 01:08,209,23,Chernigov
576,559,40,261,280,35,315,0,315,3,242,70,22.04.2019 00:45,209,23,Chernigov
528,515,14,240,278,10,288,0,288,6,234,48,22.04.2019 00:02,209,23,Chernigov
672,660,5,276,391,5,396,0,396,12,309,75,22.04.2019 00:20,209,23,Chernigov
304,285,23,109,173,22,195,0,195,2,167,26,22.04.2019 00:20,209,23,Chernigov
352,338,49,152,152,48,200,0,200,4,152,44,22.04.2019 00:01,209,23,Chernigov
560,543,53,263,248,49,297,0,297,7,213,77,22.04.2019 00:37,209,23,Chernigov
432,425,6,214,212,6,218,0,218,3,165,50,22.04.2019 00:15,209,23,Chernigov
256,247,26,95,135,26,161,0,161,2,116,43,22.04.2019 00:30,209,23,Chernigov
464,457,65,175,224,65,289,0,289,5,214,70,22.04.2019 00:35,209,23,Chernigov
448,433,31,195,222,31,253,0,253,3,204,46,22.04.2019 00:10,209,23,Chernigov
192,181,20,43,129,20,149,0,149,3,83,63,22.04.2019 02:00,209,23,Chernigov
416,411,42,109,265,42,307,0,307,4,159,144,21.04.2019 21:15,209,23,Chernigov
976,957,47,435,498,43,541,0,541,13,409,119,22.04.2019 00:20,209,23,Chernigov
720,700,60,317,345,58,403,0,403,10,301,92,22.04.2019 00:10,209,23,Chernigov
256,240,4,120,133,3,136,0,136,2,110,24,22.04.2019 00:04,209,23,Chernigov
208,192,24,95,90,23,113,0,113,1,83,29,21.04.2019 22:00,209,23,Chernigov
512,496,29,254,235,23,258,0,258,7,188,63,22.04.2019 03:45,209,23,Chernigov
448,428,51,161,236,51,287,0,287,3,233,51,22.04.2019 00:15,209,23,Chernigov
240,239,29,70,142,28,170,0,170,1,137,32,22.04.2019 00:15,209,23,Chernigov
224,26,21,201,5,18,23,0,23,1,16,6,22.04.2019 00:02,209,23,Chernigov
2224,2192,46,1024,1167,33,1200,0,1200,31,910,259,22.04.2019 00:15,209,23,Chernigov
2144,2125,25,938,1187,19,1206,0,1206,28,854,324,22.04.2019 00:35,209,23,Chernigov
2352,2333,43,1255,1072,25,1097,0,1097,34,826,237,22.04.2019 00:05,209,23,Chernigov
2112,2090,34,1053,1033,26,1059,0,1059,24,869,166,22.04.2019 01:31,209,23,Chernigov
1888,1869,18,1041,834,13,847,0,847,20,683,144,22.04.2019 00:02,209,23,Chernigov
208,205,47,64,102,42,144,0,144,1,113,30,22.04.2019 02:15,209,23,Chernigov
352,340,30,138,184,30,214,0,214,3,149,62,22.04.2019 00:45,209,23,Chernigov
256,269,41,68,148,40,188,0,188,3,112,73,22.04.2019 04:30,209,23,Chernigov
304,311,32,85,192,27,219,0,219,3,158,58,22.04.2019 00:20,209,23,Chernigov
417,411,42,69,309,39,348,0,348,3,267,78,22.04.2019 00:40,209,23,Chernigov
416,414,52,172,201,43,244,0,244,5,162,77,22.04.2019 00:10,209,23,Chernigov
608,599,77,184,351,73,424,0,424,10,284,130,21.04.2019 20:50,209,23,Chernigov
656,650,121,183,362,111,473,0,473,9,252,212,21.04.2019 21:45,209,23,Chernigov
256,249,39,72,148,36,184,0,184,4,121,59,21.04.2019 23:55,209,23,Chernigov
1536,1506,67,635,841,60,901,0,901,22,687,192,22.04.2019 05:56,209,23,Chernigov
624,618,69,193,367,64,431,0,431,12,313,106,22.04.2019 00:10,209,23,Chernigov
480,481,70,127,290,63,353,0,353,2,235,116,22.04.2019 00:50,209,23,Chernigov
512,507,78,197,242,73,315,0,315,4,203,108,22.04.2019 00:40,209,23,Chernigov
144,149,33,31,85,28,113,0,113,4,90,19,22.04.2019 00:10,209,23,Chernigov
592,591,92,162,341,89,430,0,430,17,318,95,22.04.2019 00:35,209,23,Chernigov
80,72,8,30,42,8,50,0,50,3,37,10,22.04.2019 00:25,209,23,Chernigov
288,276,28,112,151,25,176,0,176,2,130,44,21.04.2019 21:55,209,23,Chernigov
208,193,21,79,110,19,129,0,129,0,98,31,22.04.2019 00:30,209,23,Chernigov
496,490,51,142,306,48,354,0,354,5,188,161,22.04.2019 00:10,209,23,Chernigov
1872,1840,42,931,904,37,941,0,941,25,770,146,22.04.2019 00:30,209,23,Chernigov
784,769,15,419,350,15,365,0,365,6,289,70,22.04.2019 00:10,209,23,Chernigov
560,540,12,271,280,9,289,0,289,12,227,50,22.04.2019 00:05,209,23,Chernigov
768,754,19,437,318,13,331,0,331,7,252,72,22.04.2019 00:01,209,23,Chernigov
176,64,13,127,39,10,49,0,49,0,41,8,21.04.2019 22:45,209,23,Chernigov
1536,1500,39,700,801,35,836,0,836,22,644,170,22.04.2019 00:05,209,23,Chernigov
1248,1230,28,516,707,25,732,0,732,22,590,120,22.04.2019 00:10,209,23,Chernigov
112,108,12,34,66,12,78,0,78,2,58,18,21.04.2019 20:50,209,23,Chernigov
48,50,0,16,32,0,32,0,32,0,20,12,21.04.2019 21:10,209,23,Chernigov
320,310,28,135,160,25,185,0,185,6,147,32,21.04.2019 22:20,209,23,Chernigov
720,711,28,238,457,25,482,0,482,10,391,81,22.04.2019 00:15,209,23,Chernigov
160,146,16,63,84,13,97,0,97,5,73,19,21.04.2019 22:30,209,23,Chernigov
384,375,32,143,211,30,241,0,241,0,212,29,22.04.2019 00:30,209,23,Chernigov
336,326,15,116,209,11,220,0,220,3,180,37,22.04.2019 00:15,209,23,Chernigov
544,534,53,200,291,53,344,0,344,10,237,97,21.04.2019 23:10,209,23,Chernigov
304,297,32,100,173,31,204,0,204,7,163,34,22.04.2019 00:10,209,23,Chernigov
208,193,14,58,136,14,150,0,150,1,104,45,22.04.2019 00:08,209,23,Chernigov
336,325,33,92,211,33,244,0,244,4,169,71,21.04.2019 20:41,209,23,Chernigov
96,97,19,14,67,15,82,0,82,1,63,18,22.04.2019 01:00,209,23,Chernigov
256,254,10,106,142,8,150,0,150,2,127,21,22.04.2019 00:30,209,23,Chernigov
320,308,23,94,204,22,226,0,226,2,191,33,21.04.2019 21:00,209,23,Chernigov
48,45,13,14,23,11,34,0,34,1,25,8,21.04.2019 21:00,209,23,Chernigov
288,277,28,109,157,22,179,0,179,5,145,29,21.04.2019 20:45,209,23,Chernigov
224,209,14,81,131,12,143,0,143,2,99,42,22.04.2019 00:10,209,23,Chernigov
240,242,9,75,156,9,165,0,165,2,128,35,21.04.2019 20:40,209,23,Chernigov
304,288,21,94,190,20,210,0,210,3,168,39,21.04.2019 20:43,209,23,Chernigov
80,21,0,60,20,0,20,0,20,0,16,4,22.04.2019 00:10,209,23,Chernigov
2288,2263,14,973,1305,10,1315,0,1315,25,1018,272,22.04.2019 00:50,209,23,Chernigov
2224,2195,22,901,1305,18,1323,0,1323,42,1020,261,22.04.2019 00:10,209,23,Chernigov
2368,2344,25,949,1400,19,1419,0,1419,33,1156,230,22.04.2019 00:15,209,23,Chernigov
2288,2254,12,803,1474,11,1485,0,1485,46,1122,317,22.04.2019 00:10,209,23,Chernigov
2240,2212,23,960,1263,17,1280,0,1280,40,1014,226,21.04.2019 21:37,209,23,Chernigov
2160,2136,10,881,1274,5,1279,0,1279,30,1040,209,22.04.2019 00:20,209,23,Chernigov
2128,2101,13,823,1296,9,1305,0,1305,43,993,269,22.04.2019 00:17,209,23,Chernigov
2272,2256,17,850,1409,13,1422,0,1422,43,1090,289,22.04.2019 00:23,209,23,Chernigov
2368,2340,11,1006,1358,4,1362,0,1362,35,1091,236,22.04.2019 00:01,209,23,Chernigov
1696,1666,7,764,925,7,932,0,932,25,764,143,22.04.2019 00:05,209,23,Chernigov
2176,2148,12,906,1259,11,1270,0,1270,26,1001,243,22.04.2019 00:07,209,23,Chernigov
2368,2342,26,958,1390,20,1410,0,1410,37,1123,250,21.04.2019 23:10,209,23,Chernigov
2400,2353,21,1005,1377,18,1395,0,1395,33,1102,260,22.04.2019 00:28,209,23,Chernigov
2384,2344,29,950,1414,20,1434,0,1434,43,1101,290,22.04.2019 00:07,209,23,Chernigov
2368,2343,13,907,1452,9,1461,0,1461,50,1161,250,22.04.2019 00:02,209,23,Chernigov
1856,1832,18,757,1084,15,1099,0,1099,18,897,184,22.04.2019 00:45,209,23,Chernigov
1632,1590,11,699,923,10,933,0,933,32,682,219,22.04.2019 00:44,209,23,Chernigov
1952,1914,18,858,1079,15,1094,0,1094,13,897,184,22.04.2019 00:05,209,23,Chernigov
2240,2214,16,976,1253,11,1264,0,1264,25,1033,206,22.04.2019 00:22,209,23,Chernigov
2384,2367,25,973,1393,18,1411,0,1411,38,1111,262,22.04.2019 00:10,209,23,Chernigov
2368,2339,18,996,1356,16,1372,0,1372,46,1109,217,22.04.2019 00:05,209,23,Chernigov
480,37,25,450,12,18,30,0,30,0,25,5,22.04.2019 00:03,209,23,Chernigov
2240,2237,29,906,1311,23,1334,0,1334,42,980,312,22.04.2019 02:10,210,23,Chernigov
1328,1306,8,568,755,5,760,0,760,18,575,167,22.04.2019 01:55,210,23,Chernigov
1920,1900,7,844,1069,7,1076,0,1076,28,842,206,22.04.2019 00:35,210,23,Chernigov
1344,1323,29,623,696,25,721,0,721,16,574,131,22.04.2019 00:15,210,23,Chernigov
1792,1782,17,788,989,15,1004,0,1004,7,829,168,22.04.2019 00:20,210,23,Chernigov
464,454,32,152,280,32,312,0,312,5,226,81,22.04.2019 01:35,210,23,Chernigov
224,218,0,100,124,0,124,0,124,2,104,18,22.04.2019 00:53,210,23,Chernigov
496,486,10,116,370,10,380,0,380,7,324,49,22.04.2019 00:05,210,23,Chernigov
240,235,40,61,143,36,179,0,179,2,153,24,22.04.2019 01:30,210,23,Chernigov
592,592,88,219,289,84,373,0,373,6,289,78,21.04.2019 21:20,210,23,Chernigov
208,205,16,58,136,14,150,0,150,1,104,45,21.04.2019 21:40,210,23,Chernigov
336,324,43,128,168,40,208,0,208,0,111,97,22.04.2019 00:20,210,23,Chernigov
592,590,90,175,332,85,417,0,417,2,312,103,21.04.2019 22:10,210,23,Chernigov
96,95,28,37,33,26,59,0,59,2,36,21,21.04.2019 20:45,210,23,Chernigov
256,252,52,57,149,50,199,0,199,1,174,24,22.04.2019 03:00,210,23,Chernigov
1440,1432,91,614,741,85,826,0,826,19,704,103,22.04.2019 04:30,210,23,Chernigov
592,580,47,265,281,46,327,0,327,8,240,79,22.04.2019 01:15,210,23,Chernigov
704,700,53,329,329,46,375,0,375,7,309,59,22.04.2019 01:20,210,23,Chernigov
544,537,76,94,374,76,450,0,450,6,365,79,22.04.2019 00:25,210,23,Chernigov
944,941,53,422,479,43,522,0,522,10,392,120,22.04.2019 01:30,210,23,Chernigov
1136,1119,45,512,584,40,624,0,624,15,456,153,22.04.2019 00:15,210,23,Chernigov
896,881,23,425,452,19,471,0,471,5,361,105,22.04.2019 00:05,210,23,Chernigov
1280,1268,56,511,719,50,769,0,769,15,576,178,22.04.2019 00:20,210,23,Chernigov
464,453,35,154,275,35,310,0,310,1,242,67,22.04.2019 00:50,210,23,Chernigov
512,506,38,152,324,36,360,0,360,4,295,61,22.04.2019 02:10,210,23,Chernigov
400,388,68,135,200,65,265,0,265,6,194,65,22.04.2019 02:55,210,23,Chernigov
176,166,8,35,133,8,141,0,141,0,114,27,22.04.2019 00:07,210,23,Chernigov
160,156,8,40,112,8,120,0,120,0,103,17,22.04.2019 00:03,210,23,Chernigov
576,564,31,139,407,30,437,0,437,5,360,72,22.04.2019 00:15,210,23,Chernigov
416,407,43,115,259,42,301,0,301,9,210,82,21.04.2019 22:00,210,23,Chernigov
800,788,57,316,434,50,484,0,484,7,391,86,22.04.2019 01:30,210,23,Chernigov
304,302,52,93,164,47,211,0,211,0,161,50,21.04.2019 22:05,210,23,Chernigov
224,215,6,90,131,3,134,0,134,0,105,29,22.04.2019 00:45,210,23,Chernigov
96,94,19,16,67,13,80,0,80,0,59,21,22.04.2019 00:25,210,23,Chernigov
544,532,64,217,267,60,327,0,327,9,253,65,22.04.2019 00:15,210,23,Chernigov
176,170,15,68,97,11,108,0,108,2,86,20,22.04.2019 01:15,210,23,Chernigov
368,380,25,118,225,25,250,0,250,4,186,60,22.04.2019 00:15,210,23,Chernigov
560,568,52,229,283,48,331,0,331,11,251,69,21.04.2019 22:00,210,23,Chernigov
224,18,5,206,13,5,18,0,18,0,12,6,22.04.2019 00:30,210,23,Chernigov
1008,996,74,212,723,73,796,0,796,15,608,173,22.04.2019 04:23,210,23,Chernigov
192,186,11,58,125,9,134,0,134,0,111,23,22.04.2019 00:21,210,23,Chernigov
192,191,114,9,69,114,183,0,183,2,57,124,22.04.2019 06:00,210,23,Chernigov
432,434,19,85,329,18,347,0,347,17,244,86,22.04.2019 00:25,210,23,Chernigov
144,132,4,67,74,3,77,0,77,1,61,15,22.04.2019 01:17,210,23,Chernigov
192,188,30,54,110,28,138,0,138,3,103,32,22.04.2019 01:20,210,23,Chernigov
48,41,6,18,25,5,30,0,30,0,22,8,22.04.2019 00:20,210,23,Chernigov
352,356,28,161,164,27,191,0,191,5,137,49,21.04.2019 20:51,210,23,Chernigov
384,371,17,158,212,14,226,0,226,3,187,36,22.04.2019 01:30,210,23,Chernigov
272,258,22,85,170,17,187,0,187,3,112,72,22.04.2019 01:00,210,23,Chernigov
368,357,40,111,222,35,257,0,257,2,209,46,21.04.2019 21:30,210,23,Chernigov
160,149,21,63,78,19,97,0,97,1,78,18,22.04.2019 00:30,210,23,Chernigov
288,288,19,72,197,19,216,0,216,1,162,53,22.04.2019 01:30,210,23,Chernigov
400,408,46,145,211,44,255,0,255,5,150,100,22.04.2019 00:05,210,23,Chernigov
592,589,34,265,296,31,327,0,327,2,274,51,22.04.2019 00:40,210,23,Chernigov
416,417,65,120,231,65,296,0,296,3,213,80,22.04.2019 02:08,210,23,Chernigov
560,549,52,183,327,50,377,0,377,6,267,104,22.04.2019 01:20,210,23,Chernigov
256,246,19,107,134,15,149,0,149,5,87,57,22.04.2019 01:20,210,23,Chernigov
64,64,13,13,39,12,51,0,51,0,31,20,22.04.2019 00:10,210,23,Chernigov
320,315,18,92,211,17,228,0,228,2,172,54,22.04.2019 00:15,210,23,Chernigov
368,373,61,124,190,54,244,0,244,8,182,54,22.04.2019 00:45,210,23,Chernigov
176,169,15,60,103,13,116,0,116,2,87,27,22.04.2019 00:11,210,23,Chernigov
608,590,17,242,352,14,366,0,366,4,293,69,22.04.2019 00:35,210,23,Chernigov
64,60,18,15,33,16,49,0,49,1,40,8,22.04.2019 01:30,210,23,Chernigov
80,80,16,17,54,9,63,0,63,1,44,18,22.04.2019 01:30,210,23,Chernigov
160,147,28,47,86,27,113,0,113,3,82,28,22.04.2019 00:30,210,23,Chernigov
208,193,3,61,144,3,147,0,147,0,134,13,22.04.2019 01:50,210,23,Chernigov
464,460,17,159,292,13,305,0,305,6,228,71,22.04.2019 00:10,210,23,Chernigov
144,139,9,46,90,8,98,0,98,1,74,23,22.04.2019 00:22,210,23,Chernigov
224,217,15,61,150,13,163,0,163,3,116,44,21.04.2019 22:00,210,23,Chernigov
192,190,11,71,111,10,121,0,121,2,88,31,22.04.2019 00:55,210,23,Chernigov
192,181,23,88,85,19,104,0,104,0,90,14,22.04.2019 00:10,210,23,Chernigov
144,140,8,43,94,7,101,0,101,3,79,19,22.04.2019 00:40,210,23,Chernigov
176,169,25,74,82,20,102,0,102,1,87,14,22.04.2019 00:25,210,23,Chernigov
128,120,15,51,62,15,77,0,77,1,43,33,21.04.2019 23:40,210,23,Chernigov
320,312,8,106,212,2,214,0,214,2,162,50,22.04.2019 00:37,210,23,Chernigov
464,459,20,233,216,15,231,0,231,9,179,43,22.04.2019 00:30,210,23,Chernigov
240,235,15,100,128,12,140,0,140,2,90,48,21.04.2019 23:50,210,23,Chernigov
496,490,14,186,298,12,310,0,310,6,224,80,22.04.2019 00:50,210,23,Chernigov
80,65,14,36,32,12,44,0,44,0,33,11,22.04.2019 00:23,210,23,Chernigov
336,322,39,125,175,36,211,0,211,1,149,61,22.04.2019 00:30,210,23,Chernigov
432,441,53,115,269,48,317,0,317,3,246,68,22.04.2019 01:55,210,23,Chernigov
96,90,17,23,56,17,73,0,73,0,50,23,22.04.2019 00:03,210,23,Chernigov
592,576,45,240,314,38,352,0,352,15,223,114,22.04.2019 02:00,210,23,Chernigov
96,81,7,35,57,4,61,0,61,1,39,21,22.04.2019 00:55,210,23,Chernigov
1168,1153,66,490,624,54,678,0,678,18,467,193,22.04.2019 01:00,210,23,Chernigov
2160,2085,14,875,1275,10,1285,0,1285,34,863,388,22.04.2019 01:55,210,23,Chernigov
912,892,9,155,751,6,757,0,757,16,567,174,22.04.2019 00:10,210,23,Chernigov
1504,1478,3,624,878,2,880,0,880,19,601,260,22.04.2019 00:20,210,23,Chernigov
1344,1329,22,534,792,18,810,0,810,11,576,223,22.04.2019 00:25,210,23,Chernigov
1824,1806,9,698,1119,7,1126,0,1126,33,860,233,21.04.2019 22:43,210,23,Chernigov
832,817,5,344,484,4,488,0,488,6,358,124,22.04.2019 00:20,210,23,Chernigov
1600,1597,18,589,996,15,1011,0,1011,24,767,220,22.04.2019 00:30,210,23,Chernigov
928,933,8,356,568,4,572,0,572,14,424,134,22.04.2019 00:30,210,23,Chernigov
1920,1911,13,950,961,9,970,0,970,15,802,153,22.04.2019 02:35,210,23,Chernigov
352,345,4,170,179,3,182,0,182,0,144,38,22.04.2019 05:40,210,23,Chernigov
112,110,5,47,60,5,65,0,65,1,52,12,22.04.2019 05:30,210,23,Chernigov
208,15,5,201,4,3,7,0,7,0,7,0,22.04.2019 00:15,210,23,Chernigov
80,5,0,76,4,0,4,0,4,0,2,2,22.04.2019 00:15,210,23,Chernigov
704,692,64,264,377,63,440,0,440,10,299,131,21.04.2019 20:55,210,23,Chernigov
320,324,34,106,185,29,214,0,214,2,163,49,22.04.2019 00:15,210,23,Chernigov
496,480,45,220,238,38,276,0,276,4,214,58,22.04.2019 00:12,210,23,Chernigov
144,128,16,74,57,13,70,0,70,0,55,15,22.04.2019 00:04,210,23,Chernigov
304,308,41,91,174,39,213,0,213,3,174,36,22.04.2019 00:01,210,23,Chernigov
480,454,24,172,290,18,308,0,308,6,246,56,22.04.2019 00:25,210,23,Chernigov
48,47,7,19,23,6,29,0,29,0,19,10,22.04.2019 00:05,210,23,Chernigov
320,321,39,103,178,39,217,0,217,4,179,34,22.04.2019 00:35,210,23,Chernigov
352,347,67,133,166,53,219,0,219,6,171,42,22.04.2019 00:47,210,23,Chernigov
1760,1741,46,680,1045,35,1080,0,1080,23,936,121,22.04.2019 01:33,210,23,Chernigov
608,591,53,257,302,49,351,0,351,8,273,70,21.04.2019 21:25,210,23,Chernigov
912,903,93,285,539,88,627,0,627,11,484,132,22.04.2019 00:15,210,23,Chernigov
176,168,18,74,88,14,102,0,102,0,87,15,21.04.2019 22:17,210,23,Chernigov
784,763,60,263,467,54,521,0,521,5,429,87,22.04.2019 00:15,210,23,Chernigov
64,64,14,13,38,13,51,0,51,0,31,20,22.04.2019 00:15,210,23,Chernigov
128,122,8,37,83,8,91,0,91,4,71,16,22.04.2019 00:45,210,23,Chernigov
304,296,30,98,176,30,206,0,206,0,155,51,21.04.2019 21:00,210,23,Chernigov
816,804,41,289,492,35,527,0,527,8,456,63,22.04.2019 00:10,210,23,Chernigov
704,689,45,282,383,39,422,0,422,11,337,74,22.04.2019 00:20,210,23,Chernigov
368,365,55,172,155,41,196,0,196,3,142,51,22.04.2019 00:07,210,23,Chernigov
288,282,41,121,133,34,167,0,167,2,123,42,22.04.2019 00:10,210,23,Chernigov
208,204,9,88,111,9,120,0,120,3,90,27,22.04.2019 00:05,210,23,Chernigov
416,409,35,143,239,34,273,0,273,3,224,46,21.04.2019 22:50,210,23,Chernigov
128,114,13,37,78,13,91,0,91,2,72,17,22.04.2019 00:40,210,23,Chernigov
112,100,16,43,54,15,69,0,69,1,50,18,21.04.2019 21:00,210,23,Chernigov
1072,1060,22,438,612,22,634,0,634,5,537,92,22.04.2019 01:40,210,23,Chernigov
1168,1150,24,428,717,23,740,0,740,21,601,118,22.04.2019 01:35,210,23,Chernigov
1216,1191,26,626,564,26,590,0,590,16,498,76,22.04.2019 00:50,210,23,Chernigov
480,469,32,176,272,32,304,0,304,4,255,45,22.04.2019 00:15,210,23,Chernigov
1040,1017,47,411,585,44,629,0,629,13,525,91,22.04.2019 00:30,210,23,Chernigov
1024,1009,41,406,583,35,618,0,618,7,542,69,22.04.2019 00:15,210,23,Chernigov
448,435,32,221,196,31,227,0,227,6,178,43,22.04.2019 00:15,210,23,Chernigov
192,191,18,57,120,15,135,0,135,1,98,36,22.04.2019 00:10,210,23,Chernigov
560,555,44,253,268,39,307,0,307,4,252,51,22.04.2019 00:30,210,23,Chernigov
1024,1021,87,367,573,84,657,0,657,11,543,103,22.04.2019 02:15,210,23,Chernigov
544,532,57,178,314,52,366,0,366,6,280,80,22.04.2019 00:23,210,23,Chernigov
48,40,9,16,23,9,32,0,32,0,24,8,22.04.2019 00:55,210,23,Chernigov
176,169,39,85,58,33,91,0,91,1,75,15,22.04.2019 00:15,210,23,Chernigov
208,200,13,78,120,10,130,0,130,1,96,33,21.04.2019 20:50,210,23,Chernigov
400,394,23,163,217,20,237,0,237,4,186,47,22.04.2019 00:20,210,23,Chernigov
96,85,13,49,34,13,47,0,47,1,32,14,22.04.2019 00:20,210,23,Chernigov
480,464,40,110,330,40,370,0,370,13,288,69,22.04.2019 00:05,210,23,Chernigov
432,414,71,139,227,66,293,0,293,2,244,47,22.04.2019 00:40,210,23,Chernigov
224,218,23,89,112,23,135,0,135,1,105,29,21.04.2019 23:55,210,23,Chernigov
112,105,22,54,41,17,58,0,58,0,35,23,22.04.2019 00:05,210,23,Chernigov
352,347,44,136,181,35,216,0,216,5,160,51,21.04.2019 22:00,210,23,Chernigov
480,471,75,210,206,64,270,0,270,6,209,55,21.04.2019 21:45,210,23,Chernigov
432,419,54,199,190,43,233,0,233,7,166,60,22.04.2019 00:05,210,23,Chernigov
384,373,37,175,177,32,209,0,209,4,154,51,22.04.2019 01:30,210,23,Chernigov
96,93,5,37,54,5,59,0,59,1,45,13,22.04.2019 00:05,210,23,Chernigov
240,237,28,64,149,27,176,0,176,4,122,50,22.04.2019 00:30,210,23,Chernigov
64,64,2,29,33,2,35,0,35,0,21,14,22.04.2019 00:10,210,23,Chernigov
1344,1333,39,495,810,39,849,0,849,14,677,158,22.04.2019 00:10,210,23,Chernigov
144,129,9,77,59,8,67,0,67,0,49,18,22.04.2019 00:05,210,23,Chernigov
560,558,35,242,286,32,318,0,318,9,227,82,22.04.2019 00:05,210,23,Chernigov
368,366,24,164,180,24,204,0,204,3,170,31,21.04.2019 21:10,210,23,Chernigov
160,159,8,69,83,8,91,0,91,0,71,20,21.04.2019 21:30,210,23,Chernigov
1744,1714,24,664,1059,21,1080,0,1080,28,863,189,22.04.2019 01:15,210,23,Chernigov
1712,1686,17,621,1079,12,1091,0,1091,29,874,188,22.04.2019 00:30,210,23,Chernigov
2000,1975,38,743,1225,32,1257,0,1257,23,1011,223,22.04.2019 00:10,210,23,Chernigov
1184,1165,21,448,720,16,736,0,736,23,580,133,22.04.2019 00:29,210,23,Chernigov
1232,1212,11,460,764,8,772,0,772,10,620,142,22.04.2019 00:20,210,23,Chernigov
1152,1128,17,432,708,12,720,0,720,21,561,138,22.04.2019 01:20,210,23,Chernigov
1616,1613,23,558,1039,19,1058,0,1058,26,809,223,21.04.2019 22:36,210,23,Chernigov
1152,1129,18,397,741,14,755,0,755,13,609,133,22.04.2019 01:10,210,23,Chernigov
1376,1355,21,503,858,15,873,0,873,25,692,156,22.04.2019 00:25,210,23,Chernigov
1328,1299,32,537,769,22,791,0,791,17,588,186,22.04.2019 01:50,210,23,Chernigov
1632,1591,29,636,970,26,996,0,996,29,795,172,22.04.2019 00:30,210,23,Chernigov
1952,1923,28,671,1262,19,1281,0,1281,27,1008,246,22.04.2019 00:30,210,23,Chernigov
1872,1836,36,694,1151,27,1178,0,1178,28,925,225,22.04.2019 00:17,210,23,Chernigov
1856,1833,30,682,1156,18,1174,0,1174,29,906,239,22.04.2019 00:15,210,23,Chernigov
1232,1210,26,497,715,20,735,0,735,14,583,138,22.04.2019 00:05,210,23,Chernigov
1552,1527,13,608,932,12,944,0,944,12,795,137,22.04.2019 00:05,210,23,Chernigov
1824,1788,23,612,1194,18,1212,0,1212,25,956,231,22.04.2019 00:10,210,23,Chernigov
1840,1837,25,619,1204,17,1221,0,1221,36,946,239,21.04.2019 21:29,210,23,Chernigov
1408,1386,8,468,933,7,940,0,940,26,786,128,22.04.2019 00:30,210,23,Chernigov
2032,2005,37,749,1252,31,1283,0,1283,36,1001,246,22.04.2019 00:25,210,23,Chernigov
1280,1262,21,473,793,14,807,0,807,25,643,139,22.04.2019 00:35,210,23,Chernigov
1536,1518,36,554,949,33,982,0,982,20,807,155,22.04.2019 00:01,210,23,Chernigov
1856,1828,46,688,1128,40,1168,0,1168,30,948,190,21.04.2019 21:32,210,23,Chernigov
1360,1324,25,595,743,22,765,0,765,14,627,124,22.04.2019 00:15,210,23,Chernigov
1968,1965,26,740,1209,19,1228,0,1227,23,1016,188,22.04.2019 04:45,210,23,Chernigov
1120,1099,10,369,742,9,751,0,751,19,601,131,22.04.2019 00:10,210,23,Chernigov
1760,1736,16,639,1112,9,1121,0,1121,34,902,185,22.04.2019 04:00,210,23,Chernigov
1936,1907,22,695,1222,19,1241,0,1241,35,1014,192,22.04.2019 00:08,210,23,Chernigov
1808,1774,18,700,1094,14,1108,0,1108,18,934,156,22.04.2019 00:25,210,23,Chernigov
768,704,4,282,482,4,486,0,486,10,406,70,22.04.2019 00:10,210,23,Chernigov
352,70,16,288,50,14,64,0,64,0,52,12,22.04.2019 00:14,210,23,Chernigov
208,67,12,160,41,7,48,0,48,0,43,5,22.04.2019 02:00,210,23,Chernigov
240,18,0,222,18,0,18,0,18,0,15,3,21.04.2019 20:20,210,23,Chernigov
2592,2583,7,812,1773,7,1780,0,1780,45,994,741,21.04.2019 22:00,211,24,Kiev (city)
1968,2134,8,541,1421,6,1427,0,1427,40,735,652,22.04.2019 00:35,211,24,Kiev (city)
1600,1659,0,597,1003,0,1003,0,1003,20,719,264,21.04.2019 22:30,211,24,Kiev (city)
1856,1869,9,706,1143,7,1150,0,1150,47,714,389,22.04.2019 00:10,211,24,Kiev (city)
2480,2524,10,804,1667,9,1676,0,1676,49,910,717,21.04.2019 23:15,211,24,Kiev (city)
2000,1984,8,706,1286,8,1294,0,1294,35,847,412,22.04.2019 00:04,211,24,Kiev (city)
1680,1691,7,631,1045,4,1049,0,1049,20,693,336,22.04.2019 00:02,211,24,Kiev (city)
1792,1766,4,616,1172,4,1176,0,1176,43,718,415,22.04.2019 00:15,211,24,Kiev (city)
1712,1744,16,582,1115,15,1130,0,1130,29,729,372,22.04.2019 01:10,211,24,Kiev (city)
1584,1602,7,481,1096,7,1103,0,1103,30,711,362,22.04.2019 03:15,211,24,Kiev (city)
2096,2200,5,651,1444,1,1445,0,1445,38,737,670,21.04.2019 22:35,211,24,Kiev (city)
1264,1249,9,441,820,3,823,0,823,25,464,334,22.04.2019 00:05,211,24,Kiev (city)
2112,2245,9,598,1508,6,1514,0,1513,48,902,563,22.04.2019 00:05,211,24,Kiev (city)
2096,2098,13,712,1376,8,1384,0,1384,32,845,507,21.04.2019 22:10,211,24,Kiev (city)
2016,1991,1,776,1239,1,1240,0,1240,47,759,434,22.04.2019 00:05,211,24,Kiev (city)
1152,1157,2,343,807,2,809,0,807,32,404,371,21.04.2019 23:55,211,24,Kiev (city)
2128,2170,3,612,1513,3,1516,0,1516,59,818,639,22.04.2019 00:03,211,24,Kiev (city)
2064,2084,4,857,1203,4,1207,0,1207,40,824,343,21.04.2019 22:10,211,24,Kiev (city)
2336,2423,10,704,1624,8,1632,0,1632,40,929,663,21.04.2019 23:20,211,24,Kiev (city)
1920,1982,0,766,1154,0,1154,0,1154,42,778,334,21.04.2019 21:05,211,24,Kiev (city)
2240,2305,1,634,1605,1,1606,0,1606,44,901,661,21.04.2019 23:15,211,24,Kiev (city)
1904,1885,4,774,1126,4,1130,0,1130,24,744,362,21.04.2019 21:50,211,24,Kiev (city)
2016,1995,1,698,1317,1,1318,0,1318,34,819,465,21.04.2019 21:20,211,24,Kiev (city)
2016,2013,5,708,1304,4,1308,0,1308,35,817,456,21.04.2019 21:42,211,24,Kiev (city)
1056,1041,5,439,613,4,617,0,617,12,396,209,21.04.2019 22:40,211,24,Kiev (city)
2048,2092,5,660,1385,3,1388,0,1388,35,807,546,22.04.2019 00:02,211,24,Kiev (city)
2240,2257,4,700,1536,4,1540,0,1540,62,830,648,21.04.2019 21:40,211,24,Kiev (city)
2272,2273,3,741,1528,3,1531,0,1531,59,795,677,22.04.2019 00:10,211,24,Kiev (city)
2112,2114,14,603,1500,9,1509,0,1509,35,916,558,22.04.2019 02:20,211,24,Kiev (city)
2192,2192,5,734,1455,3,1458,0,1458,44,906,508,21.04.2019 21:00,211,24,Kiev (city)
2272,2378,4,629,1642,1,1643,0,1643,41,894,708,22.04.2019 00:10,211,24,Kiev (city)
2032,2061,4,586,1442,4,1446,0,1446,46,856,544,22.04.2019 00:45,211,24,Kiev (city)
2128,2136,3,670,1456,2,1458,0,1458,42,908,508,22.04.2019 00:12,211,24,Kiev (city)
2208,2200,6,753,1450,5,1455,0,1455,39,881,535,22.04.2019 00:01,211,24,Kiev (city)
2144,2161,3,658,1484,2,1486,0,1486,58,871,557,22.04.2019 00:10,211,24,Kiev (city)
2208,2264,7,753,1453,2,1455,0,1455,54,685,716,22.04.2019 00:17,211,24,Kiev (city)
2240,2303,0,716,1524,0,1524,0,1524,38,738,748,22.04.2019 01:10,211,24,Kiev (city)
1920,2051,0,512,1408,0,1408,0,1408,56,662,690,22.04.2019 00:10,211,24,Kiev (city)
1728,1906,0,413,1315,0,1315,0,1315,35,683,597,21.04.2019 21:30,211,24,Kiev (city)
2592,2626,3,661,1929,2,1931,0,1930,53,965,912,22.04.2019 00:50,211,24,Kiev (city)
2144,2307,0,490,1654,0,1654,0,1654,30,899,725,21.04.2019 22:47,211,24,Kiev (city)
2384,2687,0,662,1722,0,1722,0,1722,36,1193,493,22.04.2019 00:15,211,24,Kiev (city)
2544,2601,2,672,1870,2,1872,0,1872,46,927,899,22.04.2019 00:52,211,24,Kiev (city)
2240,2238,1,757,1482,1,1483,0,1483,40,896,547,21.04.2019 22:05,211,24,Kiev (city)
2352,2399,17,886,1459,7,1466,0,1466,41,913,512,22.04.2019 00:20,211,24,Kiev (city)
2016,2008,5,650,1362,4,1366,0,1366,41,833,492,22.04.2019 00:04,211,24,Kiev (city)
2080,2082,4,656,1421,3,1424,0,1424,57,869,498,21.04.2019 22:01,211,24,Kiev (city)
2016,2015,8,664,1346,6,1352,0,1352,39,844,469,21.04.2019 21:30,211,24,Kiev (city)
2112,2143,2,657,1453,2,1455,0,1455,43,816,596,22.04.2019 00:10,211,24,Kiev (city)
2000,2000,1,683,1316,1,1317,0,1317,41,806,469,22.04.2019 00:40,211,24,Kiev (city)
2032,2030,5,630,1398,4,1402,0,1402,38,873,491,22.04.2019 02:52,211,24,Kiev (city)
1904,1967,7,596,1302,6,1308,0,1308,52,721,535,21.04.2019 23:10,211,24,Kiev (city)
2096,2119,16,669,1413,14,1427,0,1427,57,778,592,22.04.2019 00:20,211,24,Kiev (city)
2224,2252,2,708,1514,2,1516,0,1516,54,840,622,22.04.2019 00:05,211,24,Kiev (city)
2480,2585,7,832,1644,4,1648,0,1648,49,981,618,21.04.2019 21:30,211,24,Kiev (city)
1824,1867,5,589,1230,5,1235,0,1235,34,768,433,21.04.2019 21:45,211,24,Kiev (city)
2304,2341,13,772,1520,12,1532,0,1532,47,850,635,22.04.2019 00:45,211,24,Kiev (city)
2384,2346,5,1148,1231,5,1236,0,1236,39,752,445,21.04.2019 21:20,211,24,Kiev (city)
2224,2265,8,747,1472,5,1477,0,1477,51,794,632,22.04.2019 00:03,211,24,Kiev (city)
2224,2399,3,359,1864,1,1865,0,1865,58,967,840,21.04.2019 22:45,211,24,Kiev (city)
1872,1884,4,605,1263,4,1267,0,1267,36,773,458,21.04.2019 21:30,211,24,Kiev (city)
2048,2096,12,685,1356,7,1363,0,1363,42,768,553,21.04.2019 22:00,211,24,Kiev (city)
2400,2507,4,715,1682,3,1685,0,1685,60,909,716,22.04.2019 00:10,211,24,Kiev (city)
2240,2309,8,904,1329,7,1336,0,1336,40,795,501,21.04.2019 21:47,211,24,Kiev (city)
2560,2558,8,909,1644,7,1651,0,1651,55,969,627,21.04.2019 23:30,211,24,Kiev (city)
2368,2674,4,707,1657,4,1661,0,1661,41,1033,587,22.04.2019 00:05,211,24,Kiev (city)
2032,2113,11,503,1521,8,1529,0,1529,54,845,630,21.04.2019 21:42,211,24,Kiev (city)
2096,2162,5,613,1481,2,1483,0,1483,45,830,608,22.04.2019 00:10,211,24,Kiev (city)
2272,2378,9,700,1563,9,1572,0,1572,42,873,657,22.04.2019 00:15,211,24,Kiev (city)
1600,1651,6,453,1143,4,1147,0,1147,32,713,402,22.04.2019 00:00,211,24,Kiev (city)
2048,2081,6,636,1407,5,1412,0,1412,55,804,553,21.04.2019 23:00,211,24,Kiev (city)
1856,1885,3,581,1272,3,1275,0,1275,55,654,566,21.04.2019 22:20,211,24,Kiev (city)
2272,2324,5,832,1438,2,1440,0,1438,35,755,648,21.04.2019 21:50,211,24,Kiev (city)
1856,1882,10,612,1234,10,1244,0,1244,43,667,534,21.04.2019 21:58,211,24,Kiev (city)
1920,1952,5,675,1240,5,1245,0,1245,38,677,530,21.04.2019 22:30,211,24,Kiev (city)
1936,1967,5,687,1245,4,1249,0,1249,46,650,553,22.04.2019 00:10,211,24,Kiev (city)
2112,2256,6,645,1462,5,1467,0,1467,43,834,590,22.04.2019 00:10,211,24,Kiev (city)
2176,1999,12,717,1448,11,1459,0,1459,49,743,667,22.04.2019 00:15,211,24,Kiev (city)
2096,2163,15,680,1404,12,1416,0,1416,42,775,599,21.04.2019 23:00,211,24,Kiev (city)
1856,1924,5,551,1302,3,1305,0,1305,35,692,578,21.04.2019 23:05,211,24,Kiev (city)
1968,2014,9,610,1352,6,1358,0,1358,42,743,573,22.04.2019 01:45,211,24,Kiev (city)
576,139,70,460,58,58,116,0,116,4,63,49,21.04.2019 22:12,211,24,Kiev (city)
624,92,18,553,56,15,71,0,71,0,47,24,21.04.2019 21:20,211,24,Kiev (city)
368,65,25,303,40,25,65,0,65,1,44,20,21.04.2019 20:40,211,24,Kiev (city)
96,40,2,57,37,2,39,0,39,1,29,9,21.04.2019 20:20,211,24,Kiev (city)
2272,2378,0,529,1743,0,1743,0,1743,43,926,774,22.04.2019 00:10,211,24,Kiev (city)
1840,1861,0,589,1251,0,1251,0,1251,29,607,615,22.04.2019 00:01,211,24,Kiev (city)
2304,2296,5,864,1436,4,1440,0,1440,41,820,579,22.04.2019 00:15,211,24,Kiev (city)
2352,2690,1,405,1947,0,1947,0,1947,43,974,930,22.04.2019 03:55,211,24,Kiev (city)
1952,1948,7,692,1256,4,1260,0,1260,35,855,370,21.04.2019 22:00,212,24,Kiev (city)
1872,1883,6,556,1312,4,1316,0,1316,36,760,520,22.04.2019 01:40,212,24,Kiev (city)
2272,2336,2,622,1649,1,1650,0,1650,35,935,680,22.04.2019 00:07,212,24,Kiev (city)
2336,2460,4,530,1803,3,1806,0,1806,38,1034,734,21.04.2019 23:10,212,24,Kiev (city)
2368,2405,5,683,1681,4,1685,0,1685,37,999,649,22.04.2019 01:21,212,24,Kiev (city)
2144,2192,2,649,1493,2,1495,0,1495,27,901,567,21.04.2019 21:36,212,24,Kiev (city)
2032,2055,5,587,1441,4,1445,0,1445,52,776,617,22.04.2019 00:25,212,24,Kiev (city)
2256,2264,2,698,1556,2,1558,0,1558,41,926,591,22.04.2019 00:37,212,24,Kiev (city)
2304,2301,3,692,1610,2,1612,0,1612,49,1001,562,21.04.2019 23:10,212,24,Kiev (city)
2400,2451,5,683,1713,4,1717,0,1717,44,949,724,21.04.2019 22:10,212,24,Kiev (city)
1952,1978,8,584,1362,6,1368,0,1368,31,769,568,22.04.2019 00:05,212,24,Kiev (city)
2416,2482,1,685,1730,1,1731,0,1731,39,953,739,22.04.2019 00:01,212,24,Kiev (city)
2464,2524,2,731,1732,1,1733,0,1733,53,1005,675,22.04.2019 00:15,212,24,Kiev (city)
2144,2182,8,578,1561,5,1566,0,1566,52,910,604,22.04.2019 00:20,212,24,Kiev (city)
1472,1481,7,404,1062,6,1068,0,1068,35,589,444,22.04.2019 00:03,212,24,Kiev (city)
1952,1964,15,586,1352,14,1366,0,1366,36,851,479,21.04.2019 22:37,212,24,Kiev (city)
2464,2455,8,731,1727,6,1733,0,1733,56,1026,651,21.04.2019 23:48,212,24,Kiev (city)
2016,2114,7,717,1297,2,1299,0,1299,18,845,436,22.04.2019 00:55,212,24,Kiev (city)
1328,1444,0,335,993,0,993,0,993,14,541,438,21.04.2019 20:45,212,24,Kiev (city)
2288,2328,6,638,1647,3,1650,0,1650,54,875,721,22.04.2019 00:15,212,24,Kiev (city)
2032,2055,4,604,1425,3,1428,0,1427,52,766,609,22.04.2019 00:03,212,24,Kiev (city)
2144,2256,8,479,1662,3,1665,0,1665,36,879,750,21.04.2019 22:30,212,24,Kiev (city)
1568,1602,7,403,1161,4,1165,0,1165,34,621,510,21.04.2019 22:40,212,24,Kiev (city)
2304,2337,4,656,1646,2,1648,0,1648,42,977,629,21.04.2019 21:03,212,24,Kiev (city)
2368,2414,6,712,1651,5,1656,0,1656,43,952,661,21.04.2019 23:03,212,24,Kiev (city)
2320,2332,3,713,1604,3,1607,0,1607,45,956,606,21.04.2019 22:44,212,24,Kiev (city)
2176,2175,4,715,1457,4,1461,0,1461,35,933,493,22.04.2019 00:08,212,24,Kiev (city)
2032,2049,5,613,1415,4,1419,0,1419,42,743,634,21.04.2019 22:15,212,24,Kiev (city)
2480,2536,6,736,1740,4,1744,0,1744,59,944,741,22.04.2019 00:15,212,24,Kiev (city)
1856,1839,4,586,1266,4,1270,0,1270,40,725,505,22.04.2019 00:15,212,24,Kiev (city)
2304,2304,9,743,1555,6,1561,0,1561,46,932,583,21.04.2019 21:25,212,24,Kiev (city)
2208,2208,8,688,1515,5,1520,0,1520,37,958,525,21.04.2019 22:00,212,24,Kiev (city)
2480,2499,1,700,1780,0,1780,0,1780,35,1032,713,22.04.2019 00:28,212,24,Kiev (city)
2336,2319,4,768,1564,4,1568,0,1568,51,859,658,22.04.2019 00:49,212,24,Kiev (city)
1456,1452,4,425,1029,2,1031,0,1031,37,606,388,21.04.2019 21:20,212,24,Kiev (city)
1504,1523,7,441,1059,4,1063,0,1063,30,620,413,22.04.2019 00:15,212,24,Kiev (city)
2160,2149,4,713,1443,4,1447,0,1447,36,879,532,21.04.2019 22:00,212,24,Kiev (city)
2208,2247,4,597,1607,4,1611,0,1611,47,912,652,21.04.2019 22:09,212,24,Kiev (city)
2304,2315,4,761,1542,1,1543,0,1543,49,892,602,22.04.2019 00:15,212,24,Kiev (city)
2288,2281,5,715,1570,3,1573,0,1573,43,934,596,22.04.2019 00:08,212,24,Kiev (city)
1792,1817,5,545,1244,3,1247,0,1247,33,678,536,21.04.2019 21:30,212,24,Kiev (city)
2144,2172,4,652,1488,4,1492,0,1492,41,937,514,21.04.2019 23:40,212,24,Kiev (city)
1968,1976,5,618,1346,4,1350,0,1350,50,721,579,21.04.2019 22:00,212,24,Kiev (city)
2368,2380,2,675,1692,1,1693,0,1693,53,981,659,21.04.2019 22:00,212,24,Kiev (city)
2208,2218,5,617,1587,4,1591,0,1591,47,929,615,22.04.2019 00:05,212,24,Kiev (city)
2224,2267,10,639,1578,7,1585,0,1585,38,870,677,22.04.2019 00:10,212,24,Kiev (city)
2144,2203,9,597,1542,5,1547,0,1547,34,986,527,22.04.2019 00:10,212,24,Kiev (city)
2384,2402,8,778,1600,6,1606,0,1606,49,950,607,21.04.2019 21:15,212,24,Kiev (city)
1920,1947,9,614,1301,5,1306,0,1306,35,811,460,22.04.2019 00:05,212,24,Kiev (city)
1488,1563,7,417,1066,5,1071,0,1071,27,696,348,22.04.2019 00:05,212,24,Kiev (city)
2272,2273,6,704,1562,6,1568,0,1568,46,1003,519,22.04.2019 00:07,212,24,Kiev (city)
2240,2232,8,689,1545,6,1551,0,1551,45,1005,501,22.04.2019 00:20,212,24,Kiev (city)
2288,2298,4,685,1600,3,1603,0,1603,37,1050,516,22.04.2019 00:00,212,24,Kiev (city)
2128,2116,5,715,1409,4,1413,0,1413,47,858,508,21.04.2019 22:10,212,24,Kiev (city)
2416,2401,4,734,1679,3,1682,0,1682,51,952,679,22.04.2019 00:15,212,24,Kiev (city)
2416,2481,4,653,1759,4,1763,0,1763,50,1074,639,22.04.2019 00:05,212,24,Kiev (city)
2320,2317,7,781,1534,5,1539,0,1539,32,982,525,22.04.2019 00:30,212,24,Kiev (city)
2160,2169,3,705,1452,3,1455,0,1455,43,930,482,22.04.2019 00:15,212,24,Kiev (city)
2336,2323,7,749,1582,5,1587,0,1587,49,1065,473,21.04.2019 21:30,212,24,Kiev (city)
2240,2227,10,726,1506,8,1514,0,1514,48,941,525,22.04.2019 00:05,212,24,Kiev (city)
2048,2047,10,655,1389,4,1393,0,1393,43,890,460,21.04.2019 20:25,212,24,Kiev (city)
1968,1971,2,587,1380,1,1381,0,1381,31,876,474,22.04.2019 00:05,212,24,Kiev (city)
1856,1853,4,610,1243,3,1246,0,1246,38,765,443,21.04.2019 22:52,212,24,Kiev (city)
2256,2252,3,712,1541,3,1544,0,1544,41,931,572,22.04.2019 00:15,212,24,Kiev (city)
2192,2192,7,644,1542,6,1548,0,1548,48,928,572,22.04.2019 01:06,212,24,Kiev (city)
2224,2207,6,792,1426,6,1432,0,1432,41,902,489,21.04.2019 22:19,212,24,Kiev (city)
2272,2265,7,770,1496,6,1502,0,1502,53,951,498,21.04.2019 21:00,212,24,Kiev (city)
2160,2140,7,713,1441,6,1447,0,1447,43,945,459,21.04.2019 20:56,212,24,Kiev (city)
2256,2247,22,701,1539,16,1555,0,1555,41,1008,506,21.04.2019 21:30,212,24,Kiev (city)
2224,2221,21,690,1513,21,1534,0,1534,37,1007,490,22.04.2019 01:00,212,24,Kiev (city)
2240,2226,9,773,1459,8,1467,0,1467,55,924,488,21.04.2019 21:37,212,24,Kiev (city)
2288,2288,8,861,1420,7,1427,0,1427,44,923,460,22.04.2019 00:00,212,24,Kiev (city)
2320,2301,5,887,1428,5,1433,0,1433,35,938,460,22.04.2019 02:25,212,24,Kiev (city)
2320,2307,10,852,1458,10,1468,0,1468,31,971,466,22.04.2019 00:30,212,24,Kiev (city)
2368,2347,8,1000,1360,8,1368,0,1368,43,878,447,22.04.2019 00:20,212,24,Kiev (city)
2384,2368,2,854,1530,0,1530,0,1530,32,1009,489,21.04.2019 22:30,212,24,Kiev (city)
2448,2452,7,860,1584,4,1588,0,1588,39,1058,491,22.04.2019 00:35,212,24,Kiev (city)
2544,2528,2,1129,1414,1,1415,0,1415,42,956,417,21.04.2019 22:30,212,24,Kiev (city)
880,188,71,702,108,70,178,0,178,4,126,48,21.04.2019 20:50,212,24,Kiev (city)
192,22,0,170,22,0,22,0,22,0,16,6,21.04.2019 20:20,212,24,Kiev (city)
208,38,14,172,22,14,36,0,36,0,27,9,22.04.2019 00:15,212,24,Kiev (city)
2016,1989,4,585,1428,3,1431,0,1431,46,806,579,21.04.2019 21:23,212,24,Kiev (city)
2272,2318,1,692,1579,1,1580,0,1580,38,905,637,21.04.2019 22:21,212,24,Kiev (city)
2288,2383,2,555,1731,2,1733,0,1733,46,956,731,22.04.2019 00:30,212,24,Kiev (city)
1888,1954,2,478,1408,2,1410,0,1410,38,767,605,21.04.2019 22:00,212,24,Kiev (city)
2288,2450,1,514,1774,0,1774,0,1774,38,846,890,21.04.2019 23:30,212,24,Kiev (city)
2272,2302,7,687,1578,7,1585,0,1584,52,984,548,22.04.2019 00:05,212,24,Kiev (city)
1808,1852,2,488,1318,2,1320,0,1320,29,720,571,22.04.2019 00:05,212,24,Kiev (city)
2608,2699,3,747,1859,2,1861,0,1861,40,1102,719,22.04.2019 00:15,212,24,Kiev (city)
1328,1536,3,165,1162,1,1163,0,1163,20,624,519,22.04.2019 00:23,212,24,Kiev (city)
2208,2214,3,693,1513,2,1515,0,1515,46,915,554,21.04.2019 22:00,213,24,Kiev (city)
2240,2213,9,671,1563,6,1569,0,1569,44,966,559,21.04.2019 22:45,213,24,Kiev (city)
2080,2078,9,671,1402,7,1409,0,1409,52,842,515,21.04.2019 23:00,213,24,Kiev (city)
2096,2079,14,637,1450,9,1459,0,1459,48,866,545,21.04.2019 21:15,213,24,Kiev (city)
2080,2101,10,624,1448,8,1456,0,1456,32,900,524,21.04.2019 22:58,213,24,Kiev (city)
2256,2241,10,734,1513,9,1522,0,1522,39,929,554,21.04.2019 21:30,213,24,Kiev (city)
2160,2118,14,757,1392,11,1403,0,1403,45,862,496,21.04.2019 22:08,213,24,Kiev (city)
2208,2184,7,730,1471,7,1478,0,1478,44,898,536,21.04.2019 21:46,213,24,Kiev (city)
2288,2261,20,761,1514,13,1527,0,1527,44,980,503,22.04.2019 00:10,213,24,Kiev (city)
2304,2309,7,713,1584,7,1591,0,1591,56,1005,530,22.04.2019 00:15,213,24,Kiev (city)
2160,2159,8,750,1405,5,1410,0,1410,36,864,510,22.04.2019 02:23,213,24,Kiev (city)
2304,2288,13,837,1457,10,1467,0,1467,43,969,455,21.04.2019 21:47,213,24,Kiev (city)
2224,2198,12,738,1477,9,1486,0,1486,48,963,475,21.04.2019 23:10,213,24,Kiev (city)
2304,2294,9,792,1507,5,1512,0,1512,39,944,529,21.04.2019 21:43,213,24,Kiev (city)
2336,2330,14,732,1595,9,1604,0,1603,50,1026,527,21.04.2019 22:50,213,24,Kiev (city)
2256,2235,11,752,1496,8,1504,0,1504,39,933,532,21.04.2019 23:00,213,24,Kiev (city)
2240,2224,7,654,1581,5,1586,0,1586,35,1004,547,21.04.2019 21:30,213,24,Kiev (city)
2304,2295,12,774,1522,8,1530,0,1530,42,1005,483,21.04.2019 21:50,213,24,Kiev (city)
2112,2092,15,762,1339,11,1350,0,1350,37,810,503,21.04.2019 22:26,213,24,Kiev (city)
2272,2269,16,825,1437,10,1447,0,1447,44,985,418,21.04.2019 21:30,213,24,Kiev (city)
1936,1929,7,670,1261,5,1266,0,1266,35,791,440,21.04.2019 21:07,213,24,Kiev (city)
2144,2128,4,677,1463,4,1467,0,1467,35,921,511,22.04.2019 00:05,213,24,Kiev (city)
2176,2169,3,648,1525,3,1528,0,1528,44,986,498,21.04.2019 23:40,213,24,Kiev (city)
2064,2070,3,611,1451,2,1453,0,1453,43,876,534,22.04.2019 00:07,213,24,Kiev (city)
1840,1808,8,591,1241,8,1249,0,1249,31,738,480,21.04.2019 22:41,213,24,Kiev (city)
1456,1444,9,468,982,6,988,0,988,33,620,335,21.04.2019 22:02,213,24,Kiev (city)
2256,2238,12,708,1537,11,1548,0,1548,26,1020,502,21.04.2019 21:47,213,24,Kiev (city)
2368,2355,3,750,1617,1,1618,0,1618,40,1027,551,21.04.2019 22:39,213,24,Kiev (city)
2224,2210,6,751,1471,2,1473,0,1473,31,939,503,21.04.2019 22:57,213,24,Kiev (city)
1184,1188,11,369,809,6,815,0,815,17,567,231,21.04.2019 22:18,213,24,Kiev (city)
1920,1899,19,679,1223,18,1241,0,1241,23,845,373,22.04.2019 02:13,213,24,Kiev (city)
2304,2278,5,820,1480,4,1484,0,1484,43,993,448,21.04.2019 21:35,213,24,Kiev (city)
2240,2227,11,726,1509,5,1514,0,1514,44,1001,469,21.04.2019 22:50,213,24,Kiev (city)
2320,2292,6,837,1477,6,1483,0,1483,49,980,454,22.04.2019 00:02,213,24,Kiev (city)
2352,2317,4,818,1531,3,1534,0,1534,44,891,599,21.04.2019 22:15,213,24,Kiev (city)
2304,2287,4,802,1501,1,1502,0,1502,40,990,472,21.04.2019 22:04,213,24,Kiev (city)
2400,2389,8,878,1518,4,1522,0,1522,50,940,532,21.04.2019 22:20,213,24,Kiev (city)
2448,2449,13,785,1656,7,1663,0,1662,42,1027,593,21.04.2019 23:11,213,24,Kiev (city)
2192,2179,2,722,1468,2,1470,0,1470,43,941,486,21.04.2019 21:16,213,24,Kiev (city)
2320,2307,3,740,1578,2,1580,0,1580,33,967,580,22.04.2019 00:15,213,24,Kiev (city)
2480,2419,6,1104,1371,5,1376,0,1376,28,958,390,21.04.2019 22:30,213,24,Kiev (city)
1936,1895,4,654,1278,4,1282,0,1282,27,829,426,21.04.2019 22:40,213,24,Kiev (city)
1808,1795,6,589,1215,4,1219,0,1219,40,788,391,21.04.2019 23:05,213,24,Kiev (city)
2208,2188,3,711,1495,2,1497,0,1497,30,943,524,21.04.2019 21:50,213,24,Kiev (city)
1984,1963,3,619,1364,1,1365,0,1365,30,849,486,22.04.2019 00:10,213,24,Kiev (city)
2400,2401,23,802,1580,18,1598,0,1598,42,951,605,22.04.2019 00:07,213,24,Kiev (city)
2320,2293,11,783,1532,5,1537,0,1537,48,955,534,22.04.2019 00:45,213,24,Kiev (city)
2464,2443,6,848,1614,2,1616,0,1616,24,983,609,21.04.2019 22:17,213,24,Kiev (city)
1328,1329,21,445,870,13,883,0,883,20,558,305,21.04.2019 22:30,213,24,Kiev (city)
2256,2228,8,717,1536,3,1539,0,1539,41,941,557,21.04.2019 22:30,213,24,Kiev (city)
1744,1717,4,626,1116,2,1118,0,1118,21,733,364,21.04.2019 22:00,213,24,Kiev (city)
2416,2448,8,775,1638,3,1641,0,1641,41,963,637,21.04.2019 22:40,213,24,Kiev (city)
2224,2213,5,802,1419,3,1422,0,1422,23,937,462,21.04.2019 22:30,213,24,Kiev (city)
2496,2496,11,842,1649,5,1654,0,1654,42,1024,588,21.04.2019 22:30,213,24,Kiev (city)
1600,1586,6,531,1064,5,1069,0,1069,22,681,366,22.04.2019 00:10,213,24,Kiev (city)
1360,1351,1,453,906,1,907,0,907,29,528,350,21.04.2019 22:10,213,24,Kiev (city)
2320,2293,6,821,1495,4,1499,0,1498,25,961,512,21.04.2019 23:00,213,24,Kiev (city)
2112,2074,7,702,1407,3,1410,0,1410,30,884,496,21.04.2019 21:40,213,24,Kiev (city)
2000,1977,3,730,1268,2,1270,0,1270,42,830,398,21.04.2019 22:30,213,24,Kiev (city)
1936,1920,3,668,1266,2,1268,0,1268,24,831,413,21.04.2019 22:27,213,24,Kiev (city)
1920,1913,5,634,1283,3,1286,0,1285,29,838,418,21.04.2019 23:00,213,24,Kiev (city)
2048,2025,4,680,1365,3,1368,0,1368,31,878,459,21.04.2019 22:10,213,24,Kiev (city)
2256,2252,12,749,1497,10,1507,0,1507,47,907,553,21.04.2019 22:20,213,24,Kiev (city)
2256,2221,8,788,1461,7,1468,0,1468,43,932,493,21.04.2019 22:30,213,24,Kiev (city)
2176,2153,6,716,1455,5,1460,0,1460,30,915,515,21.04.2019 22:30,213,24,Kiev (city)
2400,2409,5,754,1642,4,1646,0,1646,49,1057,540,21.04.2019 22:05,213,24,Kiev (city)
2416,2422,3,700,1714,2,1716,0,1716,39,1089,588,21.04.2019 21:30,213,24,Kiev (city)
2144,2118,13,702,1435,7,1442,0,1442,37,940,465,21.04.2019 21:45,213,24,Kiev (city)
2256,2237,7,768,1483,5,1488,0,1488,36,990,462,21.04.2019 23:00,213,24,Kiev (city)
2080,2063,7,720,1356,4,1360,0,1360,33,884,443,21.04.2019 22:00,213,24,Kiev (city)
1728,1751,4,494,1232,2,1234,0,1234,20,696,518,21.04.2019 22:00,213,24,Kiev (city)
2384,2373,5,784,1597,3,1600,0,1600,30,995,575,21.04.2019 22:35,213,24,Kiev (city)
2256,2236,7,704,1546,6,1552,0,1552,49,850,653,21.04.2019 22:00,213,24,Kiev (city)
1952,1920,4,710,1241,1,1242,0,1242,41,853,348,21.04.2019 22:22,213,24,Kiev (city)
1840,1810,0,597,1243,0,1243,0,1243,31,774,438,21.04.2019 21:06,213,24,Kiev (city)
1520,1494,7,527,989,4,993,0,993,30,626,337,21.04.2019 22:30,213,24,Kiev (city)
1600,1624,3,482,1116,2,1118,0,1118,27,704,387,21.04.2019 22:30,213,24,Kiev (city)
1408,1386,13,491,905,12,917,0,917,27,631,259,21.04.2019 21:56,213,24,Kiev (city)
2032,2087,1,503,1528,1,1529,0,1529,31,977,521,22.04.2019 00:09,213,24,Kiev (city)
1216,1208,3,409,806,1,807,0,807,23,495,289,21.04.2019 22:30,213,24,Kiev (city)
2080,2083,4,734,1343,3,1346,0,1346,38,817,491,22.04.2019 00:10,214,24,Kiev (city)
1360,1354,3,528,830,2,832,0,832,15,542,275,22.04.2019 00:15,214,24,Kiev (city)
2336,2345,9,783,1547,6,1553,0,1553,41,914,598,22.04.2019 00:27,214,24,Kiev (city)
1888,1898,2,621,1267,0,1267,0,1267,33,779,455,22.04.2019 00:15,214,24,Kiev (city)
1856,1837,2,704,1151,1,1152,0,1152,47,768,337,22.04.2019 00:15,214,24,Kiev (city)
1872,1895,4,705,1164,3,1167,0,1167,31,761,375,22.04.2019 00:50,214,24,Kiev (city)
1728,1765,9,563,1156,9,1165,0,1165,30,718,417,22.04.2019 00:17,214,24,Kiev (city)
1792,1786,6,671,1115,6,1121,0,1121,43,700,378,22.04.2019 00:35,214,24,Kiev (city)
2080,2080,5,800,1276,4,1280,0,1280,32,830,418,21.04.2019 21:05,214,24,Kiev (city)
1648,1649,3,688,959,1,960,0,960,17,633,310,22.04.2019 03:02,214,24,Kiev (city)
2368,2387,4,851,1515,2,1517,0,1517,49,911,557,22.04.2019 00:15,214,24,Kiev (city)
2368,2506,11,786,1574,8,1582,0,1582,33,1019,530,21.04.2019 21:59,214,24,Kiev (city)
2592,2591,7,826,1762,4,1766,0,1766,42,922,802,22.04.2019 00:16,214,24,Kiev (city)
2272,2365,4,690,1580,2,1582,0,1582,35,945,602,22.04.2019 00:05,214,24,Kiev (city)
2048,2112,4,553,1493,2,1495,0,1495,49,858,588,22.04.2019 00:50,214,24,Kiev (city)
2320,2343,8,670,1645,5,1650,0,1650,46,921,683,21.04.2019 20:45,214,24,Kiev (city)
1744,1751,10,583,1153,8,1161,0,1161,29,669,463,22.04.2019 00:05,214,24,Kiev (city)
2432,2474,16,719,1701,12,1713,0,1713,65,922,726,22.04.2019 00:30,214,24,Kiev (city)
1824,1849,12,550,1267,7,1274,0,1274,49,690,535,22.04.2019 00:15,214,24,Kiev (city)
2144,2178,10,615,1523,6,1529,0,1529,66,858,605,21.04.2019 22:20,214,24,Kiev (city)
2272,2300,4,794,1476,2,1478,0,1478,36,968,473,22.04.2019 00:08,214,24,Kiev (city)
2304,2327,6,860,1438,6,1444,0,1444,38,929,477,22.04.2019 01:20,214,24,Kiev (city)
1504,1504,0,489,1015,0,1015,0,1015,29,634,352,21.04.2019 22:05,214,24,Kiev (city)
1184,1192,3,379,802,3,805,0,805,31,468,306,22.04.2019 00:50,214,24,Kiev (city)
2144,2171,3,789,1353,2,1355,0,1355,35,893,427,22.04.2019 00:15,214,24,Kiev (city)
1968,1993,2,961,1006,1,1007,0,1007,22,700,285,22.04.2019 00:07,214,24,Kiev (city)
2320,2366,10,697,1613,10,1623,0,1623,50,959,614,22.04.2019 00:15,214,24,Kiev (city)
2320,2325,7,778,1535,7,1542,0,1542,58,883,601,22.04.2019 00:34,214,24,Kiev (city)
2304,2323,0,785,1519,0,1519,0,1519,60,900,559,22.04.2019 00:25,214,24,Kiev (city)
2288,2329,9,709,1574,5,1579,0,1579,54,923,602,21.04.2019 21:56,214,24,Kiev (city)
2256,2303,2,790,1464,2,1466,0,1466,54,876,536,21.04.2019 21:48,214,24,Kiev (city)
2256,2327,7,656,1594,6,1600,0,1600,46,904,650,22.04.2019 02:49,214,24,Kiev (city)
2112,2128,14,688,1414,10,1424,0,1424,46,805,573,22.04.2019 00:10,214,24,Kiev (city)
1712,1718,4,604,1105,3,1108,0,1108,41,681,386,22.04.2019 00:15,214,24,Kiev (city)
2320,2392,14,758,1554,8,1562,0,1561,38,973,550,22.04.2019 01:45,214,24,Kiev (city)
2144,2257,21,663,1461,20,1481,0,1481,47,906,527,22.04.2019 00:15,214,24,Kiev (city)
1280,1299,5,367,910,3,913,0,913,32,516,365,22.04.2019 00:20,214,24,Kiev (city)
2160,2208,9,747,1405,8,1413,0,1413,37,826,550,22.04.2019 00:25,214,24,Kiev (city)
2272,2316,9,679,1585,8,1593,0,1593,54,914,625,22.04.2019 03:30,214,24,Kiev (city)
2320,2369,4,684,1633,3,1636,0,1636,44,971,621,22.04.2019 00:23,214,24,Kiev (city)
2432,2477,18,870,1549,13,1562,0,1562,37,1006,519,22.04.2019 00:35,214,24,Kiev (city)
2448,2532,21,711,1723,14,1737,0,1736,42,1077,617,22.04.2019 00:10,214,24,Kiev (city)
2304,2328,13,832,1463,9,1472,0,1472,29,926,517,22.04.2019 00:05,214,24,Kiev (city)
2032,2062,7,768,1258,6,1264,0,1264,38,814,412,21.04.2019 22:37,214,24,Kiev (city)
1584,1604,8,563,1014,7,1021,0,1021,25,663,333,22.04.2019 00:05,214,24,Kiev (city)
2016,2031,8,712,1298,6,1304,0,1304,39,859,406,21.04.2019 21:05,214,24,Kiev (city)
2192,2233,5,769,1418,5,1423,0,1423,36,941,446,22.04.2019 00:40,214,24,Kiev (city)
2288,2289,8,905,1379,4,1383,0,1383,42,920,421,22.04.2019 00:01,214,24,Kiev (city)
2464,2473,2,737,1726,1,1727,0,1727,33,827,867,22.04.2019 00:05,214,24,Kiev (city)
1200,1189,0,275,925,0,925,0,925,12,439,474,21.04.2019 21:00,214,24,Kiev (city)
2064,2130,10,636,1420,8,1428,0,1428,44,767,617,21.04.2019 21:39,214,24,Kiev (city)
2496,2526,20,728,1752,16,1768,0,1768,63,982,723,22.04.2019 00:30,214,24,Kiev (city)
2096,2274,11,541,1544,11,1555,0,1555,43,865,647,22.04.2019 00:10,214,24,Kiev (city)
2272,2298,14,748,1517,7,1524,0,1524,53,890,581,21.04.2019 21:50,214,24,Kiev (city)
2064,2082,19,645,1408,11,1419,0,1419,65,792,562,21.04.2019 23:00,214,24,Kiev (city)
1376,1386,13,407,959,10,969,0,969,29,564,376,22.04.2019 00:25,214,24,Kiev (city)
2288,2302,14,687,1590,11,1601,0,1601,54,908,639,22.04.2019 00:22,214,24,Kiev (city)
1472,1499,11,436,1025,11,1036,0,1036,42,580,414,22.04.2019 00:05,214,24,Kiev (city)
2032,2060,12,680,1345,7,1352,0,1352,40,774,538,22.04.2019 00:03,214,24,Kiev (city)
2272,2282,16,709,1551,12,1563,0,1563,44,907,612,21.04.2019 22:42,214,24,Kiev (city)
1936,1971,8,646,1284,6,1290,0,1290,39,761,490,22.04.2019 00:15,214,24,Kiev (city)
2128,2158,17,698,1420,10,1430,0,1430,49,817,564,21.04.2019 21:45,214,24,Kiev (city)
1648,1679,12,495,1144,9,1153,0,1153,34,647,472,22.04.2019 00:10,214,24,Kiev (city)
2352,2373,15,819,1520,13,1533,0,1533,54,910,569,21.04.2019 21:20,214,24,Kiev (city)
2160,2149,11,762,1388,10,1398,0,1398,43,814,541,22.04.2019 00:30,214,24,Kiev (city)
2208,2226,9,728,1471,9,1480,0,1480,37,889,554,21.04.2019 21:45,214,24,Kiev (city)
2256,2263,11,783,1465,8,1473,0,1473,45,923,505,22.04.2019 00:25,214,24,Kiev (city)
2144,2145,7,767,1374,3,1377,0,1377,42,881,454,22.04.2019 00:15,214,24,Kiev (city)
2128,2130,9,681,1438,9,1447,0,1447,43,872,532,22.04.2019 00:35,214,24,Kiev (city)
2144,2149,9,710,1428,6,1434,0,1434,47,898,489,22.04.2019 00:10,214,24,Kiev (city)
2384,2388,18,873,1499,12,1511,0,1511,50,909,552,22.04.2019 00:30,214,24,Kiev (city)
1856,1877,4,638,1215,3,1218,0,1218,24,763,431,22.04.2019 00:25,214,24,Kiev (city)
1984,1996,15,709,1265,10,1275,0,1275,31,782,462,22.04.2019 00:34,214,24,Kiev (city)
1600,1614,0,588,1012,0,1012,0,1012,27,585,400,21.04.2019 21:00,214,24,Kiev (city)
2480,2481,6,813,1663,4,1667,0,1667,36,998,633,22.04.2019 00:20,214,24,Kiev (city)
2288,2287,5,836,1448,4,1452,0,1452,39,890,523,22.04.2019 00:20,214,24,Kiev (city)
1936,1920,5,657,1274,5,1279,0,1279,34,748,497,22.04.2019 00:20,214,24,Kiev (city)
2192,2184,1,722,1469,1,1470,0,1470,55,952,463,22.04.2019 00:07,214,24,Kiev (city)
2048,2060,2,715,1331,2,1333,0,1333,47,835,451,21.04.2019 22:08,214,24,Kiev (city)
896,219,90,679,128,89,217,0,217,10,150,57,21.04.2019 20:51,214,24,Kiev (city)
320,61,47,259,14,47,61,0,61,0,46,15,21.04.2019 21:15,214,24,Kiev (city)
2176,2159,13,710,1458,8,1466,0,1466,43,946,477,21.04.2019 22:20,215,24,Kiev (city)
2256,2226,7,800,1450,6,1456,0,1456,42,951,463,21.04.2019 23:03,215,24,Kiev (city)
2016,2016,7,705,1307,4,1311,0,1311,40,832,439,21.04.2019 21:30,215,24,Kiev (city)
1984,1972,13,691,1282,11,1293,0,1293,34,775,484,21.04.2019 22:20,215,24,Kiev (city)
2176,2164,7,654,1516,6,1522,0,1522,42,940,540,21.04.2019 21:40,215,24,Kiev (city)
2368,2377,15,932,1428,8,1436,0,1436,34,953,449,21.04.2019 21:52,215,24,Kiev (city)
2352,2354,13,782,1565,5,1570,0,1570,31,951,588,21.04.2019 22:21,215,24,Kiev (city)
2288,2277,5,848,1436,4,1440,0,1440,41,986,413,21.04.2019 21:54,215,24,Kiev (city)
2272,2264,11,794,1470,8,1478,0,1478,51,920,507,21.04.2019 22:15,215,24,Kiev (city)
2256,2236,8,804,1445,7,1452,0,1452,38,946,468,21.04.2019 22:15,215,24,Kiev (city)
2192,2166,8,811,1375,6,1381,0,1381,52,890,439,21.04.2019 22:00,215,24,Kiev (city)
2032,2030,14,668,1353,11,1364,0,1364,27,876,461,21.04.2019 21:10,215,24,Kiev (city)
2224,2207,11,767,1448,9,1457,0,1457,41,968,448,21.04.2019 22:20,215,24,Kiev (city)
2112,2092,4,675,1433,4,1437,0,1437,33,913,491,21.04.2019 22:01,215,24,Kiev (city)
2128,2109,2,733,1393,2,1395,0,1395,41,882,472,21.04.2019 22:03,215,24,Kiev (city)
2208,2186,15,831,1366,11,1377,0,1377,41,850,486,21.04.2019 22:26,215,24,Kiev (city)
2144,2117,3,765,1376,3,1379,0,1379,35,834,510,21.04.2019 21:21,215,24,Kiev (city)
2144,2121,9,766,1370,8,1378,0,1378,55,940,383,21.04.2019 23:25,215,24,Kiev (city)
2400,2391,6,764,1632,4,1636,0,1636,46,987,603,21.04.2019 21:40,215,24,Kiev (city)
2272,2252,4,711,1558,3,1561,0,1561,48,997,516,21.04.2019 22:30,215,24,Kiev (city)
2192,2178,24,836,1341,15,1356,0,1356,40,858,458,22.04.2019 02:00,215,24,Kiev (city)
2112,2116,16,825,1279,8,1287,0,1287,48,820,419,21.04.2019 22:30,215,24,Kiev (city)
2048,2055,14,646,1394,8,1402,0,1402,39,882,481,22.04.2019 00:45,215,24,Kiev (city)
2208,2186,8,772,1429,7,1436,0,1435,32,868,535,22.04.2019 02:50,215,24,Kiev (city)
2144,2153,16,755,1380,9,1389,0,1389,45,870,474,22.04.2019 00:20,215,24,Kiev (city)
2016,2015,22,645,1352,19,1371,0,1371,47,822,502,22.04.2019 03:55,215,24,Kiev (city)
2176,2177,8,764,1405,7,1412,0,1412,47,930,435,22.04.2019 00:15,215,24,Kiev (city)
2240,2229,3,870,1367,3,1370,0,1370,36,1026,308,21.04.2019 22:00,215,24,Kiev (city)
1664,1665,15,622,1033,9,1042,0,1042,38,663,341,21.04.2019 21:45,215,24,Kiev (city)
1632,1623,11,561,1064,7,1071,0,1071,35,700,336,21.04.2019 21:45,215,24,Kiev (city)
2000,1990,16,666,1323,11,1334,0,1334,37,835,462,21.04.2019 22:15,215,24,Kiev (city)
2032,2039,13,703,1321,8,1329,0,1329,53,818,458,22.04.2019 00:10,215,24,Kiev (city)
2256,2252,24,869,1368,19,1387,0,1387,42,878,467,21.04.2019 22:10,215,24,Kiev (city)
2272,2270,14,876,1386,10,1396,0,1396,50,923,423,21.04.2019 21:55,215,24,Kiev (city)
1920,1926,23,699,1202,19,1221,0,1221,35,771,415,21.04.2019 22:18,215,24,Kiev (city)
2144,2129,16,783,1351,10,1361,0,1361,50,829,482,21.04.2019 22:40,215,24,Kiev (city)
2256,2252,34,786,1448,22,1470,0,1470,49,943,478,22.04.2019 00:15,215,24,Kiev (city)
2352,2341,18,889,1453,10,1463,0,1463,46,891,526,21.04.2019 21:30,215,24,Kiev (city)
2368,2360,20,816,1532,20,1552,0,1552,45,978,529,21.04.2019 22:00,215,24,Kiev (city)
2240,2231,33,797,1431,12,1443,0,1443,45,932,466,21.04.2019 22:55,215,24,Kiev (city)
2336,2333,23,870,1447,19,1466,0,1466,41,941,484,21.04.2019 22:30,215,24,Kiev (city)
2208,2189,24,775,1419,14,1433,0,1433,45,972,416,22.04.2019 00:10,215,24,Kiev (city)
240,229,147,46,86,108,194,0,194,9,147,38,21.04.2019 22:22,215,24,Kiev (city)
2224,2215,16,841,1370,13,1383,0,1383,37,920,426,21.04.2019 23:46,215,24,Kiev (city)
2160,2145,10,808,1347,5,1352,0,1352,60,872,420,21.04.2019 22:57,215,24,Kiev (city)
2256,2246,18,788,1454,14,1468,0,1468,52,943,473,21.04.2019 22:22,215,24,Kiev (city)
2288,2279,17,746,1530,12,1542,0,1542,40,1005,497,21.04.2019 22:00,215,24,Kiev (city)
1872,1850,20,650,1205,17,1222,0,1222,32,755,435,22.04.2019 00:20,215,24,Kiev (city)
2112,2100,8,800,1305,7,1312,0,1312,59,856,397,21.04.2019 22:10,215,24,Kiev (city)
1936,1912,8,714,1216,6,1222,0,1222,30,857,335,21.04.2019 20:45,215,24,Kiev (city)
2208,2198,17,859,1341,8,1349,0,1349,39,884,426,22.04.2019 00:05,215,24,Kiev (city)
2480,2497,24,808,1659,13,1672,0,1672,41,1104,527,21.04.2019 21:15,215,24,Kiev (city)
1600,1518,2,637,963,0,963,0,963,10,454,499,21.04.2019 20:53,215,24,Kiev (city)
736,230,172,566,48,122,170,0,170,10,111,49,21.04.2019 21:07,215,24,Kiev (city)
160,34,0,126,34,0,34,0,34,1,22,11,21.04.2019 20:45,215,24,Kiev (city)
288,83,0,205,83,0,83,0,83,2,59,22,21.04.2019 20:35,215,24,Kiev (city)
176,109,93,96,9,71,80,0,80,0,60,20,21.04.2019 21:08,215,24,Kiev (city)
2288,2270,11,782,1497,9,1506,0,1506,40,960,506,21.04.2019 21:20,215,24,Kiev (city)
2304,2300,10,813,1484,7,1491,0,1491,40,927,524,21.04.2019 22:05,215,24,Kiev (city)
2208,2189,8,794,1409,5,1414,0,1414,31,859,524,21.04.2019 22:40,215,24,Kiev (city)
2144,2140,9,758,1378,8,1386,0,1386,39,853,494,21.04.2019 21:53,215,24,Kiev (city)
2160,2141,9,717,1434,9,1443,0,1443,46,905,492,21.04.2019 23:20,215,24,Kiev (city)
2192,2201,7,807,1380,5,1385,0,1385,41,846,498,22.04.2019 00:20,215,24,Kiev (city)
2160,2174,11,752,1398,10,1408,0,1408,48,851,509,21.04.2019 22:00,215,24,Kiev (city)
2144,2135,6,655,1486,3,1489,0,1489,39,891,559,21.04.2019 22:45,215,24,Kiev (city)
2032,2057,11,801,1225,6,1231,0,1231,35,828,368,21.04.2019 22:19,215,24,Kiev (city)
2096,2086,8,720,1370,6,1376,0,1376,35,884,457,21.04.2019 23:11,215,24,Kiev (city)
2128,2095,6,754,1371,3,1374,0,1374,52,869,453,21.04.2019 22:17,215,24,Kiev (city)
1824,1802,9,666,1155,3,1158,0,1158,38,713,407,21.04.2019 22:20,215,24,Kiev (city)
2176,2165,11,762,1406,8,1414,0,1414,50,885,479,22.04.2019 03:20,215,24,Kiev (city)
1472,1473,4,485,983,4,987,0,987,27,674,286,21.04.2019 22:00,215,24,Kiev (city)
2176,2150,4,736,1436,4,1440,0,1440,43,927,470,22.04.2019 00:40,215,24,Kiev (city)
1472,905,3,567,903,2,905,0,905,27,629,249,22.04.2019 00:10,215,24,Kiev (city)
2304,2303,8,881,1419,4,1423,0,1423,40,899,484,21.04.2019 22:46,215,24,Kiev (city)
2224,2246,5,825,1395,4,1399,0,1399,28,916,455,22.04.2019 01:35,215,24,Kiev (city)
1840,1822,6,705,1131,4,1135,0,1135,44,730,361,22.04.2019 00:15,215,24,Kiev (city)
2368,2348,8,886,1474,8,1482,0,1482,39,1009,434,22.04.2019 00:10,215,24,Kiev (city)
2032,2024,6,737,1292,3,1295,0,1295,44,841,410,22.04.2019 00:40,215,24,Kiev (city)
2368,2353,5,828,1538,2,1540,0,1540,43,922,575,21.04.2019 23:05,215,24,Kiev (city)
1248,1224,11,474,764,10,774,0,774,19,517,238,21.04.2019 21:25,215,24,Kiev (city)
1392,1433,0,473,919,0,919,0,919,16,725,178,21.04.2019 22:05,215,24,Kiev (city)
272,95,0,186,86,0,86,0,86,1,65,20,21.04.2019 20:30,216,24,Kiev (city)
2112,2087,8,729,1375,8,1383,0,1382,40,904,438,22.04.2019 04:53,216,24,Kiev (city)
2384,2374,11,771,1606,7,1613,0,1613,50,1027,536,22.04.2019 00:15,216,24,Kiev (city)
1200,1309,0,269,931,0,931,0,931,12,633,286,21.04.2019 22:00,216,24,Kiev (city)
1952,1940,11,701,1243,8,1251,0,1251,41,805,405,22.04.2019 00:15,216,24,Kiev (city)
2272,2254,8,830,1437,5,1442,0,1442,41,957,444,22.04.2019 00:20,216,24,Kiev (city)
2240,2211,11,812,1418,10,1428,0,1428,36,930,462,22.04.2019 00:37,216,24,Kiev (city)
2080,2059,8,775,1301,4,1305,0,1305,29,881,395,21.04.2019 22:00,216,24,Kiev (city)
2240,2213,7,916,1321,3,1324,0,1324,29,932,363,22.04.2019 00:34,216,24,Kiev (city)
2160,2136,4,720,1437,3,1440,0,1440,40,911,489,21.04.2019 22:11,216,24,Kiev (city)
1776,1739,8,653,1117,6,1123,0,1123,45,708,370,21.04.2019 22:00,216,24,Kiev (city)
2304,2292,8,744,1554,6,1560,0,1560,42,1017,501,22.04.2019 00:15,216,24,Kiev (city)
2160,2146,3,722,1436,2,1438,0,1438,32,936,470,22.04.2019 00:30,216,24,Kiev (city)
2080,2083,5,668,1409,3,1412,0,1412,28,882,502,22.04.2019 00:28,216,24,Kiev (city)
2304,2275,17,757,1533,14,1547,0,1546,38,960,548,22.04.2019 01:57,216,24,Kiev (city)
2224,2221,8,744,1476,4,1480,0,1480,47,961,472,22.04.2019 03:10,216,24,Kiev (city)
2192,2194,10,693,1495,4,1499,0,1499,36,934,529,22.04.2019 00:15,216,24,Kiev (city)
2480,2486,9,753,1722,5,1727,0,1726,61,1033,632,22.04.2019 03:00,216,24,Kiev (city)
2352,2340,7,733,1616,3,1619,0,1619,38,972,609,22.04.2019 00:18,216,24,Kiev (city)
1168,1153,5,389,776,3,779,0,779,25,492,262,22.04.2019 00:15,216,24,Kiev (city)
2368,2368,8,804,1558,6,1564,0,1564,41,966,557,22.04.2019 00:30,216,24,Kiev (city)
2352,2332,8,747,1599,6,1605,0,1605,49,1028,528,22.04.2019 00:10,216,24,Kiev (city)
2240,2240,5,708,1528,4,1532,0,1532,39,947,546,22.04.2019 00:33,216,24,Kiev (city)
2208,2202,11,806,1394,8,1402,0,1402,27,951,424,22.04.2019 00:40,216,24,Kiev (city)
1920,1913,5,714,1203,3,1206,0,1206,34,848,324,21.04.2019 22:11,216,24,Kiev (city)
1936,1931,12,716,1218,2,1220,0,1220,37,841,342,22.04.2019 00:03,216,24,Kiev (city)
2176,2168,4,833,1340,3,1343,0,1343,31,898,414,22.04.2019 01:00,216,24,Kiev (city)
2368,2346,10,890,1475,3,1478,0,1478,50,977,451,22.04.2019 00:10,216,24,Kiev (city)
2240,2235,10,801,1432,7,1439,0,1439,41,966,432,22.04.2019 00:10,216,24,Kiev (city)
1888,1874,9,730,1151,7,1158,0,1158,45,786,327,22.04.2019 00:15,216,24,Kiev (city)
2096,2071,5,871,1223,2,1225,0,1225,39,881,305,21.04.2019 21:30,216,24,Kiev (city)
2224,2213,11,765,1451,8,1459,0,1459,47,956,456,22.04.2019 01:05,216,24,Kiev (city)
2096,2078,10,745,1346,5,1351,0,1351,40,938,373,22.04.2019 00:10,216,24,Kiev (city)
2064,2065,6,728,1333,3,1336,0,1336,43,869,424,21.04.2019 22:15,216,24,Kiev (city)
2000,1979,15,676,1314,10,1324,0,1324,42,856,426,21.04.2019 20:55,216,24,Kiev (city)
2480,2463,7,876,1600,4,1604,0,1604,47,1019,538,22.04.2019 00:30,216,24,Kiev (city)
2624,2596,4,1312,1309,3,1312,0,1312,26,995,291,22.04.2019 01:30,216,24,Kiev (city)
2128,2120,12,725,1394,9,1403,0,1403,27,998,378,22.04.2019 00:09,216,24,Kiev (city)
2336,2304,10,911,1423,2,1425,0,1425,41,990,394,22.04.2019 00:30,216,24,Kiev (city)
816,804,0,341,475,0,475,0,475,11,349,115,21.04.2019 22:00,216,24,Kiev (city)
2304,2296,6,725,1576,3,1579,0,1579,53,994,532,22.04.2019 04:10,216,24,Kiev (city)
2048,2043,7,705,1337,6,1343,0,1344,39,911,394,22.04.2019 00:13,216,24,Kiev (city)
2304,2289,6,855,1445,4,1449,0,1449,34,1063,352,21.04.2019 21:16,216,24,Kiev (city)
2112,2082,2,797,1313,2,1315,0,1315,31,916,368,22.04.2019 00:40,216,24,Kiev (city)
2256,2232,2,936,1320,0,1320,0,1320,44,856,420,22.04.2019 01:00,216,24,Kiev (city)
2000,1978,4,711,1288,1,1289,0,1289,41,854,394,21.04.2019 21:10,216,24,Kiev (city)
2224,2210,11,749,1467,8,1475,0,1475,46,893,536,22.04.2019 00:10,216,24,Kiev (city)
1808,1789,12,579,1220,9,1229,0,1229,38,775,416,22.04.2019 00:15,216,24,Kiev (city)
1632,1625,4,556,1075,1,1076,0,1076,36,672,368,22.04.2019 00:15,216,24,Kiev (city)
2176,2193,14,811,1352,13,1365,0,1365,45,871,449,22.04.2019 00:15,216,24,Kiev (city)
2336,2382,14,804,1527,5,1532,0,1532,44,973,515,21.04.2019 21:45,216,24,Kiev (city)
2224,2204,8,883,1336,5,1341,0,1341,45,828,468,22.04.2019 00:14,216,24,Kiev (city)
2144,2250,8,713,1428,3,1431,0,1431,38,902,491,22.04.2019 00:10,216,24,Kiev (city)
2448,2466,12,794,1646,8,1654,0,1654,53,994,607,22.04.2019 00:12,216,24,Kiev (city)
2336,2340,18,862,1460,14,1474,0,1474,49,945,480,22.04.2019 00:20,216,24,Kiev (city)
2400,2381,3,896,1504,0,1504,0,1504,37,1003,464,21.04.2019 21:18,216,24,Kiev (city)
2432,2446,11,921,1504,7,1511,0,1511,44,1016,451,22.04.2019 00:20,216,24,Kiev (city)
2448,2444,13,984,1456,8,1464,0,1464,43,931,490,22.04.2019 00:40,216,24,Kiev (city)
2464,2451,5,833,1626,5,1631,0,1631,46,1045,540,22.04.2019 00:55,216,24,Kiev (city)
2400,2359,14,1055,1336,9,1345,0,1345,35,908,402,22.04.2019 00:20,216,24,Kiev (city)
1584,1567,6,689,889,6,895,0,895,16,559,320,21.04.2019 21:10,216,24,Kiev (city)
2112,2120,8,706,1398,8,1406,0,1406,38,900,468,22.04.2019 00:55,216,24,Kiev (city)
2064,2057,3,773,1289,2,1291,0,1291,31,804,456,22.04.2019 00:14,216,24,Kiev (city)
1424,1413,2,583,839,2,841,0,841,31,564,246,22.04.2019 02:45,216,24,Kiev (city)
1936,1917,12,767,1160,9,1169,0,1169,26,769,374,22.04.2019 00:19,216,24,Kiev (city)
2304,2277,9,861,1437,6,1443,0,1443,39,957,447,21.04.2019 22:30,216,24,Kiev (city)
1664,1608,5,1089,574,1,575,0,575,13,342,220,21.04.2019 22:15,216,24,Kiev (city)
2256,2233,14,836,1410,10,1420,0,1420,26,965,429,21.04.2019 21:10,216,24,Kiev (city)
2400,2365,3,1151,1247,2,1249,0,1249,22,908,319,21.04.2019 21:30,216,24,Kiev (city)
2304,2291,10,866,1433,5,1438,0,1438,32,915,491,22.04.2019 00:25,216,24,Kiev (city)
1680,1669,4,598,1080,2,1082,0,1082,20,676,386,21.04.2019 21:15,216,24,Kiev (city)
2400,2446,9,892,1500,8,1508,0,1508,39,973,496,22.04.2019 00:35,216,24,Kiev (city)
2304,2308,5,770,1529,5,1534,0,1534,39,1013,482,22.04.2019 00:09,216,24,Kiev (city)
2288,2346,11,784,1499,5,1504,0,1504,52,923,529,22.04.2019 00:30,216,24,Kiev (city)
1440,1455,7,538,897,5,902,0,902,38,598,266,21.04.2019 21:45,216,24,Kiev (city)
1232,1224,4,372,858,2,860,0,860,28,518,314,22.04.2019 01:10,216,24,Kiev (city)
2416,2432,6,1049,1365,2,1367,0,1367,27,869,471,22.04.2019 00:05,217,24,Kiev (city)
2064,2070,22,760,1289,15,1304,0,1303,37,795,471,22.04.2019 00:20,217,24,Kiev (city)
2160,2173,12,703,1453,4,1457,0,1457,53,844,560,22.04.2019 00:30,217,24,Kiev (city)
2208,2231,8,719,1483,6,1489,0,1489,46,877,566,22.04.2019 00:16,217,24,Kiev (city)
1968,1993,17,634,1322,12,1334,0,1334,45,803,486,22.04.2019 00:25,217,24,Kiev (city)
2160,2199,11,655,1498,7,1505,0,1505,49,884,572,22.04.2019 00:08,217,24,Kiev (city)
2128,2151,19,624,1490,14,1504,0,1503,47,843,613,21.04.2019 22:40,217,24,Kiev (city)
2112,2142,17,627,1472,13,1485,0,1485,46,790,649,21.04.2019 22:00,217,24,Kiev (city)
2096,2148,20,665,1415,16,1431,0,1431,33,836,562,22.04.2019 03:30,217,24,Kiev (city)
2144,2199,20,667,1466,11,1477,0,1477,48,902,527,22.04.2019 00:10,217,24,Kiev (city)
2016,2018,12,733,1274,9,1283,0,1283,26,836,421,22.04.2019 01:05,217,24,Kiev (city)
2208,2240,22,649,1545,14,1559,0,1559,35,940,584,22.04.2019 01:15,217,24,Kiev (city)
2032,2061,18,660,1356,16,1372,0,1372,32,866,474,22.04.2019 00:10,217,24,Kiev (city)
2160,2183,14,718,1433,9,1442,0,1442,44,835,563,22.04.2019 00:15,217,24,Kiev (city)
2096,2133,14,653,1436,7,1443,0,1443,46,838,559,21.04.2019 22:15,217,24,Kiev (city)
2384,2470,4,671,1710,3,1713,0,1713,39,907,767,22.04.2019 00:10,217,24,Kiev (city)
2352,2500,3,576,1773,3,1776,0,1776,41,987,748,21.04.2019 21:45,217,24,Kiev (city)
1904,1910,5,574,1326,4,1330,0,1330,41,789,500,22.04.2019 00:10,217,24,Kiev (city)
2192,2218,5,625,1563,4,1567,0,1567,45,871,651,22.04.2019 00:30,217,24,Kiev (city)
2128,2154,4,549,1576,3,1579,0,1579,53,923,603,21.04.2019 22:40,217,24,Kiev (city)
2032,2205,17,433,1588,11,1599,0,1599,44,939,616,21.04.2019 22:10,217,24,Kiev (city)
2160,2234,11,627,1525,8,1533,0,1533,39,879,615,22.04.2019 00:35,217,24,Kiev (city)
1856,1888,7,590,1261,5,1266,0,1266,41,727,498,21.04.2019 23:27,217,24,Kiev (city)
1808,1835,14,543,1254,11,1265,0,1265,47,744,474,21.04.2019 23:40,217,24,Kiev (city)
1792,1849,8,542,1248,2,1250,0,1249,45,719,485,21.04.2019 22:18,217,24,Kiev (city)
1648,1720,15,458,1180,10,1190,0,1190,38,720,432,22.04.2019 03:35,217,24,Kiev (city)
2048,2102,15,659,1380,9,1389,0,1389,34,826,529,22.04.2019 01:15,217,24,Kiev (city)
2112,2199,24,623,1471,18,1489,0,1489,47,867,575,22.04.2019 00:10,217,24,Kiev (city)
1824,1867,12,545,1270,9,1279,0,1279,57,726,496,21.04.2019 22:15,217,24,Kiev (city)
2080,2119,6,602,1476,2,1478,0,1478,45,861,572,21.04.2019 21:30,217,24,Kiev (city)
1600,1666,16,468,1121,11,1132,0,1132,35,701,396,21.04.2019 22:40,217,24,Kiev (city)
2240,2148,11,689,1542,9,1551,0,1551,57,892,602,22.04.2019 00:30,217,24,Kiev (city)
2000,2032,20,640,1346,14,1360,0,1360,36,797,527,21.04.2019 22:40,217,24,Kiev (city)
1936,1984,11,572,1358,6,1364,0,1364,40,812,512,21.04.2019 22:30,217,24,Kiev (city)
2176,2234,10,640,1533,3,1536,0,1536,45,894,597,21.04.2019 22:34,217,24,Kiev (city)
2256,2276,20,669,1575,12,1587,0,1587,53,904,630,21.04.2019 23:06,217,24,Kiev (city)
2238,2314,12,622,1611,5,1616,0,1616,58,932,626,21.04.2019 21:25,217,24,Kiev (city)
2208,2228,15,716,1482,10,1492,0,1492,48,895,549,21.04.2019 22:10,217,24,Kiev (city)
2032,2076,6,591,1436,5,1441,0,1441,53,813,575,21.04.2019 22:00,217,24,Kiev (city)
2128,2145,14,685,1433,10,1443,0,1443,49,827,567,21.04.2019 22:50,217,24,Kiev (city)
2128,2145,11,718,1402,8,1410,0,1410,39,863,508,22.04.2019 00:12,217,24,Kiev (city)
1808,1831,12,612,1187,9,1196,0,1196,27,755,414,21.04.2019 23:20,217,24,Kiev (city)
2304,2328,16,735,1558,11,1569,0,1569,29,1012,528,21.04.2019 23:05,217,24,Kiev (city)
2192,2210,18,712,1465,15,1480,0,1480,44,897,539,21.04.2019 21:58,217,24,Kiev (city)
2304,2304,8,768,1533,3,1536,0,1536,39,934,563,22.04.2019 00:30,217,24,Kiev (city)
2192,2194,12,748,1439,5,1444,0,1444,49,862,533,22.04.2019 02:23,217,24,Kiev (city)
2128,2119,9,619,1504,5,1509,0,1509,39,858,612,22.04.2019 00:20,217,24,Kiev (city)
2144,2141,7,642,1497,5,1502,0,1501,50,820,631,21.04.2019 23:00,217,24,Kiev (city)
2096,2106,14,678,1409,9,1418,0,1418,49,803,566,21.04.2019 22:32,217,24,Kiev (city)
2304,2331,15,719,1575,10,1585,0,1585,38,918,629,22.04.2019 00:14,217,24,Kiev (city)
2000,2033,15,664,1324,12,1336,0,1336,38,784,514,22.04.2019 00:05,217,24,Kiev (city)
2256,2216,1,914,1342,0,1342,0,1340,28,822,490,21.04.2019 23:15,217,24,Kiev (city)
2144,2157,13,657,1477,10,1487,0,1487,46,881,560,22.04.2019 00:15,217,24,Kiev (city)
2256,2265,10,759,1488,9,1497,0,1497,54,910,533,22.04.2019 00:45,217,24,Kiev (city)
2176,2173,4,763,1410,3,1413,0,1413,54,866,493,22.04.2019 00:30,217,24,Kiev (city)
1984,1986,14,635,1338,11,1349,0,1349,39,808,502,21.04.2019 22:12,217,24,Kiev (city)
2048,2069,11,681,1361,6,1367,0,1367,45,844,478,21.04.2019 23:55,217,24,Kiev (city)
1808,1815,0,890,918,0,918,0,918,26,645,247,22.04.2019 00:40,217,24,Kiev (city)
1904,1962,7,668,1230,6,1236,0,1236,34,712,490,22.04.2019 00:05,217,24,Kiev (city)
2208,2240,11,729,1472,7,1479,0,1479,58,877,544,22.04.2019 00:05,217,24,Kiev (city)
2128,2213,6,547,1577,4,1581,0,1581,49,858,674,22.04.2019 01:20,217,24,Kiev (city)
2208,2249,17,714,1481,13,1494,0,1494,53,894,547,21.04.2019 21:59,217,24,Kiev (city)
2112,2123,20,663,1437,12,1449,0,1449,49,899,501,21.04.2019 22:00,217,24,Kiev (city)
2320,2361,15,720,1594,6,1600,0,1600,41,909,650,22.04.2019 00:20,217,24,Kiev (city)
1984,1997,6,582,1398,4,1402,0,1402,38,864,500,21.04.2019 22:12,217,24,Kiev (city)
2112,2176,11,717,1389,6,1395,0,1395,45,826,524,22.04.2019 00:30,217,24,Kiev (city)
2000,2060,11,691,1304,5,1309,0,1309,45,801,463,21.04.2019 22:00,217,24,Kiev (city)
2000,2059,21,551,1432,17,1449,0,1449,41,841,567,22.04.2019 00:10,217,24,Kiev (city)
1824,1817,7,556,1261,7,1268,0,1268,26,754,488,21.04.2019 21:45,217,24,Kiev (city)
2384,2467,13,685,1692,7,1699,0,1699,51,989,659,22.04.2019 00:45,217,24,Kiev (city)
2064,2054,17,700,1348,16,1364,0,1363,37,799,527,22.04.2019 00:05,217,24,Kiev (city)
2128,2183,13,746,1375,7,1382,0,1381,48,855,478,22.04.2019 00:10,217,24,Kiev (city)
2016,2033,13,595,1413,8,1421,0,1421,55,872,494,22.04.2019 00:18,217,24,Kiev (city)
128,35,0,93,35,0,35,0,35,1,19,15,21.04.2019 20:35,217,24,Kiev (city)
96,18,0,78,18,0,18,0,18,2,10,6,21.04.2019 20:21,217,24,Kiev (city)
1904,1924,13,572,1321,11,1332,0,1332,29,797,506,22.04.2019 00:28,218,24,Kiev (city)
2176,2209,18,693,1476,7,1483,0,1483,30,955,498,22.04.2019 04:18,218,24,Kiev (city)
2144,2155,9,717,1418,9,1427,0,1427,52,829,546,22.04.2019 00:05,218,24,Kiev (city)
2128,2160,6,632,1491,5,1496,0,1496,39,919,538,22.04.2019 00:25,218,24,Kiev (city)
2144,2141,7,767,1374,3,1377,0,1377,35,795,547,21.04.2019 23:00,218,24,Kiev (city)
2320,2322,24,800,1501,19,1520,0,1520,29,981,510,22.04.2019 00:10,218,24,Kiev (city)
2144,2172,17,670,1461,13,1474,0,1474,31,982,461,22.04.2019 00:10,218,24,Kiev (city)
2208,2214,12,819,1379,10,1389,0,1389,41,839,509,21.04.2019 22:15,218,24,Kiev (city)
2400,2433,15,830,1558,12,1570,0,1570,41,1012,517,22.04.2019 00:10,218,24,Kiev (city)
2272,2304,19,754,1502,16,1518,0,1518,43,894,581,22.04.2019 00:10,218,24,Kiev (city)
2240,2264,12,720,1513,7,1520,0,1520,48,867,605,22.04.2019 03:20,218,24,Kiev (city)
2160,2187,8,666,1488,6,1494,0,1494,56,891,547,22.04.2019 00:30,218,24,Kiev (city)
2096,2114,22,772,1308,16,1324,0,1323,26,816,481,22.04.2019 04:39,218,24,Kiev (city)
2192,2189,8,762,1424,6,1430,0,1430,35,936,459,22.04.2019 00:17,218,24,Kiev (city)
2112,2110,14,740,1361,11,1372,0,1372,37,875,460,22.04.2019 00:05,218,24,Kiev (city)
1968,1971,3,620,1346,2,1348,0,1348,33,881,434,22.04.2019 00:40,218,24,Kiev (city)
2080,2071,6,663,1414,3,1417,0,1417,49,878,490,21.04.2019 22:10,218,24,Kiev (city)
2064,2057,8,613,1445,6,1451,0,1451,53,897,501,22.04.2019 00:38,218,24,Kiev (city)
2288,2306,15,710,1570,8,1578,0,1576,48,956,572,22.04.2019 01:15,218,24,Kiev (city)
2224,2406,9,474,1746,4,1750,0,1749,56,1022,671,22.04.2019 00:30,218,24,Kiev (city)
2224,2258,10,800,1419,5,1424,0,1424,30,929,465,22.04.2019 00:15,218,24,Kiev (city)
2064,2072,8,784,1275,5,1280,0,1280,36,827,417,22.04.2019 00:10,218,24,Kiev (city)
2192,2203,11,826,1359,7,1366,0,1366,26,871,469,22.04.2019 00:45,218,24,Kiev (city)
2096,2101,10,723,1366,7,1373,0,1373,42,896,435,22.04.2019 00:15,218,24,Kiev (city)
2240,2329,5,616,1620,4,1624,0,1624,33,983,608,22.04.2019 00:15,218,24,Kiev (city)
2304,2410,4,674,1629,1,1630,0,1630,39,1009,582,22.04.2019 00:10,218,24,Kiev (city)
1248,1281,14,395,842,11,853,0,853,30,529,294,22.04.2019 00:30,218,24,Kiev (city)
976,1024,9,265,704,7,711,0,711,12,468,231,22.04.2019 00:11,218,24,Kiev (city)
1424,1488,17,458,955,11,966,0,966,28,642,296,22.04.2019 00:05,218,24,Kiev (city)
144,5,0,139,5,0,5,0,5,1,4,0,21.04.2019 20:39,218,24,Kiev (city)
528,146,15,388,125,15,140,0,140,10,104,26,22.04.2019 00:05,218,24,Kiev (city)
288,59,19,232,37,19,56,0,56,3,40,13,21.04.2019 20:55,218,24,Kiev (city)
960,269,142,738,111,111,222,0,222,4,157,61,21.04.2019 22:00,218,24,Kiev (city)
2144,2164,7,678,1460,6,1466,0,1466,41,796,629,22.04.2019 00:10,218,24,Kiev (city)
2384,2378,21,800,1570,14,1584,0,1584,48,1015,521,21.04.2019 23:30,218,24,Kiev (city)
2272,2265,10,764,1500,8,1508,0,1508,61,910,537,21.04.2019 21:27,218,24,Kiev (city)
1952,1947,12,708,1236,8,1244,0,1244,30,652,562,22.04.2019 00:05,218,24,Kiev (city)
2016,2000,6,750,1263,3,1266,0,1266,26,769,471,21.04.2019 22:00,218,24,Kiev (city)
2176,2163,9,755,1414,7,1421,0,1421,48,806,567,22.04.2019 00:01,218,24,Kiev (city)
1808,1800,6,632,1173,3,1176,0,1176,21,724,431,22.04.2019 02:15,218,24,Kiev (city)
2480,2474,4,808,1668,4,1672,0,1672,30,1008,634,22.04.2019 00:30,218,24,Kiev (city)
2400,2392,4,694,1703,3,1706,0,1706,36,982,688,22.04.2019 00:15,218,24,Kiev (city)
2160,2176,6,700,1455,5,1460,0,1460,46,840,574,22.04.2019 00:15,218,24,Kiev (city)
2128,2125,2,690,1437,1,1438,0,1438,39,861,538,21.04.2019 22:36,218,24,Kiev (city)
2304,2301,5,728,1573,3,1576,0,1576,49,911,616,22.04.2019 00:02,218,24,Kiev (city)
2224,2249,4,705,1518,1,1519,0,1519,32,893,594,22.04.2019 00:10,218,24,Kiev (city)
2160,2155,8,745,1407,8,1415,0,1415,39,801,575,22.04.2019 00:50,218,24,Kiev (city)
2240,2260,12,707,1527,6,1533,0,1533,37,922,574,22.04.2019 00:09,218,24,Kiev (city)
1520,1569,1,431,1088,1,1089,0,1089,13,650,426,22.04.2019 00:10,218,24,Kiev (city)
2016,2023,6,668,1344,4,1348,0,1348,52,758,538,22.04.2019 00:55,218,24,Kiev (city)
2016,2003,7,683,1327,6,1333,0,1333,28,819,486,21.04.2019 21:15,218,24,Kiev (city)
2192,2187,6,720,1466,6,1472,0,1472,32,899,541,22.04.2019 00:15,218,24,Kiev (city)
2144,2131,6,728,1411,5,1416,0,1416,47,866,503,21.04.2019 23:30,218,24,Kiev (city)
2560,2560,9,800,1757,3,1760,0,1760,59,965,736,22.04.2019 00:10,218,24,Kiev (city)
2192,2250,9,724,1464,4,1468,0,1468,44,857,567,21.04.2019 22:20,218,24,Kiev (city)
2144,2141,5,618,1523,3,1526,0,1526,46,814,666,21.04.2019 23:15,218,24,Kiev (city)
2320,2320,7,726,1590,4,1594,0,1594,45,871,678,21.04.2019 21:48,218,24,Kiev (city)
2240,2268,3,744,1493,3,1496,0,1496,61,740,695,22.04.2019 00:20,218,24,Kiev (city)
2112,2113,6,600,1506,6,1512,0,1512,60,821,631,21.04.2019 22:00,218,24,Kiev (city)
2256,2264,1,795,1460,1,1461,0,1461,37,936,488,21.04.2019 21:45,218,24,Kiev (city)
2208,2233,5,665,1540,3,1543,0,1543,50,877,616,21.04.2019 22:08,218,24,Kiev (city)
2080,2063,7,649,1429,2,1431,0,1431,41,731,659,21.04.2019 21:19,218,24,Kiev (city)
2240,2238,13,779,1452,9,1461,0,1461,45,777,639,22.04.2019 00:05,218,24,Kiev (city)
2352,2396,18,684,1653,15,1668,0,1668,49,910,709,21.04.2019 22:00,218,24,Kiev (city)
2288,2340,10,726,1556,6,1562,0,1562,50,881,631,21.04.2019 21:03,218,24,Kiev (city)
2224,2216,5,714,1507,3,1510,0,1510,45,847,618,22.04.2019 00:15,218,24,Kiev (city)
2272,2250,9,857,1410,5,1415,0,1415,39,791,585,22.04.2019 00:10,218,24,Kiev (city)
1216,1199,1,473,743,0,743,0,743,23,457,263,22.04.2019 00:20,218,24,Kiev (city)
2304,2293,8,815,1481,8,1489,0,1489,59,872,558,22.04.2019 00:10,218,24,Kiev (city)
1888,1891,6,809,1074,5,1079,0,1079,30,702,347,22.04.2019 00:04,218,24,Kiev (city)
1744,1743,3,651,1090,3,1093,0,1093,34,647,412,22.04.2019 00:02,218,24,Kiev (city)
2048,2041,7,788,1255,5,1260,0,1260,48,806,406,22.04.2019 00:14,218,24,Kiev (city)
1344,1375,0,460,884,0,884,0,884,21,555,308,21.04.2019 21:25,218,24,Kiev (city)
64,52,2,19,45,0,45,0,45,7,23,15,21.04.2019 20:15,218,24,Kiev (city)
176,171,148,17,23,136,159,0,159,9,102,48,21.04.2019 21:20,218,24,Kiev (city)
2112,2122,4,615,1494,3,1497,0,1497,54,822,621,21.04.2019 22:55,218,24,Kiev (city)
1392,1405,3,438,952,2,954,0,953,40,553,360,22.04.2019 00:20,218,24,Kiev (city)
2464,2445,13,895,1562,7,1569,0,1569,44,930,595,22.04.2019 00:07,219,24,Kiev (city)
2368,2374,9,706,1655,7,1662,0,1662,42,971,649,22.04.2019 00:15,219,24,Kiev (city)
2352,2326,8,600,1745,7,1752,0,1752,56,937,759,22.04.2019 00:15,219,24,Kiev (city)
2256,2265,13,811,1433,12,1445,0,1445,27,889,529,22.04.2019 00:19,219,24,Kiev (city)
2368,2346,5,784,1580,4,1584,0,1584,29,965,590,22.04.2019 00:10,219,24,Kiev (city)
2448,2427,12,819,1624,5,1629,0,1629,57,971,601,22.04.2019 00:30,219,24,Kiev (city)
2352,2337,11,847,1495,10,1505,0,1505,28,912,565,22.04.2019 00:20,219,24,Kiev (city)
2144,2123,13,801,1337,6,1343,0,1343,28,839,476,22.04.2019 00:15,219,24,Kiev (city)
1616,1602,1,491,1124,1,1125,0,1125,30,696,399,22.04.2019 00:20,219,24,Kiev (city)
2272,2269,7,696,1569,7,1576,0,1576,30,957,589,22.04.2019 00:15,219,24,Kiev (city)
2064,2035,15,721,1333,10,1343,0,1343,36,805,502,22.04.2019 00:10,219,24,Kiev (city)
2272,2251,17,751,1511,10,1521,0,1521,30,919,572,22.04.2019 00:14,219,24,Kiev (city)
2224,2210,7,811,1408,5,1413,0,1413,35,883,495,22.04.2019 00:15,219,24,Kiev (city)
1712,1714,10,563,1144,5,1149,0,1149,26,732,391,22.04.2019 00:07,219,24,Kiev (city)
1488,1469,3,496,990,2,992,0,992,24,612,356,22.04.2019 00:10,219,24,Kiev (city)
1776,1763,5,668,1105,3,1108,0,1108,26,672,410,22.04.2019 00:13,219,24,Kiev (city)
2160,2157,7,732,1425,3,1428,0,1428,35,872,521,22.04.2019 00:05,219,24,Kiev (city)
1856,1853,9,633,1220,3,1223,0,1223,38,733,452,22.04.2019 00:11,219,24,Kiev (city)
1840,1830,11,746,1089,5,1094,0,1094,36,711,347,22.04.2019 00:15,219,24,Kiev (city)
1968,1978,13,704,1254,10,1264,0,1264,32,840,392,22.04.2019 01:35,219,24,Kiev (city)
1920,1938,17,661,1247,12,1259,0,1259,38,808,413,22.04.2019 00:20,219,24,Kiev (city)
2064,2046,8,695,1362,7,1369,0,1369,32,872,465,22.04.2019 00:05,219,24,Kiev (city)
2032,2027,9,686,1341,5,1346,0,1346,35,837,474,22.04.2019 00:05,219,24,Kiev (city)
2176,2162,7,827,1343,6,1349,0,1349,45,890,414,22.04.2019 00:20,219,24,Kiev (city)
1904,1902,15,664,1231,9,1240,0,1240,41,788,411,21.04.2019 22:25,219,24,Kiev (city)
1504,1500,11,487,1010,7,1017,0,1017,33,616,368,22.04.2019 00:01,219,24,Kiev (city)
1856,1836,21,655,1185,16,1201,0,1201,29,745,427,22.04.2019 00:15,219,24,Kiev (city)
2048,2037,16,658,1383,7,1390,0,1390,35,865,490,22.04.2019 00:30,219,24,Kiev (city)
2064,2064,10,734,1322,8,1330,0,1330,38,847,445,22.04.2019 00:30,219,24,Kiev (city)
2096,2092,15,795,1293,8,1301,0,1301,38,854,409,22.04.2019 00:12,219,24,Kiev (city)
2063,2035,11,754,1305,4,1309,0,1309,27,841,441,22.04.2019 00:07,219,24,Kiev (city)
1936,1925,18,647,1279,10,1289,0,1289,29,820,440,22.04.2019 00:30,219,24,Kiev (city)
2256,2267,18,741,1502,13,1515,0,1515,48,931,536,22.04.2019 00:09,219,24,Kiev (city)
2208,2227,4,558,1647,3,1650,0,1650,42,985,623,22.04.2019 00:14,219,24,Kiev (city)
1904,1890,14,621,1272,11,1283,0,1283,38,774,471,22.04.2019 00:20,219,24,Kiev (city)
2400,2391,8,904,1491,5,1496,0,1496,37,895,564,22.04.2019 00:17,219,24,Kiev (city)
1744,1734,9,691,1045,8,1053,0,1053,23,695,335,22.04.2019 00:01,219,24,Kiev (city)
2032,2024,9,719,1309,4,1313,0,1313,45,791,477,22.04.2019 00:30,219,24,Kiev (city)
1472,1459,4,469,1000,3,1003,0,1003,28,597,378,22.04.2019 00:10,219,24,Kiev (city)
1344,1346,1,360,983,1,984,0,984,28,567,389,22.04.2019 00:15,219,24,Kiev (city)
2192,2206,14,757,1427,8,1435,0,1435,38,883,514,22.04.2019 00:05,219,24,Kiev (city)
2208,2205,17,733,1464,11,1475,0,1475,36,935,504,22.04.2019 00:23,219,24,Kiev (city)
2176,2186,11,666,1504,6,1510,0,1510,49,908,553,22.04.2019 00:20,219,24,Kiev (city)
2352,2340,3,700,1650,2,1652,0,1652,41,912,699,22.04.2019 00:10,219,24,Kiev (city)
2224,2214,11,841,1378,5,1383,0,1383,46,803,534,22.04.2019 00:05,219,24,Kiev (city)
1872,1898,7,625,1241,6,1247,0,1247,38,774,435,22.04.2019 00:15,219,24,Kiev (city)
1712,1692,8,630,1075,7,1082,0,1082,30,706,346,21.04.2019 21:15,219,24,Kiev (city)
1840,1823,20,648,1177,15,1192,0,1192,36,736,420,22.04.2019 00:02,219,24,Kiev (city)
1696,1687,12,563,1126,7,1133,0,1133,40,730,363,22.04.2019 00:50,219,24,Kiev (city)
1984,1970,13,698,1278,8,1286,0,1286,27,786,473,22.04.2019 00:15,219,24,Kiev (city)
1712,1717,6,583,1125,4,1129,0,1129,45,719,365,22.04.2019 00:20,219,24,Kiev (city)
2176,2177,10,736,1432,8,1440,0,1440,50,879,511,22.04.2019 00:10,219,24,Kiev (city)
2240,2250,10,811,1425,4,1429,0,1429,34,932,463,22.04.2019 00:15,219,24,Kiev (city)
2272,2268,8,785,1483,4,1487,0,1487,38,910,539,22.04.2019 00:10,219,24,Kiev (city)
2096,2087,3,662,1431,3,1434,0,1434,55,905,474,22.04.2019 02:10,219,24,Kiev (city)
1920,1899,7,664,1251,5,1256,0,1256,29,818,409,22.04.2019 00:30,219,24,Kiev (city)
2032,2038,21,679,1340,13,1353,0,1353,32,829,492,22.04.2019 00:30,219,24,Kiev (city)
1872,1856,13,718,1146,8,1154,0,1154,41,748,365,22.04.2019 00:10,219,24,Kiev (city)
1776,1765,17,619,1145,12,1157,0,1157,24,735,398,22.04.2019 00:05,219,24,Kiev (city)
1872,1878,7,652,1216,4,1220,0,1220,44,742,434,22.04.2019 00:05,219,24,Kiev (city)
2096,2108,21,713,1364,19,1383,0,1383,48,889,446,22.04.2019 00:10,219,24,Kiev (city)
1936,1913,8,758,1171,7,1178,0,1171,20,750,401,22.04.2019 00:05,219,24,Kiev (city)
2256,2235,4,821,1432,3,1435,0,1435,32,910,493,22.04.2019 00:05,219,24,Kiev (city)
2192,2180,7,716,1471,5,1476,0,1476,43,796,637,22.04.2019 00:02,219,24,Kiev (city)
2192,2187,8,679,1510,3,1513,0,1513,47,848,618,22.04.2019 00:05,219,24,Kiev (city)
2368,2335,4,792,1575,1,1576,0,1576,38,964,574,22.04.2019 00:10,219,24,Kiev (city)
2320,2368,4,631,1686,3,1689,0,1689,52,857,780,22.04.2019 00:15,219,24,Kiev (city)
2304,2378,8,695,1604,5,1609,0,1609,37,913,659,22.04.2019 00:05,219,24,Kiev (city)
2320,2361,9,695,1617,8,1625,0,1625,51,995,579,21.04.2019 21:30,219,24,Kiev (city)
2192,2250,1,627,1565,0,1565,0,1565,44,942,579,22.04.2019 00:05,219,24,Kiev (city)
2256,2283,6,770,1483,3,1486,0,1486,45,835,606,22.04.2019 00:25,219,24,Kiev (city)
2368,2477,27,624,1726,18,1744,0,1744,54,975,715,21.04.2019 23:35,219,24,Kiev (city)
2224,2241,8,836,1381,7,1388,0,1388,43,862,483,21.04.2019 22:00,219,24,Kiev (city)
2128,2156,6,631,1491,6,1497,0,1497,40,825,632,22.04.2019 00:30,219,24,Kiev (city)
1744,1998,6,516,1222,6,1228,0,1228,41,784,403,22.04.2019 00:09,219,24,Kiev (city)
1840,1879,4,622,1215,3,1218,0,1218,35,678,505,22.04.2019 00:20,219,24,Kiev (city)
1952,1937,10,666,1276,10,1286,0,1286,26,751,509,22.04.2019 00:30,219,24,Kiev (city)
2112,2132,5,759,1350,3,1353,0,1353,38,821,494,22.04.2019 00:05,219,24,Kiev (city)
1008,997,3,343,662,3,665,0,665,21,390,254,22.04.2019 00:12,219,24,Kiev (city)
416,143,41,292,90,34,124,0,124,12,75,37,22.04.2019 00:30,219,24,Kiev (city)
240,24,0,221,19,0,19,0,19,0,17,2,21.04.2019 20:40,219,24,Kiev (city)
288,103,44,197,59,32,91,0,91,5,64,22,22.04.2019 00:20,219,24,Kiev (city)
560,91,14,476,72,12,84,0,84,2,59,23,22.04.2019 00:05,219,24,Kiev (city)
352,94,4,273,76,3,79,0,79,1,50,28,22.04.2019 00:05,219,24,Kiev (city)
560,549,0,173,387,0,387,0,387,9,212,166,21.04.2019 21:31,219,24,Kiev (city)
2272,2510,10,742,1525,5,1530,0,1530,46,824,660,22.04.2019 00:20,220,24,Kiev (city)
2176,2468,10,479,1692,5,1697,0,1697,58,825,814,22.04.2019 01:30,220,24,Kiev (city)
2736,2720,7,813,1916,7,1923,0,1923,54,1000,869,22.04.2019 01:05,220,24,Kiev (city)
2448,2528,10,756,1686,6,1692,0,1692,47,926,719,22.04.2019 00:02,220,24,Kiev (city)
2032,2075,9,678,1348,6,1354,0,1354,45,736,573,22.04.2019 00:30,220,24,Kiev (city)
2144,2209,11,705,1430,9,1439,0,1439,40,759,640,22.04.2019 00:10,220,24,Kiev (city)
2064,2097,14,811,1249,4,1253,0,1253,33,755,465,22.04.2019 00:05,220,24,Kiev (city)
2368,2398,8,748,1616,4,1620,0,1620,30,1016,574,22.04.2019 00:45,220,24,Kiev (city)
2320,2233,0,916,1404,0,1404,0,1404,21,632,751,22.04.2019 00:15,220,24,Kiev (city)
1584,1569,2,673,909,2,911,0,911,18,570,323,22.04.2019 00:15,220,24,Kiev (city)
2112,2130,14,707,1392,13,1405,0,1404,41,851,512,22.04.2019 00:01,220,24,Kiev (city)
2288,2322,8,948,1338,2,1340,0,1340,29,785,526,22.04.2019 00:50,220,24,Kiev (city)
2224,2232,6,747,1474,3,1477,0,1477,48,845,584,22.04.2019 00:20,220,24,Kiev (city)
2320,2310,15,844,1468,8,1476,0,1476,47,836,593,22.04.2019 00:05,220,24,Kiev (city)
2400,2398,11,837,1556,7,1563,0,1563,44,918,601,22.04.2019 00:20,220,24,Kiev (city)
1408,1414,8,554,850,4,854,0,854,27,553,274,22.04.2019 00:30,220,24,Kiev (city)
2384,2396,9,906,1472,6,1478,0,1478,45,958,475,22.04.2019 00:10,220,24,Kiev (city)
2432,2485,16,789,1630,13,1643,0,1643,44,920,679,22.04.2019 00:07,220,24,Kiev (city)
2448,2415,7,903,1540,5,1545,0,1545,39,1032,474,22.04.2019 00:05,220,24,Kiev (city)
2272,2268,8,660,1610,2,1612,0,1611,48,923,640,22.04.2019 00:42,220,24,Kiev (city)
2000,2005,16,725,1263,12,1275,0,1275,40,820,415,22.04.2019 00:16,220,24,Kiev (city)
1984,1967,11,744,1234,6,1240,0,1240,46,733,461,22.04.2019 00:10,220,24,Kiev (city)
1936,1928,11,706,1224,6,1230,0,1230,37,762,431,22.04.2019 00:08,220,24,Kiev (city)
2000,1964,11,731,1262,7,1269,0,1269,30,761,478,22.04.2019 00:23,220,24,Kiev (city)
2352,2341,5,848,1500,4,1504,0,1504,41,927,536,22.04.2019 00:10,220,24,Kiev (city)
2176,2181,1,719,1456,1,1457,0,1457,38,918,501,22.04.2019 00:30,220,24,Kiev (city)
2320,2306,7,751,1565,4,1569,0,1569,44,952,573,22.04.2019 00:50,220,24,Kiev (city)
2048,2027,5,659,1387,2,1389,0,1389,34,906,449,22.04.2019 00:20,220,24,Kiev (city)
2000,1998,2,659,1339,2,1341,0,1341,34,805,502,22.04.2019 00:30,220,24,Kiev (city)
2240,2248,7,729,1505,6,1511,0,1511,33,896,582,22.04.2019 00:15,220,24,Kiev (city)
1968,1953,13,684,1276,8,1284,0,1284,21,765,498,22.04.2019 00:15,220,24,Kiev (city)
2128,2115,2,659,1468,1,1469,0,1469,55,867,547,21.04.2019 22:00,220,24,Kiev (city)
2464,2489,7,777,1683,4,1687,0,1687,40,969,678,22.04.2019 00:05,220,24,Kiev (city)
2064,2068,6,698,1365,1,1366,0,1366,32,859,475,22.04.2019 00:01,220,24,Kiev (city)
2224,2203,9,731,1486,7,1493,0,1493,38,910,545,22.04.2019 00:45,220,24,Kiev (city)
2304,2291,7,774,1524,6,1530,0,1530,49,961,520,22.04.2019 00:05,220,24,Kiev (city)
2256,2226,13,826,1422,8,1430,0,1430,38,872,520,22.04.2019 03:58,220,24,Kiev (city)
2352,2326,4,1130,1219,3,1222,0,1222,36,751,435,22.04.2019 00:15,220,24,Kiev (city)
2416,2419,10,893,1516,7,1523,0,1523,45,953,525,22.04.2019 00:10,220,24,Kiev (city)
2336,2304,3,859,1476,1,1477,0,1477,44,948,485,22.04.2019 00:27,220,24,Kiev (city)
2176,2157,7,687,1485,4,1489,0,1489,49,819,621,22.04.2019 01:30,220,24,Kiev (city)
2400,2387,4,707,1691,2,1693,0,1693,58,941,694,22.04.2019 00:30,220,24,Kiev (city)
2320,2301,4,742,1576,2,1578,0,1578,38,910,630,22.04.2019 00:05,220,24,Kiev (city)
2192,2182,12,706,1477,9,1486,0,1486,41,828,617,22.04.2019 01:05,220,24,Kiev (city)
2304,2300,2,710,1594,0,1594,0,1594,54,898,642,22.04.2019 00:20,220,24,Kiev (city)
2064,2050,6,718,1343,3,1346,0,1346,39,834,473,22.04.2019 00:04,220,24,Kiev (city)
2272,2253,8,727,1541,4,1545,0,1545,46,931,568,22.04.2019 00:34,220,24,Kiev (city)
2368,2351,8,846,1514,8,1522,0,1522,52,932,538,22.04.2019 00:30,220,24,Kiev (city)
2256,2245,15,720,1526,10,1536,0,1536,35,1017,484,22.04.2019 00:07,220,24,Kiev (city)
2112,2088,11,671,1433,8,1441,0,1441,49,927,465,22.04.2019 00:05,220,24,Kiev (city)
1376,1368,12,484,885,7,892,0,892,26,602,264,22.04.2019 00:02,220,24,Kiev (city)
2240,2215,10,1003,1230,7,1237,0,1237,25,850,362,22.04.2019 00:05,220,24,Kiev (city)
2064,2039,18,809,1246,9,1255,0,1255,35,833,387,22.04.2019 00:12,220,24,Kiev (city)
2112,2093,12,810,1292,10,1302,0,1302,47,860,395,22.04.2019 00:07,220,24,Kiev (city)
2160,2142,19,863,1281,16,1297,0,1297,33,856,408,22.04.2019 02:00,220,24,Kiev (city)
2256,2232,8,814,1435,7,1442,0,1442,44,919,479,22.04.2019 03:11,220,24,Kiev (city)
2240,2228,1,825,1415,0,1415,0,1415,44,925,446,22.04.2019 00:10,220,24,Kiev (city)
2208,2213,10,817,1387,4,1391,0,1391,34,924,433,22.04.2019 00:18,220,24,Kiev (city)
2192,2176,6,825,1366,1,1367,0,1367,36,897,434,22.04.2019 00:03,220,24,Kiev (city)
2112,2078,8,646,1460,6,1466,0,1466,33,912,521,22.04.2019 00:37,220,24,Kiev (city)
2064,2037,4,652,1410,2,1412,0,1412,48,811,553,22.04.2019 00:05,220,24,Kiev (city)
2112,2115,7,697,1409,6,1415,0,1415,28,914,473,22.04.2019 00:10,220,24,Kiev (city)
1712,1696,12,559,1144,9,1153,0,1153,30,705,418,22.04.2019 00:10,220,24,Kiev (city)
2272,2228,17,873,1388,11,1399,0,1399,39,865,495,22.04.2019 00:15,220,24,Kiev (city)
144,26,5,118,21,5,26,0,26,0,18,8,22.04.2019 00:02,220,24,Kiev (city)
1328,222,29,1117,182,29,211,0,211,17,138,56,22.04.2019 00:10,220,24,Kiev (city)
240,35,24,208,10,22,32,0,32,1,23,8,22.04.2019 00:10,220,24,Kiev (city)
224,87,7,148,70,6,76,0,76,2,63,11,22.04.2019 00:05,220,24,Kiev (city)
208,46,0,164,44,0,44,0,44,1,27,16,21.04.2019 20:44,220,24,Kiev (city)
176,45,14,136,28,12,40,0,40,3,29,8,22.04.2019 00:02,220,24,Kiev (city)
64,24,1,41,22,1,23,0,23,1,15,7,22.04.2019 00:02,220,24,Kiev (city)
272,33,11,242,19,11,30,0,30,1,21,8,22.04.2019 00:10,220,24,Kiev (city)
2512,2466,2,1091,1419,2,1421,0,1421,32,811,578,22.04.2019 07:00,220,24,Kiev (city)
1536,1547,4,613,920,3,923,0,923,18,471,434,22.04.2019 00:13,220,24,Kiev (city)
2880,2888,1,850,2030,0,2030,0,2030,26,1119,885,22.04.2019 00:05,220,24,Kiev (city)
1472,1453,11,769,694,9,703,0,703,18,418,267,22.04.2019 00:30,220,24,Kiev (city)
32,13,0,19,13,0,13,0,13,0,9,4,21.04.2019 20:40,221,24,Kiev (city)
1856,1984,13,585,1266,5,1271,0,1271,46,682,543,22.04.2019 00:15,221,24,Kiev (city)
2032,2090,13,704,1319,9,1328,0,1328,42,708,578,22.04.2019 00:30,221,24,Kiev (city)
2448,2453,11,829,1612,7,1619,0,1618,45,931,642,22.04.2019 00:10,221,24,Kiev (city)
1840,2001,13,638,1195,7,1202,0,1202,39,574,589,22.04.2019 01:33,221,24,Kiev (city)
1216,1277,7,370,842,4,846,0,846,34,433,379,22.04.2019 03:30,221,24,Kiev (city)
1760,2097,16,318,1428,14,1442,0,1442,50,756,636,22.04.2019 00:03,221,24,Kiev (city)
1920,1918,14,659,1249,12,1261,0,1261,51,680,530,22.04.2019 00:15,221,24,Kiev (city)
2000,2212,12,470,1522,8,1530,0,1530,45,782,703,22.04.2019 00:40,221,24,Kiev (city)
1920,1997,30,606,1294,20,1314,0,1314,50,685,579,22.04.2019 00:35,221,24,Kiev (city)
2128,2198,19,681,1432,15,1447,0,1447,57,873,517,22.04.2019 01:10,221,24,Kiev (city)
2112,2175,6,749,1358,5,1363,0,1363,34,803,526,22.04.2019 00:10,221,24,Kiev (city)
2272,2380,19,693,1569,10,1579,0,1579,50,838,691,21.04.2019 22:16,221,24,Kiev (city)
2592,2553,2,1078,1512,2,1514,0,1514,37,867,610,22.04.2019 01:20,221,24,Kiev (city)
2416,2466,3,835,1578,3,1581,0,1580,52,901,627,21.04.2019 22:12,221,24,Kiev (city)
2144,2251,16,644,1486,14,1500,0,1500,48,762,690,22.04.2019 00:30,221,24,Kiev (city)
2416,2454,10,801,1608,7,1615,0,1615,39,888,688,21.04.2019 22:00,221,24,Kiev (city)
1152,1153,5,390,758,4,762,0,762,18,448,296,22.04.2019 00:10,221,24,Kiev (city)
2448,2404,6,1098,1345,5,1350,0,1350,35,910,405,22.04.2019 00:15,221,24,Kiev (city)
2240,2333,11,706,1526,8,1534,0,1534,45,765,724,22.04.2019 00:00,221,24,Kiev (city)
2352,2371,4,965,1383,4,1387,0,1387,51,807,529,22.04.2019 00:02,221,24,Kiev (city)
2480,2511,22,889,1578,13,1591,0,1591,47,908,636,22.04.2019 00:10,221,24,Kiev (city)
2336,2391,29,809,1510,17,1527,0,1527,65,852,610,22.04.2019 01:20,221,24,Kiev (city)
2240,2270,5,940,1295,5,1300,0,1300,34,825,441,21.04.2019 22:20,221,24,Kiev (city)
2239,2290,20,811,1414,14,1428,0,1428,41,865,522,22.04.2019 00:20,221,24,Kiev (city)
2128,2158,12,972,1147,9,1156,0,1156,69,716,371,22.04.2019 00:10,221,24,Kiev (city)
2240,2292,1,946,1293,1,1294,0,1294,42,917,335,22.04.2019 00:10,221,24,Kiev (city)
2288,2351,18,691,1584,13,1597,0,1597,47,929,621,22.04.2019 00:25,221,24,Kiev (city)
2144,2286,16,648,1487,9,1496,0,1496,55,807,634,22.04.2019 00:15,221,24,Kiev (city)
2432,2495,20,856,1559,17,1576,0,1576,44,808,724,22.04.2019 00:17,221,24,Kiev (city)
2032,2410,22,375,1643,14,1657,0,1657,56,923,678,21.04.2019 23:59,221,24,Kiev (city)
2176,2324,33,640,1512,24,1536,0,1536,45,914,577,21.04.2019 23:10,221,24,Kiev (city)
2608,2618,5,1077,1526,5,1531,0,1531,33,999,499,22.04.2019 00:05,221,24,Kiev (city)
2368,2511,26,694,1654,20,1674,0,1674,30,884,760,22.04.2019 00:40,221,24,Kiev (city)
2400,2448,21,760,1624,16,1640,0,1640,66,877,697,21.04.2019 23:00,221,24,Kiev (city)
2384,2421,26,897,1469,18,1487,0,1487,56,793,638,21.04.2019 22:50,221,24,Kiev (city)
1888,2044,9,613,1269,6,1275,0,1275,51,643,581,22.04.2019 00:05,221,24,Kiev (city)
1872,1962,11,545,1320,7,1327,0,1327,43,652,632,22.04.2019 00:21,221,24,Kiev (city)
2160,2298,15,699,1448,13,1461,0,1461,34,818,609,21.04.2019 21:55,221,24,Kiev (city)
2288,2313,13,820,1456,12,1468,0,1468,48,827,593,22.04.2019 00:10,221,24,Kiev (city)
1872,2003,11,553,1310,9,1319,0,1319,30,713,576,22.04.2019 00:30,221,24,Kiev (city)
2544,2531,22,948,1581,15,1596,0,1596,50,916,630,22.04.2019 00:25,221,24,Kiev (city)
224,60,9,168,47,9,56,0,56,2,34,20,21.04.2019 20:45,221,24,Kiev (city)
944,135,112,816,23,105,128,0,128,3,85,40,22.04.2019 04:15,221,24,Kiev (city)
176,53,0,123,53,0,53,0,53,0,41,12,21.04.2019 20:30,221,24,Kiev (city)
640,117,69,529,47,64,111,0,111,4,76,31,21.04.2019 20:45,221,24,Kiev (city)
144,31,0,113,31,0,31,0,31,0,24,7,21.04.2019 20:35,221,24,Kiev (city)
1024,323,195,718,128,178,306,0,306,8,210,88,22.04.2019 00:32,221,24,Kiev (city)
224,50,21,178,27,19,46,0,46,0,31,15,22.04.2019 00:05,221,24,Kiev (city)
224,105,0,121,103,0,103,0,103,1,75,27,21.04.2019 20:40,221,24,Kiev (city)
1888,1918,3,523,1362,3,1365,0,1365,58,715,592,22.04.2019 00:19,221,24,Kiev (city)
1696,1694,13,566,1121,9,1130,0,1130,29,663,438,22.04.2019 00:15,221,24,Kiev (city)
1232,1218,7,496,731,5,736,0,736,31,456,249,22.04.2019 00:15,221,24,Kiev (city)
2288,2275,5,894,1390,4,1394,0,1394,36,928,430,22.04.2019 00:45,221,24,Kiev (city)
2480,2459,9,935,1537,8,1545,0,1545,27,878,640,22.04.2019 00:10,221,24,Kiev (city)
2208,2215,10,764,1436,8,1444,0,1444,59,828,557,22.04.2019 00:40,221,24,Kiev (city)
2000,1991,17,724,1262,14,1276,0,1276,37,730,509,22.04.2019 00:40,221,24,Kiev (city)
1744,1744,20,559,1168,17,1185,0,1185,41,690,454,22.04.2019 01:00,221,24,Kiev (city)
2064,2042,13,734,1320,10,1330,0,1330,40,757,533,22.04.2019 00:05,221,24,Kiev (city)
1920,1934,10,671,1243,6,1249,0,1249,38,741,470,21.04.2019 23:19,221,24,Kiev (city)
2528,2560,8,781,1741,6,1747,0,1747,53,973,721,22.04.2019 00:31,221,24,Kiev (city)
2128,2183,3,838,1287,3,1290,0,1290,33,928,329,22.04.2019 00:47,221,24,Kiev (city)
2160,2150,9,766,1390,4,1394,0,1394,37,798,559,21.04.2019 22:20,221,24,Kiev (city)
1584,1589,10,509,1070,5,1075,0,1075,35,610,430,22.04.2019 00:05,221,24,Kiev (city)
2272,2268,9,717,1546,9,1555,0,1555,47,906,602,22.04.2019 00:30,221,24,Kiev (city)
2336,2354,14,753,1574,9,1583,0,1583,45,882,656,22.04.2019 04:58,221,24,Kiev (city)
2336,2478,5,738,1593,5,1598,0,1598,33,1101,464,22.04.2019 00:07,221,24,Kiev (city)
2144,2214,9,630,1507,7,1514,0,1514,50,854,610,21.04.2019 22:00,221,24,Kiev (city)
2288,2094,5,752,1533,3,1536,0,1536,31,1073,432,22.04.2019 00:30,221,24,Kiev (city)
2016,1992,1,617,1398,1,1399,0,1399,39,807,553,22.04.2019 00:25,221,24,Kiev (city)
2080,2073,2,618,1460,2,1462,0,1462,41,900,521,21.04.2019 22:20,221,24,Kiev (city)
2112,2093,1,643,1468,1,1469,0,1469,50,904,515,22.04.2019 00:05,221,24,Kiev (city)
2304,2322,9,748,1552,4,1556,0,1556,51,854,651,22.04.2019 00:12,221,24,Kiev (city)
1232,1235,5,449,781,2,783,0,783,20,479,284,22.04.2019 00:55,221,24,Kiev (city)
1280,1302,3,496,781,3,784,0,784,17,477,290,22.04.2019 00:04,221,24,Kiev (city)
1984,2025,5,636,1343,5,1348,0,1348,37,732,579,22.04.2019 00:28,221,24,Kiev (city)
1376,1393,18,417,944,15,959,0,959,33,575,351,22.04.2019 00:15,221,24,Kiev (city)
1712,1710,5,566,1143,3,1146,0,1146,27,669,450,22.04.2019 00:10,221,24,Kiev (city)
2032,2023,19,754,1264,14,1278,0,1278,32,727,519,22.04.2019 01:57,221,24,Kiev (city)
2336,2365,17,683,1642,11,1653,0,1653,54,986,613,22.04.2019 00:40,221,24,Kiev (city)
1728,1754,6,629,1094,5,1099,0,1099,21,649,429,22.04.2019 00:05,221,24,Kiev (city)
2256,2154,0,924,1332,0,1332,0,1332,25,604,703,21.04.2019 22:15,221,24,Kiev (city)
2256,2158,0,955,1301,0,1301,0,1301,16,590,695,21.04.2019 22:38,221,24,Kiev (city)
1808,1867,6,554,1251,3,1254,0,1254,35,690,529,21.04.2019 22:00,221,24,Kiev (city)
1360,1391,9,451,901,8,909,0,909,23,518,368,22.04.2019 00:40,221,24,Kiev (city)
2192,2220,7,857,1334,1,1335,0,1335,34,792,509,21.04.2019 22:50,221,24,Kiev (city)
384,102,19,304,61,19,80,0,80,3,61,16,21.04.2019 21:01,221,24,Kiev (city)
144,55,0,101,43,0,43,0,43,1,33,9,21.04.2019 20:30,221,24,Kiev (city)
672,220,65,465,150,57,207,0,207,8,146,53,22.04.2019 00:10,221,24,Kiev (city)
224,86,0,150,74,0,74,0,74,1,53,20,21.04.2019 20:45,221,24,Kiev (city)
352,76,31,278,45,29,74,0,74,3,53,18,21.04.2019 21:00,221,24,Kiev (city)
336,76,0,263,73,0,73,0,73,2,55,16,21.04.2019 21:30,221,24,Kiev (city)
144,34,10,116,21,7,28,0,28,0,20,8,21.04.2019 20:31,221,24,Kiev (city)
1744,1784,3,630,1111,3,1114,0,1114,38,547,529,22.04.2019 00:05,221,24,Kiev (city)
1648,1694,8,589,1055,4,1059,0,1059,37,547,475,21.04.2019 22:30,221,24,Kiev (city)
2160,2119,7,830,1326,4,1330,0,1330,34,646,650,21.04.2019 23:00,221,24,Kiev (city)
960,984,10,350,605,5,610,0,610,25,294,291,22.04.2019 05:40,221,24,Kiev (city)
832,847,6,280,548,4,552,0,552,21,267,264,21.04.2019 22:45,221,24,Kiev (city)
1264,1257,9,479,780,5,785,0,785,30,372,383,22.04.2019 00:30,221,24,Kiev (city)
1872,1928,9,612,1254,6,1260,0,1260,43,639,578,22.04.2019 01:20,221,24,Kiev (city)
96,28,0,74,22,0,22,0,22,0,14,8,21.04.2019 20:45,221,24,Kiev (city)
2096,2103,0,918,1178,0,1178,0,1178,23,813,342,22.04.2019 00:10,221,24,Kiev (city)
1888,1926,12,602,1278,8,1286,0,1286,41,757,488,22.04.2019 00:40,222,24,Kiev (city)
2016,2026,7,700,1311,5,1316,0,1316,25,848,443,22.04.2019 00:30,222,24,Kiev (city)
1984,2004,5,638,1342,4,1346,0,1346,39,797,510,21.04.2019 21:21,222,24,Kiev (city)
2112,2097,6,757,1350,5,1355,0,1355,53,764,538,22.04.2019 00:10,222,24,Kiev (city)
2592,2558,7,1317,1268,7,1275,0,1274,24,948,302,22.04.2019 00:10,222,24,Kiev (city)
2160,2175,8,788,1366,6,1372,0,1372,36,793,543,22.04.2019 00:30,222,24,Kiev (city)
2128,2131,13,737,1383,8,1391,0,1391,41,852,498,22.04.2019 00:15,222,24,Kiev (city)
1552,1549,13,631,913,8,921,0,921,23,566,332,22.04.2019 00:30,222,24,Kiev (city)
2416,2428,8,826,1586,4,1590,0,1590,39,963,588,21.04.2019 21:45,222,24,Kiev (city)
1888,1889,21,657,1222,9,1231,0,1231,31,752,448,21.04.2019 22:40,222,24,Kiev (city)
1680,1667,20,583,1080,17,1097,0,1097,27,700,370,22.04.2019 00:12,222,24,Kiev (city)
1904,2122,12,452,1443,9,1452,0,1452,41,921,490,21.04.2019 23:40,222,24,Kiev (city)
1728,1738,10,560,1163,5,1168,0,1168,28,696,444,21.04.2019 21:54,222,24,Kiev (city)
1760,1760,17,584,1165,11,1176,0,1176,28,645,503,22.04.2019 00:02,222,24,Kiev (city)
1920,1928,10,720,1192,8,1200,0,1200,37,646,517,21.04.2019 23:00,222,24,Kiev (city)
1984,2005,14,645,1331,8,1339,0,1339,58,769,512,22.04.2019 00:32,222,24,Kiev (city)
2304,2309,21,835,1455,14,1469,0,1469,43,860,566,22.04.2019 00:09,222,24,Kiev (city)
1680,1677,5,541,1137,2,1139,0,1139,36,665,438,22.04.2019 00:20,222,24,Kiev (city)
2272,2271,22,848,1407,17,1424,0,1424,32,822,570,22.04.2019 00:10,222,24,Kiev (city)
2256,2252,11,688,1562,6,1568,0,1568,39,890,639,22.04.2019 01:30,222,24,Kiev (city)
1760,1754,6,677,1078,5,1083,0,1083,30,736,317,22.04.2019 00:15,222,24,Kiev (city)
1840,1824,14,736,1094,10,1104,0,1104,19,717,368,21.04.2019 22:48,222,24,Kiev (city)
2480,2461,0,809,1671,0,1671,0,1671,44,816,811,21.04.2019 22:30,222,24,Kiev (city)
1584,1631,2,469,1113,2,1115,0,1115,35,629,451,22.04.2019 00:10,222,24,Kiev (city)
1600,1648,3,586,1013,1,1014,0,1014,12,670,332,22.04.2019 00:36,222,24,Kiev (city)
1664,1671,11,521,1134,9,1143,0,1143,33,641,469,22.04.2019 00:05,222,24,Kiev (city)
2080,2109,7,659,1417,4,1421,0,1421,53,788,580,22.04.2019 05:30,222,24,Kiev (city)
1840,1816,0,740,1100,0,1100,0,1100,40,800,260,21.04.2019 22:18,222,24,Kiev (city)
1632,1611,0,567,1065,0,1065,0,1065,33,695,337,21.04.2019 22:17,222,24,Kiev (city)
2464,2482,9,798,1659,7,1666,0,1666,60,921,685,21.04.2019 21:15,222,24,Kiev (city)
1968,1960,0,649,1319,0,1319,0,1319,49,860,410,21.04.2019 21:13,222,24,Kiev (city)
1760,1746,0,645,1115,0,1115,0,1115,41,753,321,21.04.2019 21:00,222,24,Kiev (city)
1792,1750,0,584,1208,0,1208,0,1208,44,797,367,21.04.2019 23:23,222,24,Kiev (city)
1664,1687,9,532,1125,7,1132,0,1132,40,640,452,21.04.2019 21:09,222,24,Kiev (city)
2256,2292,6,722,1530,4,1534,0,1534,50,816,668,22.04.2019 00:10,222,24,Kiev (city)
2096,2135,18,623,1455,18,1473,0,1473,56,845,572,22.04.2019 00:01,222,24,Kiev (city)
1920,1888,1,792,1127,1,1128,0,1128,42,741,345,22.04.2019 00:03,222,24,Kiev (city)
2304,2318,2,753,1549,2,1551,0,1551,58,862,631,21.04.2019 21:50,222,24,Kiev (city)
2288,2297,11,793,1486,9,1495,0,1495,29,853,613,22.04.2019 02:03,222,24,Kiev (city)
2320,2309,9,861,1451,8,1459,0,1459,40,848,571,22.04.2019 00:10,222,24,Kiev (city)
1904,1919,10,658,1236,10,1246,0,1246,32,709,505,21.04.2019 21:45,222,24,Kiev (city)
2144,2015,5,823,1318,3,1321,0,1321,25,933,363,21.04.2019 21:30,222,24,Kiev (city)
2064,2041,0,898,1166,0,1166,0,1166,19,769,378,21.04.2019 22:15,222,24,Kiev (city)
2320,2282,7,853,1461,6,1467,0,1467,56,857,554,21.04.2019 22:00,222,24,Kiev (city)
2432,2482,12,683,1739,10,1749,0,1749,49,1001,699,21.04.2019 22:05,222,24,Kiev (city)
1952,1965,7,691,1255,6,1261,0,1260,30,726,504,22.04.2019 00:03,222,24,Kiev (city)
1968,1971,8,679,1281,8,1289,0,1289,22,789,478,22.04.2019 02:08,222,24,Kiev (city)
2224,2207,12,839,1378,7,1385,0,1385,40,810,535,21.04.2019 21:40,222,24,Kiev (city)
2288,2279,10,803,1476,9,1485,0,1485,48,935,502,22.04.2019 00:09,222,24,Kiev (city)
1760,1759,10,660,1095,5,1100,0,1100,37,678,385,22.04.2019 00:15,222,24,Kiev (city)
1184,1185,15,472,700,12,712,0,712,13,435,264,21.04.2019 22:05,222,24,Kiev (city)
2224,2199,7,804,1417,3,1420,0,1420,38,864,518,22.04.2019 00:12,222,24,Kiev (city)
1632,1628,15,604,1018,10,1028,0,1028,48,567,413,21.04.2019 22:30,222,24,Kiev (city)
2080,2090,5,789,1289,2,1291,0,1291,34,782,475,22.04.2019 02:30,222,24,Kiev (city)
2032,2028,21,720,1293,19,1312,0,1312,24,752,536,21.04.2019 22:01,222,24,Kiev (city)
1648,1627,6,570,1076,2,1078,0,1078,30,678,370,21.04.2019 21:28,222,24,Kiev (city)
2032,2005,7,859,1169,4,1173,0,1173,33,827,313,21.04.2019 22:16,222,24,Kiev (city)
1856,1839,6,709,1143,4,1147,0,1147,36,719,392,21.04.2019 21:46,222,24,Kiev (city)
1664,1655,15,586,1069,9,1078,0,1078,29,667,382,22.04.2019 00:15,222,24,Kiev (city)
2048,2053,13,739,1297,12,1309,0,1309,36,859,414,21.04.2019 23:50,222,24,Kiev (city)
1392,1383,4,502,886,4,890,0,890,23,558,309,22.04.2019 00:32,222,24,Kiev (city)
2160,2147,34,778,1353,29,1382,0,1380,29,894,457,21.04.2019 21:37,222,24,Kiev (city)
2112,2103,23,782,1309,21,1330,0,1330,41,856,433,21.04.2019 21:05,222,24,Kiev (city)
2176,2177,15,770,1394,12,1406,0,1406,49,860,497,22.04.2019 00:03,222,24,Kiev (city)
2368,2370,21,823,1530,15,1545,0,1545,38,948,559,22.04.2019 00:08,222,24,Kiev (city)
1328,1318,7,441,881,6,887,0,887,28,505,354,21.04.2019 21:33,222,24,Kiev (city)
1824,1817,16,662,1150,12,1162,0,1161,36,711,414,22.04.2019 00:02,222,24,Kiev (city)
1472,1460,5,504,963,5,968,0,968,32,558,378,21.04.2019 22:00,222,24,Kiev (city)
1776,1724,16,671,1092,13,1105,0,1105,33,681,391,21.04.2019 21:49,222,24,Kiev (city)
1328,1323,18,501,817,10,827,0,827,18,514,295,21.04.2019 23:00,222,24,Kiev (city)
2128,2098,11,859,1261,8,1269,0,1269,47,808,414,22.04.2019 00:05,222,24,Kiev (city)
1984,1963,10,734,1241,9,1250,0,1250,26,814,410,22.04.2019 00:20,222,24,Kiev (city)
2336,2282,3,1333,1002,1,1003,0,1003,21,622,360,21.04.2019 22:05,222,24,Kiev (city)
2032,2008,4,665,1363,4,1367,0,1367,43,826,498,22.04.2019 00:15,222,24,Kiev (city)
1520,1520,0,664,856,0,856,0,856,25,601,230,21.04.2019 21:47,222,24,Kiev (city)
1536,1522,0,754,782,0,782,0,782,17,618,147,21.04.2019 22:53,222,24,Kiev (city)
2144,2125,1,835,1308,1,1309,0,1309,20,820,469,21.04.2019 21:57,222,24,Kiev (city)
2464,2502,12,843,1610,11,1621,0,1621,44,939,638,21.04.2019 21:43,222,24,Kiev (city)
2016,2002,6,681,1329,6,1335,0,1335,33,759,543,21.04.2019 21:35,222,24,Kiev (city)
1200,1316,0,440,760,0,760,0,760,22,524,214,22.04.2019 00:05,222,24,Kiev (city)
1952,1948,4,501,1448,3,1451,0,1451,39,833,579,22.04.2019 00:25,222,24,Kiev (city)
2320,2314,9,738,1577,5,1582,0,1582,40,921,621,21.04.2019 22:15,222,24,Kiev (city)
2240,2221,8,885,1349,6,1355,0,1355,45,771,539,22.04.2019 06:45,222,24,Kiev (city)
2480,2507,4,808,1668,4,1672,0,1672,43,1001,628,22.04.2019 00:10,222,24,Kiev (city)
512,124,123,388,1,123,124,0,124,4,76,44,21.04.2019 22:30,222,24,Kiev (city)
480,317,29,340,119,21,140,0,140,7,105,28,22.04.2019 00:07,222,24,Kiev (city)
1568,1578,8,572,988,8,996,0,996,23,578,395,21.04.2019 21:30,222,24,Kiev (city)
2416,2530,3,212,2201,3,2204,0,2204,155,1925,124,22.04.2019 01:30,223,24,Kiev (city)
64,74,0,15,49,0,49,0,49,0,40,9,21.04.2019 21:00,223,24,Kiev (city)
1344,1346,7,490,848,6,854,0,854,40,415,399,22.04.2019 00:15,223,24,Kiev (city)
1072,1094,5,327,741,4,745,0,745,27,397,321,22.04.2019 00:30,223,24,Kiev (city)
1488,1480,8,604,878,6,884,0,884,32,447,405,22.04.2019 00:23,223,24,Kiev (city)
1568,1576,6,474,1091,3,1094,0,1094,35,567,491,22.04.2019 00:45,223,24,Kiev (city)
784,781,8,261,518,5,523,0,523,20,267,236,22.04.2019 00:35,223,24,Kiev (city)
1056,1087,9,362,691,3,694,0,694,25,343,326,22.04.2019 00:30,223,24,Kiev (city)
1072,1071,3,319,751,2,753,0,753,35,365,353,22.04.2019 00:03,223,24,Kiev (city)
816,812,5,306,505,5,510,0,510,13,265,232,21.04.2019 20:51,223,24,Kiev (city)
1232,1220,7,416,809,7,816,0,816,21,402,393,22.04.2019 00:10,223,24,Kiev (city)
1616,1618,13,574,1037,5,1042,0,1042,50,508,484,22.04.2019 00:10,223,24,Kiev (city)
2080,2094,13,792,1278,10,1288,0,1288,48,629,611,22.04.2019 00:02,223,24,Kiev (city)
1552,1535,11,625,920,7,927,0,927,37,475,415,22.04.2019 00:17,223,24,Kiev (city)
1712,1715,11,505,1203,4,1207,0,1207,45,626,536,22.04.2019 01:15,223,24,Kiev (city)
1408,1428,13,486,912,10,922,0,922,26,471,425,22.04.2019 03:45,223,24,Kiev (city)
2000,2007,8,711,1284,5,1289,0,1289,34,708,547,22.04.2019 00:05,223,24,Kiev (city)
2480,2495,12,813,1657,10,1667,0,1667,53,881,733,22.04.2019 00:15,223,24,Kiev (city)
1120,1136,10,414,697,9,706,0,706,23,416,267,22.04.2019 00:03,223,24,Kiev (city)
1344,1329,4,501,841,2,843,0,843,29,427,387,21.04.2019 22:30,223,24,Kiev (city)
1360,1368,6,511,844,5,849,0,849,22,446,381,22.04.2019 00:08,223,24,Kiev (city)
2496,2471,5,897,1595,4,1599,0,1599,44,904,651,21.04.2019 23:30,223,24,Kiev (city)
2448,2432,3,827,1619,2,1621,0,1621,44,881,696,22.04.2019 00:14,223,24,Kiev (city)
2400,2384,14,876,1516,8,1524,0,1524,46,869,609,21.04.2019 23:49,223,24,Kiev (city)
2240,2246,13,754,1476,10,1486,0,1486,48,788,650,22.04.2019 00:30,223,24,Kiev (city)
2304,2286,15,760,1535,9,1544,0,1544,41,833,670,22.04.2019 00:50,223,24,Kiev (city)
2320,2317,10,710,1600,10,1610,0,1610,45,846,719,22.04.2019 00:30,223,24,Kiev (city)
2368,2350,6,790,1574,4,1578,0,1578,50,846,682,22.04.2019 00:10,223,24,Kiev (city)
2432,2414,9,869,1554,9,1563,0,1563,40,859,664,22.04.2019 00:35,223,24,Kiev (city)
2336,2259,4,930,1403,3,1406,0,1406,31,811,564,21.04.2019 21:47,223,24,Kiev (city)
2480,2494,18,865,1601,14,1615,0,1615,66,854,695,22.04.2019 00:15,223,24,Kiev (city)
2080,2091,16,750,1318,12,1330,0,1330,36,718,576,22.04.2019 00:47,223,24,Kiev (city)
2384,2352,8,882,1497,5,1502,0,1502,38,881,583,22.04.2019 00:45,223,24,Kiev (city)
2224,2219,10,700,1519,5,1524,0,1524,61,830,633,22.04.2019 00:05,223,24,Kiev (city)
2416,2428,15,826,1580,10,1590,0,1590,46,850,694,22.04.2019 00:18,223,24,Kiev (city)
2192,2202,18,728,1451,13,1464,0,1464,53,764,647,22.04.2019 00:23,223,24,Kiev (city)
2080,2120,17,624,1445,11,1456,0,1456,65,821,570,22.04.2019 00:22,223,24,Kiev (city)
2192,2198,9,720,1464,8,1472,0,1472,58,833,581,21.04.2019 23:10,223,24,Kiev (city)
2080,2086,13,789,1282,9,1291,0,1291,31,710,550,22.04.2019 00:30,223,24,Kiev (city)
2064,1943,1,776,1287,1,1288,0,1288,32,810,446,22.04.2019 00:07,223,24,Kiev (city)
2112,2120,8,882,1226,4,1230,0,1230,29,752,449,22.04.2019 01:05,223,24,Kiev (city)
2208,2209,7,779,1423,6,1429,0,1429,32,709,688,22.04.2019 00:05,223,24,Kiev (city)
2464,2488,16,821,1629,14,1643,0,1643,71,930,642,21.04.2019 22:44,223,24,Kiev (city)
2288,2319,15,759,1520,9,1529,0,1529,45,832,652,22.04.2019 00:25,223,24,Kiev (city)
2416,2416,10,861,1548,7,1555,0,1555,42,916,597,22.04.2019 00:05,223,24,Kiev (city)
2288,2279,16,871,1409,8,1417,0,1417,40,824,553,21.04.2019 21:04,223,24,Kiev (city)
2336,2326,14,900,1426,10,1436,0,1436,42,833,561,22.04.2019 00:05,223,24,Kiev (city)
2208,2200,10,802,1398,8,1406,0,1406,39,809,557,22.04.2019 00:15,223,24,Kiev (city)
1520,1533,3,569,949,2,951,0,951,31,582,338,22.04.2019 00:05,223,24,Kiev (city)
2000,2001,3,836,1162,2,1164,0,1164,38,674,452,22.04.2019 00:35,223,24,Kiev (city)
1728,1717,11,623,1098,7,1105,0,1105,36,657,412,22.04.2019 00:25,223,24,Kiev (city)
1616,1610,8,602,1009,5,1014,0,1014,27,585,402,22.04.2019 00:06,223,24,Kiev (city)
1696,1697,11,616,1071,9,1080,0,1080,35,623,421,22.04.2019 00:22,223,24,Kiev (city)
1984,2024,7,642,1338,4,1342,0,1342,36,742,564,22.04.2019 00:15,223,24,Kiev (city)
1824,1835,7,699,1120,5,1125,0,1125,30,633,462,21.04.2019 21:40,223,24,Kiev (city)
1568,1555,10,587,974,7,981,0,981,26,561,394,22.04.2019 00:20,223,24,Kiev (city)
1440,1438,12,502,931,7,938,0,938,18,527,393,21.04.2019 22:00,223,24,Kiev (city)
2064,2054,9,778,1283,3,1286,0,1286,14,764,508,22.04.2019 00:21,223,24,Kiev (city)
2400,2389,8,931,1462,7,1469,0,1469,41,897,531,22.04.2019 00:07,223,24,Kiev (city)
2432,2460,8,793,1633,6,1639,0,1639,45,838,755,21.04.2019 22:38,223,24,Kiev (city)
2384,2379,3,950,1434,0,1434,0,1434,62,803,569,22.04.2019 00:05,223,24,Kiev (city)
1760,1781,0,777,983,0,983,0,983,27,566,390,22.04.2019 00:20,223,24,Kiev (city)
2368,2402,0,975,1393,0,1393,0,1393,30,767,596,21.04.2019 21:35,223,24,Kiev (city)
2384,2381,8,945,1433,6,1439,0,1439,35,817,587,22.04.2019 00:02,223,24,Kiev (city)
2080,2106,8,707,1368,5,1373,0,1373,37,709,627,22.04.2019 00:03,223,24,Kiev (city)
2352,2354,9,788,1558,6,1564,0,1564,53,818,693,22.04.2019 00:16,223,24,Kiev (city)
2224,2228,7,780,1439,5,1444,0,1444,38,886,520,22.04.2019 00:10,223,24,Kiev (city)
2320,2360,66,766,1550,4,1554,0,1554,44,948,562,22.04.2019 02:25,223,24,Kiev (city)
2160,2155,6,801,1354,5,1359,0,1359,33,819,507,22.04.2019 00:15,223,24,Kiev (city)
1792,1790,3,625,1164,3,1167,0,1167,36,669,462,22.04.2019 00:25,223,24,Kiev (city)
2288,2291,12,835,1444,9,1453,0,1453,58,812,583,21.04.2019 22:00,223,24,Kiev (city)
2240,2248,1,835,1404,1,1405,0,1405,28,860,517,22.04.2019 00:12,223,24,Kiev (city)
1696,1697,3,597,1096,3,1099,0,1099,28,698,373,22.04.2019 00:10,223,24,Kiev (city)
1280,1256,2,523,755,2,757,0,757,23,441,293,22.04.2019 00:10,223,24,Kiev (city)
1872,1902,6,652,1217,3,1220,0,1220,33,695,492,22.04.2019 00:22,223,24,Kiev (city)
2208,2235,9,808,1398,2,1400,0,1400,34,844,522,22.04.2019 00:26,223,24,Kiev (city)
2128,2098,11,808,1313,7,1320,0,1320,39,821,460,22.04.2019 00:20,223,24,Kiev (city)
1872,1900,7,666,1201,5,1206,0,1206,34,761,411,22.04.2019 00:40,223,24,Kiev (city)
2192,2189,4,837,1353,2,1355,0,1355,37,807,511,22.04.2019 00:25,223,24,Kiev (city)
2336,2339,8,747,1584,5,1589,0,1589,41,956,592,22.04.2019 00:10,223,24,Kiev (city)
2368,2402,7,884,1479,5,1484,0,1484,41,924,519,22.04.2019 01:00,223,24,Kiev (city)
2464,2528,3,972,1490,2,1492,0,1492,31,994,467,22.04.2019 00:15,223,24,Kiev (city)
1824,1841,9,768,1051,5,1056,0,1056,34,672,350,22.04.2019 00:03,223,24,Kiev (city)
2432,2515,9,734,1692,6,1698,0,1698,55,974,669,22.04.2019 00:15,223,24,Kiev (city)
112,41,0,71,41,0,41,0,41,2,21,18,21.04.2019 20:30,223,24,Kiev (city)
448,168,20,282,147,19,166,0,166,7,109,50,21.04.2019 21:00,223,24,Kiev (city)
0,12,0,1,12,0,12,0,12,0,4,8,21.04.2019 08:45,223,24,Kiev (city)
224,61,1,163,60,1,61,0,61,4,42,15,22.04.2019 01:05,223,24,Kiev (city)
224,57,2,171,51,2,53,0,53,0,40,13,22.04.2019 00:20,223,24,Kiev (city)
256,141,14,116,126,14,140,0,140,7,78,55,22.04.2019 00:18,223,24,Kiev (city)
224,98,4,129,91,4,95,0,95,5,64,26,21.04.2019 22:50,223,24,Kiev (city)
256,61,26,199,32,25,57,0,57,0,42,15,21.04.2019 20:45,223,24,Kiev (city)
448,120,67,352,40,56,96,0,96,5,65,26,21.04.2019 21:01,223,24,Kiev (city)
640,118,0,544,96,0,96,0,96,3,82,11,21.04.2019 22:00,223,24,Kiev (city)
384,177,47,287,73,24,97,0,97,0,77,20,21.04.2019 20:31,223,24,Kiev (city)
256,40,25,217,15,24,39,0,39,1,28,10,21.04.2019 20:20,223,24,Kiev (city)
528,103,81,430,21,77,98,0,98,3,76,19,21.04.2019 21:00,223,24,Kiev (city)
656,254,150,504,61,91,152,0,152,5,107,40,22.04.2019 01:05,223,24,Kiev (city)
288,32,0,257,31,0,31,0,31,0,23,8,21.04.2019 20:25,223,24,Kiev (city)
592,192,23,410,160,22,182,0,182,10,132,40,22.04.2019 00:15,223,24,Kiev (city)
640,236,21,415,204,21,225,0,225,3,161,61,21.04.2019 21:00,223,24,Kiev (city)
1744,1744,,1645,99,0,99,0,99,1,26,72,21.04.2019 21:30,226,-1,
2384,2761,0,1284,1100,0,1100,0,1100,21,349,730,21.04.2019 22:07,226,-1,
304,363,0,71,233,0,233,0,233,0,120,113,21.04.2019 20:48,226,-1,
304,291,0,241,63,0,63,0,63,1,31,31,21.04.2019 20:25,226,-1,
1056,1065,0,860,196,0,196,0,196,1,113,82,21.04.2019 20:35,226,-1,
2272,2356,0,1582,690,0,690,0,690,11,242,437,21.04.2019 21:00,226,-1,
7216,7315,0,6394,822,0,822,0,822,11,529,282,22.04.2019 00:05,226,-1,
4992,4970,0,4694,298,0,298,0,298,1,238,59,21.04.2019 21:15,226,-1,
2880,2920,0,2655,225,0,225,0,225,4,91,130,21.04.2019 20:45,226,-1,
128,126,0,104,24,0,24,0,24,0,18,6,21.04.2019 20:35,226,-1,
192,204,0,119,73,0,73,0,73,0,15,58,21.04.2019 20:10,226,-1,
2592,2847,0,1251,1341,0,1341,0,1340,23,373,944,21.04.2019 23:27,226,-1,
160,168,0,88,72,0,72,0,72,2,28,42,21.04.2019 20:17,226,-1,
416,412,0,280,136,0,136,0,136,4,92,40,21.04.2019 20:34,226,-1,
2640,2780,0,1528,1112,0,1112,0,1112,29,415,668,21.04.2019 22:35,226,-1,
944,957,0,799,145,0,145,0,145,4,72,69,21.04.2019 20:45,226,-1,
8433,8593,0,8044,389,0,389,0,389,7,196,186,21.04.2019 21:57,226,-1,
2768,2900,0,2297,471,0,471,0,471,5,165,301,21.04.2019 21:20,226,-1,
4528,4574,0,3390,1138,0,1138,0,1137,17,822,298,22.04.2019 00:10,226,-1,
160,181,0,74,86,0,86,0,86,2,33,51,21.04.2019 20:34,226,-1,
14016,14340,0,13370,646,0,646,0,646,5,315,326,21.04.2019 22:59,226,-1,
160,168,0,91,69,0,69,0,69,0,27,42,21.04.2019 20:32,226,-1,
240,228,0,176,64,0,64,0,64,1,31,32,21.04.2019 20:14,226,-1,
704,766,0,343,361,0,361,0,361,5,100,256,21.04.2019 21:50,226,-1,
4576,5043,0,2367,2209,0,2209,0,2209,53,930,1226,21.04.2019 23:36,226,-1,
5280,5813,0,3772,1508,0,1508,0,1508,22,580,906,21.04.2019 21:20,226,-1,
2672,2907,0,1576,1096,0,1096,0,1096,23,509,564,21.04.2019 21:40,226,-1,
7936,8129,0,5753,2183,0,2183,0,2183,27,550,1606,21.04.2019 22:22,226,-1,
5360,5887,0,3673,1687,0,1687,0,1687,40,756,891,21.04.2019 22:40,226,-1,
5568,5683,0,4117,1451,0,1451,0,1451,34,643,774,22.04.2019 00:15,226,-1,
656,688,0,455,201,0,201,0,201,2,126,73,21.04.2019 20:31,226,-1,
4192,4109,0,4017,175,0,175,0,175,2,87,86,21.04.2019 21:07,226,-1,
1248,1335,0,882,366,0,366,0,366,2,93,271,21.04.2019 21:11,226,-1,
4912,5326,0,3780,1132,0,1132,0,1132,20,310,802,21.04.2019 22:17,226,-1,
144,140,0,92,52,0,52,0,52,0,37,15,21.04.2019 20:30,226,-1,
352,418,0,76,276,0,276,0,276,2,142,132,21.04.2019 20:50,226,-1,
448,504,0,155,293,0,293,0,293,4,124,165,21.04.2019 20:50,226,-1,
528,681,0,137,391,0,391,0,391,7,139,245,21.04.2019 21:02,226,-1,
224,231,0,114,110,0,110,0,110,1,47,62,21.04.2019 21:09,226,-1,
384,368,0,298,86,0,86,0,86,0,73,13,21.04.2019 21:00,226,-1,
208,211,0,116,92,0,92,0,92,0,46,46,21.04.2019 20:20,226,-1,
2240,2387,0,1517,723,0,723,0,723,10,445,268,21.04.2019 21:05,226,-1,
3008,3104,0,2531,477,0,477,0,477,10,252,215,21.04.2019 21:33,226,-1,
1376,1435,0,1109,267,0,267,0,267,4,127,136,22.04.2019 00:10,226,-1,
80,71,0,34,46,0,46,0,46,0,22,24,21.04.2019 20:12,226,-1,
128,125,0,17,111,0,111,0,111,0,32,79,21.04.2019 20:20,226,-1,
592,586,0,442,150,0,150,0,150,0,92,58,21.04.2019 21:00,226,-1,
240,240,0,160,80,0,80,0,80,1,29,50,21.04.2019 20:39,226,-1,
52320,52035,0,51891,429,0,429,0,429,10,291,128,21.04.2019 22:50,226,-1,
13600,13536,0,13419,181,0,181,0,181,4,144,33,22.04.2019 00:30,226,-1,
1584,1943,0,678,906,0,906,0,906,8,222,676,21.04.2019 23:45,226,-1,
16752,17030,0,15083,1669,0,1669,0,1669,19,696,954,22.04.2019 00:12,226,-1,
14224,14279,0,13306,918,0,918,0,918,16,396,506,21.04.2019 21:25,226,-1,
25968,26191,0,24143,1825,0,1825,0,1825,26,701,1098,22.04.2019 00:15,226,-1,
13360,13413,0,12337,1023,0,1023,0,1023,13,434,576,21.04.2019 22:03,226,-1,
496,544,0,293,203,0,203,0,203,0,62,141,21.04.2019 21:26,226,-1,
288,351,0,107,181,0,181,0,181,3,72,106,21.04.2019 20:40,226,-1,
224,212,0,181,43,0,43,0,43,0,26,17,21.04.2019 20:10,226,-1,
352,351,0,281,71,0,71,0,71,0,29,42,21.04.2019 20:05,226,-1,
16960,18057,0,12743,4217,0,4217,0,4217,55,2141,2021,21.04.2019 23:30,226,-1,
4192,4781,0,2939,1253,0,1253,0,1253,15,781,457,21.04.2019 22:20,226,-1,
10144,10977,0,8206,1938,0,1938,0,1937,22,840,1075,22.04.2019 00:10,226,-1,
3712,3830,0,3239,473,0,473,0,473,6,230,237,22.04.2019 00:10,226,-1,
2560,2805,0,1359,1201,0,1201,0,1201,14,486,701,21.04.2019 23:06,226,-1,
784,844,0,505,279,0,279,0,279,4,118,157,22.04.2019 00:05,226,-1,
288,314,0,165,123,0,123,0,123,1,58,64,21.04.2019 20:50,226,-1,
112,101,0,64,48,0,48,0,48,1,18,29,21.04.2019 20:35,226,-1,
352,349,0,251,101,0,101,0,101,1,40,60,21.04.2019 20:45,226,-1,
272,278,0,104,168,0,168,0,168,2,72,94,21.04.2019 20:45,226,-1,
3680,3788,0,3229,451,0,451,0,451,2,234,215,21.04.2019 20:45,226,-1,
688,688,0,436,252,0,252,0,252,2,106,144,21.04.2019 21:10,226,-1,
7184,7299,0,6720,464,0,464,0,464,8,120,336,21.04.2019 21:52,226,-1,
5456,5927,0,4330,1126,0,1126,0,1125,32,354,739,21.04.2019 23:43,226,-1,
176,209,0,74,102,0,102,0,102,0,38,64,21.04.2019 20:38,226,-1,
368,351,0,269,99,0,99,0,99,0,57,42,21.04.2019 20:20,226,-1,
256,237,0,89,167,0,167,0,167,2,68,97,21.04.2019 21:25,226,-1,
560,600,0,142,418,0,418,0,418,4,174,240,21.04.2019 20:40,226,-1,
208,210,0,137,71,0,71,0,71,0,50,21,21.04.2019 20:50,226,-1,
2384,2500,0,2042,342,0,342,0,342,7,152,183,21.04.2019 21:18,226,-1,
4080,4068,0,3983,97,0,97,0,97,2,70,25,21.04.2019 20:10,226,-1,
1200,1211,0,1087,113,0,113,0,113,1,48,64,21.04.2019 20:30,226,-1,
20861,20806,0,20347,514,0,514,0,514,6,235,273,22.04.2019 00:01,226,-1,
3456,3738,0,2262,1194,0,1194,0,1194,24,375,795,21.04.2019 21:42,226,-1,
256,263,0,169,87,0,87,0,87,3,37,47,21.04.2019 20:30,226,-1,
22416,23383,0,18235,4181,0,4181,0,4181,56,2425,1700,22.04.2019 01:48,226,-1,
5056,5321,0,4070,986,0,986,0,986,12,625,349,21.04.2019 21:20,226,-1,
192,214,0,61,131,0,131,0,131,2,33,96,21.04.2019 20:35,226,-1,
1296,1380,0,894,402,0,402,0,402,6,99,297,21.04.2019 21:25,226,-1,
768,904,0,381,387,0,387,0,387,2,127,258,21.04.2019 21:00,226,-1,
464,483,0,299,165,0,165,0,165,1,68,96,21.04.2019 23:15,226,-1,
272,268,0,20,252,0,252,0,252,2,147,103,21.04.2019 21:35,226,-1,
48,42,0,7,41,0,41,0,41,1,25,15,21.04.2019 20:25,226,-1,
1120,1298,0,437,683,0,683,0,683,10,336,337,21.04.2019 21:00,226,-1,
176,185,0,66,110,0,110,0,110,0,67,43,21.04.2019 20:50,226,-1,
4192,4314,0,3612,580,0,580,0,580,6,178,396,21.04.2019 22:21,226,-1,
21280,21386,0,19753,1527,0,1527,0,1527,26,795,706,21.04.2019 22:17,226,-1,
96,101,0,28,68,0,68,0,68,2,33,33,21.04.2019 20:12,226,-1,
384,408,0,59,325,0,325,0,325,4,151,170,21.04.2019 21:20,226,-1,
896,1035,0,595,301,0,301,0,301,4,89,208,21.04.2019 21:18,226,-1,
