1.К-сть одержаних бюлетенів,"2.К-сть виборців, внесених до списку","3.К-сть виборців, внесених до витягу для голос. за місцем перебув.",4.К-сть невикор. бюлетенів,"5.К-сть виборців, які отримали бюлетені у приміщ.","6.К-сть виборців, які отримали бюлетені за місцем перебув.","7.Загальна к-сть виборців, які отримали бюлетені","8.К-сть бюлетенів, що не підлягають врахуванню","9.К-сть виборців, які взяли участь у голосуванні","10.К-сть бюлетенів, визнаних недійсними",Зеленський Володимир,Порошенко Петро,Дата та час протоколу,11,0,Vinnitsa
240,222,0,108,132,0,132,0,132,0,77,55,21.04.2019 22:10,11,0,Vinnitsa
384,373,16,127,241,16,257,0,257,9,149,99,22.04.2019 00:20,11,0,Vinnitsa
688,679,36,204,451,33,484,0,484,13,235,236,22.04.2019 00:04,11,0,Vinnitsa
400,386,19,139,244,17,261,0,261,4,143,114,22.04.2019 00:05,11,0,Vinnitsa
304,301,14,101,189,14,203,0,203,4,95,104,22.04.2019 00:10,11,0,Vinnitsa
752,745,12,329,411,12,423,0,423,10,228,185,22.04.2019 00:30,11,0,Vinnitsa
479,160,45,384,62,33,95,0,95,4,54,37,21.04.2019 22:10,11,0,Vinnitsa
432,78,7,354,71,7,78,0,78,4,54,20,22.04.2019 00:25,11,0,Vinnitsa
1120,485,38,636,446,38,484,0,484,26,412,46,22.04.2019 00:02,11,0,Vinnitsa
128,39,19,89,21,18,39,0,39,2,23,14,22.04.2019 00:04,11,0,Vinnitsa
96,63,0,34,62,0,62,0,62,4,43,15,22.04.2019 00:10,11,0,Vinnitsa
272,44,7,229,37,6,43,0,43,1,25,17,22.04.2019 00:03,11,0,Vinnitsa
464,56,0,422,42,0,42,0,42,1,31,10,22.04.2019 00:06,11,0,Vinnitsa
1040,503,73,616,366,58,424,0,424,37,241,146,21.04.2019 23:40,11,0,Vinnitsa
240,94,12,152,78,10,88,0,88,0,47,41,22.04.2019 00:10,11,0,Vinnitsa
144,33,0,112,32,0,32,0,32,0,23,9,22.04.2019 00:20,11,0,Vinnitsa
736,196,153,555,41,140,181,0,181,6,111,64,22.04.2019 00:05,11,0,Vinnitsa
128,12,0,116,12,0,12,0,12,0,6,6,22.04.2019 00:05,11,0,Vinnitsa
64,20,1,45,18,1,19,0,19,0,11,8,22.04.2019 00:05,11,0,Vinnitsa
320,43,13,277,30,13,43,0,43,0,28,15,22.04.2019 00:20,11,0,Vinnitsa
352,348,1,107,245,0,245,0,245,5,128,112,22.04.2019 00:05,11,0,Vinnitsa
1040,1031,5,340,695,5,700,0,700,8,351,341,22.04.2019 00:10,12,0,Vinnitsa
688,679,65,206,419,63,482,0,482,8,222,252,22.04.2019 00:20,12,0,Vinnitsa
2160,2127,33,786,1344,30,1374,0,1374,38,783,553,22.04.2019 00:02,12,0,Vinnitsa
1376,1360,108,369,899,108,1007,0,1007,15,456,536,22.04.2019 00:05,12,0,Vinnitsa
608,593,20,187,405,16,421,0,421,4,269,148,22.04.2019 00:10,12,0,Vinnitsa
400,396,48,130,225,45,270,0,270,2,161,107,22.04.2019 00:15,12,0,Vinnitsa
160,152,11,65,86,9,95,0,95,0,47,48,21.04.2019 21:30,12,0,Vinnitsa
560,550,20,189,358,13,371,0,371,7,207,157,22.04.2019 00:05,12,0,Vinnitsa
1200,1196,35,390,775,35,810,0,810,15,505,290,22.04.2019 00:05,12,0,Vinnitsa
656,646,16,242,402,12,414,0,414,7,231,176,22.04.2019 00:15,12,0,Vinnitsa
400,393,34,112,255,33,288,0,288,2,157,129,22.04.2019 00:06,12,0,Vinnitsa
304,291,17,133,156,15,171,0,171,5,119,47,22.04.2019 00:02,12,0,Vinnitsa
496,481,30,178,291,27,318,0,318,14,188,116,21.04.2019 21:50,12,0,Vinnitsa
2288,2252,8,820,1462,6,1468,0,1468,50,860,558,22.04.2019 00:30,12,0,Vinnitsa
2016,2005,16,667,1338,11,1349,0,1349,35,767,547,22.04.2019 00:20,12,0,Vinnitsa
1792,1772,10,631,1151,10,1161,0,1161,36,687,438,22.04.2019 00:06,12,0,Vinnitsa
1344,1356,4,449,891,4,895,0,895,17,476,402,22.04.2019 00:15,12,0,Vinnitsa
1760,1703,1,725,1034,1,1035,0,1035,28,518,489,22.04.2019 00:15,12,0,Vinnitsa
1936,1907,19,632,1288,16,1304,0,1304,33,751,520,22.04.2019 00:15,12,0,Vinnitsa
2080,2031,3,732,1345,3,1348,0,1348,33,622,693,22.04.2019 00:20,12,0,Vinnitsa
2352,2333,15,887,1454,11,1465,0,1465,47,803,615,22.04.2019 00:03,12,0,Vinnitsa
2448,2464,13,905,1533,10,1543,0,1543,52,860,631,22.04.2019 00:10,12,0,Vinnitsa
2288,2276,15,879,1399,10,1409,0,1409,42,778,589,22.04.2019 00:45,12,0,Vinnitsa
2112,2078,3,909,1200,3,1203,0,1203,29,632,542,22.04.2019 01:05,12,0,Vinnitsa
2400,2381,14,948,1443,9,1452,0,1452,39,856,557,21.04.2019 22:31,12,0,Vinnitsa
2192,2175,14,807,1373,12,1385,0,1385,37,761,587,22.04.2019 00:10,12,0,Vinnitsa
2256,2193,8,908,1344,4,1348,0,1348,29,862,457,22.04.2019 00:40,12,0,Vinnitsa
2336,2298,7,891,1440,5,1445,0,1445,33,809,603,22.04.2019 00:30,12,0,Vinnitsa
96,46,17,51,29,16,45,0,45,2,27,16,22.04.2019 00:05,12,0,Vinnitsa
96,13,1,83,12,1,13,0,13,0,8,5,22.04.2019 00:15,12,0,Vinnitsa
176,72,63,109,9,58,67,0,67,3,38,26,22.04.2019 00:10,12,0,Vinnitsa
208,16,0,192,16,0,16,0,16,0,9,7,22.04.2019 00:15,12,0,Vinnitsa
400,396,23,85,295,20,315,0,315,2,140,173,21.04.2019 20:35,13,0,Vinnitsa
384,374,33,137,217,30,247,0,247,2,127,118,21.04.2019 23:00,13,0,Vinnitsa
960,955,44,328,589,43,632,0,632,11,383,238,21.04.2019 21:40,13,0,Vinnitsa
48,42,7,14,28,6,34,0,34,0,26,8,21.04.2019 21:31,13,0,Vinnitsa
208,197,19,75,115,18,133,0,133,2,92,39,21.04.2019 21:10,13,0,Vinnitsa
560,551,33,182,345,33,378,0,378,10,278,90,22.04.2019 00:07,13,0,Vinnitsa
240,234,19,94,129,17,146,0,146,0,66,80,21.04.2019 21:43,13,0,Vinnitsa
624,607,64,191,372,61,433,0,433,7,218,208,21.04.2019 20:48,13,0,Vinnitsa
544,526,60,200,292,52,344,0,344,3,231,110,21.04.2019 20:45,13,0,Vinnitsa
1568,1548,50,708,810,50,860,0,860,16,530,314,21.04.2019 22:06,13,0,Vinnitsa
1664,1648,43,787,837,40,877,0,877,9,546,322,22.04.2019 00:14,13,0,Vinnitsa
544,534,42,226,280,38,318,0,318,7,171,140,21.04.2019 23:11,13,0,Vinnitsa
400,392,45,157,202,41,243,8,243,7,130,106,21.04.2019 23:20,13,0,Vinnitsa
320,296,21,127,173,20,193,0,193,1,105,87,22.04.2019 00:15,13,0,Vinnitsa
464,457,8,177,280,7,287,0,287,7,189,91,22.04.2019 00:15,13,0,Vinnitsa
928,920,51,299,579,50,629,0,629,17,373,239,21.04.2019 21:20,13,0,Vinnitsa
480,475,31,156,300,24,324,0,324,5,173,146,21.04.2019 22:18,13,0,Vinnitsa
304,302,28,131,152,21,173,0,173,1,120,52,21.04.2019 21:00,13,0,Vinnitsa
448,437,24,168,256,24,280,0,280,5,188,87,21.04.2019 20:48,13,0,Vinnitsa
256,250,28,74,154,28,182,0,182,3,101,78,21.04.2019 22:17,13,0,Vinnitsa
240,246,38,50,153,37,190,0,190,3,111,76,21.04.2019 21:45,13,0,Vinnitsa
928,913,78,380,477,71,548,0,548,11,260,277,22.04.2019 00:15,13,0,Vinnitsa
496,489,51,190,261,45,306,0,306,5,150,151,21.04.2019 20:50,13,0,Vinnitsa
112,112,14,32,68,12,80,0,80,1,39,40,21.04.2019 20:45,13,0,Vinnitsa
176,165,14,55,109,12,121,0,121,0,72,49,21.04.2019 20:47,13,0,Vinnitsa
784,778,80,336,375,73,448,0,448,13,283,152,22.04.2019 00:01,13,0,Vinnitsa
768,744,100,177,493,98,591,0,591,9,354,228,22.04.2019 00:12,13,0,Vinnitsa
528,509,78,110,344,74,418,0,418,10,271,137,21.04.2019 20:30,13,0,Vinnitsa
320,304,48,76,204,40,244,0,244,1,156,87,21.04.2019 21:10,13,0,Vinnitsa
1392,1367,45,557,798,37,835,0,835,13,448,374,21.04.2019 21:15,13,0,Vinnitsa
624,604,25,141,458,25,483,0,483,10,281,192,21.04.2019 21:30,13,0,Vinnitsa
832,824,53,313,472,47,519,0,519,8,343,168,21.04.2019 22:00,13,0,Vinnitsa
1504,1501,47,607,859,38,897,0,897,18,461,418,21.04.2019 22:35,13,0,Vinnitsa
656,628,23,292,346,18,364,0,364,8,267,89,21.04.2019 21:45,13,0,Vinnitsa
288,282,32,121,139,28,167,0,167,4,78,85,21.04.2019 22:30,13,0,Vinnitsa
208,199,9,90,111,7,118,3,118,3,72,43,21.04.2019 23:05,13,0,Vinnitsa
432,416,26,162,244,26,270,0,270,5,145,120,21.04.2019 21:20,13,0,Vinnitsa
240,237,21,92,131,17,148,0,148,1,80,67,21.04.2019 20:37,13,0,Vinnitsa
208,198,19,81,110,17,127,0,127,2,80,45,21.04.2019 20:40,13,0,Vinnitsa
1024,1019,64,355,613,56,669,0,669,18,400,251,22.04.2019 00:35,13,0,Vinnitsa
2240,2182,44,797,1400,43,1443,0,1443,22,910,511,21.04.2019 22:00,13,0,Vinnitsa
2336,2287,13,847,1480,9,1489,0,1489,32,795,662,21.04.2019 23:50,13,0,Vinnitsa
1904,1903,39,649,1224,31,1255,0,1255,28,641,586,22.04.2019 00:10,13,0,Vinnitsa
1664,1640,13,646,1006,12,1018,0,1018,29,539,450,22.04.2019 00:15,13,0,Vinnitsa
1744,1708,31,591,1125,28,1153,0,1153,30,682,441,21.04.2019 22:00,13,0,Vinnitsa
208,192,0,91,117,0,117,0,117,2,78,37,21.04.2019 22:05,13,0,Vinnitsa
2304,2309,25,823,1462,19,1481,0,1481,32,866,583,21.04.2019 23:40,13,0,Vinnitsa
272,103,21,186,67,19,86,0,86,1,57,28,21.04.2019 20:45,13,0,Vinnitsa
480,459,35,149,300,31,331,0,331,4,188,139,21.04.2019 23:05,13,0,Vinnitsa
224,207,4,103,117,4,121,0,121,3,71,47,21.04.2019 20:40,13,0,Vinnitsa
176,165,18,65,94,17,111,0,111,5,66,40,21.04.2019 23:05,13,0,Vinnitsa
80,79,6,15,60,5,65,0,65,0,31,34,21.04.2019 21:00,13,0,Vinnitsa
192,187,5,72,115,5,120,0,120,3,74,43,21.04.2019 21:10,13,0,Vinnitsa
560,556,8,289,266,5,271,0,271,2,173,96,21.04.2019 20:50,13,0,Vinnitsa
1376,1355,37,489,850,37,887,0,887,16,516,355,21.04.2019 21:00,13,0,Vinnitsa
224,225,20,63,141,20,161,0,161,0,98,63,21.04.2019 22:00,13,0,Vinnitsa
224,208,17,75,132,17,149,0,149,2,86,61,22.04.2019 00:05,13,0,Vinnitsa
80,73,18,13,49,18,67,3,67,3,34,30,21.04.2019 20:25,13,0,Vinnitsa
192,183,2,68,122,2,124,0,124,3,67,54,21.04.2019 21:20,13,0,Vinnitsa
432,418,36,119,277,36,313,0,313,7,216,90,22.04.2019 01:10,13,0,Vinnitsa
400,385,19,176,205,19,224,0,224,5,144,75,21.04.2019 21:03,13,0,Vinnitsa
144,139,1,64,79,1,80,0,80,1,51,28,21.04.2019 21:30,13,0,Vinnitsa
480,469,31,215,238,27,265,0,265,1,195,69,21.04.2019 20:30,13,0,Vinnitsa
256,253,13,96,151,9,160,0,160,2,91,67,21.04.2019 21:00,13,0,Vinnitsa
64,53,11,28,25,11,36,0,36,0,20,16,21.04.2019 20:40,13,0,Vinnitsa
240,224,24,84,133,23,156,0,156,2,104,50,21.04.2019 21:00,13,0,Vinnitsa
64,59,6,26,34,4,38,0,38,2,16,20,21.04.2019 21:20,13,0,Vinnitsa
112,109,16,27,69,16,85,0,85,0,36,49,22.04.2019 00:15,13,0,Vinnitsa
256,254,31,86,143,27,170,0,170,2,120,48,21.04.2019 20:36,13,0,Vinnitsa
400,392,42,143,220,37,257,0,257,4,131,122,21.04.2019 21:50,13,0,Vinnitsa
32,23,1,9,22,1,23,1,23,1,11,11,22.04.2019 00:12,13,0,Vinnitsa
208,193,4,88,116,4,120,0,120,1,73,46,21.04.2019 20:50,13,0,Vinnitsa
400,394,37,153,210,37,247,0,247,4,164,79,21.04.2019 20:25,13,0,Vinnitsa
448,431,20,176,252,20,272,0,272,6,203,63,21.04.2019 21:00,13,0,Vinnitsa
384,375,23,109,253,22,275,0,275,4,169,102,21.04.2019 21:00,13,0,Vinnitsa
384,378,33,165,193,26,219,0,219,6,148,65,21.04.2019 20:40,13,0,Vinnitsa
816,796,30,395,395,26,421,0,421,8,248,165,21.04.2019 21:15,13,0,Vinnitsa
512,500,8,225,280,7,287,0,287,14,213,60,22.04.2019 00:10,13,0,Vinnitsa
176,169,11,44,123,9,132,0,132,0,78,54,21.04.2019 21:05,13,0,Vinnitsa
224,219,11,58,155,11,166,0,166,2,136,28,21.04.2019 20:39,13,0,Vinnitsa
80,69,4,21,55,4,59,0,59,0,40,19,21.04.2019 21:30,13,0,Vinnitsa
752,748,6,361,385,6,391,0,391,2,282,107,22.04.2019 00:05,13,0,Vinnitsa
432,424,29,168,237,27,264,0,264,5,159,100,21.04.2019 21:36,13,0,Vinnitsa
96,88,9,44,44,8,52,0,52,0,38,14,21.04.2019 20:35,13,0,Vinnitsa
208,205,15,88,105,15,120,0,120,4,83,33,21.04.2019 20:10,13,0,Vinnitsa
528,522,35,199,294,35,329,0,329,5,212,112,22.04.2019 00:05,13,0,Vinnitsa
304,293,15,121,169,14,183,0,183,6,135,42,21.04.2019 20:56,13,0,Vinnitsa
1392,1379,88,579,738,75,813,0,813,24,452,337,22.04.2019 00:25,13,0,Vinnitsa
80,88,2,35,43,2,45,0,45,1,32,12,21.04.2019 20:30,13,0,Vinnitsa
96,82,2,45,49,2,51,0,51,0,30,21,21.04.2019 23:07,13,0,Vinnitsa
192,191,12,72,110,10,120,0,120,4,75,41,22.04.2019 00:30,13,0,Vinnitsa
368,363,30,137,202,29,231,0,231,3,176,52,21.04.2019 21:30,13,0,Vinnitsa
800,779,35,252,513,35,548,0,548,16,382,150,22.04.2019 00:13,13,0,Vinnitsa
432,418,29,172,231,29,260,0,260,4,158,98,21.04.2019 23:30,13,0,Vinnitsa
64,33,11,31,22,11,33,0,33,0,27,6,21.04.2019 21:55,13,0,Vinnitsa
496,475,38,142,317,37,354,0,354,11,208,135,21.04.2019 21:00,13,0,Vinnitsa
80,73,16,23,42,15,57,0,57,0,34,23,21.04.2019 21:00,13,0,Vinnitsa
704,692,24,344,336,24,360,0,360,8,266,86,21.04.2019 20:38,13,0,Vinnitsa
288,286,10,115,163,10,173,0,173,0,126,47,21.04.2019 20:15,13,0,Vinnitsa
336,336,22,120,195,21,216,0,216,1,163,52,21.04.2019 20:44,13,0,Vinnitsa
480,474,19,160,301,19,320,0,320,3,154,163,21.04.2019 20:40,13,0,Vinnitsa
64,59,1,25,38,1,39,0,39,0,21,18,21.04.2019 20:55,13,0,Vinnitsa
240,220,10,59,171,10,181,0,181,2,120,59,22.04.2019 00:05,13,0,Vinnitsa
1488,1472,41,736,711,41,752,0,752,14,524,214,21.04.2019 22:00,13,0,Vinnitsa
464,461,2,186,277,1,278,0,278,4,204,70,21.04.2019 20:40,13,0,Vinnitsa
272,263,26,56,195,21,216,0,216,1,52,163,21.04.2019 21:20,13,0,Vinnitsa
32,26,0,7,25,0,25,0,25,0,17,8,21.04.2019 20:35,13,0,Vinnitsa
160,151,0,64,96,0,96,0,96,0,77,19,21.04.2019 21:20,13,0,Vinnitsa
144,134,0,50,94,0,94,0,94,1,77,16,21.04.2019 20:35,13,0,Vinnitsa
288,275,29,69,192,27,219,0,219,1,139,79,21.04.2019 21:00,13,0,Vinnitsa
208,203,29,27,152,29,181,0,181,4,97,80,21.04.2019 20:15,13,0,Vinnitsa
240,235,8,110,122,8,130,0,130,2,66,62,21.04.2019 21:10,13,0,Vinnitsa
208,201,17,64,127,17,144,0,144,6,67,71,21.04.2019 21:00,13,0,Vinnitsa
352,341,47,82,223,47,270,0,270,7,95,168,21.04.2019 21:45,13,0,Vinnitsa
160,153,22,49,89,22,111,0,111,0,60,51,21.04.2019 20:25,13,0,Vinnitsa
352,334,18,91,243,18,261,0,261,4,124,133,21.04.2019 21:50,13,0,Vinnitsa
160,164,8,34,118,8,126,0,126,3,69,54,21.04.2019 21:40,13,0,Vinnitsa
224,208,0,63,161,0,161,0,161,3,103,55,21.04.2019 21:00,13,0,Vinnitsa
160,158,0,35,125,0,125,0,125,1,69,55,21.04.2019 21:15,13,0,Vinnitsa
256,248,11,61,184,11,195,0,195,1,132,62,21.04.2019 21:00,13,0,Vinnitsa
448,431,37,158,253,37,290,0,290,1,156,133,21.04.2019 20:30,13,0,Vinnitsa
224,214,14,72,138,14,152,0,152,3,64,85,21.04.2019 22:20,13,0,Vinnitsa
448,450,51,114,286,48,334,0,334,5,192,137,21.04.2019 20:30,13,0,Vinnitsa
192,189,28,70,94,28,122,0,122,6,57,59,21.04.2019 20:40,13,0,Vinnitsa
288,271,18,107,165,16,181,0,181,4,107,70,21.04.2019 21:37,13,0,Vinnitsa
144,128,1,52,91,1,92,0,92,1,53,38,21.04.2019 20:45,13,0,Vinnitsa
96,83,1,46,49,1,50,0,50,1,24,25,21.04.2019 20:20,13,0,Vinnitsa
192,175,16,89,87,16,103,0,103,0,44,59,21.04.2019 20:50,13,0,Vinnitsa
448,442,18,125,307,16,323,0,323,4,168,151,21.04.2019 20:50,13,0,Vinnitsa
304,301,15,84,205,15,220,0,220,7,135,78,21.04.2019 21:20,13,0,Vinnitsa
512,501,1,169,342,1,343,0,343,4,233,106,21.04.2019 21:30,13,0,Vinnitsa
416,394,36,79,305,32,337,0,337,6,226,105,22.04.2019 00:17,13,0,Vinnitsa
304,287,22,138,146,20,166,0,166,3,78,85,21.04.2019 21:10,13,0,Vinnitsa
256,243,32,82,145,29,174,0,174,1,92,81,21.04.2019 20:30,13,0,Vinnitsa
352,340,8,90,254,8,262,0,262,8,182,72,21.04.2019 20:28,13,0,Vinnitsa
368,348,12,102,255,11,266,0,266,1,172,93,21.04.2019 20:30,13,0,Vinnitsa
720,698,70,252,398,70,468,0,468,9,322,137,22.04.2019 00:25,13,0,Vinnitsa
176,163,18,71,87,18,105,0,105,1,69,35,21.04.2019 21:45,13,0,Vinnitsa
240,238,25,43,172,25,197,0,197,2,99,96,21.04.2019 21:20,13,0,Vinnitsa
208,192,19,82,107,19,126,0,126,3,96,27,21.04.2019 20:45,13,0,Vinnitsa
416,398,16,160,240,16,256,0,256,7,130,119,21.04.2019 21:00,13,0,Vinnitsa
240,229,13,74,153,13,166,0,166,0,65,101,21.04.2019 20:45,13,0,Vinnitsa
464,438,16,118,331,15,346,26,346,7,202,137,21.04.2019 20:50,13,0,Vinnitsa
1328,1294,49,508,773,47,820,0,820,10,540,270,21.04.2019 21:00,13,0,Vinnitsa
912,898,43,394,478,40,518,0,518,18,319,181,21.04.2019 20:50,13,0,Vinnitsa
464,457,29,88,347,29,376,0,376,6,252,118,21.04.2019 21:10,13,0,Vinnitsa
336,322,23,92,224,20,244,0,244,8,95,141,22.04.2019 00:20,13,0,Vinnitsa
128,122,16,39,73,16,89,0,89,0,58,31,21.04.2019 20:30,13,0,Vinnitsa
592,573,13,316,263,13,276,0,276,10,183,83,21.04.2019 22:52,13,0,Vinnitsa
64,23,6,41,17,6,23,0,23,0,11,12,21.04.2019 21:21,13,0,Vinnitsa
1120,1101,17,477,627,16,643,0,643,15,483,145,22.04.2019 00:45,13,0,Vinnitsa
640,632,3,227,410,3,413,0,413,7,295,111,22.04.2019 01:05,13,0,Vinnitsa
128,10,0,118,10,0,10,0,10,4,4,2,21.04.2019 20:06,13,0,Vinnitsa
272,26,26,249,0,23,23,0,23,0,15,8,21.04.2019 22:32,13,0,Vinnitsa
2032,1995,28,745,1264,23,1287,0,1287,26,846,415,22.04.2019 00:20,13,0,Vinnitsa
400,396,1,87,312,1,313,0,313,5,201,107,22.04.2019 00:05,13,0,Vinnitsa
224,40,14,194,17,13,30,0,30,0,21,9,21.04.2019 22:40,13,0,Vinnitsa
1520,1498,6,618,896,6,902,0,902,26,561,315,21.04.2019 23:18,14,0,Vinnitsa
2144,2105,4,873,1267,4,1271,0,1271,30,769,472,22.04.2019 01:11,14,0,Vinnitsa
2192,2179,34,971,1187,34,1221,0,1221,24,806,391,22.04.2019 00:20,14,0,Vinnitsa
1744,1717,6,690,1049,5,1054,0,1054,29,654,371,21.04.2019 23:00,14,0,Vinnitsa
2176,2133,5,847,1324,5,1329,0,1329,28,809,492,22.04.2019 00:20,14,0,Vinnitsa
2176,2150,10,927,1239,10,1249,0,1249,22,782,445,22.04.2019 02:20,14,0,Vinnitsa
736,722,0,292,444,0,444,0,444,13,271,160,22.04.2019 00:00,14,0,Vinnitsa
704,691,40,299,365,40,405,0,405,10,248,147,22.04.2019 01:10,14,0,Vinnitsa
160,146,8,65,87,8,95,0,95,2,54,39,22.04.2019 01:00,14,0,Vinnitsa
256,252,0,111,145,0,145,0,145,0,97,48,22.04.2019 00:20,14,0,Vinnitsa
144,141,1,39,104,1,105,0,105,0,68,37,22.04.2019 01:00,14,0,Vinnitsa
128,120,9,48,71,9,80,0,80,1,54,25,22.04.2019 00:12,14,0,Vinnitsa
672,667,4,188,482,2,484,0,484,9,206,269,22.04.2019 00:20,14,0,Vinnitsa
208,208,0,80,128,0,128,0,128,8,64,56,21.04.2019 22:14,14,0,Vinnitsa
608,599,53,256,301,51,352,0,352,5,240,107,22.04.2019 01:00,14,0,Vinnitsa
656,624,30,245,381,30,411,0,411,9,263,139,22.04.2019 00:35,14,0,Vinnitsa
192,174,18,78,97,17,114,0,114,3,80,31,22.04.2019 00:15,14,0,Vinnitsa
768,751,21,354,393,21,414,0,414,9,239,166,22.04.2019 00:20,14,0,Vinnitsa
1072,1059,32,487,557,28,585,0,585,13,373,199,22.04.2019 00:05,14,0,Vinnitsa
592,592,31,229,332,31,363,0,363,13,226,124,21.04.2019 22:00,14,0,Vinnitsa
320,314,13,93,214,13,227,0,227,1,107,119,21.04.2019 22:22,14,0,Vinnitsa
224,206,19,67,138,19,157,0,157,0,105,52,21.04.2019 21:00,14,0,Vinnitsa
160,149,10,64,88,8,96,0,96,0,61,35,21.04.2019 22:40,14,0,Vinnitsa
320,311,14,138,168,14,182,0,182,1,158,23,21.04.2019 22:00,14,0,Vinnitsa
144,138,12,56,76,12,88,0,88,2,61,25,21.04.2019 21:40,14,0,Vinnitsa
560,556,25,252,283,25,308,0,308,17,166,125,21.04.2019 23:40,14,0,Vinnitsa
608,587,20,291,297,20,317,0,317,5,209,103,21.04.2019 21:00,14,0,Vinnitsa
480,471,32,154,294,32,326,0,326,5,167,154,22.04.2019 00:10,14,0,Vinnitsa
992,956,22,482,488,22,510,0,510,5,330,175,21.04.2019 23:00,14,0,Vinnitsa
1296,1256,4,543,749,4,753,0,753,14,467,272,22.04.2019 00:20,14,0,Vinnitsa
304,283,26,117,161,26,187,0,187,0,118,69,21.04.2019 22:58,14,0,Vinnitsa
272,263,18,53,201,18,219,0,219,4,166,49,21.04.2019 23:00,14,0,Vinnitsa
352,340,16,127,210,15,225,0,225,4,168,53,22.04.2019 00:20,14,0,Vinnitsa
144,135,6,51,87,6,93,0,93,2,46,45,21.04.2019 23:00,14,0,Vinnitsa
352,347,2,130,220,2,222,0,222,4,153,65,21.04.2019 22:05,14,0,Vinnitsa
544,533,24,205,315,24,339,0,339,5,232,102,22.04.2019 01:00,14,0,Vinnitsa
224,209,5,89,130,5,135,0,135,3,74,58,21.04.2019 21:30,14,0,Vinnitsa
176,168,25,44,107,25,132,0,132,2,69,61,21.04.2019 22:00,14,0,Vinnitsa
128,119,0,22,106,0,106,0,106,1,58,47,21.04.2019 22:00,14,0,Vinnitsa
608,596,74,249,289,70,359,0,359,6,227,126,21.04.2019 21:13,14,0,Vinnitsa
320,314,31,34,255,31,286,0,286,2,179,105,21.04.2019 23:00,14,0,Vinnitsa
752,733,10,309,433,10,443,0,443,7,290,146,21.04.2019 23:01,14,0,Vinnitsa
512,501,6,210,296,6,302,0,302,12,224,66,22.04.2019 01:00,14,0,Vinnitsa
176,169,17,46,113,17,130,0,130,2,88,40,21.04.2019 22:25,14,0,Vinnitsa
192,190,14,55,123,14,137,0,137,2,119,16,22.04.2019 00:15,14,0,Vinnitsa
288,270,11,134,143,11,154,0,154,3,108,43,21.04.2019 21:00,14,0,Vinnitsa
128,116,6,46,76,6,82,0,82,4,58,20,22.04.2019 02:20,14,0,Vinnitsa
688,666,62,308,322,58,380,0,380,11,255,114,22.04.2019 01:00,14,0,Vinnitsa
304,289,15,101,188,15,203,0,203,1,133,69,21.04.2019 22:00,14,0,Vinnitsa
368,361,16,156,196,16,212,0,212,3,94,115,22.04.2019 00:50,14,0,Vinnitsa
224,209,23,32,169,23,192,0,192,0,77,115,21.04.2019 21:00,14,0,Vinnitsa
720,708,20,302,398,20,418,0,418,6,235,177,21.04.2019 22:18,14,0,Vinnitsa
544,540,52,180,312,52,364,0,364,4,237,123,21.04.2019 21:21,14,0,Vinnitsa
160,159,36,49,77,34,111,0,111,1,68,42,21.04.2019 21:30,14,0,Vinnitsa
544,526,33,98,413,33,446,0,446,3,263,180,21.04.2019 22:00,14,0,Vinnitsa
320,315,17,67,236,17,253,0,253,3,146,104,21.04.2019 21:00,14,0,Vinnitsa
432,416,41,177,216,39,255,0,255,3,168,84,21.04.2019 23:00,14,0,Vinnitsa
880,868,32,410,438,32,470,0,470,8,321,141,22.04.2019 00:40,14,0,Vinnitsa
480,467,24,221,235,24,259,0,259,6,160,93,22.04.2019 01:30,14,0,Vinnitsa
288,293,25,101,166,21,187,0,187,1,124,62,21.04.2019 23:00,14,0,Vinnitsa
752,733,11,318,423,11,434,0,434,4,273,157,21.04.2019 22:00,14,0,Vinnitsa
368,348,2,145,221,2,223,0,223,9,135,79,21.04.2019 22:55,14,0,Vinnitsa
256,242,10,59,187,10,197,0,197,0,135,62,22.04.2019 00:20,14,0,Vinnitsa
240,222,0,116,124,0,124,0,124,1,69,54,22.04.2019 00:20,14,0,Vinnitsa
240,39,11,219,13,8,21,0,21,2,12,7,21.04.2019 21:40,14,0,Vinnitsa
1360,1357,15,600,749,11,760,0,760,18,486,256,21.04.2019 23:00,14,0,Vinnitsa
1168,1199,40,458,673,37,710,0,710,31,406,273,22.04.2019 00:00,14,0,Vinnitsa
1504,1484,71,691,747,66,813,0,813,16,519,278,22.04.2019 00:10,14,0,Vinnitsa
288,303,16,90,183,15,198,0,198,5,128,65,21.04.2019 21:08,14,0,Vinnitsa
464,452,20,120,324,20,344,0,344,7,171,166,21.04.2019 21:40,14,0,Vinnitsa
352,358,27,84,242,26,268,0,268,6,181,81,21.04.2019 21:00,14,0,Vinnitsa
240,234,18,58,164,18,182,0,182,4,121,57,21.04.2019 22:00,14,0,Vinnitsa
528,531,12,87,429,12,441,0,441,8,291,142,21.04.2019 21:00,14,0,Vinnitsa
1088,1119,49,405,634,49,683,0,683,20,370,293,22.04.2019 01:40,14,0,Vinnitsa
400,389,38,128,234,38,272,0,272,4,112,156,22.04.2019 00:00,14,0,Vinnitsa
656,687,41,162,453,41,494,0,494,8,294,192,22.04.2019 00:20,14,0,Vinnitsa
272,257,18,94,160,18,178,0,178,5,121,52,21.04.2019 21:00,14,0,Vinnitsa
256,256,18,80,158,18,176,0,176,0,90,86,21.04.2019 21:00,14,0,Vinnitsa
64,60,6,22,36,6,42,0,42,0,22,20,22.04.2019 00:01,14,0,Vinnitsa
448,439,50,166,233,49,282,0,282,3,186,93,21.04.2019 22:00,14,0,Vinnitsa
192,185,23,83,87,22,109,0,109,1,65,43,22.04.2019 00:20,14,0,Vinnitsa
528,510,17,139,372,17,389,0,389,2,211,176,21.04.2019 22:00,14,0,Vinnitsa
96,91,9,30,58,8,66,0,66,0,26,40,21.04.2019 21:00,14,0,Vinnitsa
608,603,56,190,373,45,418,0,418,11,203,204,21.04.2019 22:00,14,0,Vinnitsa
432,450,6,182,245,5,250,0,250,5,160,85,21.04.2019 21:00,14,0,Vinnitsa
96,97,12,25,60,11,71,0,71,0,36,35,21.04.2019 21:25,14,0,Vinnitsa
96,92,5,41,52,3,55,0,55,1,35,19,21.04.2019 21:00,14,0,Vinnitsa
240,228,18,68,154,18,172,0,172,2,114,56,22.04.2019 00:30,14,0,Vinnitsa
208,201,23,44,142,22,164,0,164,3,76,85,21.04.2019 22:50,14,0,Vinnitsa
656,678,7,181,470,5,475,0,475,6,312,157,21.04.2019 23:00,14,0,Vinnitsa
688,665,3,335,350,3,353,0,353,7,290,56,21.04.2019 23:00,14,0,Vinnitsa
240,230,10,81,149,10,159,0,159,2,121,36,21.04.2019 21:18,14,0,Vinnitsa
240,263,12,52,178,10,188,0,188,2,113,73,21.04.2019 22:00,14,0,Vinnitsa
208,207,22,80,111,17,128,0,128,0,63,65,21.04.2019 21:05,14,0,Vinnitsa
480,469,35,207,244,29,273,0,273,4,196,73,21.04.2019 21:00,14,0,Vinnitsa
368,363,35,150,183,35,218,0,218,2,113,103,21.04.2019 21:00,14,0,Vinnitsa
80,64,3,39,38,3,41,0,41,1,23,17,21.04.2019 21:22,14,0,Vinnitsa
336,327,25,95,216,25,241,0,241,7,136,98,22.04.2019 01:00,14,0,Vinnitsa
1072,1033,42,471,559,42,601,0,601,8,397,196,22.04.2019 01:30,14,0,Vinnitsa
832,810,59,270,505,57,562,0,562,11,320,231,22.04.2019 02:00,14,0,Vinnitsa
608,610,42,176,390,42,432,0,432,10,243,179,22.04.2019 01:00,14,0,Vinnitsa
368,364,47,108,224,36,260,0,260,6,160,94,21.04.2019 23:45,14,0,Vinnitsa
176,169,3,70,104,2,106,0,106,0,64,42,22.04.2019 00:02,14,0,Vinnitsa
464,459,35,70,359,35,394,0,394,3,199,192,21.04.2019 21:00,14,0,Vinnitsa
160,149,21,34,105,21,126,0,126,4,76,46,21.04.2019 23:00,14,0,Vinnitsa
528,521,20,182,326,20,346,0,346,4,230,112,21.04.2019 21:25,14,0,Vinnitsa
224,225,20,111,95,18,113,0,113,4,76,33,21.04.2019 21:05,14,0,Vinnitsa
1392,1418,44,606,746,40,786,0,786,14,485,287,22.04.2019 00:00,14,0,Vinnitsa
128,125,10,21,97,10,107,0,107,0,77,30,21.04.2019 21:00,14,0,Vinnitsa
816,795,50,346,421,49,470,0,470,7,327,136,22.04.2019 01:00,14,0,Vinnitsa
384,425,19,126,240,18,258,0,258,1,162,95,21.04.2019 21:30,14,0,Vinnitsa
1072,1080,20,467,585,20,605,0,605,9,463,133,21.04.2019 22:00,14,0,Vinnitsa
1024,1030,24,464,538,22,560,0,560,4,427,129,21.04.2019 22:00,14,0,Vinnitsa
464,442,25,161,279,24,303,0,303,9,171,123,22.04.2019 00:49,14,0,Vinnitsa
176,176,10,44,122,10,132,0,132,4,49,79,21.04.2019 21:01,14,0,Vinnitsa
400,395,46,133,227,40,267,0,267,3,169,95,22.04.2019 00:20,14,0,Vinnitsa
384,375,39,150,195,39,234,0,234,3,184,47,21.04.2019 23:05,14,0,Vinnitsa
192,180,16,69,108,15,123,0,123,4,86,33,21.04.2019 21:20,14,0,Vinnitsa
320,303,28,85,207,28,235,0,235,18,107,110,22.04.2019 00:20,14,0,Vinnitsa
912,896,52,354,509,49,558,0,558,12,385,161,21.04.2019 23:20,14,0,Vinnitsa
160,159,3,46,113,1,114,0,114,4,73,37,21.04.2019 22:00,14,0,Vinnitsa
352,343,42,78,234,40,274,0,274,7,180,87,21.04.2019 21:35,14,0,Vinnitsa
2064,2029,30,749,1294,21,1315,0,1315,55,829,431,22.04.2019 01:30,14,0,Vinnitsa
608,601,39,228,342,38,380,0,380,5,206,169,22.04.2019 01:02,14,0,Vinnitsa
656,638,29,278,349,29,378,0,378,3,204,171,22.04.2019 00:55,14,0,Vinnitsa
96,82,9,40,49,7,56,0,56,0,30,26,22.04.2019 00:20,14,0,Vinnitsa
416,405,44,142,234,40,274,0,274,10,165,99,22.04.2019 00:18,14,0,Vinnitsa
160,147,35,73,61,26,87,0,87,1,57,29,22.04.2019 00:00,14,0,Vinnitsa
672,648,61,213,401,58,459,0,459,5,192,262,22.04.2019 00:00,14,0,Vinnitsa
288,282,27,96,169,23,192,0,192,2,107,83,21.04.2019 23:00,14,0,Vinnitsa
256,248,24,99,133,24,157,0,157,5,84,68,22.04.2019 02:00,14,0,Vinnitsa
240,215,22,87,134,19,153,0,153,2,68,83,22.04.2019 00:20,14,0,Vinnitsa
144,140,17,59,70,15,85,0,85,0,31,54,22.04.2019 00:38,14,0,Vinnitsa
64,57,11,30,26,8,34,0,34,0,25,9,21.04.2019 21:10,14,0,Vinnitsa
352,344,25,124,203,25,228,0,228,2,115,111,22.04.2019 00:10,14,0,Vinnitsa
272,252,27,102,147,23,170,0,170,2,92,76,22.04.2019 00:58,14,0,Vinnitsa
752,746,30,315,407,30,437,0,437,9,251,177,22.04.2019 01:00,14,0,Vinnitsa
544,539,17,135,393,16,409,0,409,8,243,158,22.04.2019 01:05,14,0,Vinnitsa
80,75,7,27,47,6,53,0,53,3,21,29,21.04.2019 21:20,14,0,Vinnitsa
880,866,54,351,479,50,529,0,529,8,321,200,22.04.2019 01:00,14,0,Vinnitsa
272,266,42,75,155,42,197,0,197,1,109,87,21.04.2019 22:55,14,0,Vinnitsa
704,701,68,254,389,61,450,0,450,9,233,208,22.04.2019 01:00,14,0,Vinnitsa
304,300,25,93,186,25,211,0,211,4,118,89,21.04.2019 23:00,14,0,Vinnitsa
96,88,20,51,28,17,45,0,45,0,28,17,22.04.2019 01:30,14,0,Vinnitsa
288,283,25,82,183,23,206,0,206,2,120,84,21.04.2019 23:05,14,0,Vinnitsa
112,106,16,24,72,16,88,0,88,1,23,64,22.04.2019 00:20,14,0,Vinnitsa
512,494,39,180,295,37,332,0,332,7,174,151,22.04.2019 01:05,14,0,Vinnitsa
80,62,7,38,36,6,42,0,42,0,20,22,22.04.2019 00:20,14,0,Vinnitsa
496,492,53,186,257,53,310,0,310,4,179,127,21.04.2019 22:10,14,0,Vinnitsa
368,350,39,66,265,37,302,0,302,9,169,124,21.04.2019 21:00,14,0,Vinnitsa
112,116,13,20,79,13,92,0,92,1,54,37,21.04.2019 21:25,14,0,Vinnitsa
576,560,14,216,348,12,360,0,360,9,189,162,22.04.2019 00:00,14,0,Vinnitsa
480,470,41,129,313,38,351,0,351,9,174,168,22.04.2019 00:17,14,0,Vinnitsa
224,228,21,58,146,20,166,0,166,6,101,59,22.04.2019 00:00,14,0,Vinnitsa
320,310,43,95,186,39,225,0,225,6,125,94,21.04.2019 21:10,14,0,Vinnitsa
80,76,6,33,41,6,47,0,47,0,17,30,21.04.2019 23:00,14,0,Vinnitsa
768,744,80,214,477,77,554,0,554,4,213,337,22.04.2019 02:00,14,0,Vinnitsa
1312,1277,43,541,732,39,771,0,771,20,445,306,22.04.2019 00:20,14,0,Vinnitsa
592,578,72,230,297,65,362,0,362,6,186,169,22.04.2019 01:00,14,0,Vinnitsa
720,705,51,248,429,43,472,0,472,8,279,185,22.04.2019 01:30,14,0,Vinnitsa
832,819,44,279,513,40,553,0,553,8,380,165,22.04.2019 00:20,14,0,Vinnitsa
352,347,9,96,247,9,256,0,256,6,145,105,22.04.2019 00:45,14,0,Vinnitsa
208,190,22,78,113,17,130,0,130,6,67,57,21.04.2019 23:00,14,0,Vinnitsa
208,197,11,76,121,11,132,0,132,5,76,51,21.04.2019 23:00,14,0,Vinnitsa
112,103,14,41,58,13,71,0,71,2,33,36,21.04.2019 23:00,14,0,Vinnitsa
64,56,5,22,38,4,42,0,42,1,20,21,21.04.2019 22:40,14,0,Vinnitsa
800,787,55,351,395,54,449,0,449,5,296,148,22.04.2019 02:00,14,0,Vinnitsa
640,612,30,300,312,28,340,0,340,9,236,95,22.04.2019 00:10,14,0,Vinnitsa
272,259,16,101,156,15,171,0,171,7,110,54,21.04.2019 22:30,14,0,Vinnitsa
160,161,19,43,99,18,117,0,117,0,66,51,21.04.2019 23:25,14,0,Vinnitsa
528,516,32,217,280,31,311,0,311,5,188,118,22.04.2019 00:20,14,0,Vinnitsa
80,88,9,27,44,9,53,0,53,1,28,24,22.04.2019 01:30,14,0,Vinnitsa
80,69,9,36,35,9,44,0,44,0,23,21,22.04.2019 00:20,14,0,Vinnitsa
352,345,37,118,204,30,234,0,234,8,122,104,22.04.2019 00:00,14,0,Vinnitsa
96,29,4,67,25,4,29,0,29,0,7,22,21.04.2019 21:00,14,0,Vinnitsa
672,236,0,437,235,0,235,0,235,8,137,90,22.04.2019 02:00,14,0,Vinnitsa
1392,1369,3,545,844,3,847,0,847,23,490,334,22.04.2019 01:30,14,0,Vinnitsa
1664,1634,9,691,964,9,973,0,973,15,595,363,22.04.2019 01:30,14,0,Vinnitsa
768,751,12,318,438,12,450,0,450,7,250,193,22.04.2019 02:20,14,0,Vinnitsa
1248,1218,12,542,694,12,706,0,706,20,412,274,22.04.2019 02:20,14,0,Vinnitsa
1104,1095,23,455,626,23,649,0,649,7,415,227,22.04.2019 02:00,14,0,Vinnitsa
1216,1211,13,380,823,13,836,0,836,12,424,400,21.04.2019 22:25,14,0,Vinnitsa
1024,1002,11,390,623,11,634,0,634,22,380,232,22.04.2019 00:20,14,0,Vinnitsa
1024,1004,9,383,634,7,641,0,641,11,377,253,22.04.2019 00:00,14,0,Vinnitsa
208,195,110,25,78,105,183,0,183,3,44,136,21.04.2019 21:50,14,0,Vinnitsa
304,298,25,110,169,25,194,0,194,0,101,93,22.04.2019 01:00,14,0,Vinnitsa
336,331,20,101,217,18,235,0,235,4,116,115,22.04.2019 02:00,14,0,Vinnitsa
160,164,13,52,95,13,108,0,108,1,49,58,22.04.2019 01:30,14,0,Vinnitsa
448,432,0,168,280,0,280,0,280,2,134,144,22.04.2019 00:20,14,0,Vinnitsa
224,213,0,106,118,0,118,0,118,2,58,58,21.04.2019 22:35,14,0,Vinnitsa
880,874,25,361,494,25,519,0,519,6,315,198,22.04.2019 02:00,14,0,Vinnitsa
112,103,6,41,65,6,71,0,71,1,53,17,21.04.2019 22:23,14,0,Vinnitsa
224,211,1,125,98,1,99,0,99,1,68,30,22.04.2019 01:04,14,0,Vinnitsa
224,220,17,68,142,14,156,0,156,5,116,35,21.04.2019 21:30,14,0,Vinnitsa
144,129,8,31,106,7,113,0,113,1,76,36,21.04.2019 21:20,14,0,Vinnitsa
208,208,14,75,122,11,133,0,133,4,66,63,21.04.2019 22:30,14,0,Vinnitsa
368,342,21,128,224,16,240,0,240,1,138,101,22.04.2019 01:00,14,0,Vinnitsa
112,106,5,50,57,5,62,0,62,2,36,24,21.04.2019 22:55,14,0,Vinnitsa
176,175,6,62,108,6,114,0,114,1,82,31,22.04.2019 00:00,14,0,Vinnitsa
224,215,8,80,137,7,144,0,144,2,97,45,21.04.2019 23:10,14,0,Vinnitsa
112,112,2,33,77,2,79,0,79,1,50,28,21.04.2019 22:00,14,0,Vinnitsa
304,293,9,136,166,2,168,0,168,2,120,46,21.04.2019 22:00,14,0,Vinnitsa
160,152,8,71,82,7,89,0,89,1,54,34,21.04.2019 21:35,14,0,Vinnitsa
80,81,2,23,55,2,57,0,57,1,35,21,21.04.2019 22:12,14,0,Vinnitsa
48,41,2,16,30,2,32,0,32,0,9,23,21.04.2019 21:32,14,0,Vinnitsa
192,191,3,86,103,3,106,0,106,3,68,35,22.04.2019 00:20,14,0,Vinnitsa
176,171,18,59,101,16,117,0,117,3,65,49,22.04.2019 02:00,14,0,Vinnitsa
128,115,13,36,79,13,92,0,92,0,44,48,22.04.2019 00:00,14,0,Vinnitsa
176,167,6,63,107,6,113,0,113,0,81,32,22.04.2019 01:15,14,0,Vinnitsa
208,196,13,86,112,10,122,0,122,5,68,49,22.04.2019 00:05,14,0,Vinnitsa
80,76,6,14,60,6,66,0,66,1,28,37,22.04.2019 00:15,14,0,Vinnitsa
512,511,58,196,260,56,316,0,316,8,218,90,22.04.2019 01:30,14,0,Vinnitsa
784,788,34,280,470,34,504,0,504,18,329,157,21.04.2019 23:44,14,0,Vinnitsa
592,585,19,249,327,16,343,0,343,9,178,156,22.04.2019 00:15,14,0,Vinnitsa
192,179,16,65,112,15,127,0,127,1,56,70,21.04.2019 23:00,14,0,Vinnitsa
112,108,10,51,53,8,61,0,61,0,31,30,21.04.2019 22:00,14,0,Vinnitsa
1744,1725,32,679,1036,29,1065,0,1065,29,625,411,22.04.2019 01:10,14,0,Vinnitsa
208,201,10,70,128,10,138,0,138,1,64,73,22.04.2019 01:30,14,0,Vinnitsa
432,426,11,181,243,8,251,0,251,4,140,107,22.04.2019 01:13,14,0,Vinnitsa
160,145,6,74,80,6,86,0,86,1,42,43,22.04.2019 01:02,14,0,Vinnitsa
736,716,37,308,394,34,428,0,428,6,236,186,22.04.2019 01:12,14,0,Vinnitsa
320,301,13,122,186,12,198,0,198,6,145,47,21.04.2019 23:00,14,0,Vinnitsa
400,392,25,125,250,25,275,0,275,3,172,100,22.04.2019 00:15,14,0,Vinnitsa
640,625,35,270,339,31,370,0,370,4,233,133,22.04.2019 02:20,14,0,Vinnitsa
928,904,29,390,511,27,538,0,538,7,354,177,22.04.2019 01:00,14,0,Vinnitsa
96,88,9,45,43,8,51,0,51,0,22,29,22.04.2019 02:00,14,0,Vinnitsa
1552,1555,7,580,967,5,972,0,972,20,740,212,22.04.2019 00:10,14,0,Vinnitsa
1600,1588,6,640,954,6,960,0,960,25,745,190,21.04.2019 22:00,14,0,Vinnitsa
2144,2128,15,896,1234,14,1248,0,1248,35,944,269,22.04.2019 01:00,14,0,Vinnitsa
1632,1594,14,672,950,10,960,0,960,14,770,176,22.04.2019 01:00,14,0,Vinnitsa
2240,2214,10,1012,1220,8,1228,0,1228,30,997,201,22.04.2019 01:00,14,0,Vinnitsa
2320,2265,16,1076,1229,15,1244,0,1244,32,977,235,22.04.2019 00:13,14,0,Vinnitsa
2134,2185,17,792,1336,6,1342,0,1342,49,1026,267,21.04.2019 22:00,14,0,Vinnitsa
2224,2212,21,832,1374,18,1392,0,1392,55,1066,271,21.04.2019 23:00,14,0,Vinnitsa
1424,1443,10,644,770,10,780,0,780,36,528,216,21.04.2019 22:20,14,0,Vinnitsa
2080,2041,13,877,1195,8,1203,0,1203,36,891,276,21.04.2019 23:58,14,0,Vinnitsa
1984,1969,7,757,1224,3,1227,0,1227,40,899,288,21.04.2019 21:20,14,0,Vinnitsa
1824,1823,8,726,1091,7,1098,0,1098,22,840,236,21.04.2019 21:00,14,0,Vinnitsa
1392,1429,9,471,913,8,921,0,921,32,710,179,22.04.2019 01:00,14,0,Vinnitsa
1280,1263,12,523,749,8,757,0,757,27,605,125,22.04.2019 00:01,14,0,Vinnitsa
1680,1651,5,675,1000,5,1005,0,1005,29,745,231,21.04.2019 22:05,14,0,Vinnitsa
1456,1447,10,599,850,7,857,0,857,20,644,193,21.04.2019 21:00,14,0,Vinnitsa
256,103,4,166,86,4,90,0,90,1,31,58,22.04.2019 01:30,14,0,Vinnitsa
496,481,44,182,275,39,314,0,314,5,179,130,21.04.2019 20:55,15,0,Vinnitsa
128,130,10,38,81,9,90,0,90,1,60,29,21.04.2019 21:30,15,0,Vinnitsa
64,57,15,16,36,12,48,0,48,0,32,16,21.04.2019 21:05,15,0,Vinnitsa
1248,1217,6,580,664,4,668,0,668,11,522,135,22.04.2019 00:15,15,0,Vinnitsa
2128,2115,14,934,1182,12,1194,0,1194,14,919,261,22.04.2019 00:35,15,0,Vinnitsa
160,157,10,55,97,8,105,0,105,2,68,35,22.04.2019 00:25,15,0,Vinnitsa
2128,2077,14,934,1180,14,1194,0,1194,29,858,307,21.04.2019 21:06,15,0,Vinnitsa
848,835,73,287,492,69,561,0,561,14,323,224,21.04.2019 21:31,15,0,Vinnitsa
448,446,31,173,246,29,275,0,275,5,172,98,21.04.2019 20:45,15,0,Vinnitsa
944,929,23,383,539,22,561,0,561,9,383,169,21.04.2019 21:30,15,0,Vinnitsa
112,108,15,39,58,15,73,0,73,1,36,36,21.04.2019 21:30,15,0,Vinnitsa
512,508,28,126,359,27,386,0,386,6,258,122,21.04.2019 21:30,15,0,Vinnitsa
304,286,14,50,240,14,254,0,254,3,149,102,22.04.2019 00:45,15,0,Vinnitsa
624,611,73,253,304,67,371,0,371,7,211,153,21.04.2019 21:50,15,0,Vinnitsa
928,910,3,440,485,3,488,0,488,14,285,189,22.04.2019 00:06,15,0,Vinnitsa
480,469,21,218,243,19,262,0,262,7,152,103,22.04.2019 00:25,15,0,Vinnitsa
208,201,17,89,102,17,119,0,119,1,96,22,21.04.2019 22:15,15,0,Vinnitsa
208,200,25,48,135,25,160,0,160,5,96,59,21.04.2019 22:00,15,0,Vinnitsa
144,135,15,67,62,15,77,0,77,0,46,31,21.04.2019 21:40,15,0,Vinnitsa
96,92,4,33,59,4,63,0,63,0,49,14,21.04.2019 23:20,15,0,Vinnitsa
624,611,40,232,361,31,392,0,392,8,329,55,22.04.2019 00:05,15,0,Vinnitsa
640,616,22,323,295,22,317,0,317,6,187,124,22.04.2019 00:10,15,0,Vinnitsa
176,166,19,63,94,19,113,0,113,1,66,46,22.04.2019 00:20,15,0,Vinnitsa
784,784,36,235,514,35,549,0,549,7,276,266,21.04.2019 20:55,15,0,Vinnitsa
1728,1708,34,678,1024,26,1050,0,1050,36,745,269,21.04.2019 23:00,15,0,Vinnitsa
1264,1246,69,519,679,66,745,0,745,10,550,185,22.04.2019 00:25,15,0,Vinnitsa
544,533,19,234,291,19,310,0,310,6,163,141,22.04.2019 00:05,15,0,Vinnitsa
560,545,26,230,309,21,330,0,330,6,264,60,22.04.2019 00:40,15,0,Vinnitsa
240,237,16,68,157,15,172,0,172,1,126,45,22.04.2019 00:05,15,0,Vinnitsa
656,648,26,273,363,20,383,0,383,6,253,124,21.04.2019 22:00,15,0,Vinnitsa
144,138,15,56,73,15,88,0,88,1,56,31,21.04.2019 22:03,15,0,Vinnitsa
128,116,13,52,64,12,76,0,76,0,52,24,21.04.2019 20:58,15,0,Vinnitsa
320,303,15,77,231,12,243,0,243,0,170,73,22.04.2019 00:20,15,0,Vinnitsa
1552,1531,13,558,983,11,994,0,994,21,738,235,22.04.2019 00:30,15,0,Vinnitsa
400,382,23,165,219,16,235,0,235,1,176,58,22.04.2019 00:05,16,0,Vinnitsa
64,59,7,26,33,5,38,0,38,1,29,8,21.04.2019 21:10,16,0,Vinnitsa
736,709,41,326,380,30,410,0,410,12,271,127,22.04.2019 00:15,16,0,Vinnitsa
304,291,20,123,166,15,181,0,181,1,148,32,21.04.2019 23:05,16,0,Vinnitsa
96,96,9,28,59,9,68,0,68,1,55,12,21.04.2019 23:15,16,0,Vinnitsa
224,207,22,86,123,15,138,0,138,3,112,23,21.04.2019 21:01,16,0,Vinnitsa
192,188,14,60,118,14,132,0,132,0,109,23,22.04.2019 00:17,16,0,Vinnitsa
96,99,15,40,48,8,56,0,56,0,32,24,21.04.2019 20:40,16,0,Vinnitsa
1296,1274,47,449,803,44,847,0,847,19,514,314,22.04.2019 00:10,16,0,Vinnitsa
288,276,17,111,168,9,177,0,177,5,122,50,21.04.2019 20:30,16,0,Vinnitsa
304,294,21,150,140,14,154,0,154,5,116,33,22.04.2019 00:10,16,0,Vinnitsa
384,365,24,147,216,21,237,0,237,5,178,54,21.04.2019 21:50,16,0,Vinnitsa
288,280,21,122,147,19,166,0,166,9,114,43,22.04.2019 00:15,16,0,Vinnitsa
240,239,12,68,161,11,172,0,172,0,126,46,22.04.2019 00:16,16,0,Vinnitsa
304,300,24,97,184,23,207,0,207,6,136,65,21.04.2019 21:20,16,0,Vinnitsa
384,381,18,109,257,18,275,0,275,9,149,117,22.04.2019 00:10,16,0,Vinnitsa
160,160,16,59,89,12,101,0,101,1,70,30,22.04.2019 00:15,16,0,Vinnitsa
384,368,9,159,219,6,225,0,225,13,136,76,21.04.2019 20:54,16,0,Vinnitsa
160,152,15,56,89,15,104,0,104,0,44,60,21.04.2019 23:15,16,0,Vinnitsa
1104,1081,53,364,695,45,740,0,740,12,388,340,21.04.2019 22:30,16,0,Vinnitsa
240,233,25,109,112,19,131,0,131,2,76,53,22.04.2019 00:30,16,0,Vinnitsa
2080,2042,52,943,1085,52,1137,0,1137,16,893,228,22.04.2019 00:15,16,0,Vinnitsa
432,420,45,166,223,43,266,0,266,6,209,51,22.04.2019 00:30,16,0,Vinnitsa
384,380,22,190,172,22,194,0,194,2,136,56,21.04.2019 21:00,16,0,Vinnitsa
80,71,4,33,43,4,47,0,47,0,28,19,21.04.2019 21:15,16,0,Vinnitsa
320,315,26,123,174,23,197,0,197,6,144,47,21.04.2019 20:45,16,0,Vinnitsa
1232,1208,93,593,564,75,639,0,639,11,518,110,21.04.2019 21:38,16,0,Vinnitsa
432,425,46,194,196,42,238,0,238,3,155,80,21.04.2019 21:00,16,0,Vinnitsa
288,275,20,101,168,19,187,0,187,5,148,34,21.04.2019 21:00,16,0,Vinnitsa
1424,1405,50,565,815,44,859,0,859,19,633,207,21.04.2019 21:35,16,0,Vinnitsa
816,797,46,355,423,38,461,0,461,14,362,85,21.04.2019 23:00,16,0,Vinnitsa
112,102,2,49,62,1,63,0,63,2,45,16,21.04.2019 22:10,16,0,Vinnitsa
288,291,17,152,123,13,136,0,136,1,91,44,22.04.2019 00:15,16,0,Vinnitsa
176,171,1,51,125,0,125,0,125,2,88,35,21.04.2019 22:40,16,0,Vinnitsa
560,544,38,246,279,35,314,0,314,5,246,63,22.04.2019 00:10,16,0,Vinnitsa
432,418,34,188,210,34,244,0,244,6,154,84,21.04.2019 20:50,16,0,Vinnitsa
144,140,26,37,84,23,107,0,107,0,86,21,21.04.2019 23:00,16,0,Vinnitsa
128,52,14,77,37,14,51,0,51,3,33,15,22.04.2019 00:10,16,0,Vinnitsa
384,382,20,104,260,20,280,0,280,5,194,81,22.04.2019 02:10,16,0,Vinnitsa
2512,2456,17,1342,1155,15,1170,0,1170,30,827,313,22.04.2019 00:35,16,0,Vinnitsa
2192,2146,27,1084,1082,26,1108,0,1108,34,743,331,22.04.2019 00:14,16,0,Vinnitsa
2016,1987,36,979,1004,33,1037,0,1037,27,693,317,22.04.2019 00:25,16,0,Vinnitsa
2208,2154,30,1087,1096,25,1121,0,1121,27,823,271,22.04.2019 00:15,16,0,Vinnitsa
560,541,27,276,263,21,284,0,284,6,228,50,21.04.2019 23:15,16,0,Vinnitsa
272,269,17,140,117,15,132,0,132,1,96,35,21.04.2019 20:58,16,0,Vinnitsa
960,938,44,436,480,44,524,0,524,10,369,145,21.04.2019 20:53,16,0,Vinnitsa
1024,999,65,459,506,59,565,0,565,4,405,156,21.04.2019 21:00,16,0,Vinnitsa
912,902,38,447,429,36,465,0,465,6,332,127,21.04.2019 21:59,16,0,Vinnitsa
576,559,39,288,253,35,288,0,288,1,213,74,21.04.2019 23:20,16,0,Vinnitsa
1136,1117,39,494,608,34,642,0,642,14,354,274,21.04.2019 22:00,16,0,Vinnitsa
928,909,39,409,485,34,519,0,519,12,360,147,22.04.2019 00:20,16,0,Vinnitsa
640,628,57,271,312,57,369,0,369,8,298,63,21.04.2019 22:30,16,0,Vinnitsa
368,353,37,165,170,33,203,0,203,2,147,54,21.04.2019 21:30,16,0,Vinnitsa
448,426,33,218,199,31,230,0,230,3,177,50,21.04.2019 23:15,16,0,Vinnitsa
608,596,41,229,341,38,379,0,379,2,282,95,22.04.2019 00:30,16,0,Vinnitsa
336,321,25,136,175,25,200,0,200,0,153,47,21.04.2019 20:58,16,0,Vinnitsa
400,379,23,167,212,21,233,0,233,8,150,75,21.04.2019 21:15,16,0,Vinnitsa
816,797,48,352,416,48,464,0,464,12,311,141,21.04.2019 21:20,16,0,Vinnitsa
208,208,17,58,133,17,150,0,150,2,80,68,22.04.2019 00:06,16,0,Vinnitsa
512,503,23,218,271,23,294,0,294,5,223,66,22.04.2019 00:40,16,0,Vinnitsa
176,169,7,97,73,6,79,0,79,0,55,24,22.04.2019 00:02,16,0,Vinnitsa
128,76,15,54,59,15,74,0,74,0,36,38,21.04.2019 23:45,16,0,Vinnitsa
1104,1076,18,551,536,17,553,0,553,14,427,112,21.04.2019 22:00,16,0,Vinnitsa
1632,1593,23,759,856,17,873,0,873,20,676,177,22.04.2019 00:50,16,0,Vinnitsa
1856,1829,17,805,1038,13,1051,0,1051,28,792,231,22.04.2019 01:10,16,0,Vinnitsa
1664,1632,23,733,911,20,931,0,931,17,738,176,21.04.2019 22:00,16,0,Vinnitsa
1392,1368,12,700,681,11,692,0,692,17,519,156,21.04.2019 22:00,16,0,Vinnitsa
240,226,8,94,138,8,146,0,146,1,113,32,21.04.2019 21:05,16,0,Vinnitsa
64,36,0,28,36,0,36,0,36,2,25,9,21.04.2019 22:20,16,0,Vinnitsa
896,880,20,359,517,20,537,0,537,12,318,207,21.04.2019 23:40,17,0,Vinnitsa
1376,1350,10,565,802,9,811,0,811,17,615,179,22.04.2019 00:15,17,0,Vinnitsa
1744,1725,7,706,1034,4,1038,0,1038,31,780,227,22.04.2019 00:34,17,0,Vinnitsa
1040,1024,7,451,584,5,589,0,589,6,418,165,22.04.2019 00:10,17,0,Vinnitsa
1440,1413,10,587,845,8,853,0,853,15,610,228,22.04.2019 00:10,17,0,Vinnitsa
688,681,16,208,464,16,480,0,480,11,244,225,22.04.2019 00:08,17,0,Vinnitsa
192,187,1,65,126,1,127,0,127,1,78,48,22.04.2019 01:10,17,0,Vinnitsa
64,55,4,25,35,4,39,0,39,2,20,17,22.04.2019 01:10,17,0,Vinnitsa
368,362,16,160,194,14,208,0,208,0,133,75,22.04.2019 00:11,17,0,Vinnitsa
480,479,31,206,243,31,274,0,274,6,171,97,22.04.2019 00:04,17,0,Vinnitsa
192,188,9,75,108,9,117,0,117,2,56,59,21.04.2019 22:00,17,0,Vinnitsa
160,153,7,66,88,6,94,0,94,5,65,24,22.04.2019 00:05,17,0,Vinnitsa
384,379,19,146,220,18,238,0,238,5,129,104,22.04.2019 00:07,17,0,Vinnitsa
720,698,12,284,426,10,436,0,436,15,288,133,22.04.2019 00:40,17,0,Vinnitsa
448,446,26,177,245,26,271,0,271,0,180,91,22.04.2019 00:10,17,0,Vinnitsa
144,126,13,64,67,13,80,0,80,3,52,25,22.04.2019 00:07,17,0,Vinnitsa
272,333,32,59,181,32,213,0,213,5,145,63,21.04.2019 21:45,17,0,Vinnitsa
496,501,41,148,308,40,348,0,348,9,230,109,22.04.2019 00:03,17,0,Vinnitsa
656,636,8,245,405,6,411,0,411,9,304,98,22.04.2019 00:01,17,0,Vinnitsa
432,427,4,189,239,4,243,0,243,4,149,90,22.04.2019 00:30,17,0,Vinnitsa
624,606,17,142,466,16,482,0,482,6,334,142,22.04.2019 00:30,17,0,Vinnitsa
256,244,11,91,156,9,165,0,165,2,101,62,22.04.2019 00:20,17,0,Vinnitsa
176,159,0,56,120,0,120,0,120,6,89,25,22.04.2019 00:10,17,0,Vinnitsa
128,39,4,92,32,4,36,0,36,0,26,10,22.04.2019 00:55,17,0,Vinnitsa
48,11,8,37,3,8,11,0,11,0,5,6,22.04.2019 00:40,17,0,Vinnitsa
1776,1753,19,737,1021,18,1039,0,1039,23,709,307,22.04.2019 00:56,17,0,Vinnitsa
2112,2077,12,871,1232,9,1241,0,1241,26,891,324,22.04.2019 00:05,17,0,Vinnitsa
2208,2152,5,918,1285,5,1290,0,1290,30,873,387,22.04.2019 01:25,17,0,Vinnitsa
544,539,37,188,319,37,356,0,356,3,183,170,22.04.2019 00:25,17,0,Vinnitsa
912,894,53,264,595,53,648,0,648,14,467,167,22.04.2019 00:50,17,0,Vinnitsa
1120,1104,43,283,797,40,837,0,837,8,553,276,22.04.2019 01:45,17,0,Vinnitsa
912,901,63,298,553,61,614,0,614,13,432,169,22.04.2019 00:10,17,0,Vinnitsa
512,490,37,176,300,36,336,0,336,4,257,75,22.04.2019 00:20,17,0,Vinnitsa
1424,1401,11,638,775,11,786,0,786,10,545,231,22.04.2019 00:35,17,0,Vinnitsa
672,654,25,297,352,23,375,0,375,9,247,119,22.04.2019 01:30,17,0,Vinnitsa
208,203,7,53,148,7,155,0,155,2,65,88,21.04.2019 21:10,17,0,Vinnitsa
576,559,32,231,315,30,345,0,345,11,184,150,22.04.2019 00:20,17,0,Vinnitsa
1200,1183,3,545,652,3,655,0,655,16,426,213,22.04.2019 01:30,17,0,Vinnitsa
784,766,5,360,419,5,424,0,424,5,324,95,22.04.2019 01:20,17,0,Vinnitsa
480,472,14,109,357,14,371,0,371,3,226,142,22.04.2019 02:20,17,0,Vinnitsa
896,884,7,351,538,7,545,0,545,8,385,152,22.04.2019 00:12,17,0,Vinnitsa
736,722,11,248,477,11,488,0,488,3,341,144,22.04.2019 00:04,17,0,Vinnitsa
80,72,5,27,49,4,53,0,53,1,40,12,22.04.2019 00:15,17,0,Vinnitsa
1264,1238,84,566,621,77,698,0,698,13,539,146,21.04.2019 21:00,17,0,Vinnitsa
976,959,41,355,580,41,621,0,621,15,452,154,22.04.2019 00:30,17,0,Vinnitsa
128,119,0,52,76,0,76,0,76,0,62,14,22.04.2019 00:05,17,0,Vinnitsa
576,569,11,178,387,11,398,0,398,8,217,173,22.04.2019 00:30,17,0,Vinnitsa
464,459,5,217,243,4,247,0,247,5,165,77,22.04.2019 00:25,17,0,Vinnitsa
624,620,19,284,321,19,340,0,340,5,233,102,22.04.2019 00:20,17,0,Vinnitsa
144,42,25,112,15,17,32,0,32,1,23,8,22.04.2019 00:35,17,0,Vinnitsa
2224,2196,41,757,1436,31,1467,0,1467,38,1086,343,22.04.2019 00:20,17,0,Vinnitsa
2416,2412,41,822,1563,31,1594,0,1594,27,1156,411,22.04.2019 01:45,17,0,Vinnitsa
592,581,29,250,315,27,342,0,342,11,260,71,22.04.2019 00:20,17,0,Vinnitsa
288,278,3,107,178,3,181,0,181,4,124,53,22.04.2019 00:30,17,0,Vinnitsa
1536,1531,14,559,966,11,977,0,977,26,694,257,22.04.2019 00:16,17,0,Vinnitsa
2032,2025,27,690,1327,15,1342,0,1342,38,965,339,22.04.2019 00:06,17,0,Vinnitsa
2176,2142,17,857,1309,10,1319,0,1319,37,952,330,22.04.2019 00:41,17,0,Vinnitsa
1104,1092,8,381,718,5,723,0,723,17,517,189,22.04.2019 00:15,17,0,Vinnitsa
112,10,9,103,1,8,9,0,9,0,6,3,22.04.2019 00:20,17,0,Vinnitsa
752,745,40,258,461,33,494,0,494,9,349,136,22.04.2019 02:05,18,0,Vinnitsa
1104,1082,9,352,744,8,752,0,752,15,499,238,22.04.2019 00:20,18,0,Vinnitsa
1376,1340,6,503,868,5,873,0,873,24,589,260,22.04.2019 00:09,18,0,Vinnitsa
304,300,17,111,176,17,193,0,193,4,133,56,22.04.2019 00:40,18,0,Vinnitsa
928,908,36,392,503,33,536,0,536,10,345,181,22.04.2019 00:35,18,0,Vinnitsa
896,874,61,357,482,57,539,0,539,8,339,192,21.04.2019 20:33,18,0,Vinnitsa
192,189,5,66,123,3,126,0,126,0,81,45,22.04.2019 00:45,18,0,Vinnitsa
336,328,18,128,191,17,208,0,208,6,164,38,22.04.2019 00:06,18,0,Vinnitsa
368,359,37,129,207,32,239,0,239,7,122,110,22.04.2019 00:40,18,0,Vinnitsa
528,526,31,240,258,30,288,0,288,6,188,94,22.04.2019 00:47,18,0,Vinnitsa
576,558,39,251,292,33,325,0,325,8,226,91,22.04.2019 00:55,18,0,Vinnitsa
80,68,4,31,46,3,49,0,49,0,37,12,22.04.2019 00:02,18,0,Vinnitsa
256,252,22,73,163,20,183,0,183,2,109,72,22.04.2019 00:10,18,0,Vinnitsa
880,859,39,318,525,37,562,0,562,5,381,176,22.04.2019 00:40,18,0,Vinnitsa
208,205,15,68,125,15,140,0,140,1,107,32,22.04.2019 00:15,18,0,Vinnitsa
272,269,23,69,181,22,203,0,203,1,147,55,22.04.2019 00:10,18,0,Vinnitsa
80,68,4,34,43,3,46,0,46,0,24,22,22.04.2019 00:05,18,0,Vinnitsa
416,436,47,147,229,40,269,0,269,7,165,97,22.04.2019 01:20,18,0,Vinnitsa
208,200,12,87,110,11,121,0,121,0,88,33,22.04.2019 00:20,18,0,Vinnitsa
448,432,21,141,286,21,307,0,307,9,215,83,22.04.2019 00:05,18,0,Vinnitsa
256,239,11,126,121,9,130,0,130,0,95,35,22.04.2019 01:05,18,0,Vinnitsa
672,656,52,213,410,49,459,0,459,2,298,159,21.04.2019 23:15,18,0,Vinnitsa
256,249,29,66,161,29,190,0,190,1,137,52,22.04.2019 00:30,18,0,Vinnitsa
272,265,17,85,170,17,187,0,187,0,127,60,22.04.2019 00:05,18,0,Vinnitsa
288,284,15,108,165,15,180,0,180,1,107,72,22.04.2019 00:05,18,0,Vinnitsa
64,56,5,16,43,5,48,0,48,0,34,14,22.04.2019 00:10,18,0,Vinnitsa
144,143,7,40,97,7,104,0,104,2,44,58,22.04.2019 00:30,18,0,Vinnitsa
160,19,15,148,3,9,12,0,12,0,10,2,22.04.2019 00:15,18,0,Vinnitsa
32,25,19,11,4,17,21,0,21,0,17,4,21.04.2019 20:50,18,0,Vinnitsa
1472,1429,16,598,859,15,874,0,874,21,551,302,22.04.2019 01:00,18,0,Vinnitsa
1360,1335,21,613,730,17,747,0,747,20,522,205,22.04.2019 00:05,18,0,Vinnitsa
1088,1066,12,423,654,11,665,0,665,17,433,215,22.04.2019 01:50,18,0,Vinnitsa
288,267,28,113,148,27,175,0,175,1,109,65,22.04.2019 00:50,18,0,Vinnitsa
192,184,22,80,91,21,112,0,112,1,82,29,22.04.2019 00:05,18,0,Vinnitsa
1600,1582,49,658,896,46,942,0,942,14,573,355,22.04.2019 00:25,18,0,Vinnitsa
320,314,6,149,166,5,171,0,171,2,116,53,22.04.2019 00:15,18,0,Vinnitsa
144,46,11,108,25,11,36,0,36,1,27,8,22.04.2019 00:15,18,0,Vinnitsa
1744,1760,10,632,1106,6,1112,0,1112,29,752,331,22.04.2019 01:45,18,0,Vinnitsa
1872,1810,8,739,1125,8,1133,0,1133,27,712,394,22.04.2019 00:05,18,0,Vinnitsa
240,231,34,67,139,34,173,0,173,1,82,90,22.04.2019 00:30,18,0,Vinnitsa
288,309,29,45,215,28,243,0,243,5,145,93,22.04.2019 00:45,18,0,Vinnitsa
384,369,26,197,162,25,187,0,187,1,120,66,22.04.2019 00:10,18,0,Vinnitsa
1104,1093,31,443,632,29,661,0,661,12,413,236,22.04.2019 00:05,18,0,Vinnitsa
416,408,30,70,316,30,346,0,346,6,221,119,21.04.2019 20:40,18,0,Vinnitsa
1120,1100,35,430,659,31,690,0,690,15,460,215,22.04.2019 01:05,18,0,Vinnitsa
528,518,40,173,316,39,355,0,355,4,178,173,22.04.2019 00:30,18,0,Vinnitsa
96,89,6,29,61,6,67,0,67,0,39,28,22.04.2019 00:40,18,0,Vinnitsa
1456,1429,48,517,893,46,939,0,939,14,602,323,22.04.2019 00:10,18,0,Vinnitsa
144,138,5,53,87,4,91,0,91,1,53,37,22.04.2019 00:10,18,0,Vinnitsa
720,717,50,233,440,47,487,0,487,10,322,155,22.04.2019 02:10,18,0,Vinnitsa
528,522,51,177,301,50,351,0,351,7,179,165,22.04.2019 00:15,18,0,Vinnitsa
464,459,38,130,299,35,334,0,334,4,207,123,22.04.2019 00:10,18,0,Vinnitsa
208,208,9,87,114,7,121,0,121,0,87,34,22.04.2019 00:15,18,0,Vinnitsa
208,199,10,83,117,8,125,0,125,4,84,37,22.04.2019 00:15,18,0,Vinnitsa
576,562,8,217,352,7,359,0,359,12,246,101,22.04.2019 00:45,18,0,Vinnitsa
416,400,17,170,230,16,246,0,246,6,166,74,22.04.2019 00:05,18,0,Vinnitsa
160,147,9,57,96,7,103,0,103,1,65,37,22.04.2019 00:15,18,0,Vinnitsa
608,606,52,177,386,45,431,0,431,6,249,176,22.04.2019 00:15,18,0,Vinnitsa
144,141,16,41,87,16,103,0,103,1,61,41,22.04.2019 00:10,18,0,Vinnitsa
304,295,22,110,172,22,194,0,194,3,128,63,22.04.2019 01:40,18,0,Vinnitsa
688,673,70,164,454,70,524,0,524,8,297,219,22.04.2019 00:22,18,0,Vinnitsa
336,328,28,104,205,27,232,0,232,1,139,92,22.04.2019 00:55,18,0,Vinnitsa
880,871,78,278,540,62,602,0,602,14,376,212,22.04.2019 00:30,18,0,Vinnitsa
96,23,12,74,11,11,22,0,22,0,11,11,22.04.2019 00:10,18,0,Vinnitsa
1328,1303,5,550,773,5,778,0,778,20,512,246,22.04.2019 00:40,18,0,Vinnitsa
1056,1040,9,478,569,9,578,0,578,15,389,174,22.04.2019 00:05,18,0,Vinnitsa
448,436,29,178,242,28,270,0,270,4,150,116,22.04.2019 00:20,18,0,Vinnitsa
624,609,52,182,393,49,442,0,442,6,300,136,22.04.2019 00:40,18,0,Vinnitsa
256,257,22,94,141,21,162,0,162,3,108,51,22.04.2019 00:40,18,0,Vinnitsa
256,241,27,76,153,27,180,0,180,2,118,60,22.04.2019 00:40,18,0,Vinnitsa
32,31,5,8,19,5,24,0,24,1,5,18,22.04.2019 00:10,18,0,Vinnitsa
160,159,19,51,90,19,109,0,109,1,50,58,22.04.2019 00:20,18,0,Vinnitsa
352,338,25,134,194,24,218,0,218,3,120,95,22.04.2019 00:15,18,0,Vinnitsa
352,360,43,102,207,43,250,0,250,4,160,86,22.04.2019 00:15,18,0,Vinnitsa
224,210,26,104,95,25,120,0,120,3,71,46,22.04.2019 00:15,18,0,Vinnitsa
128,47,20,91,17,20,37,0,37,0,19,18,22.04.2019 00:05,18,0,Vinnitsa
512,490,32,154,329,29,358,0,358,4,195,159,22.04.2019 00:15,19,1,Volyn
80,81,2,20,58,2,60,0,60,4,22,34,22.04.2019 00:15,19,1,Volyn
112,111,2,40,70,2,72,0,72,0,43,29,22.04.2019 00:05,19,1,Volyn
320,308,10,118,193,9,202,0,202,6,162,34,22.04.2019 01:50,19,1,Volyn
64,62,2,17,45,2,47,0,47,1,32,14,22.04.2019 01:10,19,1,Volyn
256,245,8,106,144,6,150,0,150,4,114,32,22.04.2019 00:45,19,1,Volyn
448,434,20,190,241,17,258,0,258,3,144,111,22.04.2019 01:55,19,1,Volyn
208,192,9,100,101,7,108,0,108,1,56,51,21.04.2019 21:40,19,1,Volyn
64,61,2,31,31,2,33,0,33,2,16,15,21.04.2019 22:00,19,1,Volyn
448,437,24,168,256,24,280,0,280,4,211,65,22.04.2019 00:05,19,1,Volyn
704,679,25,258,425,21,446,0,446,14,310,122,22.04.2019 00:04,19,1,Volyn
144,145,13,21,110,13,123,0,123,4,89,30,22.04.2019 00:04,19,1,Volyn
160,158,16,58,88,14,102,0,102,4,60,38,22.04.2019 00:15,19,1,Volyn
128,129,8,41,81,6,87,0,87,4,62,21,22.04.2019 00:10,19,1,Volyn
256,251,20,90,149,17,166,0,166,1,120,45,22.04.2019 00:05,19,1,Volyn
64,63,0,19,45,0,45,0,45,2,30,13,21.04.2019 20:45,19,1,Volyn
64,56,5,20,39,5,44,0,44,0,33,11,21.04.2019 22:15,19,1,Volyn
368,356,20,134,219,15,234,0,234,1,114,119,22.04.2019 00:10,19,1,Volyn
128,118,11,40,77,11,88,0,88,0,53,35,22.04.2019 00:20,19,1,Volyn
976,986,78,347,557,72,629,0,629,5,479,145,21.04.2019 22:30,19,1,Volyn
224,216,8,92,126,6,132,0,132,3,101,28,22.04.2019 00:05,19,1,Volyn
224,211,15,76,133,15,148,0,148,2,100,46,22.04.2019 00:05,19,1,Volyn
640,631,22,237,382,21,403,0,403,5,299,99,22.04.2019 00:05,19,1,Volyn
288,282,8,89,191,8,199,0,199,3,120,76,22.04.2019 00:10,19,1,Volyn
128,116,4,43,81,4,85,0,85,2,56,27,22.04.2019 00:10,19,1,Volyn
144,144,11,50,83,11,94,0,94,0,82,12,22.04.2019 00:10,19,1,Volyn
352,335,27,120,212,20,232,0,232,2,158,72,22.04.2019 01:10,19,1,Volyn
128,112,16,61,56,11,67,0,67,3,43,21,21.04.2019 23:15,19,1,Volyn
208,198,10,75,123,10,133,0,133,0,104,29,22.04.2019 00:05,19,1,Volyn
144,141,14,49,84,11,95,0,95,4,67,24,21.04.2019 21:32,19,1,Volyn
160,154,11,60,89,11,100,0,100,2,84,14,22.04.2019 00:10,19,1,Volyn
544,535,36,178,333,33,366,0,366,6,236,124,22.04.2019 00:10,19,1,Volyn
304,291,32,97,176,31,207,0,207,2,166,39,21.04.2019 21:00,19,1,Volyn
128,125,2,46,81,1,82,0,82,3,53,26,22.04.2019 00:05,19,1,Volyn
624,605,12,204,408,12,420,0,420,6,276,138,22.04.2019 00:20,19,1,Volyn
352,337,15,125,212,15,227,0,227,3,163,61,22.04.2019 01:10,19,1,Volyn
144,146,6,47,92,5,97,0,97,1,73,23,22.04.2019 00:10,19,1,Volyn
288,272,8,99,181,8,189,0,189,7,113,69,21.04.2019 21:00,19,1,Volyn
400,390,13,177,213,10,223,0,223,5,129,89,21.04.2019 22:00,19,1,Volyn
336,331,28,114,195,27,222,0,222,2,145,75,21.04.2019 21:50,19,1,Volyn
176,174,4,56,116,4,120,0,120,1,61,58,21.04.2019 23:15,19,1,Volyn
688,665,36,273,379,36,415,0,415,10,255,150,22.04.2019 00:22,19,1,Volyn
576,582,47,212,320,44,364,0,364,7,270,87,22.04.2019 00:40,19,1,Volyn
304,287,16,114,174,16,190,0,190,4,124,62,21.04.2019 22:30,19,1,Volyn
224,220,12,89,123,12,135,0,135,3,82,50,22.04.2019 00:15,19,1,Volyn
192,186,18,42,132,18,150,0,150,1,100,49,22.04.2019 00:05,19,1,Volyn
688,684,51,258,382,48,430,0,430,8,307,115,22.04.2019 00:16,19,1,Volyn
640,645,30,249,363,28,391,0,391,1,330,60,22.04.2019 00:03,19,1,Volyn
176,169,18,54,105,17,122,0,122,0,94,28,22.04.2019 00:45,19,1,Volyn
1472,1439,32,518,923,31,954,0,954,37,692,225,22.04.2019 00:10,19,1,Volyn
1584,1541,25,587,980,17,997,0,997,22,712,263,22.04.2019 00:20,19,1,Volyn
1360,1328,49,542,779,39,818,0,818,26,610,182,22.04.2019 00:05,19,1,Volyn
1392,1365,18,479,900,13,913,0,913,26,637,250,22.04.2019 00:05,19,1,Volyn
1200,1182,18,424,763,13,776,0,776,28,535,213,22.04.2019 00:45,19,1,Volyn
1344,1324,31,540,782,22,804,0,804,28,557,219,22.04.2019 00:17,19,1,Volyn
1520,1482,17,611,894,15,909,0,909,24,642,243,22.04.2019 00:20,19,1,Volyn
2096,2055,9,900,1189,7,1196,0,1196,34,771,391,22.04.2019 00:03,19,1,Volyn
1920,1909,23,833,1066,21,1087,0,1087,38,770,279,22.04.2019 01:10,19,1,Volyn
2000,1956,20,868,1117,15,1132,0,1132,27,761,344,22.04.2019 01:26,19,1,Volyn
1968,1920,10,758,1201,9,1210,0,1210,31,822,357,22.04.2019 01:10,19,1,Volyn
320,157,63,173,93,54,147,0,147,4,105,38,21.04.2019 20:48,19,1,Volyn
64,45,16,19,29,16,45,0,45,0,12,33,22.04.2019 00:20,20,1,Volyn
1280,1265,22,577,687,16,703,20,703,20,422,261,21.04.2019 23:45,20,1,Volyn
1168,1140,8,517,645,6,651,0,651,14,405,232,22.04.2019 00:30,20,1,Volyn
1248,1231,22,531,703,14,717,0,717,24,385,308,22.04.2019 00:10,20,1,Volyn
880,874,62,320,509,51,560,0,560,17,324,219,22.04.2019 00:25,20,1,Volyn
384,372,26,146,215,23,238,0,238,4,145,89,21.04.2019 23:00,20,1,Volyn
496,487,39,190,269,37,306,0,306,7,176,123,22.04.2019 00:12,20,1,Volyn
416,402,15,127,274,15,289,0,289,3,166,120,22.04.2019 00:15,20,1,Volyn
224,209,5,83,136,5,141,0,141,7,73,61,22.04.2019 00:10,20,1,Volyn
112,100,0,42,70,0,70,0,70,3,24,43,22.04.2019 00:20,20,1,Volyn
560,552,25,159,377,24,401,0,401,11,172,218,22.04.2019 00:35,20,1,Volyn
320,307,21,133,169,18,187,0,187,4,87,96,22.04.2019 00:02,20,1,Volyn
80,67,4,30,46,4,50,0,50,0,38,12,22.04.2019 00:05,20,1,Volyn
608,599,51,174,385,49,434,0,434,6,229,199,22.04.2019 00:10,20,1,Volyn
208,191,18,39,151,18,169,0,169,1,86,82,22.04.2019 00:15,20,1,Volyn
208,196,9,46,153,9,162,0,162,3,70,89,22.04.2019 00:15,20,1,Volyn
352,339,28,124,205,23,228,0,228,2,130,96,22.04.2019 00:01,20,1,Volyn
416,402,25,172,226,18,244,0,244,6,123,115,22.04.2019 00:05,20,1,Volyn
128,117,3,52,73,3,76,0,76,2,35,39,22.04.2019 00:15,20,1,Volyn
576,560,27,202,349,25,374,0,374,3,197,174,22.04.2019 00:03,20,1,Volyn
240,222,11,64,165,11,176,0,176,1,89,86,21.04.2019 21:30,20,1,Volyn
384,372,18,108,258,18,276,0,276,3,125,148,22.04.2019 00:00,20,1,Volyn
256,240,15,74,167,15,182,0,182,5,65,112,22.04.2019 00:15,20,1,Volyn
192,190,12,68,112,12,124,0,124,2,59,63,22.04.2019 00:30,20,1,Volyn
336,320,14,151,172,13,185,0,185,1,119,65,21.04.2019 22:10,20,1,Volyn
240,232,16,101,123,16,139,0,139,3,88,48,22.04.2019 00:20,20,1,Volyn
480,473,30,149,301,30,331,0,331,11,223,97,22.04.2019 00:10,20,1,Volyn
416,404,27,183,206,27,233,0,233,3,117,113,22.04.2019 00:05,20,1,Volyn
208,192,17,65,126,17,143,0,143,2,51,90,21.04.2019 21:45,20,1,Volyn
416,399,23,143,250,23,273,0,273,4,127,142,21.04.2019 20:55,20,1,Volyn
192,189,4,78,112,2,114,0,114,2,58,54,22.04.2019 00:05,20,1,Volyn
352,348,8,91,253,8,261,0,261,3,167,91,22.04.2019 00:02,20,1,Volyn
336,331,15,76,246,14,260,0,260,6,150,104,22.04.2019 00:10,20,1,Volyn
528,519,46,169,316,43,359,0,359,3,196,160,21.04.2019 21:30,20,1,Volyn
672,658,32,236,405,31,436,0,436,7,241,188,22.04.2019 00:50,20,1,Volyn
96,89,0,30,66,0,66,0,66,0,40,26,21.04.2019 23:50,20,1,Volyn
128,38,24,90,14,24,38,0,38,0,8,30,21.04.2019 20:40,20,1,Volyn
928,917,4,363,561,4,565,0,565,10,353,202,21.04.2019 21:35,20,1,Volyn
256,247,5,99,152,5,157,0,157,1,111,45,22.04.2019 01:05,20,1,Volyn
64,48,5,29,32,3,35,0,35,1,27,7,21.04.2019 23:50,20,1,Volyn
224,217,4,62,158,4,162,0,162,4,89,69,21.04.2019 21:00,20,1,Volyn
112,102,8,40,66,6,72,0,72,0,41,31,22.04.2019 00:05,20,1,Volyn
304,291,11,83,210,11,221,0,221,6,141,74,22.04.2019 00:10,20,1,Volyn
64,60,3,16,45,3,48,0,48,0,26,22,21.04.2019 20:30,20,1,Volyn
240,233,13,49,179,12,191,0,191,1,98,92,21.04.2019 20:45,20,1,Volyn
64,53,6,22,36,6,42,0,42,1,16,25,21.04.2019 21:10,20,1,Volyn
192,173,7,87,98,7,105,0,105,5,59,41,22.04.2019 01:00,20,1,Volyn
160,149,7,76,77,7,84,0,84,0,51,33,22.04.2019 00:03,20,1,Volyn
560,558,17,88,455,17,472,0,472,12,288,172,22.04.2019 00:15,20,1,Volyn
480,475,28,135,321,24,345,0,345,3,211,131,22.04.2019 00:15,20,1,Volyn
272,259,6,116,150,6,156,0,156,0,70,86,21.04.2019 21:10,20,1,Volyn
80,76,4,37,39,4,43,0,43,0,25,18,22.04.2019 01:52,20,1,Volyn
928,904,60,336,538,54,592,0,592,20,340,232,22.04.2019 00:30,20,1,Volyn
432,423,26,167,239,26,265,0,265,0,150,115,22.04.2019 00:03,20,1,Volyn
640,625,41,294,314,32,346,0,346,0,211,135,22.04.2019 00:10,20,1,Volyn
128,124,10,37,81,10,91,0,91,0,47,44,22.04.2019 00:15,20,1,Volyn
400,395,26,144,233,23,256,0,256,2,120,134,21.04.2019 21:45,20,1,Volyn
272,259,30,103,142,27,169,0,169,0,87,82,21.04.2019 23:56,20,1,Volyn
192,185,11,47,134,11,145,0,145,3,107,35,21.04.2019 23:40,20,1,Volyn
976,962,12,301,664,11,675,0,675,21,357,297,22.04.2019 00:05,20,1,Volyn
992,973,15,302,676,14,690,0,690,11,377,302,21.04.2019 21:30,20,1,Volyn
336,323,8,130,199,7,206,0,206,7,122,77,22.04.2019 00:30,20,1,Volyn
2000,1971,19,614,1370,16,1386,0,1386,31,797,558,22.04.2019 00:15,20,1,Volyn
320,311,28,113,181,26,207,0,207,3,124,80,21.04.2019 23:58,20,1,Volyn
1488,1485,13,527,952,9,961,0,961,28,572,361,22.04.2019 00:10,20,1,Volyn
768,748,26,264,480,24,504,0,504,7,287,210,21.04.2019 23:40,20,1,Volyn
192,28,14,168,14,10,24,0,24,0,12,12,22.04.2019 00:02,20,1,Volyn
144,136,13,59,73,12,85,0,85,0,60,25,22.04.2019 00:05,20,1,Volyn
144,136,8,53,84,7,91,0,91,1,51,39,22.04.2019 00:05,20,1,Volyn
240,239,12,77,151,12,163,0,163,6,121,36,21.04.2019 21:15,20,1,Volyn
576,561,32,169,379,28,407,0,407,8,267,132,22.04.2019 00:05,20,1,Volyn
464,457,23,170,271,23,294,0,294,4,187,103,21.04.2019 21:10,20,1,Volyn
480,468,38,171,277,32,309,0,309,5,178,126,21.04.2019 22:25,20,1,Volyn
128,112,7,57,65,6,71,0,71,2,47,22,22.04.2019 00:10,20,1,Volyn
896,884,47,361,493,42,535,0,535,17,372,146,22.04.2019 00:10,21,1,Volyn
272,265,12,21,240,11,251,0,251,6,137,108,22.04.2019 00:05,21,1,Volyn
208,197,14,46,148,14,162,0,162,2,123,37,22.04.2019 00:24,21,1,Volyn
112,100,9,51,54,7,61,0,61,0,42,19,22.04.2019 00:00,21,1,Volyn
160,158,15,48,98,14,112,0,112,0,88,24,22.04.2019 01:00,21,1,Volyn
320,306,25,108,190,22,212,0,212,4,121,87,22.04.2019 00:15,21,1,Volyn
224,219,13,95,116,13,129,0,129,4,79,46,21.04.2019 22:45,21,1,Volyn
256,240,8,97,153,6,159,0,159,6,83,70,22.04.2019 00:05,21,1,Volyn
960,934,22,338,600,22,622,0,622,14,416,192,22.04.2019 00:20,21,1,Volyn
800,780,14,317,473,10,483,0,483,13,327,143,22.04.2019 00:05,21,1,Volyn
432,420,27,161,249,22,271,0,271,4,173,94,22.04.2019 00:10,21,1,Volyn
96,85,6,53,39,4,43,0,43,2,25,16,22.04.2019 00:05,21,1,Volyn
256,251,16,103,137,16,153,0,153,3,115,35,21.04.2019 20:54,21,1,Volyn
352,333,18,145,193,14,207,0,207,4,132,71,22.04.2019 00:07,21,1,Volyn
112,98,10,39,64,9,73,0,73,1,39,33,22.04.2019 00:15,21,1,Volyn
64,66,9,14,46,4,50,0,50,2,22,26,22.04.2019 00:05,21,1,Volyn
80,72,18,30,35,15,50,0,50,1,15,34,21.04.2019 20:05,21,1,Volyn
448,439,20,137,291,20,311,0,311,3,192,116,22.04.2019 02:30,21,1,Volyn
48,42,9,15,24,9,33,0,33,1,22,10,21.04.2019 23:30,21,1,Volyn
176,161,12,57,108,11,119,0,119,3,73,43,21.04.2019 21:40,21,1,Volyn
48,34,5,21,22,5,27,0,27,1,17,9,22.04.2019 00:40,21,1,Volyn
192,190,17,47,131,14,145,0,145,4,81,60,22.04.2019 00:10,21,1,Volyn
48,36,4,15,29,4,33,0,33,0,13,20,22.04.2019 00:01,21,1,Volyn
176,163,11,73,93,10,103,0,103,2,40,61,22.04.2019 00:45,21,1,Volyn
576,563,42,178,357,41,398,0,398,21,225,152,22.04.2019 00:10,21,1,Volyn
304,287,12,102,190,12,202,0,202,14,149,39,22.04.2019 00:20,21,1,Volyn
128,114,9,52,68,8,76,0,76,1,64,11,22.04.2019 00:45,21,1,Volyn
496,475,10,242,246,8,254,0,254,4,176,74,22.04.2019 00:10,21,1,Volyn
416,405,30,153,236,27,263,0,263,7,190,66,22.04.2019 00:50,21,1,Volyn
176,173,9,47,120,9,129,0,129,5,87,37,22.04.2019 01:20,21,1,Volyn
160,155,13,34,113,13,126,0,126,4,60,62,22.04.2019 00:02,21,1,Volyn
784,765,9,324,452,8,460,0,460,21,341,98,22.04.2019 00:30,21,1,Volyn
240,224,6,102,132,6,138,0,138,2,110,26,22.04.2019 00:20,21,1,Volyn
1408,1381,15,490,904,14,918,0,918,23,599,296,22.04.2019 01:40,21,1,Volyn
784,776,44,327,414,43,457,0,457,8,275,174,21.04.2019 21:50,21,1,Volyn
1312,1284,5,535,772,5,777,0,777,24,509,244,22.04.2019 00:35,21,1,Volyn
1760,1739,11,689,1060,11,1071,0,1071,33,705,333,22.04.2019 00:05,21,1,Volyn
1056,1029,16,433,614,9,623,0,623,27,425,171,22.04.2019 00:15,21,1,Volyn
2176,2139,18,852,1308,16,1324,0,1324,52,867,405,22.04.2019 00:20,21,1,Volyn
2192,2177,12,758,1423,11,1434,0,1434,38,998,398,21.04.2019 22:10,21,1,Volyn
848,853,4,279,565,4,569,0,569,24,350,195,22.04.2019 00:30,21,1,Volyn
1232,1194,5,476,752,4,756,0,756,9,512,235,22.04.2019 00:15,21,1,Volyn
1904,1867,4,654,1247,3,1250,0,1250,34,854,362,22.04.2019 00:05,21,1,Volyn
1584,1553,6,595,983,6,989,0,989,32,699,258,22.04.2019 00:50,21,1,Volyn
1584,1569,26,557,1003,24,1027,0,1027,28,669,330,22.04.2019 00:03,21,1,Volyn
1968,1950,11,761,1199,8,1207,0,1207,43,830,334,22.04.2019 00:15,21,1,Volyn
1984,1962,6,838,1140,6,1146,0,1146,29,811,306,22.04.2019 02:21,21,1,Volyn
1776,1765,6,727,1044,5,1049,0,1049,30,695,324,22.04.2019 00:05,21,1,Volyn
1440,1427,3,510,927,3,930,0,930,29,641,260,22.04.2019 00:30,21,1,Volyn
144,40,40,111,0,33,33,0,33,0,19,14,22.04.2019 00:10,21,1,Volyn
624,159,97,482,51,91,142,0,142,5,101,36,22.04.2019 00:57,21,1,Volyn
208,18,0,190,18,0,18,0,18,0,17,1,22.04.2019 00:12,21,1,Volyn
352,276,3,82,267,3,270,0,270,23,216,31,22.04.2019 00:03,22,1,Volyn
1520,1497,7,574,939,7,946,0,946,21,590,335,22.04.2019 00:20,22,1,Volyn
2304,2253,4,782,1519,3,1522,0,1522,55,884,583,22.04.2019 00:20,22,1,Volyn
2240,2214,8,804,1429,7,1436,0,1436,55,866,515,22.04.2019 00:20,22,1,Volyn
2080,2049,13,736,1331,13,1344,0,1344,44,810,490,22.04.2019 00:12,22,1,Volyn
2192,2168,22,832,1344,16,1360,0,1360,46,781,533,22.04.2019 00:10,22,1,Volyn
2000,1976,12,756,1236,8,1244,0,1244,33,745,466,22.04.2019 00:05,22,1,Volyn
1600,1581,8,536,1056,8,1064,0,1064,28,629,407,22.04.2019 00:10,22,1,Volyn
2256,2236,20,853,1388,15,1403,0,1403,39,858,506,22.04.2019 00:08,22,1,Volyn
1680,1682,15,637,1031,12,1043,0,1043,35,603,405,22.04.2019 00:10,22,1,Volyn
2368,2361,21,854,1496,18,1514,0,1514,53,925,536,22.04.2019 00:35,22,1,Volyn
2368,2352,15,841,1516,11,1527,0,1527,39,897,591,22.04.2019 00:45,22,1,Volyn
2144,2109,13,708,1425,11,1436,0,1436,35,957,444,22.04.2019 00:03,22,1,Volyn
2208,2170,11,778,1422,8,1430,0,1430,38,891,501,22.04.2019 00:10,22,1,Volyn
2112,2018,10,818,1287,7,1294,0,1294,44,743,507,22.04.2019 00:25,22,1,Volyn
2144,2140,14,756,1376,12,1388,0,1388,42,838,508,22.04.2019 00:10,22,1,Volyn
2176,2162,14,724,1440,12,1452,0,1452,52,882,518,22.04.2019 00:03,22,1,Volyn
2096,2067,9,780,1308,8,1316,0,1316,43,807,466,22.04.2019 00:13,22,1,Volyn
1792,1759,20,584,1191,17,1208,0,1208,47,669,492,22.04.2019 00:01,22,1,Volyn
1856,1841,9,651,1196,9,1205,0,1205,44,695,466,22.04.2019 00:03,22,1,Volyn
1776,1750,15,612,1150,14,1164,0,1164,42,675,447,22.04.2019 00:05,22,1,Volyn
2080,2049,15,748,1320,12,1332,0,1332,39,769,524,22.04.2019 00:15,22,1,Volyn
2080,2056,7,806,1270,4,1274,0,1274,46,756,472,22.04.2019 00:10,22,1,Volyn
1504,1448,8,643,855,6,861,0,861,24,521,316,22.04.2019 00:15,22,1,Volyn
2320,2304,10,815,1496,9,1505,0,1505,32,851,622,22.04.2019 00:05,22,1,Volyn
2112,2082,13,660,1441,11,1452,0,1452,43,820,589,22.04.2019 00:02,22,1,Volyn
2272,2261,7,896,1370,6,1376,0,1376,34,923,419,22.04.2019 00:30,22,1,Volyn
2320,2297,15,762,1547,11,1558,0,1558,59,869,630,22.04.2019 00:55,22,1,Volyn
2240,2186,6,727,1509,4,1513,0,1513,50,867,596,22.04.2019 00:30,22,1,Volyn
2320,2292,8,725,1589,6,1595,0,1595,42,950,603,22.04.2019 00:15,22,1,Volyn
2368,2343,8,767,1596,5,1601,0,1601,58,967,576,22.04.2019 00:41,22,1,Volyn
2368,2333,8,746,1616,6,1622,0,1622,48,938,636,22.04.2019 00:50,22,1,Volyn
2144,2113,14,677,1453,14,1467,0,1467,37,867,563,22.04.2019 00:10,22,1,Volyn
2384,2367,10,817,1558,9,1567,0,1567,50,913,604,22.04.2019 00:01,22,1,Volyn
2016,2019,12,867,1140,9,1149,0,1149,26,698,425,22.04.2019 00:10,22,1,Volyn
2352,2321,24,896,1436,20,1456,0,1456,45,785,626,22.04.2019 00:07,22,1,Volyn
208,109,32,102,75,31,106,0,106,7,57,42,22.04.2019 00:15,22,1,Volyn
80,26,0,56,24,0,24,0,24,1,14,9,22.04.2019 00:10,22,1,Volyn
224,71,0,153,71,0,71,153,71,0,56,15,22.04.2019 00:05,22,1,Volyn
720,284,132,459,145,116,261,0,261,7,172,82,22.04.2019 00:05,22,1,Volyn
128,35,0,94,34,0,34,0,34,0,26,8,22.04.2019 00:05,22,1,Volyn
128,47,2,82,44,2,46,0,46,2,29,15,22.04.2019 00:17,22,1,Volyn
2032,2021,2,599,1432,1,1433,0,1433,36,800,597,22.04.2019 00:31,22,1,Volyn
320,89,48,238,38,44,82,0,82,3,50,29,21.04.2019 22:20,23,1,Volyn
272,267,18,98,158,16,174,0,174,3,110,61,21.04.2019 22:10,23,1,Volyn
1424,1404,20,623,787,14,801,0,801,16,513,272,22.04.2019 00:05,23,1,Volyn
1504,1485,44,620,848,36,884,0,884,21,609,254,21.04.2019 23:06,23,1,Volyn
1952,1929,15,704,1239,9,1248,0,1248,34,818,396,22.04.2019 00:10,23,1,Volyn
224,213,5,66,153,5,158,0,158,3,89,66,22.04.2019 00:05,23,1,Volyn
208,193,11,67,130,11,141,0,141,1,73,67,21.04.2019 23:00,23,1,Volyn
304,292,13,74,219,11,230,0,230,3,110,117,21.04.2019 22:30,23,1,Volyn
592,574,10,260,323,9,332,0,332,9,180,143,21.04.2019 23:55,23,1,Volyn
160,142,10,74,77,9,86,0,86,0,48,38,21.04.2019 23:10,23,1,Volyn
368,353,13,171,184,13,197,0,197,5,110,82,21.04.2019 22:10,23,1,Volyn
96,90,8,27,61,8,69,0,69,0,30,39,21.04.2019 22:40,23,1,Volyn
224,21,12,206,8,10,18,0,18,2,13,3,22.04.2019 00:03,23,1,Volyn
1072,490,0,591,481,0,481,0,481,29,412,40,22.04.2019 00:15,23,1,Volyn
2080,2061,18,731,1339,10,1349,0,1349,21,1156,172,22.04.2019 00:10,24,2,Dnepr
1568,1551,12,437,1122,9,1131,0,1131,21,993,117,22.04.2019 00:10,24,2,Dnepr
1920,1898,13,569,1341,10,1351,0,1351,34,1143,174,22.04.2019 00:10,24,2,Dnepr
1920,1908,11,608,1303,9,1312,0,1312,25,1138,149,22.04.2019 00:16,24,2,Dnepr
1680,1655,7,515,1162,3,1165,0,1165,37,956,172,22.04.2019 00:15,24,2,Dnepr
2144,2128,7,690,1450,4,1454,0,1454,47,1175,232,22.04.2019 00:30,24,2,Dnepr
2352,2337,13,704,1637,11,1648,0,1648,32,1327,289,22.04.2019 00:30,24,2,Dnepr
2128,2120,9,627,1495,6,1501,0,1501,18,1268,215,22.04.2019 00:07,24,2,Dnepr
1600,1576,0,511,1089,0,1089,0,1089,16,942,131,22.04.2019 00:30,24,2,Dnepr
2224,2225,11,703,1513,8,1521,0,1521,38,1265,218,21.04.2019 22:20,24,2,Dnepr
2000,1973,6,742,1254,4,1258,0,1258,35,1064,159,22.04.2019 00:30,24,2,Dnepr
496,180,40,326,130,40,170,0,170,5,148,17,22.04.2019 00:35,24,2,Dnepr
192,90,0,102,90,0,90,0,90,1,74,15,22.04.2019 00:15,24,2,Dnepr
1872,1841,8,697,1168,7,1175,0,1175,24,1005,146,21.04.2019 20:40,24,2,Dnepr
1664,1647,11,643,1015,6,1021,0,1021,16,870,135,21.04.2019 22:52,24,2,Dnepr
2352,2319,13,888,1454,10,1464,0,1464,35,1252,177,22.04.2019 00:05,24,2,Dnepr
624,611,127,139,377,108,485,0,485,45,335,105,22.04.2019 00:30,24,2,Dnepr
384,135,30,256,101,27,128,0,128,3,121,4,21.04.2019 22:30,24,2,Dnepr
496,155,0,348,148,0,148,0,148,6,139,3,21.04.2019 21:15,24,2,Dnepr
912,896,0,37,875,0,875,0,875,114,743,18,22.04.2019 00:05,25,2,Dnepr
2224,2235,7,660,1557,7,1564,0,1564,24,1301,239,22.04.2019 00:20,25,2,Dnepr
1344,1336,12,486,849,9,858,0,858,13,720,125,22.04.2019 00:19,25,2,Dnepr
1104,1087,4,388,713,3,716,0,716,14,629,73,22.04.2019 00:20,25,2,Dnepr
2192,2162,12,815,1366,11,1377,0,1377,31,1146,200,22.04.2019 00:11,25,2,Dnepr
2080,2057,14,660,1411,9,1420,0,1420,19,1199,202,22.04.2019 00:05,25,2,Dnepr
1744,1723,4,540,1200,4,1204,0,1204,32,998,174,22.04.2019 00:10,25,2,Dnepr
1376,1378,7,396,976,4,980,0,980,23,801,156,22.04.2019 00:15,25,2,Dnepr
1888,1862,7,608,1273,7,1280,0,1280,21,1095,164,22.04.2019 00:15,25,2,Dnepr
144,89,2,58,85,1,86,0,86,5,74,7,21.04.2019 21:30,25,2,Dnepr
736,594,14,146,576,14,590,0,590,24,454,112,22.04.2019 00:05,25,2,Dnepr
48,43,0,5,43,0,43,0,43,0,39,4,21.04.2019 20:35,26,2,Dnepr
2352,2409,18,755,1584,13,1597,0,1597,30,1231,336,21.04.2019 22:43,26,2,Dnepr
1952,1927,15,677,1265,10,1275,0,1275,37,1021,217,22.04.2019 00:10,26,2,Dnepr
1968,1953,14,581,1378,9,1387,0,1387,31,1152,204,22.04.2019 00:10,26,2,Dnepr
2048,2016,16,602,1440,6,1446,0,1446,25,1198,223,22.04.2019 00:03,26,2,Dnepr
1728,1711,9,597,1124,7,1131,0,1131,25,940,166,22.04.2019 00:07,26,2,Dnepr
2144,2136,27,580,1550,14,1564,0,1564,31,1271,262,22.04.2019 00:10,26,2,Dnepr
2192,2175,19,631,1545,16,1561,0,1561,37,1251,273,21.04.2019 22:00,26,2,Dnepr
2336,2337,29,1073,1248,15,1263,0,1263,20,1055,188,22.04.2019 00:05,26,2,Dnepr
1824,1805,21,642,1169,13,1182,0,1182,30,1011,141,22.04.2019 00:15,26,2,Dnepr
1728,1696,4,609,1116,3,1119,0,1119,21,993,105,21.04.2019 22:38,26,2,Dnepr
1856,1826,5,678,1175,3,1178,0,1178,22,1043,113,21.04.2019 21:08,26,2,Dnepr
1776,1756,5,606,1168,2,1170,0,1170,23,1031,116,22.04.2019 00:38,26,2,Dnepr
176,94,0,85,91,0,91,0,91,1,82,8,22.04.2019 00:10,26,2,Dnepr
432,414,59,26,347,59,406,0,406,8,353,45,22.04.2019 00:02,26,2,Dnepr
1552,1520,9,599,946,7,953,0,953,26,758,169,22.04.2019 00:30,26,2,Dnepr
2144,2144,22,704,1424,16,1440,0,1440,32,1177,231,22.04.2019 00:07,26,2,Dnepr
1680,1664,6,722,955,3,958,0,958,29,780,149,22.04.2019 00:15,26,2,Dnepr
2287,2237,13,956,1320,11,1331,0,1331,25,1095,211,22.04.2019 00:05,26,2,Dnepr
160,109,19,52,89,19,108,0,108,2,97,9,22.04.2019 00:45,26,2,Dnepr
144,123,36,25,83,36,119,0,119,5,106,8,22.04.2019 00:10,26,2,Dnepr
48,15,0,33,15,0,15,0,15,0,15,0,21.04.2019 21:00,27,2,Dnepr
1952,1922,17,806,1131,15,1146,0,1146,25,921,200,22.04.2019 00:20,27,2,Dnepr
1312,1303,11,392,909,11,920,0,920,22,689,209,22.04.2019 00:45,27,2,Dnepr
1520,1516,6,519,996,5,1001,0,1001,30,764,207,22.04.2019 00:02,27,2,Dnepr
1728,1728,32,615,1086,27,1113,0,1113,19,888,206,22.04.2019 00:30,27,2,Dnepr
1584,1563,11,589,989,6,995,0,995,21,808,166,22.04.2019 00:15,27,2,Dnepr
1472,1458,8,567,900,5,905,0,905,20,727,158,21.04.2019 23:52,27,2,Dnepr
1456,1437,0,881,575,0,575,0,575,9,527,39,22.04.2019 00:10,27,2,Dnepr
2064,2062,16,684,1365,15,1380,0,1380,27,1138,215,22.04.2019 00:15,27,2,Dnepr
2176,2156,6,737,1434,5,1439,0,1439,37,1138,264,22.04.2019 00:10,27,2,Dnepr
1696,1692,17,511,1177,8,1185,0,1185,21,962,202,22.04.2019 00:25,27,2,Dnepr
1584,1571,3,453,1130,1,1131,0,1131,27,931,173,22.04.2019 00:15,27,2,Dnepr
1872,1865,11,651,1211,10,1221,0,1221,22,1019,180,22.04.2019 00:15,27,2,Dnepr
2128,2119,16,689,1427,12,1439,0,1439,51,1143,245,22.04.2019 00:05,27,2,Dnepr
1200,533,148,672,383,145,528,0,528,8,469,51,22.04.2019 00:05,27,2,Dnepr
224,42,0,183,41,0,41,0,41,1,23,17,21.04.2019 21:55,27,2,Dnepr
176,131,0,46,130,0,130,0,130,4,119,7,22.04.2019 00:31,27,2,Dnepr
320,118,0,202,118,0,118,0,118,4,98,16,22.04.2019 00:20,27,2,Dnepr
112,20,0,92,20,0,20,0,20,0,17,3,22.04.2019 02:10,27,2,Dnepr
192,176,0,20,172,0,172,0,172,1,154,17,22.04.2019 00:10,27,2,Dnepr
160,144,0,17,143,0,143,0,143,2,121,20,22.04.2019 00:15,27,2,Dnepr
272,128,7,144,121,7,128,0,128,2,112,14,22.04.2019 00:15,27,2,Dnepr
1296,1318,8,476,814,6,820,0,820,28,646,146,22.04.2019 00:10,27,2,Dnepr
2192,2186,28,806,1366,20,1386,0,1386,54,1032,300,22.04.2019 00:12,27,2,Dnepr
1088,1134,13,301,777,10,787,0,787,31,604,152,22.04.2019 00:01,27,2,Dnepr
2272,2247,15,801,1461,10,1471,0,1471,41,1184,246,22.04.2019 00:10,27,2,Dnepr
112,75,3,40,69,3,72,0,72,4,45,23,21.04.2019 20:50,27,2,Dnepr
2288,2244,7,854,1429,5,1434,0,1434,28,1208,198,21.04.2019 22:30,28,2,Dnepr
2304,2271,11,856,1437,11,1448,0,1448,33,1267,148,22.04.2019 01:00,28,2,Dnepr
1856,1799,9,1094,754,8,762,0,762,19,657,86,22.04.2019 00:27,28,2,Dnepr
1872,1847,12,780,1088,4,1092,0,1092,23,968,101,22.04.2019 00:15,28,2,Dnepr
2208,2193,12,773,1427,8,1435,0,1435,32,1278,125,22.04.2019 00:33,28,2,Dnepr
1568,1553,3,596,969,3,972,0,972,9,871,92,22.04.2019 00:15,28,2,Dnepr
1968,1947,8,739,1222,7,1229,0,1229,19,1137,73,21.04.2019 23:50,28,2,Dnepr
2384,2349,17,925,1445,14,1459,0,1459,18,1323,118,22.04.2019 00:05,28,2,Dnepr
2304,2282,16,811,1481,12,1493,0,1493,39,1277,177,22.04.2019 00:20,28,2,Dnepr
2176,2141,11,682,1488,6,1494,0,1494,40,1205,249,21.04.2019 21:45,28,2,Dnepr
2272,2255,10,931,1336,5,1341,0,1341,36,1168,137,21.04.2019 23:18,28,2,Dnepr
2128,2086,4,696,1429,3,1432,0,1432,28,1247,157,22.04.2019 00:05,28,2,Dnepr
1760,1738,5,624,1135,1,1136,0,1136,43,970,123,21.04.2019 22:15,28,2,Dnepr
1744,1736,6,684,1058,2,1060,0,1060,24,917,119,21.04.2019 21:30,28,2,Dnepr
2320,2276,9,735,1578,7,1585,0,1585,32,1390,163,22.04.2019 00:50,28,2,Dnepr
2224,2210,5,832,1388,4,1392,0,1392,29,1217,146,22.04.2019 01:10,28,2,Dnepr
1696,1692,0,739,957,0,957,0,957,25,840,92,22.04.2019 00:06,28,2,Dnepr
1264,1252,4,440,821,3,824,0,824,20,693,111,22.04.2019 00:20,28,2,Dnepr
1072,1056,3,400,669,3,672,0,672,10,576,86,21.04.2019 21:50,28,2,Dnepr
1952,1925,13,646,1293,13,1306,0,1306,30,1116,160,22.04.2019 00:15,28,2,Dnepr
1520,1502,4,629,888,3,891,0,891,14,783,94,22.04.2019 00:05,28,2,Dnepr
1568,1541,8,484,1079,5,1084,0,1084,19,943,122,21.04.2019 21:52,28,2,Dnepr
1696,1666,2,610,1084,2,1086,0,1086,37,876,173,22.04.2019 00:25,28,2,Dnepr
1328,1295,3,485,841,2,843,0,843,17,756,70,22.04.2019 00:30,28,2,Dnepr
2016,1984,5,844,1169,3,1172,0,1172,16,1016,140,22.04.2019 00:10,28,2,Dnepr
1872,1833,5,813,1055,4,1059,0,1059,26,937,96,22.04.2019 00:08,28,2,Dnepr
1424,1438,13,410,1001,13,1014,0,1014,19,850,145,22.04.2019 00:15,28,2,Dnepr
2192,2187,6,847,1339,6,1345,0,1345,26,1165,154,22.04.2019 00:15,28,2,Dnepr
2272,2251,8,685,1584,3,1587,0,1587,32,1307,248,22.04.2019 00:15,28,2,Dnepr
2288,2276,17,769,1512,7,1519,0,1519,34,1319,166,22.04.2019 00:07,28,2,Dnepr
2048,2029,11,558,1479,11,1490,0,1490,27,1197,266,21.04.2019 22:52,28,2,Dnepr
2256,2230,16,732,1514,10,1524,0,1524,35,1262,227,22.04.2019 00:05,28,2,Dnepr
2176,2170,14,742,1426,8,1434,0,1434,20,1230,184,22.04.2019 00:15,28,2,Dnepr
2112,2065,22,691,1404,17,1421,0,1420,35,1178,207,22.04.2019 00:03,28,2,Dnepr
2192,2159,5,709,1479,4,1483,0,1483,37,1232,214,22.04.2019 00:02,28,2,Dnepr
2128,2090,8,740,1384,4,1388,0,1388,31,1153,204,21.04.2019 22:55,28,2,Dnepr
1680,1650,8,503,1171,6,1177,0,1177,24,992,161,22.04.2019 00:35,28,2,Dnepr
2112,2077,13,653,1451,8,1459,0,1459,25,1197,237,22.04.2019 00:20,28,2,Dnepr
1872,1862,5,547,1321,4,1325,0,1325,28,1104,193,22.04.2019 00:10,28,2,Dnepr
2096,2078,4,643,1449,4,1453,0,1453,30,1186,237,21.04.2019 22:40,28,2,Dnepr
224,130,89,100,41,83,124,0,124,6,110,8,21.04.2019 21:37,28,2,Dnepr
768,776,128,5,636,127,763,0,763,17,641,105,21.04.2019 23:30,28,2,Dnepr
304,290,37,16,251,37,288,0,288,4,256,28,21.04.2019 21:20,28,2,Dnepr
1024,616,6,413,605,6,611,0,611,17,565,29,22.04.2019 00:05,28,2,Dnepr
2272,2268,17,849,1411,12,1423,0,1423,31,1261,131,22.04.2019 00:25,29,2,Dnepr
2464,2468,19,895,1553,16,1569,0,1569,31,1347,191,21.04.2019 22:00,29,2,Dnepr
2112,2112,45,774,1308,30,1338,0,1338,29,1181,128,22.04.2019 00:05,29,2,Dnepr
1024,999,15,347,662,15,677,0,677,21,572,84,22.04.2019 00:28,29,2,Dnepr
1680,1714,5,472,1205,3,1208,0,1208,29,945,234,22.04.2019 00:16,29,2,Dnepr
1600,1609,16,500,1088,12,1100,0,1100,34,903,163,21.04.2019 22:20,29,2,Dnepr
1392,1410,15,381,999,12,1011,0,1011,18,860,133,22.04.2019 00:03,29,2,Dnepr
2256,2241,23,791,1443,22,1465,0,1465,29,1331,105,22.04.2019 00:20,29,2,Dnepr
1392,1375,18,579,797,16,813,0,813,23,720,70,22.04.2019 00:20,29,2,Dnepr
1328,1256,71,404,863,61,924,0,924,12,820,92,22.04.2019 00:04,29,2,Dnepr
464,456,35,171,263,30,293,0,293,3,267,23,22.04.2019 00:03,29,2,Dnepr
816,796,51,295,485,36,521,0,521,11,444,66,22.04.2019 00:22,29,2,Dnepr
2336,2303,57,823,1470,43,1513,0,1513,37,1292,184,22.04.2019 00:04,29,2,Dnepr
1168,1156,36,406,729,33,762,0,762,14,632,116,22.04.2019 00:15,29,2,Dnepr
1536,1517,25,566,949,21,970,0,970,15,844,111,21.04.2019 21:38,29,2,Dnepr
1520,1499,66,488,968,64,1032,0,1032,17,820,195,21.04.2019 21:51,29,2,Dnepr
304,284,33,94,179,31,210,0,210,3,182,25,22.04.2019 00:10,29,2,Dnepr
2448,2431,9,897,1543,8,1551,0,1551,13,1305,233,22.04.2019 00:30,29,2,Dnepr
2320,2286,7,841,1474,5,1479,0,1479,35,1304,140,22.04.2019 00:26,29,2,Dnepr
2432,2390,10,950,1475,7,1482,0,1482,28,1331,123,22.04.2019 00:16,29,2,Dnepr
2352,2320,8,782,1562,8,1570,0,1570,30,1348,192,22.04.2019 00:15,29,2,Dnepr
2160,2133,6,765,1390,5,1395,0,1395,23,1260,112,22.04.2019 00:05,29,2,Dnepr
2192,2163,13,654,1526,12,1538,0,1538,32,1321,185,22.04.2019 00:10,29,2,Dnepr
2224,2206,9,693,1526,5,1531,0,1531,26,1287,218,22.04.2019 00:14,29,2,Dnepr
2096,2062,6,595,1498,3,1501,0,1501,30,1281,190,22.04.2019 00:15,29,2,Dnepr
2240,2205,16,721,1507,12,1519,0,1519,37,1307,175,22.04.2019 00:15,29,2,Dnepr
2080,2060,10,604,1467,9,1476,0,1476,36,1249,191,22.04.2019 00:15,29,2,Dnepr
2144,2118,10,614,1523,7,1530,0,1530,37,1301,192,22.04.2019 00:03,29,2,Dnepr
1872,1861,12,609,1251,12,1263,0,1263,18,1106,139,22.04.2019 00:25,29,2,Dnepr
784,790,2,227,556,1,557,0,557,14,473,70,22.04.2019 00:25,29,2,Dnepr
96,70,3,26,67,3,70,0,70,3,65,2,22.04.2019 00:20,29,2,Dnepr
1360,1355,22,557,789,14,803,0,803,31,683,89,22.04.2019 00:31,29,2,Dnepr
2368,2333,9,1003,1358,7,1365,0,1365,30,1218,117,22.04.2019 00:15,30,2,Dnepr
2448,2416,23,1027,1398,23,1421,0,1421,15,1303,103,22.04.2019 00:05,30,2,Dnepr
2112,2112,10,854,1251,7,1258,0,1258,21,1153,84,22.04.2019 00:30,30,2,Dnepr
2352,2272,32,968,1360,24,1384,0,1384,30,1256,98,22.04.2019 00:10,30,2,Dnepr
1200,1165,17,484,699,17,716,0,716,9,673,34,22.04.2019 00:01,30,2,Dnepr
1664,1633,6,697,962,5,967,0,967,23,873,71,22.04.2019 00:15,30,2,Dnepr
1920,1880,7,762,1154,4,1158,0,1158,27,1022,109,22.04.2019 00:08,30,2,Dnepr
2224,2180,9,858,1358,8,1366,0,1366,34,1227,105,22.04.2019 00:05,30,2,Dnepr
2112,2064,12,827,1275,10,1285,0,1285,28,1134,123,22.04.2019 00:05,30,2,Dnepr
2160,2124,7,855,1298,7,1305,0,1305,27,1174,104,22.04.2019 00:05,30,2,Dnepr
2224,2171,7,804,1414,6,1420,0,1420,31,1284,105,22.04.2019 00:10,30,2,Dnepr
2208,2172,8,881,1320,7,1327,0,1327,33,1166,128,22.04.2019 00:20,30,2,Dnepr
2176,2116,15,820,1344,12,1356,0,1356,29,1188,139,22.04.2019 00:20,30,2,Dnepr
2272,2232,14,836,1422,14,1436,0,1436,27,1308,101,22.04.2019 01:08,30,2,Dnepr
2272,2221,12,912,1350,10,1360,0,1360,18,1250,92,22.04.2019 00:05,30,2,Dnepr
2272,2233,17,946,1311,15,1326,0,1326,30,1211,85,22.04.2019 00:17,30,2,Dnepr
2320,2281,8,927,1386,7,1393,0,1393,20,1273,100,22.04.2019 00:10,30,2,Dnepr
2128,2110,15,722,1393,13,1406,0,1406,23,1244,139,22.04.2019 00:10,30,2,Dnepr
2144,2109,11,800,1337,7,1344,0,1344,34,1188,122,22.04.2019 00:50,30,2,Dnepr
2287,2247,9,812,1467,8,1475,0,1475,29,1341,105,22.04.2019 00:20,30,2,Dnepr
2016,1986,17,675,1328,13,1341,0,1341,27,1204,110,22.04.2019 00:10,30,2,Dnepr
1952,1917,21,694,1242,16,1258,0,1258,13,1122,123,22.04.2019 00:05,30,2,Dnepr
2240,2219,16,697,1533,10,1543,0,1543,35,1381,127,22.04.2019 00:05,30,2,Dnepr
1680,1643,9,614,1059,7,1066,0,1066,19,972,75,21.04.2019 22:16,30,2,Dnepr
1696,1666,5,623,1068,5,1073,0,1073,29,980,64,22.04.2019 00:08,30,2,Dnepr
1888,1863,64,693,1137,58,1195,0,1195,11,1097,87,22.04.2019 00:06,30,2,Dnepr
1808,1767,9,810,992,6,998,0,998,28,928,42,22.04.2019 00:10,30,2,Dnepr
1824,1795,9,696,1120,8,1128,0,1128,24,1015,89,22.04.2019 00:10,30,2,Dnepr
1696,1673,23,619,1062,15,1077,0,1077,18,978,81,22.04.2019 00:50,30,2,Dnepr
64,53,7,11,46,7,53,0,53,0,38,15,22.04.2019 00:10,30,2,Dnepr
240,118,55,130,59,51,110,0,110,6,91,13,22.04.2019 00:30,30,2,Dnepr
2368,2304,9,888,1472,8,1480,0,1480,30,1345,105,22.04.2019 00:25,30,2,Dnepr
1904,1877,8,694,1202,8,1210,0,1210,22,1100,88,21.04.2019 23:58,30,2,Dnepr
2368,2324,9,801,1560,7,1567,0,1567,28,1399,140,22.04.2019 00:05,30,2,Dnepr
1824,1779,8,640,1179,5,1184,0,1184,32,1045,107,22.04.2019 00:05,30,2,Dnepr
1872,1852,8,605,1261,6,1267,0,1267,34,1110,123,22.04.2019 00:15,30,2,Dnepr
2064,2035,7,748,1312,4,1316,0,1316,27,1151,138,22.04.2019 01:10,30,2,Dnepr
2368,2334,12,753,1607,8,1615,0,1615,41,1361,213,22.04.2019 00:05,30,2,Dnepr
2048,2020,9,642,1399,7,1406,0,1406,24,1256,126,22.04.2019 00:05,30,2,Dnepr
2144,2126,14,682,1450,12,1462,0,1462,43,1291,128,22.04.2019 00:15,30,2,Dnepr
2096,2095,8,712,1380,4,1384,0,1384,30,1185,169,22.04.2019 00:10,30,2,Dnepr
2160,2139,14,669,1480,11,1491,0,1491,26,1328,137,22.04.2019 00:20,30,2,Dnepr
1648,1624,9,570,1072,6,1078,0,1078,31,951,96,22.04.2019 00:15,30,2,Dnepr
1888,1870,5,579,1306,3,1309,0,1309,33,1182,94,22.04.2019 00:30,30,2,Dnepr
2000,1953,4,826,1172,2,1174,0,1174,26,1061,87,22.04.2019 00:20,30,2,Dnepr
1584,1574,8,524,1054,6,1060,0,1060,19,948,93,22.04.2019 01:00,30,2,Dnepr
1568,1543,7,574,990,4,994,0,994,20,907,67,22.04.2019 00:30,30,2,Dnepr
2032,1976,13,746,1277,9,1286,0,1286,26,1171,89,22.04.2019 00:01,30,2,Dnepr
2240,2193,7,800,1437,3,1440,0,1440,26,1296,118,21.04.2019 21:44,30,2,Dnepr
1968,1931,16,637,1317,14,1331,0,1331,20,1204,107,22.04.2019 00:03,30,2,Dnepr
1600,1574,12,519,1072,9,1081,0,1081,16,979,86,22.04.2019 00:25,30,2,Dnepr
1808,1765,5,663,1140,5,1145,0,1145,20,1017,108,22.04.2019 00:15,30,2,Dnepr
2128,2082,4,709,1415,4,1419,0,1419,27,1271,121,22.04.2019 00:04,30,2,Dnepr
1952,1918,4,648,1300,4,1304,0,1304,31,1178,95,22.04.2019 00:35,30,2,Dnepr
2032,1985,11,662,1362,8,1370,0,1370,31,1226,113,22.04.2019 00:04,30,2,Dnepr
2160,2122,12,802,1347,11,1358,0,1358,25,1188,145,22.04.2019 00:20,30,2,Dnepr
1776,1731,3,657,1118,1,1119,0,1119,10,988,121,22.04.2019 00:05,30,2,Dnepr
2208,2160,9,701,1502,5,1507,0,1507,29,1363,115,22.04.2019 00:02,30,2,Dnepr
2000,1965,6,652,1345,3,1348,0,1348,18,1206,124,22.04.2019 00:30,30,2,Dnepr
2160,2100,12,713,1437,10,1447,0,1447,17,1294,136,22.04.2019 00:40,30,2,Dnepr
1920,1883,2,688,1231,1,1232,0,1232,21,1096,115,22.04.2019 00:17,30,2,Dnepr
2256,2216,8,761,1489,6,1495,0,1495,40,1302,153,22.04.2019 00:30,30,2,Dnepr
2112,2088,8,711,1394,7,1401,0,1401,30,1250,121,22.04.2019 00:10,30,2,Dnepr
2144,2129,5,890,1250,4,1254,0,1254,26,1104,124,22.04.2019 00:28,30,2,Dnepr
2320,2284,6,1050,1266,4,1270,0,1270,44,1109,117,22.04.2019 00:10,30,2,Dnepr
2352,2295,11,946,1397,9,1406,0,1406,37,1248,121,22.04.2019 00:05,30,2,Dnepr
2288,2242,12,776,1503,9,1512,0,1512,33,1309,168,22.04.2019 00:07,30,2,Dnepr
2320,2310,9,829,1484,7,1491,0,1491,36,1307,148,22.04.2019 00:25,30,2,Dnepr
2144,2127,13,679,1456,9,1465,0,1465,47,1227,191,22.04.2019 00:05,30,2,Dnepr
2272,2236,21,803,1453,16,1469,0,1469,38,1272,159,22.04.2019 00:15,30,2,Dnepr
2112,2091,10,837,1269,6,1275,0,1275,29,1135,111,22.04.2019 00:12,30,2,Dnepr
2240,2178,7,956,1277,7,1284,0,1284,34,1141,109,22.04.2019 00:04,30,2,Dnepr
2192,2155,13,776,1410,6,1416,0,1416,39,1233,144,22.04.2019 00:30,30,2,Dnepr
2240,2195,12,857,1373,10,1383,0,1383,21,1262,100,22.04.2019 00:03,30,2,Dnepr
2144,2108,11,818,1317,9,1326,0,1326,35,1177,114,22.04.2019 00:26,30,2,Dnepr
2224,2186,10,845,1369,10,1379,0,1379,28,1254,97,22.04.2019 00:12,30,2,Dnepr
2304,2293,9,891,1408,5,1413,0,1413,22,1283,108,22.04.2019 00:15,30,2,Dnepr
1440,1401,11,537,893,10,903,0,903,21,822,60,22.04.2019 00:02,30,2,Dnepr
272,252,0,20,252,0,252,0,252,10,206,36,22.04.2019 00:15,30,2,Dnepr
96,93,13,3,80,13,93,0,93,5,84,4,22.04.2019 00:05,30,2,Dnepr
448,228,41,220,188,40,228,0,228,5,209,14,22.04.2019 00:20,30,2,Dnepr
128,67,14,64,50,14,64,0,64,1,57,6,22.04.2019 00:15,30,2,Dnepr
1632,1582,21,528,1086,18,1104,0,1104,11,1019,74,21.04.2019 21:15,31,2,Dnepr
2064,2021,22,650,1394,20,1414,0,1414,21,1282,111,22.04.2019 00:05,31,2,Dnepr
2112,2088,56,660,1413,39,1452,0,1452,20,1300,132,22.04.2019 00:05,31,2,Dnepr
2256,2224,46,739,1487,30,1517,0,1517,8,1409,100,21.04.2019 21:53,32,2,Dnepr
1632,1607,57,611,976,45,1021,0,1021,10,929,82,21.04.2019 21:45,32,2,Dnepr
1952,1894,34,746,1182,24,1206,0,1206,16,1116,74,21.04.2019 22:14,32,2,Dnepr
1904,1871,73,724,1114,66,1180,0,1180,15,1068,97,21.04.2019 23:25,32,2,Dnepr
1680,1660,89,567,1037,76,1113,0,1113,23,1013,77,21.04.2019 22:10,32,2,Dnepr
1840,1793,55,532,1269,39,1308,0,1308,24,1202,82,21.04.2019 22:05,32,2,Dnepr
1808,1772,71,569,1188,51,1239,0,1239,36,1103,100,21.04.2019 22:30,32,2,Dnepr
1392,1361,62,425,912,55,967,0,967,16,855,96,21.04.2019 21:40,32,2,Dnepr
2064,2025,83,717,1297,50,1347,0,1347,20,1220,107,22.04.2019 00:00,32,2,Dnepr
2016,1976,82,703,1264,49,1313,0,1313,19,1197,97,21.04.2019 21:33,32,2,Dnepr
1952,1922,71,562,1344,46,1390,0,1390,30,1244,116,21.04.2019 23:00,32,2,Dnepr
1584,1560,61,480,1056,48,1104,0,1104,15,989,100,21.04.2019 22:26,32,2,Dnepr
1872,1848,77,539,1269,64,1333,0,1333,12,1220,101,21.04.2019 21:35,32,2,Dnepr
2096,2088,99,608,1406,82,1488,0,1488,18,1270,200,21.04.2019 22:00,32,2,Dnepr
2176,2127,90,716,1387,73,1460,0,1460,30,1292,138,21.04.2019 21:39,32,2,Dnepr
1104,1095,47,326,738,40,778,0,778,16,682,80,21.04.2019 21:08,32,2,Dnepr
1280,1268,61,392,835,53,888,0,888,17,783,88,21.04.2019 21:45,32,2,Dnepr
1152,1133,25,367,766,19,785,0,785,14,707,64,21.04.2019 22:25,32,2,Dnepr
1120,1104,32,372,724,24,748,0,748,3,681,64,22.04.2019 00:05,32,2,Dnepr
1856,1817,23,584,1258,14,1272,0,1272,19,1159,94,21.04.2019 21:15,32,2,Dnepr
1952,1913,18,578,1360,14,1374,0,1374,17,1235,122,21.04.2019 21:30,32,2,Dnepr
1984,1945,24,597,1374,13,1387,0,1387,22,1241,124,22.04.2019 00:02,32,2,Dnepr
1936,1895,20,616,1305,15,1320,0,1320,21,1198,101,21.04.2019 21:15,32,2,Dnepr
176,61,7,115,54,7,61,0,61,4,50,7,21.04.2019 20:15,32,2,Dnepr
288,245,56,49,183,56,239,0,239,6,192,41,21.04.2019 21:20,32,2,Dnepr
1616,1584,43,508,1079,29,1108,0,1108,25,994,89,21.04.2019 23:00,32,2,Dnepr
1488,1473,20,538,933,17,950,0,950,13,869,68,21.04.2019 22:50,32,2,Dnepr
2160,2118,33,805,1328,27,1355,0,1355,18,1233,104,21.04.2019 21:20,32,2,Dnepr
2048,2010,18,666,1369,13,1382,0,1382,23,1237,122,21.04.2019 22:40,32,2,Dnepr
1840,1848,27,554,1266,20,1286,0,1286,19,1140,127,21.04.2019 21:46,32,2,Dnepr
1920,1894,14,569,1343,8,1351,0,1351,20,1232,99,21.04.2019 21:58,32,2,Dnepr
2176,2140,12,661,1513,2,1515,0,1515,18,1363,134,22.04.2019 00:10,32,2,Dnepr
1920,1906,20,556,1347,17,1364,0,1364,27,1221,116,21.04.2019 22:00,32,2,Dnepr
1968,1945,35,609,1328,31,1359,0,1359,22,1233,104,21.04.2019 22:40,32,2,Dnepr
1888,1850,31,679,1189,20,1209,0,1209,28,1083,98,22.04.2019 00:15,32,2,Dnepr
1872,1834,55,562,1266,44,1310,0,1310,21,1195,94,21.04.2019 22:00,32,2,Dnepr
1824,1788,39,603,1190,31,1221,0,1221,21,1050,150,21.04.2019 21:49,32,2,Dnepr
2336,2268,28,730,1581,25,1606,0,1606,24,1425,157,21.04.2019 21:44,32,2,Dnepr
2192,2162,24,618,1554,20,1574,0,1574,21,1410,143,21.04.2019 22:15,32,2,Dnepr
304,80,26,224,54,26,80,0,80,0,75,5,21.04.2019 20:30,32,2,Dnepr
704,273,71,433,202,69,271,0,271,1,248,22,21.04.2019 21:23,32,2,Dnepr
144,120,58,24,62,58,120,0,120,2,110,8,21.04.2019 20:35,32,2,Dnepr
80,67,0,13,67,0,67,0,67,1,58,8,21.04.2019 20:20,32,2,Dnepr
1520,1491,11,517,996,7,1003,0,1003,10,886,107,21.04.2019 21:50,33,2,Dnepr
1936,1889,17,577,1345,14,1359,0,1359,22,1202,135,21.04.2019 22:22,33,2,Dnepr
1808,1789,18,522,1271,15,1286,0,1286,26,1120,140,22.04.2019 00:02,33,2,Dnepr
1280,1263,28,408,855,17,872,0,872,13,770,89,21.04.2019 22:30,33,2,Dnepr
1440,1399,10,513,919,8,927,0,927,8,845,74,22.04.2019 00:10,33,2,Dnepr
912,915,53,243,619,50,669,0,669,3,633,33,21.04.2019 22:27,33,2,Dnepr
208,64,24,144,40,24,64,0,64,1,55,8,21.04.2019 23:00,33,2,Dnepr
2064,2018,34,663,1374,27,1401,0,1401,21,1298,82,21.04.2019 22:51,33,2,Dnepr
1952,1926,49,581,1329,42,1371,0,1371,19,1239,113,21.04.2019 22:20,33,2,Dnepr
1904,1863,21,561,1330,13,1343,0,1343,13,1239,91,21.04.2019 21:55,33,2,Dnepr
176,90,21,86,69,21,90,0,90,1,83,6,21.04.2019 21:00,33,2,Dnepr
1568,1544,26,521,1030,17,1047,0,1047,23,901,123,21.04.2019 22:48,33,2,Dnepr
1088,1072,18,312,761,15,776,0,776,7,737,32,21.04.2019 23:20,33,2,Dnepr
1072,1047,18,451,611,10,621,0,621,5,566,50,21.04.2019 22:30,33,2,Dnepr
1840,1811,37,652,1162,26,1188,0,1188,29,1071,88,21.04.2019 21:26,33,2,Dnepr
1392,1375,30,516,849,27,876,0,876,15,780,81,21.04.2019 22:00,33,2,Dnepr
1712,1683,20,455,1240,17,1257,0,1257,24,1122,111,21.04.2019 22:30,33,2,Dnepr
1856,1810,12,569,1279,8,1287,0,1287,20,1170,97,21.04.2019 22:52,33,2,Dnepr
2080,2048,37,607,1437,36,1473,0,1473,14,1339,120,21.04.2019 23:15,33,2,Dnepr
2080,2040,5,635,1442,3,1445,0,1445,27,1308,110,21.04.2019 22:00,33,2,Dnepr
880,848,30,360,496,24,520,0,520,4,494,22,21.04.2019 22:05,33,2,Dnepr
1152,1111,56,440,668,44,712,0,712,7,662,43,21.04.2019 21:25,33,2,Dnepr
1168,1175,17,385,770,13,783,0,783,21,657,105,21.04.2019 21:45,33,2,Dnepr
1456,1450,14,550,897,9,906,0,906,11,825,70,22.04.2019 00:10,33,2,Dnepr
1840,1797,23,616,1206,18,1224,0,1224,19,1074,131,21.04.2019 23:49,33,2,Dnepr
1488,1448,24,478,987,23,1010,0,1010,21,853,136,21.04.2019 23:49,33,2,Dnepr
160,68,0,93,67,0,67,0,67,1,64,2,21.04.2019 21:00,33,2,Dnepr
240,225,31,97,115,28,143,0,143,1,125,17,21.04.2019 21:00,34,2,Dnepr
1472,1453,34,463,975,34,1009,0,1009,18,892,99,22.04.2019 00:05,34,2,Dnepr
1232,1222,42,399,793,40,833,0,833,18,727,88,22.04.2019 00:15,34,2,Dnepr
1264,1252,81,504,688,72,760,0,760,8,705,47,22.04.2019 00:10,34,2,Dnepr
416,415,58,121,241,54,295,0,295,5,255,35,21.04.2019 21:00,34,2,Dnepr
672,661,81,230,371,71,442,0,442,8,394,40,22.04.2019 00:10,34,2,Dnepr
576,555,65,132,381,63,444,0,444,5,363,76,21.04.2019 21:45,34,2,Dnepr
656,647,58,183,422,51,473,0,473,4,424,45,21.04.2019 23:40,34,2,Dnepr
544,511,29,255,260,29,289,0,289,4,269,16,22.04.2019 00:10,34,2,Dnepr
1168,1146,33,400,740,28,768,0,768,11,677,80,21.04.2019 23:00,35,2,Dnepr
1424,1399,21,556,848,20,868,0,868,17,792,59,22.04.2019 00:10,35,2,Dnepr
1136,1119,7,470,660,6,666,0,666,5,631,30,22.04.2019 00:12,35,2,Dnepr
352,341,3,121,228,3,231,0,231,2,224,5,22.04.2019 00:10,35,2,Dnepr
272,256,19,75,178,19,197,0,197,5,177,15,22.04.2019 00:15,35,2,Dnepr
1472,1453,3,602,868,2,870,0,870,13,769,88,22.04.2019 00:20,35,2,Dnepr
960,944,10,329,623,8,631,0,631,17,515,99,21.04.2019 22:18,35,2,Dnepr
1792,1758,9,731,1052,9,1061,0,1061,33,900,128,22.04.2019 00:36,35,2,Dnepr
1152,1124,11,538,607,7,614,0,614,11,526,77,22.04.2019 00:25,35,2,Dnepr
1472,1449,11,559,906,7,913,0,913,29,794,90,22.04.2019 00:20,35,2,Dnepr
1008,995,4,412,593,3,596,0,596,16,508,72,22.04.2019 00:10,35,2,Dnepr
880,857,1,353,526,1,527,0,527,20,449,58,22.04.2019 00:07,35,2,Dnepr
2096,2060,4,824,1269,3,1272,0,1272,26,1088,158,22.04.2019 00:30,35,2,Dnepr
1392,1360,3,578,813,1,814,0,814,8,673,133,22.04.2019 00:05,35,2,Dnepr
2128,2089,8,803,1319,6,1325,0,1325,29,1125,171,21.04.2019 23:16,35,2,Dnepr
2144,2103,21,811,1320,13,1333,0,1333,42,1117,174,22.04.2019 00:02,35,2,Dnepr
2240,2192,8,845,1388,7,1395,0,1395,42,1170,183,22.04.2019 00:30,35,2,Dnepr
2160,2109,10,852,1301,7,1308,0,1308,37,1085,186,22.04.2019 00:16,35,2,Dnepr
2000,1978,4,863,1134,3,1137,0,1137,18,986,133,22.04.2019 00:45,35,2,Dnepr
1344,1337,8,490,849,5,854,0,854,16,742,96,22.04.2019 00:15,35,2,Dnepr
2176,2129,13,952,1213,11,1224,0,1224,20,1054,150,21.04.2019 21:20,35,2,Dnepr
1840,1800,9,754,1080,6,1086,0,1086,27,915,144,22.04.2019 00:45,35,2,Dnepr
416,215,137,201,78,137,215,0,215,3,195,17,22.04.2019 00:05,35,2,Dnepr
128,64,5,65,59,4,63,0,63,2,51,10,21.04.2019 23:35,35,2,Dnepr
1408,1384,57,430,921,57,978,0,978,15,863,100,22.04.2019 00:04,36,2,Dnepr
1680,1648,87,610,988,82,1070,0,1070,16,954,100,22.04.2019 00:05,36,2,Dnepr
1104,1078,63,348,709,47,756,0,756,8,673,75,22.04.2019 00:06,36,2,Dnepr
1680,1655,95,529,1080,71,1151,0,1151,10,1039,102,22.04.2019 00:10,36,2,Dnepr
336,323,11,98,227,11,238,0,238,3,208,27,22.04.2019 00:12,36,2,Dnepr
288,286,29,92,172,24,196,0,196,4,180,12,21.04.2019 22:00,36,2,Dnepr
608,596,54,218,341,49,390,0,390,5,349,36,22.04.2019 00:15,36,2,Dnepr
464,452,44,155,266,43,309,0,309,0,288,21,22.04.2019 00:15,36,2,Dnepr
1840,1803,73,611,1170,59,1229,0,1229,19,1104,106,22.04.2019 00:15,36,2,Dnepr
1424,1399,64,437,927,60,987,0,987,17,919,51,22.04.2019 00:25,36,2,Dnepr
240,218,31,117,97,26,123,0,123,1,112,10,22.04.2019 00:10,36,2,Dnepr
544,543,56,213,278,53,331,0,331,4,310,17,22.04.2019 00:10,36,2,Dnepr
400,391,35,81,285,34,319,0,319,7,287,25,22.04.2019 00:07,36,2,Dnepr
1040,1036,111,349,590,101,691,0,691,14,573,104,22.04.2019 00:10,36,2,Dnepr
2192,2153,12,688,1492,12,1504,0,1504,24,1338,142,22.04.2019 01:00,36,2,Dnepr
2176,2146,8,708,1460,8,1468,0,1468,24,1336,108,22.04.2019 00:40,36,2,Dnepr
1488,1465,5,532,951,5,956,0,956,13,872,71,22.04.2019 00:20,36,2,Dnepr
1968,1940,16,684,1271,13,1284,0,1284,24,1180,80,22.04.2019 00:10,36,2,Dnepr
2080,2023,9,631,1441,8,1449,0,1449,23,1273,153,22.04.2019 00:15,36,2,Dnepr
1728,1725,15,490,1223,15,1238,0,1238,28,1049,161,22.04.2019 00:15,36,2,Dnepr
2288,2283,13,748,1527,13,1540,0,1540,35,1285,220,22.04.2019 00:05,36,2,Dnepr
1216,1204,9,406,804,6,810,0,810,18,728,64,22.04.2019 00:05,36,2,Dnepr
1136,1130,11,398,729,9,738,0,738,9,650,79,22.04.2019 00:20,36,2,Dnepr
2272,2263,13,647,1616,9,1625,0,1625,31,1406,188,22.04.2019 01:47,36,2,Dnepr
2304,2309,18,666,1622,16,1638,0,1638,23,1438,177,22.04.2019 00:15,36,2,Dnepr
2160,2130,33,741,1394,25,1419,0,1419,25,1215,179,22.04.2019 00:20,36,2,Dnepr
2112,2077,8,695,1409,8,1417,0,1417,19,1261,137,22.04.2019 00:30,36,2,Dnepr
2064,2031,8,617,1439,8,1447,0,1447,33,1227,187,22.04.2019 00:12,36,2,Dnepr
1360,1331,6,485,871,4,875,0,875,20,768,87,22.04.2019 00:05,36,2,Dnepr
1888,1872,5,650,1233,5,1238,0,1238,24,1082,132,22.04.2019 00:10,36,2,Dnepr
1632,1609,8,563,1065,4,1069,0,1069,30,944,95,22.04.2019 00:30,36,2,Dnepr
1344,1325,12,390,942,12,954,0,954,6,848,100,22.04.2019 00:31,36,2,Dnepr
1520,1543,9,444,1068,8,1076,0,1076,13,951,112,22.04.2019 00:52,36,2,Dnepr
1792,1751,7,582,1205,5,1210,0,1210,12,1100,98,22.04.2019 00:15,36,2,Dnepr
2272,2214,10,713,1550,9,1559,0,1559,22,1373,164,22.04.2019 00:05,36,2,Dnepr
2096,2089,10,636,1450,10,1460,0,1460,27,1286,147,22.04.2019 00:05,36,2,Dnepr
2240,2217,5,720,1515,5,1520,0,1520,39,1359,122,22.04.2019 00:10,36,2,Dnepr
2256,2214,18,769,1472,15,1487,0,1487,22,1318,147,22.04.2019 00:10,36,2,Dnepr
1952,1960,7,556,1389,7,1396,0,1396,20,1242,134,22.04.2019 00:17,36,2,Dnepr
1904,1884,11,632,1263,9,1272,0,1272,25,1151,96,22.04.2019 00:05,36,2,Dnepr
2256,2216,15,746,1498,12,1510,0,1510,31,1344,135,22.04.2019 01:50,36,2,Dnepr
2192,2168,10,698,1485,9,1494,0,1494,37,1340,117,22.04.2019 00:30,36,2,Dnepr
144,53,0,94,50,0,50,0,50,5,38,7,22.04.2019 00:05,36,2,Dnepr
160,55,10,105,45,10,55,0,55,2,44,9,22.04.2019 00:03,36,2,Dnepr
240,31,3,209,28,3,31,0,31,0,24,7,22.04.2019 00:08,36,2,Dnepr
160,53,20,107,33,20,53,0,53,1,38,14,22.04.2019 00:20,36,2,Dnepr
1968,1937,13,619,1344,5,1349,0,1349,32,1223,94,22.04.2019 00:15,36,2,Dnepr
1328,1318,11,433,885,10,895,0,895,5,830,60,21.04.2019 21:25,36,2,Dnepr
64,40,0,24,40,0,40,0,40,1,35,4,21.04.2019 20:40,36,2,Dnepr
672,650,9,270,393,9,402,0,402,4,386,12,22.04.2019 00:25,37,2,Dnepr
2288,2248,57,1059,1192,37,1229,0,1229,24,1125,80,22.04.2019 00:15,37,2,Dnepr
736,713,43,365,338,33,371,0,371,3,343,25,21.04.2019 21:13,37,2,Dnepr
480,459,51,178,256,46,302,0,302,6,274,22,21.04.2019 21:00,37,2,Dnepr
400,386,6,193,201,6,207,0,207,3,196,8,21.04.2019 22:30,37,2,Dnepr
1776,1738,25,711,1040,25,1065,0,1065,20,973,72,22.04.2019 00:11,37,2,Dnepr
1712,1673,13,648,1051,13,1064,0,1064,17,996,51,22.04.2019 00:01,37,2,Dnepr
896,866,39,354,504,38,542,0,542,5,495,42,21.04.2019 23:46,37,2,Dnepr
1216,1188,14,456,747,13,760,0,760,12,680,68,22.04.2019 00:30,37,2,Dnepr
1536,1517,17,590,929,17,946,0,946,12,848,86,22.04.2019 01:00,37,2,Dnepr
464,462,37,128,303,33,336,0,336,9,296,31,22.04.2019 00:02,37,2,Dnepr
832,817,50,288,494,50,544,0,544,6,499,39,22.04.2019 00:53,37,2,Dnepr
512,497,20,190,302,20,322,0,322,2,303,17,22.04.2019 00:10,37,2,Dnepr
2256,2219,29,705,1522,29,1551,0,1551,35,1369,147,22.04.2019 00:40,37,2,Dnepr
1536,1519,115,534,896,106,1002,0,1002,18,908,76,21.04.2019 21:25,37,2,Dnepr
2048,2014,53,706,1297,45,1342,0,1342,27,1229,86,22.04.2019 00:10,37,2,Dnepr
1216,1192,32,453,738,25,763,0,763,6,703,54,21.04.2019 22:35,37,2,Dnepr
400,132,0,268,132,0,132,0,132,6,84,42,21.04.2019 21:10,37,2,Dnepr
192,46,24,146,22,24,46,0,46,1,39,6,22.04.2019 00:10,37,2,Dnepr
512,515,42,186,290,36,326,0,326,3,292,31,22.04.2019 00:24,37,2,Dnepr
464,449,27,156,284,24,308,0,308,4,284,20,21.04.2019 22:15,37,2,Dnepr
400,387,19,151,230,19,249,0,249,3,232,14,22.04.2019 01:15,37,2,Dnepr
704,687,24,255,425,24,449,0,449,6,397,46,22.04.2019 01:30,37,2,Dnepr
960,948,48,387,532,41,573,0,573,4,531,38,22.04.2019 00:30,37,2,Dnepr
416,415,21,115,280,21,301,0,301,7,283,11,22.04.2019 01:48,37,2,Dnepr
1184,1148,110,475,621,88,709,0,709,53,615,41,21.04.2019 21:30,37,2,Dnepr
320,310,9,111,201,8,209,0,209,4,187,18,21.04.2019 20:40,37,2,Dnepr
336,330,18,161,157,18,175,0,175,1,163,11,22.04.2019 00:20,37,2,Dnepr
1024,1007,65,410,563,51,614,0,614,5,583,26,22.04.2019 00:15,37,2,Dnepr
384,374,14,163,209,12,221,0,221,3,204,14,22.04.2019 01:55,37,2,Dnepr
1120,1095,38,445,645,30,675,0,675,14,627,34,22.04.2019 00:40,37,2,Dnepr
592,580,23,215,356,21,377,0,377,8,345,24,22.04.2019 00:15,37,2,Dnepr
1040,1025,22,350,678,12,690,0,690,12,635,43,22.04.2019 00:15,37,2,Dnepr
1600,1555,43,601,967,32,999,0,999,11,932,56,22.04.2019 00:04,37,2,Dnepr
496,490,17,156,328,12,340,0,340,12,309,19,22.04.2019 00:20,37,2,Dnepr
1904,1870,80,679,1160,65,1225,0,1225,9,1137,79,22.04.2019 00:15,37,2,Dnepr
128,60,26,72,31,25,56,0,56,0,53,3,21.04.2019 21:05,37,2,Dnepr
160,54,0,107,53,0,53,0,53,1,51,1,22.04.2019 01:10,37,2,Dnepr
1632,1602,22,555,1064,13,1077,0,1077,17,987,73,22.04.2019 00:30,37,2,Dnepr
1920,1877,19,569,1336,15,1351,0,1351,17,1239,95,21.04.2019 21:21,37,2,Dnepr
1808,1766,13,556,1239,13,1252,0,1252,19,1101,132,21.04.2019 22:15,37,2,Dnepr
224,102,26,122,76,26,102,0,102,0,97,5,22.04.2019 00:10,37,2,Dnepr
944,927,30,265,649,30,679,0,679,9,642,28,22.04.2019 00:40,38,2,Dnepr
320,317,13,66,242,12,254,0,254,0,233,21,22.04.2019 00:10,38,2,Dnepr
2320,2286,10,855,1456,9,1465,0,1465,35,1330,100,22.04.2019 00:30,38,2,Dnepr
416,397,5,132,279,5,284,0,284,1,247,36,22.04.2019 00:10,38,2,Dnepr
608,592,28,236,344,28,372,0,372,8,335,29,22.04.2019 00:05,38,2,Dnepr
624,616,47,197,380,47,427,0,427,6,375,46,22.04.2019 00:05,38,2,Dnepr
208,197,12,68,128,12,140,0,140,3,122,15,22.04.2019 00:05,38,2,Dnepr
256,256,19,55,182,19,201,0,201,3,181,17,21.04.2019 22:40,38,2,Dnepr
688,662,184,193,312,183,495,0,495,7,406,82,22.04.2019 00:45,38,2,Dnepr
544,530,27,251,266,27,293,0,293,6,262,25,22.04.2019 00:30,38,2,Dnepr
1456,1412,46,674,739,43,782,0,782,10,704,68,22.04.2019 00:20,38,2,Dnepr
592,584,18,192,382,18,400,0,400,7,366,27,22.04.2019 00:03,38,2,Dnepr
2208,2071,8,969,1234,5,1239,0,1239,23,1028,188,22.04.2019 00:01,38,2,Dnepr
1360,1337,19,607,735,18,753,0,753,15,688,50,21.04.2019 21:30,38,2,Dnepr
1600,1566,17,731,854,15,869,0,869,13,802,54,22.04.2019 00:00,38,2,Dnepr
224,210,6,108,110,6,116,0,116,0,107,9,22.04.2019 00:55,38,2,Dnepr
496,506,1,163,332,1,333,0,333,2,292,39,22.04.2019 00:10,38,2,Dnepr
1536,1510,10,573,954,9,963,0,963,14,901,48,22.04.2019 00:30,38,2,Dnepr
1840,1796,18,732,1090,18,1108,0,1108,15,1033,60,22.04.2019 00:10,38,2,Dnepr
176,179,11,51,114,11,125,0,125,0,111,14,22.04.2019 00:20,38,2,Dnepr
896,874,41,242,613,41,654,0,654,7,589,58,22.04.2019 00:10,38,2,Dnepr
1248,1237,12,513,725,10,735,0,735,13,674,48,22.04.2019 00:04,38,2,Dnepr
736,726,19,264,453,19,472,0,472,15,414,43,22.04.2019 01:31,38,2,Dnepr
944,925,57,284,607,53,660,0,660,15,592,53,22.04.2019 00:10,38,2,Dnepr
624,621,41,256,333,35,368,0,368,4,341,23,22.04.2019 00:15,38,2,Dnepr
240,226,14,88,139,13,152,0,152,2,134,16,22.04.2019 00:15,38,2,Dnepr
128,127,14,24,90,14,104,0,104,1,92,11,22.04.2019 00:10,38,2,Dnepr
1472,1446,29,563,881,28,909,0,909,18,810,81,22.04.2019 00:09,38,2,Dnepr
1360,1337,47,473,841,46,887,0,887,12,785,90,21.04.2019 21:40,38,2,Dnepr
1488,1464,29,551,918,19,937,0,937,19,844,74,22.04.2019 00:47,38,2,Dnepr
1632,1605,38,579,1015,38,1053,0,1053,15,976,62,22.04.2019 00:10,38,2,Dnepr
912,897,18,344,554,14,568,0,568,7,525,36,22.04.2019 00:15,38,2,Dnepr
320,182,51,143,130,47,177,0,177,1,153,23,22.04.2019 00:30,38,2,Dnepr
1968,1950,29,691,1256,21,1277,0,1277,30,1091,156,22.04.2019 00:02,38,2,Dnepr
896,886,17,277,607,12,619,0,619,13,515,91,22.04.2019 00:10,38,2,Dnepr
1584,1544,15,523,1049,12,1061,0,1061,24,909,128,22.04.2019 00:50,38,2,Dnepr
1296,1278,18,434,849,13,862,0,862,22,727,113,22.04.2019 00:04,38,2,Dnepr
2096,2073,36,698,1371,27,1398,0,1398,38,1149,211,22.04.2019 00:02,38,2,Dnepr
1456,1446,20,427,1012,17,1029,0,1029,28,841,160,22.04.2019 00:07,38,2,Dnepr
2288,2263,20,695,1580,13,1593,0,1593,28,1381,184,21.04.2019 23:20,38,2,Dnepr
2256,2216,26,761,1473,22,1495,0,1495,50,1269,176,22.04.2019 00:30,38,2,Dnepr
1744,1708,24,627,1096,21,1117,0,1117,19,979,119,21.04.2019 22:36,38,2,Dnepr
1376,1355,18,494,869,13,882,0,882,23,770,89,22.04.2019 00:22,38,2,Dnepr
1392,1367,21,534,841,17,858,0,858,18,758,82,22.04.2019 00:45,38,2,Dnepr
1264,1244,18,439,812,13,825,0,825,14,718,93,21.04.2019 21:37,38,2,Dnepr
1456,1430,9,549,901,6,907,0,907,17,822,68,22.04.2019 00:10,38,2,Dnepr
336,105,18,231,87,18,105,0,105,3,95,7,22.04.2019 00:15,38,2,Dnepr
2064,2046,74,745,1258,61,1319,0,1319,16,1189,114,22.04.2019 00:05,39,2,Dnepr
1936,1928,53,700,1191,45,1236,0,1236,25,1103,108,22.04.2019 00:40,39,2,Dnepr
1984,1950,69,759,1163,62,1225,0,1225,16,1093,116,22.04.2019 00:35,39,2,Dnepr
1392,1372,52,552,793,47,840,0,840,14,784,42,22.04.2019 00:20,39,2,Dnepr
928,913,47,400,482,46,528,0,528,4,477,47,22.04.2019 00:26,39,2,Dnepr
816,801,32,319,468,29,497,0,497,7,466,24,21.04.2019 23:00,39,2,Dnepr
352,336,22,116,218,18,236,0,236,0,204,32,22.04.2019 00:20,39,2,Dnepr
416,406,35,138,248,30,278,0,278,1,256,21,22.04.2019 00:12,39,2,Dnepr
320,310,33,106,181,33,214,0,214,2,187,25,22.04.2019 00:05,39,2,Dnepr
448,425,28,172,254,22,276,0,276,3,242,31,22.04.2019 00:05,39,2,Dnepr
656,641,32,265,360,31,391,0,391,10,355,26,22.04.2019 00:20,39,2,Dnepr
832,807,37,344,458,30,488,0,488,5,431,52,22.04.2019 00:10,39,2,Dnepr
400,387,21,161,220,19,239,0,239,3,209,27,22.04.2019 00:36,39,2,Dnepr
272,247,8,138,128,6,134,0,134,2,115,17,21.04.2019 21:03,39,2,Dnepr
944,932,243,260,459,225,684,0,684,15,544,125,22.04.2019 00:50,39,2,Dnepr
1280,1261,71,617,596,67,663,0,663,11,607,45,22.04.2019 00:03,39,2,Dnepr
320,303,19,59,242,19,261,0,261,2,229,30,22.04.2019 00:15,39,2,Dnepr
480,469,39,187,262,31,293,0,293,2,265,26,22.04.2019 00:15,39,2,Dnepr
320,303,23,77,222,21,243,0,243,2,213,28,21.04.2019 20:35,39,2,Dnepr
2192,2143,26,819,1348,25,1373,0,1373,18,1242,113,22.04.2019 00:35,39,2,Dnepr
336,321,36,131,170,35,205,0,205,3,184,18,21.04.2019 22:00,39,2,Dnepr
1600,1570,74,537,991,72,1063,0,1063,8,932,123,21.04.2019 21:35,39,2,Dnepr
320,311,21,80,223,17,240,0,240,2,210,28,22.04.2019 00:30,39,2,Dnepr
544,531,38,149,360,35,395,0,395,5,351,39,22.04.2019 00:10,39,2,Dnepr
1888,1860,106,773,1009,106,1115,0,1115,27,1018,70,21.04.2019 21:15,39,2,Dnepr
1968,1933,43,666,1262,40,1302,0,1302,20,1177,105,21.04.2019 21:00,39,2,Dnepr
704,685,28,288,391,25,416,0,416,2,380,34,21.04.2019 22:05,39,2,Dnepr
1264,1242,27,395,842,27,869,0,869,19,758,92,22.04.2019 00:10,39,2,Dnepr
624,615,16,229,381,14,395,0,395,2,349,44,22.04.2019 00:15,39,2,Dnepr
176,160,9,54,113,9,122,0,122,0,81,41,22.04.2019 00:20,39,2,Dnepr
1872,1190,77,682,1131,59,1190,0,1190,17,1066,107,22.04.2019 00:50,40,2,Dnepr
1952,1926,59,690,1207,55,1262,0,1262,24,1100,138,22.04.2019 00:05,40,2,Dnepr
784,766,14,291,481,12,493,0,493,7,420,66,22.04.2019 00:55,40,2,Dnepr
544,525,25,250,272,22,294,0,294,2,270,22,22.04.2019 00:05,40,2,Dnepr
528,516,42,198,290,40,330,0,330,0,293,37,22.04.2019 00:05,40,2,Dnepr
1248,1236,24,463,763,22,785,0,785,16,717,52,22.04.2019 00:15,40,2,Dnepr
752,739,24,278,458,16,474,0,474,6,427,41,22.04.2019 02:31,40,2,Dnepr
1008,1005,184,380,456,172,628,0,628,18,562,48,22.04.2019 00:30,40,2,Dnepr
496,486,55,218,229,49,278,0,278,4,262,12,21.04.2019 21:46,40,2,Dnepr
528,512,60,220,258,50,308,0,308,2,278,28,22.04.2019 00:30,40,2,Dnepr
944,919,75,360,519,65,584,0,584,9,529,46,22.04.2019 00:15,40,2,Dnepr
544,525,33,226,289,29,318,0,318,4,298,16,22.04.2019 00:02,40,2,Dnepr
928,909,28,382,518,28,546,0,546,10,511,25,22.04.2019 00:15,40,2,Dnepr
1088,1065,63,513,522,53,575,0,575,5,537,33,22.04.2019 00:23,40,2,Dnepr
816,798,90,323,413,80,493,0,493,9,452,32,22.04.2019 00:10,40,2,Dnepr
544,532,39,176,330,38,368,0,368,4,334,30,22.04.2019 00:02,40,2,Dnepr
336,327,34,99,206,31,237,0,237,1,213,23,22.04.2019 00:02,40,2,Dnepr
1312,1288,38,512,764,36,800,0,800,22,688,90,22.04.2019 00:05,40,2,Dnepr
1136,1110,58,422,660,54,714,0,714,10,624,80,22.04.2019 00:30,40,2,Dnepr
880,861,10,335,536,9,545,0,545,8,507,30,22.04.2019 00:05,40,2,Dnepr
704,676,54,281,374,49,423,0,423,9,376,38,22.04.2019 00:10,40,2,Dnepr
672,650,37,211,425,36,461,0,461,4,422,35,22.04.2019 00:30,40,2,Dnepr
1216,1195,9,496,712,8,720,0,720,10,645,65,22.04.2019 00:10,40,2,Dnepr
368,360,3,176,189,3,192,0,192,4,160,28,22.04.2019 00:05,40,2,Dnepr
352,337,8,117,228,7,235,0,235,4,196,35,22.04.2019 00:10,40,2,Dnepr
288,281,18,68,202,18,220,0,220,0,207,13,22.04.2019 00:45,40,2,Dnepr
528,515,37,253,240,35,275,0,275,4,226,45,22.04.2019 00:45,40,2,Dnepr
224,214,21,65,141,18,159,0,159,3,133,23,22.04.2019 00:15,40,2,Dnepr
464,457,30,163,272,29,301,0,301,5,236,60,22.04.2019 00:50,40,2,Dnepr
736,727,46,304,389,43,432,0,432,11,373,48,22.04.2019 00:15,40,2,Dnepr
704,686,1,328,375,1,376,0,376,2,340,34,22.04.2019 00:10,40,2,Dnepr
1344,1314,2,585,757,2,759,0,759,10,683,66,22.04.2019 00:10,40,2,Dnepr
464,458,18,156,292,16,308,0,308,0,281,27,22.04.2019 00:20,40,2,Dnepr
432,410,14,150,272,10,282,0,282,3,231,48,22.04.2019 00:15,40,2,Dnepr
448,447,25,138,286,24,310,0,310,1,286,23,22.04.2019 00:30,40,2,Dnepr
1744,1723,62,635,1058,51,1109,0,1109,26,908,175,22.04.2019 01:20,40,2,Dnepr
752,742,40,274,439,39,478,0,478,10,416,52,22.04.2019 00:15,40,2,Dnepr
2160,2129,17,879,1271,10,1281,0,1281,32,1137,112,22.04.2019 00:45,40,2,Dnepr
2224,2187,6,907,1313,4,1317,0,1317,31,1148,138,22.04.2019 00:55,40,2,Dnepr
2336,2306,13,826,1501,9,1510,0,1510,33,1329,148,22.04.2019 00:10,40,2,Dnepr
2208,2176,11,926,1272,10,1282,0,1282,37,1142,103,22.04.2019 00:10,40,2,Dnepr
2064,2033,11,689,1366,9,1375,0,1375,39,1221,115,22.04.2019 00:05,40,2,Dnepr
2304,2276,10,851,1446,7,1453,0,1453,28,1295,130,22.04.2019 00:11,40,2,Dnepr
2208,2156,12,857,1342,9,1351,0,1351,9,1237,105,22.04.2019 00:14,40,2,Dnepr
2240,2221,8,823,1410,7,1417,0,1417,17,1297,103,22.04.2019 00:10,40,2,Dnepr
1584,1554,9,554,1021,9,1030,0,1030,23,910,97,22.04.2019 00:03,40,2,Dnepr
368,285,65,83,220,65,285,0,285,6,198,81,22.04.2019 00:12,40,2,Dnepr
848,278,0,572,276,0,276,0,276,3,257,16,22.04.2019 00:10,40,2,Dnepr
1344,1336,44,428,877,39,916,0,916,7,860,49,22.04.2019 00:10,40,2,Dnepr
320,296,0,36,284,0,284,0,284,30,92,162,21.04.2019 21:10,45,3,Donetsk
336,319,0,19,317,0,317,0,317,14,132,171,21.04.2019 23:00,45,3,Donetsk
352,366,0,22,330,0,330,0,330,9,187,134,22.04.2019 00:09,45,3,Donetsk
928,920,0,14,914,0,914,0,914,26,305,583,22.04.2019 00:01,45,3,Donetsk
320,316,0,45,275,0,275,0,275,15,97,163,22.04.2019 00:40,45,3,Donetsk
576,556,0,101,475,0,475,0,475,8,305,162,22.04.2019 00:10,45,3,Donetsk
2144,2095,55,1160,941,43,984,0,984,34,776,174,22.04.2019 01:30,45,3,Donetsk
560,611,14,424,136,0,136,0,136,2,70,64,22.04.2019 01:00,45,3,Donetsk
1024,1014,62,239,723,62,785,0,785,16,447,322,22.04.2019 00:05,45,3,Donetsk
1456,1463,20,744,693,19,712,0,712,33,518,161,22.04.2019 01:33,45,3,Donetsk
1552,1574,23,795,734,23,757,0,757,30,628,99,21.04.2019 22:20,45,3,Donetsk
640,622,41,346,256,38,294,0,294,7,227,60,22.04.2019 00:30,45,3,Donetsk
480,491,22,265,201,14,215,0,215,1,176,38,21.04.2019 21:00,45,3,Donetsk
720,726,61,260,399,61,460,0,460,22,359,79,22.04.2019 00:10,45,3,Donetsk
1344,1309,48,689,608,47,655,0,655,31,429,195,21.04.2019 22:25,45,3,Donetsk
432,419,8,128,296,8,304,0,304,2,203,99,21.04.2019 21:00,45,3,Donetsk
1776,1723,151,820,805,151,956,0,956,48,666,242,22.04.2019 00:50,45,3,Donetsk
816,782,73,238,505,73,578,0,578,6,337,235,22.04.2019 00:10,45,3,Donetsk
1968,1845,36,1464,494,10,504,0,504,7,235,262,21.04.2019 23:40,45,3,Donetsk
560,554,47,239,284,37,321,0,321,9,238,74,21.04.2019 21:20,45,3,Donetsk
704,693,62,223,432,49,481,0,481,3,295,183,22.04.2019 01:30,45,3,Donetsk
576,564,0,328,248,0,248,0,248,1,153,94,22.04.2019 00:20,45,3,Donetsk
992,969,14,599,381,12,393,0,393,21,348,24,22.04.2019 00:15,45,3,Donetsk
1408,1394,37,899,481,28,509,0,509,17,443,49,21.04.2019 22:01,45,3,Donetsk
944,912,27,576,343,25,368,0,368,16,318,34,22.04.2019 00:30,45,3,Donetsk
976,956,26,592,368,16,384,0,384,19,343,22,22.04.2019 00:13,45,3,Donetsk
1248,1199,40,734,484,30,514,0,514,21,438,55,22.04.2019 00:24,45,3,Donetsk
1040,1005,30,640,370,30,400,0,400,15,350,35,22.04.2019 00:50,45,3,Donetsk
1264,1209,57,800,408,56,464,0,464,18,411,35,22.04.2019 00:05,45,3,Donetsk
1984,1897,10,1140,835,9,844,0,844,44,730,70,22.04.2019 00:01,45,3,Donetsk
2224,2147,23,1386,819,19,838,0,838,13,761,64,22.04.2019 00:30,45,3,Donetsk
1872,1822,17,1049,807,16,823,0,823,40,712,71,22.04.2019 00:30,45,3,Donetsk
1136,1093,10,637,489,10,499,0,499,20,439,40,22.04.2019 00:01,45,3,Donetsk
2032,1954,32,1240,773,19,792,0,792,30,681,81,22.04.2019 00:30,45,3,Donetsk
2160,2044,19,1272,874,14,888,0,888,31,793,64,22.04.2019 00:13,45,3,Donetsk
1952,1852,23,1163,777,12,789,0,789,28,704,57,22.04.2019 00:40,45,3,Donetsk
2016,1949,21,1151,849,16,865,0,865,33,762,70,22.04.2019 00:09,45,3,Donetsk
2080,1985,14,1171,900,9,909,0,909,37,787,85,22.04.2019 00:20,45,3,Donetsk
832,602,0,230,602,0,602,0,602,52,537,13,22.04.2019 00:10,46,3,Donetsk
272,256,0,42,230,0,230,0,230,8,167,55,21.04.2019 20:30,46,3,Donetsk
256,227,0,68,188,0,188,0,188,6,125,57,21.04.2019 21:15,46,3,Donetsk
336,332,0,7,329,0,329,0,329,37,107,185,21.04.2019 20:50,46,3,Donetsk
288,261,0,50,238,0,238,0,238,24,124,90,21.04.2019 21:10,46,3,Donetsk
192,180,0,14,178,0,178,0,178,13,79,86,21.04.2019 20:46,46,3,Donetsk
1520,1487,40,740,753,27,780,0,780,16,718,46,21.04.2019 21:00,46,3,Donetsk
1408,1393,68,723,641,44,685,0,685,9,629,47,21.04.2019 21:00,46,3,Donetsk
608,597,39,268,308,32,340,0,340,3,314,23,22.04.2019 00:02,46,3,Donetsk
448,439,23,259,171,18,189,0,189,4,174,11,22.04.2019 00:15,46,3,Donetsk
256,253,10,99,152,5,157,0,157,4,140,13,22.04.2019 00:15,46,3,Donetsk
832,806,46,438,360,34,394,0,394,7,362,25,21.04.2019 20:54,46,3,Donetsk
336,326,32,145,170,21,191,0,191,13,154,24,21.04.2019 21:05,46,3,Donetsk
528,503,25,217,291,20,311,0,311,5,289,17,22.04.2019 00:30,46,3,Donetsk
400,396,21,182,197,21,218,0,218,3,179,36,21.04.2019 21:55,46,3,Donetsk
592,583,17,279,298,15,313,0,313,6,279,28,21.04.2019 21:50,46,3,Donetsk
384,370,16,245,124,15,139,0,139,1,131,7,21.04.2019 21:18,46,3,Donetsk
224,218,6,95,123,6,129,0,129,4,110,15,22.04.2019 00:31,46,3,Donetsk
528,512,18,243,273,12,285,0,285,3,265,17,22.04.2019 00:01,46,3,Donetsk
288,278,11,105,174,9,183,0,183,3,165,15,21.04.2019 22:00,46,3,Donetsk
512,489,47,173,297,42,339,0,339,4,261,74,22.04.2019 00:10,46,3,Donetsk
512,511,59,241,221,50,271,0,271,4,243,24,21.04.2019 22:05,46,3,Donetsk
1488,1461,15,680,796,12,808,0,808,17,738,53,22.04.2019 00:01,46,3,Donetsk
1552,1589,30,643,886,23,909,0,909,26,789,94,22.04.2019 00:10,46,3,Donetsk
1360,1341,35,589,741,30,771,0,771,14,705,52,21.04.2019 22:00,46,3,Donetsk
848,840,9,354,488,6,494,0,494,15,416,63,22.04.2019 00:15,46,3,Donetsk
1216,1183,16,517,686,13,699,0,699,10,644,45,21.04.2019 21:17,46,3,Donetsk
1120,1146,33,451,640,29,669,0,669,27,569,73,21.04.2019 22:00,46,3,Donetsk
1888,1873,20,935,938,15,953,0,953,23,841,89,21.04.2019 22:15,46,3,Donetsk
992,995,51,394,548,50,598,0,598,16,514,68,21.04.2019 21:44,46,3,Donetsk
1344,1321,16,558,774,12,786,0,786,12,713,61,21.04.2019 21:36,46,3,Donetsk
1504,1460,12,664,831,9,840,0,840,24,757,59,21.04.2019 21:36,46,3,Donetsk
1200,1173,9,497,694,9,703,0,703,23,614,66,21.04.2019 21:40,46,3,Donetsk
1600,1564,16,674,916,10,926,0,926,30,829,67,22.04.2019 00:06,46,3,Donetsk
1952,1920,18,808,1134,10,1144,0,1144,35,1021,88,21.04.2019 21:20,46,3,Donetsk
2176,2123,18,892,1272,12,1284,0,1284,32,1158,94,21.04.2019 21:55,46,3,Donetsk
1840,1791,15,811,1017,12,1029,0,1029,29,920,80,22.04.2019 00:30,46,3,Donetsk
1760,1779,20,733,1012,15,1027,0,1027,29,905,93,21.04.2019 22:12,46,3,Donetsk
1664,1585,30,816,820,28,848,0,848,22,743,83,21.04.2019 21:18,46,3,Donetsk
1344,1323,10,518,818,8,826,0,826,13,767,46,22.04.2019 00:23,46,3,Donetsk
1904,1871,11,820,1073,11,1084,0,1084,34,973,77,21.04.2019 22:05,46,3,Donetsk
1728,1696,35,753,941,34,975,0,975,30,877,68,21.04.2019 21:46,46,3,Donetsk
1840,1816,23,886,932,22,954,0,954,18,897,39,21.04.2019 22:15,46,3,Donetsk
448,441,13,163,272,13,285,0,285,7,250,28,22.04.2019 00:01,46,3,Donetsk
544,536,6,287,251,6,257,0,257,7,244,6,22.04.2019 00:02,46,3,Donetsk
896,882,7,485,409,2,411,0,411,4,382,25,21.04.2019 21:45,46,3,Donetsk
1856,1836,12,691,1156,9,1165,0,1165,19,1087,59,22.04.2019 00:01,46,3,Donetsk
1888,1865,14,720,1156,12,1168,0,1168,27,1094,47,21.04.2019 21:17,46,3,Donetsk
1648,1636,13,722,920,6,926,0,926,22,857,47,21.04.2019 21:30,46,3,Donetsk
848,841,19,434,399,15,414,0,414,7,391,16,21.04.2019 21:20,46,3,Donetsk
880,854,11,475,397,8,405,0,405,12,383,10,21.04.2019 23:50,46,3,Donetsk
1104,1083,28,587,490,27,517,0,517,19,457,41,22.04.2019 00:20,46,3,Donetsk
752,753,66,366,323,63,386,0,386,3,322,61,22.04.2019 00:08,46,3,Donetsk
688,675,36,318,335,35,370,0,370,13,306,51,22.04.2019 01:05,46,3,Donetsk
944,929,55,409,484,51,535,0,535,9,480,46,22.04.2019 00:30,46,3,Donetsk
1504,1486,94,603,811,90,901,0,901,18,807,76,21.04.2019 21:10,46,3,Donetsk
288,279,1,110,177,1,178,0,178,5,147,26,21.04.2019 22:02,46,3,Donetsk
1264,1256,26,579,662,23,685,0,685,8,646,31,21.04.2019 21:07,46,3,Donetsk
144,152,7,37,100,7,107,0,107,2,60,45,21.04.2019 23:30,46,3,Donetsk
240,239,7,70,163,7,170,0,170,4,113,53,22.04.2019 00:30,46,3,Donetsk
896,909,10,433,455,8,463,0,463,7,427,29,22.04.2019 00:10,46,3,Donetsk
704,706,12,349,343,12,355,0,355,3,327,25,22.04.2019 00:10,46,3,Donetsk
992,973,9,387,596,9,605,0,605,14,535,56,21.04.2019 23:50,46,3,Donetsk
1040,1024,8,497,537,6,543,0,543,10,505,28,22.04.2019 00:25,46,3,Donetsk
560,558,32,277,252,31,283,0,283,8,251,24,22.04.2019 00:15,46,3,Donetsk
272,270,12,124,136,12,148,0,148,1,132,15,22.04.2019 00:00,46,3,Donetsk
1312,1330,33,519,762,31,793,0,793,16,687,90,22.04.2019 00:50,46,3,Donetsk
336,314,2,181,154,1,155,0,155,4,128,23,22.04.2019 00:03,46,3,Donetsk
64,57,39,19,14,31,45,0,45,1,40,4,21.04.2019 21:00,46,3,Donetsk
128,96,0,32,96,0,96,0,96,4,86,6,21.04.2019 20:15,46,3,Donetsk
80,63,0,19,61,0,61,0,61,1,50,10,21.04.2019 21:20,47,3,Donetsk
560,535,43,191,330,39,369,0,369,4,308,57,22.04.2019 00:15,47,3,Donetsk
464,452,25,166,275,23,298,0,298,4,255,39,21.04.2019 21:26,47,3,Donetsk
1392,1356,42,547,803,42,845,0,845,17,777,51,22.04.2019 01:10,47,3,Donetsk
416,417,46,166,207,43,250,0,250,2,225,23,22.04.2019 00:10,47,3,Donetsk
672,685,56,195,423,54,477,0,477,13,380,84,21.04.2019 22:05,47,3,Donetsk
624,605,56,184,393,47,440,0,440,9,339,92,22.04.2019 00:10,47,3,Donetsk
1008,1004,91,341,588,79,667,0,667,9,616,42,21.04.2019 23:00,47,3,Donetsk
528,524,49,266,215,47,262,0,262,10,232,20,21.04.2019 20:56,47,3,Donetsk
528,515,26,168,334,26,360,0,360,11,330,19,22.04.2019 00:30,47,3,Donetsk
1184,1166,71,592,522,70,592,0,592,8,540,44,22.04.2019 00:05,47,3,Donetsk
1632,1613,35,888,712,32,744,0,744,10,656,78,22.04.2019 00:05,47,3,Donetsk
368,361,42,154,174,40,214,0,214,0,193,21,21.04.2019 21:10,47,3,Donetsk
1520,1508,72,743,716,61,777,0,777,15,698,64,22.04.2019 00:02,47,3,Donetsk
1136,1108,44,414,678,44,722,0,722,16,661,45,22.04.2019 00:01,47,3,Donetsk
480,469,20,155,305,20,325,0,325,12,265,48,21.04.2019 22:00,47,3,Donetsk
416,414,28,180,212,24,236,0,236,7,209,20,22.04.2019 00:10,47,3,Donetsk
400,392,32,156,214,30,244,0,244,3,217,24,22.04.2019 00:10,47,3,Donetsk
512,504,25,229,258,25,283,0,283,8,257,18,22.04.2019 00:20,47,3,Donetsk
1632,1643,20,729,885,18,903,0,903,28,782,93,22.04.2019 00:35,47,3,Donetsk
1824,1809,30,854,956,14,970,0,970,21,821,128,22.04.2019 00:15,47,3,Donetsk
1168,1162,13,542,614,12,626,0,626,12,557,57,22.04.2019 00:07,47,3,Donetsk
1664,1636,14,776,882,6,888,0,888,24,782,82,22.04.2019 00:30,47,3,Donetsk
1872,1861,42,845,1003,24,1027,0,1027,36,890,101,22.04.2019 00:10,47,3,Donetsk
1296,1297,54,617,639,40,679,0,679,25,594,60,22.04.2019 00:03,47,3,Donetsk
1840,1865,39,742,1073,25,1098,0,1098,33,946,119,22.04.2019 00:17,47,3,Donetsk
2016,2030,26,831,1168,17,1185,0,1185,29,1030,126,22.04.2019 00:08,47,3,Donetsk
1680,1710,17,611,1056,13,1069,0,1069,36,880,153,21.04.2019 23:15,47,3,Donetsk
1888,1868,32,958,910,20,930,0,930,29,829,72,22.04.2019 00:25,47,3,Donetsk
1936,1925,24,828,1094,14,1108,0,1108,27,997,84,21.04.2019 21:40,47,3,Donetsk
1792,1771,18,805,974,13,987,0,987,28,860,99,22.04.2019 00:25,47,3,Donetsk
1008,998,9,495,505,8,513,0,513,15,446,52,22.04.2019 00:02,47,3,Donetsk
1392,1399,7,550,835,7,842,0,842,14,727,101,22.04.2019 00:00,47,3,Donetsk
2128,2146,39,828,1271,29,1300,0,1300,32,1133,135,22.04.2019 00:01,47,3,Donetsk
2176,2149,28,935,1220,21,1241,0,1241,33,1078,130,22.04.2019 00:03,47,3,Donetsk
448,445,7,218,225,5,230,0,230,7,210,13,22.04.2019 00:05,47,3,Donetsk
1744,1723,26,802,921,21,942,0,942,28,825,89,22.04.2019 00:15,47,3,Donetsk
1680,1704,22,593,1067,20,1087,0,1087,26,932,129,22.04.2019 00:02,47,3,Donetsk
1488,1466,49,670,777,41,818,0,818,24,738,56,22.04.2019 00:03,47,3,Donetsk
1168,1155,9,557,604,7,611,0,611,15,555,41,22.04.2019 01:08,47,3,Donetsk
1632,1624,94,692,860,80,940,0,940,23,828,89,22.04.2019 00:30,47,3,Donetsk
1296,1287,14,565,722,9,731,0,731,15,649,67,22.04.2019 00:15,47,3,Donetsk
1520,1508,15,709,804,7,811,0,811,12,711,88,22.04.2019 00:35,47,3,Donetsk
1184,1167,10,550,626,8,634,0,634,11,576,47,21.04.2019 21:40,47,3,Donetsk
1968,1940,33,913,1026,29,1055,0,1055,30,937,88,22.04.2019 00:05,47,3,Donetsk
1984,1944,21,1069,902,13,915,0,915,39,812,64,22.04.2019 00:08,47,3,Donetsk
2048,2020,27,988,1039,21,1060,0,1060,24,961,75,22.04.2019 00:05,47,3,Donetsk
1840,1832,19,899,925,16,941,0,941,32,844,65,22.04.2019 00:03,47,3,Donetsk
1904,1864,12,782,1112,10,1122,0,1122,18,999,105,22.04.2019 00:10,47,3,Donetsk
64,18,5,46,13,5,18,0,18,0,13,5,22.04.2019 00:10,47,3,Donetsk
48,14,0,34,14,0,14,0,14,0,8,6,22.04.2019 00:10,47,3,Donetsk
320,125,20,203,97,20,117,0,117,15,76,26,22.04.2019 00:30,47,3,Donetsk
64,25,6,46,14,4,18,0,18,0,12,6,22.04.2019 00:10,47,3,Donetsk
64,39,0,26,38,0,38,0,38,0,30,8,22.04.2019 00:15,47,3,Donetsk
128,57,44,79,9,40,49,0,49,0,36,13,22.04.2019 00:05,47,3,Donetsk
1664,1625,10,613,1041,10,1051,0,1051,27,907,117,21.04.2019 21:30,48,3,Donetsk
2016,2004,15,702,1304,10,1314,0,1314,41,1121,152,21.04.2019 21:30,48,3,Donetsk
1776,1763,6,684,1088,4,1092,0,1092,25,953,114,21.04.2019 21:50,48,3,Donetsk
1840,1819,9,754,1081,5,1086,0,1086,16,958,112,21.04.2019 21:30,48,3,Donetsk
2240,2220,13,992,1240,8,1248,0,1248,32,1042,174,22.04.2019 00:05,48,3,Donetsk
1984,1962,32,817,1140,27,1167,0,1167,24,1059,84,22.04.2019 00:10,48,3,Donetsk
1728,1708,5,931,794,3,797,0,797,26,689,82,21.04.2019 21:32,48,3,Donetsk
1648,1612,8,845,796,7,803,0,803,15,691,97,21.04.2019 22:30,48,3,Donetsk
1616,1596,11,803,806,7,813,0,813,18,713,82,21.04.2019 20:50,48,3,Donetsk
1264,1256,8,652,605,7,612,0,612,14,560,38,21.04.2019 22:50,48,3,Donetsk
1360,1348,9,575,779,6,785,0,785,24,703,58,21.04.2019 22:02,48,3,Donetsk
2144,2104,37,1078,1039,27,1066,0,1066,17,932,117,21.04.2019 21:30,48,3,Donetsk
1232,1221,5,557,671,4,675,0,675,16,602,57,21.04.2019 21:00,48,3,Donetsk
1408,1387,11,585,814,9,823,0,823,19,746,58,21.04.2019 22:25,48,3,Donetsk
1456,1432,14,708,741,7,748,0,748,19,662,67,21.04.2019 21:40,48,3,Donetsk
2048,2025,7,938,1103,7,1110,0,1110,31,948,131,21.04.2019 21:50,48,3,Donetsk
1520,1518,18,609,899,12,911,0,911,15,772,124,21.04.2019 21:26,48,3,Donetsk
1456,1460,7,607,844,5,849,0,849,14,718,117,21.04.2019 21:15,48,3,Donetsk
1680,1671,9,826,849,5,854,0,854,20,770,64,22.04.2019 00:03,48,3,Donetsk
1504,1484,9,729,770,5,775,0,775,27,681,67,21.04.2019 21:28,48,3,Donetsk
1168,1152,13,606,553,9,562,0,562,10,483,69,22.04.2019 00:10,48,3,Donetsk
1664,1643,4,832,831,1,832,0,832,23,731,78,21.04.2019 21:35,48,3,Donetsk
2016,2006,19,832,1167,17,1184,0,1184,24,1014,146,21.04.2019 21:30,48,3,Donetsk
1200,1119,12,567,624,9,633,0,633,16,548,69,22.04.2019 00:10,48,3,Donetsk
1136,1123,8,568,560,8,568,0,568,11,488,69,21.04.2019 21:00,48,3,Donetsk
1936,1955,16,781,1145,10,1155,0,1155,28,958,169,21.04.2019 21:50,48,3,Donetsk
1952,1953,10,716,1229,7,1236,0,1236,21,1038,177,21.04.2019 21:00,48,3,Donetsk
1920,1943,17,640,1268,12,1280,0,1280,33,1069,178,21.04.2019 21:38,48,3,Donetsk
1920,1954,6,677,1239,4,1243,0,1243,28,1038,177,21.04.2019 22:00,48,3,Donetsk
2096,2091,10,804,1285,7,1292,0,1292,41,1087,164,21.04.2019 21:15,48,3,Donetsk
1920,1907,13,718,1193,9,1202,0,1202,22,1014,166,21.04.2019 21:40,48,3,Donetsk
1808,1845,13,652,1148,8,1156,0,1156,29,928,199,21.04.2019 21:30,48,3,Donetsk
1600,1624,13,621,966,13,979,0,979,23,831,125,21.04.2019 21:30,48,3,Donetsk
1504,1507,17,605,887,12,899,0,899,38,705,156,22.04.2019 00:01,48,3,Donetsk
1648,1692,10,634,1008,6,1014,0,1014,26,876,112,21.04.2019 23:10,48,3,Donetsk
1504,1536,15,547,949,8,957,0,957,33,802,122,22.04.2019 00:05,48,3,Donetsk
2032,2047,17,861,1157,14,1171,0,1171,33,962,176,21.04.2019 21:35,48,3,Donetsk
1248,1288,22,473,762,13,775,0,775,24,644,107,21.04.2019 21:12,48,3,Donetsk
1408,1408,4,574,831,3,834,0,834,18,698,118,21.04.2019 20:56,48,3,Donetsk
1488,1524,18,513,959,16,975,0,975,24,770,181,21.04.2019 21:30,48,3,Donetsk
1344,1370,16,448,881,15,896,0,896,37,728,131,21.04.2019 22:20,48,3,Donetsk
2000,1959,13,754,1234,12,1246,0,1246,32,988,226,21.04.2019 21:18,48,3,Donetsk
208,121,0,120,88,0,88,0,88,7,73,8,21.04.2019 20:45,48,3,Donetsk
208,111,0,99,109,0,109,0,109,12,84,13,21.04.2019 21:00,48,3,Donetsk
224,52,39,180,13,31,44,0,44,0,36,8,21.04.2019 21:25,48,3,Donetsk
368,35,21,334,14,20,34,0,34,1,26,7,21.04.2019 22:10,48,3,Donetsk
272,34,21,238,13,21,34,0,34,1,28,5,21.04.2019 20:31,48,3,Donetsk
240,36,3,207,30,3,33,0,33,0,29,4,21.04.2019 22:00,48,3,Donetsk
208,18,0,194,14,0,14,0,14,1,9,4,21.04.2019 20:26,48,3,Donetsk
144,136,0,15,129,0,129,0,129,0,38,91,21.04.2019 20:30,49,3,Donetsk
304,294,0,35,269,0,269,0,269,10,138,121,21.04.2019 20:35,49,3,Donetsk
432,421,18,162,252,18,270,0,270,5,203,62,22.04.2019 00:05,49,3,Donetsk
320,315,38,121,161,38,199,0,199,6,160,33,22.04.2019 00:05,49,3,Donetsk
448,437,55,49,344,55,399,0,399,6,263,130,22.04.2019 00:20,49,3,Donetsk
160,156,7,58,95,7,102,0,102,3,65,34,22.04.2019 00:26,49,3,Donetsk
368,358,31,73,264,31,295,0,295,3,248,44,22.04.2019 00:05,49,3,Donetsk
192,181,7,79,106,7,113,0,113,8,94,11,21.04.2019 20:53,49,3,Donetsk
192,179,6,88,98,6,104,0,104,2,89,13,21.04.2019 21:30,49,3,Donetsk
320,303,23,141,156,23,179,0,179,2,153,24,21.04.2019 20:50,49,3,Donetsk
688,676,26,380,282,26,308,0,308,0,253,55,22.04.2019 00:02,49,3,Donetsk
512,505,27,133,352,27,379,0,379,9,337,33,22.04.2019 00:45,49,3,Donetsk
432,426,20,184,228,20,248,0,248,2,199,47,22.04.2019 00:30,49,3,Donetsk
288,281,20,131,137,20,157,0,157,2,120,35,21.04.2019 20:50,49,3,Donetsk
368,363,7,180,181,7,188,0,188,3,156,29,21.04.2019 21:05,49,3,Donetsk
128,121,6,67,55,6,61,0,61,0,44,17,21.04.2019 22:50,49,3,Donetsk
1648,1620,21,777,856,15,871,0,871,16,806,49,22.04.2019 00:05,49,3,Donetsk
2096,2076,22,1084,994,18,1012,0,1012,18,934,60,21.04.2019 21:19,49,3,Donetsk
2224,2191,21,1155,1056,13,1069,0,1069,25,974,70,21.04.2019 21:40,49,3,Donetsk
1280,1269,17,550,713,17,730,0,730,16,672,42,22.04.2019 00:10,49,3,Donetsk
1392,1365,13,654,729,9,738,0,738,15,659,64,22.04.2019 00:15,49,3,Donetsk
2224,2228,22,993,1218,13,1231,0,1231,32,1108,91,21.04.2019 23:55,49,3,Donetsk
1312,1292,9,707,598,7,605,0,605,7,562,36,22.04.2019 00:02,49,3,Donetsk
1520,1498,21,779,720,21,741,0,741,20,702,19,22.04.2019 00:01,49,3,Donetsk
80,61,0,22,58,0,58,0,58,2,21,35,21.04.2019 21:00,49,3,Donetsk
64,48,25,18,23,23,46,0,46,0,31,15,21.04.2019 20:40,49,3,Donetsk
1456,1423,27,673,763,20,783,0,783,21,708,54,22.04.2019 00:15,49,3,Donetsk
1344,1328,17,699,631,14,645,0,645,10,610,25,21.04.2019 20:50,49,3,Donetsk
1136,1141,13,551,576,9,585,0,585,20,518,47,21.04.2019 22:10,49,3,Donetsk
1216,1197,20,628,578,10,588,0,588,11,555,22,22.04.2019 00:15,49,3,Donetsk
1296,1281,12,605,683,8,691,0,691,22,634,35,22.04.2019 00:24,49,3,Donetsk
112,101,0,11,101,0,101,0,101,3,51,47,21.04.2019 23:05,50,3,Donetsk
736,700,0,61,675,0,675,0,675,20,387,268,21.04.2019 21:40,50,3,Donetsk
432,412,28,169,236,27,263,0,263,3,244,16,21.04.2019 20:50,50,3,Donetsk
400,394,32,106,262,32,294,0,294,2,266,26,22.04.2019 00:05,50,3,Donetsk
1312,1280,85,577,659,76,735,0,735,16,689,30,21.04.2019 23:51,50,3,Donetsk
336,323,18,150,168,18,186,0,186,6,163,17,21.04.2019 23:10,50,3,Donetsk
816,802,53,364,407,45,452,0,452,8,385,59,21.04.2019 21:33,50,3,Donetsk
384,377,19,145,224,15,239,0,239,4,212,23,21.04.2019 22:14,50,3,Donetsk
384,373,15,152,218,14,232,0,232,2,213,17,21.04.2019 21:29,50,3,Donetsk
160,147,17,92,53,15,68,0,68,0,64,4,22.04.2019 00:02,50,3,Donetsk
224,215,27,73,127,24,151,0,151,2,117,32,21.04.2019 20:38,50,3,Donetsk
1072,1060,58,380,639,53,692,0,692,17,605,70,21.04.2019 20:48,50,3,Donetsk
464,443,29,153,282,29,311,0,311,3,270,38,21.04.2019 22:15,50,3,Donetsk
224,208,18,98,109,17,126,0,126,0,121,5,21.04.2019 21:17,50,3,Donetsk
688,669,45,316,335,37,372,0,372,0,328,44,21.04.2019 21:00,50,3,Donetsk
592,575,42,292,271,29,300,0,300,5,240,55,21.04.2019 20:48,50,3,Donetsk
144,135,14,65,66,13,79,0,79,1,73,5,21.04.2019 21:50,50,3,Donetsk
368,350,25,142,205,21,226,0,226,6,200,20,21.04.2019 22:00,50,3,Donetsk
320,304,23,107,193,20,213,0,213,2,205,6,21.04.2019 21:02,50,3,Donetsk
1584,1556,8,756,822,6,828,0,828,21,755,52,21.04.2019 23:22,50,3,Donetsk
368,92,45,281,46,41,87,0,87,2,84,1,21.04.2019 23:57,50,3,Donetsk
96,34,0,62,34,0,34,0,34,2,30,2,21.04.2019 21:18,50,3,Donetsk
1184,1156,3,523,658,3,661,0,661,18,578,65,21.04.2019 21:10,50,3,Donetsk
1632,1602,237,611,788,233,1021,0,1021,14,952,55,22.04.2019 00:00,50,3,Donetsk
1584,1553,11,600,976,8,984,0,984,15,902,67,22.04.2019 00:02,50,3,Donetsk
1600,1567,11,686,907,7,914,0,914,11,868,35,21.04.2019 22:58,50,3,Donetsk
736,713,15,271,452,13,465,0,465,10,425,30,21.04.2019 23:17,50,3,Donetsk
1312,1291,13,536,763,13,776,0,776,15,712,49,21.04.2019 22:40,50,3,Donetsk
1536,1522,14,714,808,14,822,0,822,14,760,48,21.04.2019 22:30,50,3,Donetsk
1568,1546,22,634,913,21,934,0,934,21,845,68,21.04.2019 21:11,50,3,Donetsk
2112,2066,16,800,1302,10,1312,0,1312,20,1199,93,21.04.2019 22:10,50,3,Donetsk
1920,1905,20,799,1108,13,1121,0,1121,28,1017,76,21.04.2019 22:05,50,3,Donetsk
336,68,34,277,25,34,59,0,59,0,55,4,21.04.2019 20:10,50,3,Donetsk
80,31,2,52,26,2,28,0,28,0,27,1,21.04.2019 20:45,50,3,Donetsk
48,22,3,26,19,3,22,0,22,0,21,1,21.04.2019 21:15,50,3,Donetsk
496,471,22,274,201,21,222,0,222,8,137,77,21.04.2019 21:25,51,3,Donetsk
2240,2210,64,1951,248,41,289,0,289,1,196,92,21.04.2019 22:30,51,3,Donetsk
624,610,0,63,561,0,561,0,561,22,152,387,22.04.2019 00:21,52,3,Donetsk
256,254,0,5,251,0,251,0,251,40,63,148,22.04.2019 00:10,52,3,Donetsk
1952,1907,46,1156,766,30,796,0,796,39,715,42,21.04.2019 21:00,52,3,Donetsk
1104,1073,12,609,484,11,495,0,495,20,376,99,22.04.2019 00:00,52,3,Donetsk
1024,1008,11,487,529,8,537,0,537,23,474,40,22.04.2019 00:05,52,3,Donetsk
832,807,5,410,417,5,422,0,422,14,391,17,22.04.2019 00:35,52,3,Donetsk
1296,1266,19,684,600,12,612,0,612,9,559,44,21.04.2019 20:55,52,3,Donetsk
1200,1188,10,674,518,8,526,0,526,21,461,44,21.04.2019 21:10,52,3,Donetsk
1456,1479,80,737,643,76,719,0,719,28,652,39,21.04.2019 22:45,52,3,Donetsk
1104,1094,18,533,559,12,571,0,571,27,498,46,22.04.2019 00:05,52,3,Donetsk
1072,1046,6,568,498,6,504,0,504,13,468,23,22.04.2019 00:25,52,3,Donetsk
1344,1300,10,766,568,10,578,0,578,17,511,50,21.04.2019 21:29,52,3,Donetsk
1616,1588,17,808,793,15,808,0,808,33,725,50,22.04.2019 00:10,52,3,Donetsk
1264,1258,15,599,650,15,665,0,665,25,543,97,22.04.2019 00:03,52,3,Donetsk
784,761,5,525,256,3,259,0,259,7,236,16,22.04.2019 00:10,52,3,Donetsk
832,829,8,487,338,7,345,0,345,11,323,11,22.04.2019 00:01,52,3,Donetsk
848,827,2,537,310,1,311,0,311,11,277,23,21.04.2019 21:11,52,3,Donetsk
976,965,1,611,364,1,365,0,365,14,310,41,22.04.2019 00:30,52,3,Donetsk
480,452,2,299,180,1,181,0,181,5,158,18,21.04.2019 21:45,52,3,Donetsk
1616,1582,11,899,706,11,717,0,717,24,572,121,21.04.2019 21:20,52,3,Donetsk
1680,1659,26,926,731,23,754,0,754,27,674,53,22.04.2019 00:05,52,3,Donetsk
624,597,7,425,194,5,199,0,199,6,183,10,21.04.2019 20:03,52,3,Donetsk
1008,981,15,602,391,15,406,0,406,12,374,20,22.04.2019 00:10,52,3,Donetsk
816,785,15,575,231,10,241,0,241,8,204,29,22.04.2019 00:22,52,3,Donetsk
1552,1518,19,996,540,16,556,0,556,17,517,22,22.04.2019 00:05,52,3,Donetsk
1936,1908,29,1028,883,25,908,0,908,26,829,53,22.04.2019 00:05,52,3,Donetsk
1184,1163,15,624,547,13,560,0,560,25,487,48,22.04.2019 02:06,52,3,Donetsk
1376,1341,56,509,811,56,867,0,867,26,733,108,21.04.2019 22:30,52,3,Donetsk
624,601,22,329,273,22,295,0,295,8,269,18,22.04.2019 00:06,52,3,Donetsk
640,624,27,308,305,27,332,0,332,14,294,24,21.04.2019 23:10,52,3,Donetsk
672,656,19,377,280,15,295,0,295,6,256,33,22.04.2019 00:14,52,3,Donetsk
464,449,37,205,222,37,259,0,259,3,218,38,22.04.2019 00:20,52,3,Donetsk
432,422,17,202,215,15,230,0,230,6,197,26,21.04.2019 21:50,52,3,Donetsk
1168,1145,51,481,637,50,687,0,687,0,631,56,22.04.2019 00:17,52,3,Donetsk
1040,1024,50,519,480,41,521,0,521,11,466,44,21.04.2019 22:30,52,3,Donetsk
672,656,35,297,340,35,375,0,375,7,340,28,22.04.2019 00:01,52,3,Donetsk
352,68,31,285,36,31,67,0,67,3,53,11,21.04.2019 20:15,52,3,Donetsk
592,544,0,61,531,0,531,0,531,38,475,18,22.04.2019 00:01,52,3,Donetsk
576,432,0,144,432,0,432,0,432,39,380,13,21.04.2019 20:35,57,3,Donetsk
624,607,0,24,600,0,600,0,600,19,262,319,21.04.2019 20:40,57,3,Donetsk
912,897,0,58,854,0,854,0,854,21,521,312,21.04.2019 21:15,57,3,Donetsk
1792,1750,20,757,1016,19,1035,0,1035,15,983,37,22.04.2019 00:20,57,3,Donetsk
624,572,2,350,272,2,274,0,274,1,265,8,21.04.2019 22:10,57,3,Donetsk
1600,1584,12,553,1037,10,1047,0,1047,21,954,72,21.04.2019 22:40,57,3,Donetsk
1776,1748,9,736,1031,9,1040,0,1040,17,959,64,21.04.2019 21:40,57,3,Donetsk
1984,1950,10,742,1233,9,1242,0,1242,13,1135,94,21.04.2019 21:43,57,3,Donetsk
1264,1266,3,671,591,2,593,0,593,20,535,38,21.04.2019 22:01,57,3,Donetsk
1712,1714,13,607,1094,11,1105,0,1105,21,1000,84,21.04.2019 21:35,57,3,Donetsk
1744,1742,5,822,917,5,922,0,922,26,835,61,21.04.2019 21:30,57,3,Donetsk
1632,1607,6,835,791,6,797,0,797,14,759,24,21.04.2019 22:00,57,3,Donetsk
944,936,1,444,499,1,500,0,500,15,461,24,21.04.2019 21:08,57,3,Donetsk
1120,1101,1,575,544,1,545,0,545,13,507,25,21.04.2019 21:00,57,3,Donetsk
1664,1629,14,741,909,14,923,0,923,29,829,65,21.04.2019 22:00,57,3,Donetsk
1280,1262,1,584,695,1,696,0,696,9,670,17,22.04.2019 00:10,57,3,Donetsk
1712,1688,6,842,865,5,870,0,870,30,789,51,21.04.2019 22:20,57,3,Donetsk
624,618,1,287,336,1,337,0,337,6,315,16,21.04.2019 20:50,57,3,Donetsk
1152,1134,1,527,624,1,625,0,625,17,587,21,21.04.2019 22:30,57,3,Donetsk
1168,1152,1,512,655,1,656,0,656,11,622,23,21.04.2019 21:27,57,3,Donetsk
1216,1183,2,517,698,1,699,0,699,13,668,18,21.04.2019 21:15,57,3,Donetsk
848,835,1,311,536,1,537,0,537,12,507,18,21.04.2019 20:53,57,3,Donetsk
1344,1313,4,611,729,4,733,0,733,20,674,39,21.04.2019 21:45,57,3,Donetsk
1392,1368,3,686,704,2,706,0,706,10,649,47,21.04.2019 21:40,57,3,Donetsk
2048,2015,6,846,1198,4,1202,0,1202,29,1114,59,21.04.2019 21:25,57,3,Donetsk
1216,1192,5,512,702,2,704,0,704,19,641,44,21.04.2019 21:44,57,3,Donetsk
1184,1172,6,548,630,6,636,0,636,13,602,21,21.04.2019 20:53,57,3,Donetsk
384,372,8,179,197,8,205,0,205,3,197,5,21.04.2019 20:45,57,3,Donetsk
80,27,0,53,27,0,27,0,27,0,21,6,21.04.2019 20:33,57,3,Donetsk
480,141,66,342,74,64,138,0,138,9,122,7,21.04.2019 21:10,57,3,Donetsk
144,30,1,116,27,1,28,0,28,0,28,0,21.04.2019 21:00,57,3,Donetsk
1584,1564,7,660,920,4,924,0,924,23,833,68,22.04.2019 00:10,57,3,Donetsk
1440,1434,16,573,857,10,867,0,867,16,780,71,21.04.2019 21:45,57,3,Donetsk
1712,1681,35,633,1053,26,1079,0,1079,10,990,79,21.04.2019 21:00,57,3,Donetsk
1760,1718,20,714,1029,17,1046,0,1046,23,939,84,21.04.2019 20:56,57,3,Donetsk
1152,1124,10,470,674,8,682,0,682,14,612,56,22.04.2019 00:02,57,3,Donetsk
1664,1632,8,883,774,7,781,0,781,11,728,42,21.04.2019 21:59,57,3,Donetsk
1360,1337,13,535,814,11,825,0,825,17,751,57,21.04.2019 21:36,57,3,Donetsk
1392,1365,13,543,841,8,849,0,849,11,793,45,22.04.2019 00:05,57,3,Donetsk
1456,1449,15,681,763,12,775,0,775,22,705,48,21.04.2019 21:15,57,3,Donetsk
1776,1747,18,805,957,14,971,0,971,14,898,59,21.04.2019 22:00,57,3,Donetsk
1664,1623,4,747,914,3,917,0,917,20,839,58,21.04.2019 21:40,57,3,Donetsk
1856,1825,13,802,1046,8,1054,0,1054,26,957,71,21.04.2019 21:50,57,3,Donetsk
2048,2005,10,895,1148,5,1153,0,1153,32,1050,71,21.04.2019 21:30,57,3,Donetsk
2192,2149,6,933,1253,6,1259,0,1259,29,1170,60,21.04.2019 23:38,57,3,Donetsk
1440,1409,7,618,817,5,822,0,822,19,745,58,21.04.2019 21:40,57,3,Donetsk
2176,2129,3,932,1242,2,1244,0,1244,26,1142,76,21.04.2019 21:35,57,3,Donetsk
1472,1436,17,579,876,17,893,0,893,21,812,60,22.04.2019 00:02,57,3,Donetsk
304,118,118,197,0,107,107,0,107,1,96,10,22.04.2019 00:05,57,3,Donetsk
144,60,8,85,51,8,59,0,59,1,54,4,21.04.2019 20:42,57,3,Donetsk
1072,1048,7,515,552,5,557,0,557,16,519,22,22.04.2019 00:02,58,3,Donetsk
1200,1180,5,632,564,4,568,0,568,8,552,8,21.04.2019 23:22,58,3,Donetsk
1488,1459,10,582,899,7,906,0,906,15,819,72,21.04.2019 23:29,58,3,Donetsk
1472,1462,5,545,922,5,927,0,927,19,861,47,22.04.2019 00:15,58,3,Donetsk
1184,1173,3,565,619,0,619,0,619,11,576,32,21.04.2019 23:00,58,3,Donetsk
1936,1894,7,901,1030,5,1035,0,1035,29,928,78,21.04.2019 21:00,58,3,Donetsk
1232,1214,9,431,793,8,801,0,801,16,736,49,22.04.2019 00:20,58,3,Donetsk
2256,2273,3,1100,1154,2,1156,0,1156,16,1040,100,21.04.2019 22:50,58,3,Donetsk
1088,1071,6,440,643,5,648,0,648,19,524,105,21.04.2019 23:55,58,3,Donetsk
2144,2213,8,770,1368,6,1374,0,1374,48,1174,152,21.04.2019 23:30,58,3,Donetsk
1632,1591,8,763,862,7,869,0,869,14,764,91,21.04.2019 21:00,58,3,Donetsk
688,682,1,295,393,0,393,0,393,8,331,54,22.04.2019 00:15,58,3,Donetsk
1968,1982,14,821,1139,8,1147,0,1147,25,1015,107,21.04.2019 21:30,58,3,Donetsk
1264,1279,6,519,739,6,745,0,745,20,623,102,21.04.2019 21:15,58,3,Donetsk
1776,1792,8,670,1099,7,1106,0,1106,33,925,148,21.04.2019 22:20,58,3,Donetsk
1472,1462,6,586,881,5,886,0,886,31,786,69,21.04.2019 21:35,58,3,Donetsk
1776,1549,11,864,902,10,912,0,912,22,799,91,21.04.2019 22:25,58,3,Donetsk
1712,1682,7,658,1047,7,1054,0,1054,22,927,105,21.04.2019 21:45,58,3,Donetsk
1472,1455,5,596,873,3,876,0,876,27,780,69,21.04.2019 21:03,58,3,Donetsk
1168,1152,4,433,731,4,735,0,735,16,669,50,21.04.2019 22:00,58,3,Donetsk
1968,1995,4,581,1383,4,1387,0,1387,29,1243,115,22.04.2019 00:15,58,3,Donetsk
2144,2119,5,849,1291,4,1295,0,1295,29,1150,116,22.04.2019 00:05,58,3,Donetsk
1856,1846,9,668,1180,8,1188,0,1188,35,1062,91,22.04.2019 00:05,58,3,Donetsk
992,968,2,403,587,2,589,0,589,22,512,55,21.04.2019 22:20,58,3,Donetsk
2032,2032,14,730,1291,11,1302,0,1302,27,1158,117,21.04.2019 22:20,58,3,Donetsk
960,939,4,356,601,3,604,0,604,9,548,47,22.04.2019 00:07,58,3,Donetsk
1568,1562,9,601,959,8,967,0,967,23,873,71,21.04.2019 23:10,58,3,Donetsk
2064,2044,12,731,1323,10,1333,0,1333,26,1198,109,22.04.2019 00:10,58,3,Donetsk
2112,2100,13,869,1233,10,1243,0,1243,36,1130,77,21.04.2019 21:46,58,3,Donetsk
2176,2193,15,829,1336,11,1347,0,1347,24,1213,110,22.04.2019 00:05,58,3,Donetsk
1824,1797,7,688,1131,5,1136,0,1136,23,1029,84,21.04.2019 23:05,58,3,Donetsk
1808,1817,5,678,1125,5,1130,0,1130,21,1026,83,22.04.2019 00:05,58,3,Donetsk
1888,1851,8,695,1185,8,1193,0,1193,11,1102,80,22.04.2019 00:15,58,3,Donetsk
2064,2044,8,840,1218,6,1224,0,1224,27,1112,85,22.04.2019 00:03,58,3,Donetsk
1472,1442,6,585,881,6,887,0,887,13,792,82,21.04.2019 21:25,58,3,Donetsk
1968,1953,6,734,1229,5,1234,0,1234,26,1116,92,22.04.2019 00:20,58,3,Donetsk
2176,2173,5,798,1375,3,1378,0,1378,40,1249,89,22.04.2019 00:20,58,3,Donetsk
2240,2198,8,879,1355,6,1361,0,1361,26,1236,99,21.04.2019 22:05,58,3,Donetsk
1840,1817,9,730,1103,7,1110,0,1110,20,1039,51,21.04.2019 21:50,58,3,Donetsk
2080,2073,5,743,1333,4,1337,0,1337,31,1225,81,22.04.2019 00:20,58,3,Donetsk
2112,2080,3,717,1392,3,1395,0,1395,29,1278,88,22.04.2019 00:30,58,3,Donetsk
1248,1216,2,559,689,0,689,0,689,12,645,32,22.04.2019 00:20,58,3,Donetsk
2080,2053,21,930,1138,12,1150,0,1150,22,1036,92,21.04.2019 22:00,58,3,Donetsk
1296,1272,3,608,686,2,688,0,688,7,642,39,21.04.2019 21:39,58,3,Donetsk
1360,1328,8,631,723,6,729,0,729,8,675,46,21.04.2019 22:45,58,3,Donetsk
224,144,14,126,85,13,98,0,98,3,87,8,21.04.2019 21:00,58,3,Donetsk
80,16,8,64,8,8,16,0,16,0,14,2,21.04.2019 22:10,58,3,Donetsk
576,32,14,545,17,14,31,0,31,1,27,3,21.04.2019 20:46,58,3,Donetsk
208,90,10,131,69,8,77,0,77,0,70,7,21.04.2019 20:50,58,3,Donetsk
1680,1658,12,762,907,11,918,0,918,19,824,75,21.04.2019 21:48,58,3,Donetsk
944,932,1,371,572,1,573,0,573,9,503,61,21.04.2019 20:48,58,3,Donetsk
1424,1415,19,543,868,13,881,0,881,13,788,80,21.04.2019 22:33,58,3,Donetsk
1712,1717,7,739,968,5,973,0,973,34,845,94,21.04.2019 21:50,58,3,Donetsk
1776,1765,16,729,1033,14,1047,0,1047,26,907,114,21.04.2019 21:00,58,3,Donetsk
1568,1593,15,646,913,9,922,0,922,35,802,85,21.04.2019 22:36,58,3,Donetsk
1648,1616,11,761,880,7,887,0,887,10,784,93,22.04.2019 00:10,58,3,Donetsk
1376,1351,10,592,777,7,784,0,784,9,715,60,22.04.2019 00:15,58,3,Donetsk
1952,1931,4,762,1186,4,1190,0,1190,23,1079,88,21.04.2019 22:00,58,3,Donetsk
2016,2000,14,778,1231,7,1238,0,1238,21,1125,92,21.04.2019 22:30,58,3,Donetsk
1280,1231,26,582,677,21,698,0,698,18,626,54,21.04.2019 22:35,58,3,Donetsk
2176,2114,12,879,1287,10,1297,0,1297,29,1141,127,21.04.2019 21:30,58,3,Donetsk
2096,2069,8,805,1284,7,1291,0,1291,28,1141,122,21.04.2019 22:30,58,3,Donetsk
1472,1243,7,767,699,6,705,0,705,17,614,74,21.04.2019 21:45,58,3,Donetsk
1712,1671,4,758,951,3,954,0,954,24,862,68,21.04.2019 22:50,58,3,Donetsk
1760,1723,7,845,911,4,915,0,915,13,852,50,21.04.2019 21:01,58,3,Donetsk
288,134,41,172,78,38,116,0,116,1,103,12,22.04.2019 00:25,58,3,Donetsk
192,137,0,64,128,0,128,0,128,7,87,34,21.04.2019 21:10,59,3,Donetsk
304,260,0,50,254,0,254,0,254,21,33,200,21.04.2019 20:47,59,3,Donetsk
192,163,0,29,163,0,163,0,163,1,31,131,21.04.2019 21:30,59,3,Donetsk
240,228,0,14,226,0,226,0,226,10,25,191,21.04.2019 22:30,59,3,Donetsk
272,266,0,7,265,0,265,0,265,5,15,245,21.04.2019 23:30,59,3,Donetsk
96,83,0,13,83,0,83,0,83,0,23,60,21.04.2019 22:30,59,3,Donetsk
400,325,0,87,313,0,313,0,313,6,126,181,21.04.2019 23:06,59,3,Donetsk
880,875,0,12,868,0,868,0,868,101,363,404,21.04.2019 21:21,59,3,Donetsk
368,346,0,30,338,0,338,0,338,22,82,234,21.04.2019 22:30,59,3,Donetsk
112,100,0,12,100,0,100,0,100,4,37,59,21.04.2019 20:50,59,3,Donetsk
624,604,0,20,604,0,604,0,604,17,280,307,21.04.2019 21:25,59,3,Donetsk
208,203,8,53,147,8,155,0,155,2,116,37,21.04.2019 20:20,59,3,Donetsk
288,284,19,136,136,16,152,0,152,0,124,28,21.04.2019 20:40,59,3,Donetsk
1552,1532,48,807,697,48,745,0,745,35,533,177,21.04.2019 21:12,59,3,Donetsk
1168,1144,4,691,473,4,477,0,477,5,223,249,21.04.2019 21:50,59,3,Donetsk
1392,1328,35,684,685,23,708,0,708,16,418,274,21.04.2019 21:25,59,3,Donetsk
1120,1075,25,557,538,25,563,0,563,0,384,179,21.04.2019 21:20,59,3,Donetsk
1280,1222,9,730,546,4,550,0,550,7,260,283,21.04.2019 20:55,59,3,Donetsk
1104,1064,34,360,722,22,744,0,744,7,230,507,21.04.2019 21:15,59,3,Donetsk
1536,1477,20,795,735,6,741,0,741,25,258,458,21.04.2019 21:20,59,3,Donetsk
1664,1648,14,771,881,12,893,0,893,32,803,58,21.04.2019 21:43,59,3,Donetsk
624,611,20,380,227,17,244,0,244,5,223,16,21.04.2019 21:05,59,3,Donetsk
288,282,7,94,187,7,194,0,194,4,124,66,21.04.2019 20:35,59,3,Donetsk
288,286,12,32,245,11,256,0,256,0,174,82,21.04.2019 20:30,59,3,Donetsk
480,468,14,154,315,11,326,0,326,4,267,55,21.04.2019 22:10,59,3,Donetsk
240,240,17,84,139,17,156,0,156,5,133,18,21.04.2019 20:40,59,3,Donetsk
160,30,0,131,29,0,29,0,29,0,23,6,22.04.2019 00:15,59,3,Donetsk
144,101,34,58,52,34,86,0,86,1,75,10,21.04.2019 20:15,59,3,Donetsk
1152,1134,26,371,756,25,781,0,781,74,645,62,21.04.2019 21:30,59,3,Donetsk
1488,1454,32,892,574,22,596,0,596,11,567,18,21.04.2019 22:35,59,3,Donetsk
800,706,0,119,681,0,681,0,681,43,607,31,21.04.2019 21:00,59,3,Donetsk
576,541,0,48,528,0,528,0,528,28,227,273,21.04.2019 21:55,60,3,Donetsk
784,767,0,90,694,0,694,0,694,25,382,287,21.04.2019 21:50,60,3,Donetsk
448,341,0,111,337,0,337,0,337,18,122,197,21.04.2019 23:10,60,3,Donetsk
336,307,0,77,259,0,259,0,259,28,133,98,21.04.2019 21:24,60,3,Donetsk
288,272,0,17,271,0,271,0,271,26,118,127,21.04.2019 21:00,60,3,Donetsk
880,773,0,170,710,0,710,0,710,76,402,232,22.04.2019 02:15,60,3,Donetsk
336,318,0,18,318,0,318,0,318,25,102,191,21.04.2019 21:00,60,3,Donetsk
512,489,0,39,473,0,473,0,473,36,209,228,21.04.2019 23:15,60,3,Donetsk
208,194,0,22,186,0,186,0,186,3,74,109,21.04.2019 21:05,60,3,Donetsk
128,106,0,24,104,0,104,0,104,4,42,58,21.04.2019 20:40,60,3,Donetsk
352,318,0,52,300,0,300,15,300,15,209,76,21.04.2019 21:20,60,3,Donetsk
272,224,0,53,219,0,219,0,219,5,132,82,21.04.2019 21:05,60,3,Donetsk
144,122,0,26,118,0,118,0,118,6,94,18,21.04.2019 20:36,60,3,Donetsk
528,492,0,242,286,0,286,0,286,23,154,109,21.04.2019 20:50,60,3,Donetsk
1504,1492,73,600,831,73,904,0,904,19,809,76,22.04.2019 01:25,60,3,Donetsk
1936,1918,90,811,1051,74,1125,0,1125,27,984,114,22.04.2019 00:40,60,3,Donetsk
2224,2229,69,923,1254,47,1301,0,1301,40,1093,168,22.04.2019 00:05,60,3,Donetsk
1248,1238,33,560,660,28,688,0,688,21,598,69,21.04.2019 21:23,60,3,Donetsk
1248,1233,61,562,628,58,686,0,686,15,600,71,22.04.2019 00:05,60,3,Donetsk
2304,2279,43,908,1361,35,1396,0,1396,32,1232,132,22.04.2019 00:30,60,3,Donetsk
1984,1966,25,1008,959,17,976,0,976,23,902,51,22.04.2019 00:13,60,3,Donetsk
1328,1301,50,672,610,46,656,0,656,16,554,86,22.04.2019 00:10,60,3,Donetsk
1808,1769,73,1111,644,53,697,0,697,56,565,76,22.04.2019 00:01,60,3,Donetsk
880,871,58,482,347,51,398,0,398,8,318,72,22.04.2019 00:50,60,3,Donetsk
576,558,51,156,373,47,420,0,420,11,348,61,22.04.2019 00:30,60,3,Donetsk
976,969,35,461,483,32,515,0,515,8,485,22,22.04.2019 00:15,60,3,Donetsk
912,922,22,371,522,19,541,0,541,20,452,69,22.04.2019 00:20,60,3,Donetsk
768,758,19,231,519,18,537,0,537,9,482,46,22.04.2019 00:01,60,3,Donetsk
432,421,24,178,232,22,254,0,254,3,227,24,21.04.2019 21:00,60,3,Donetsk
384,374,16,180,190,14,204,0,204,6,186,12,21.04.2019 21:00,60,3,Donetsk
704,690,60,341,311,52,363,0,363,5,324,34,21.04.2019 21:00,60,3,Donetsk
448,433,23,194,233,21,254,0,254,1,238,15,21.04.2019 20:35,60,3,Donetsk
704,692,34,315,359,30,389,0,389,4,366,19,22.04.2019 00:03,60,3,Donetsk
592,580,54,161,378,53,431,0,431,7,322,102,21.04.2019 21:25,60,3,Donetsk
1008,994,57,465,486,57,543,0,543,20,491,32,22.04.2019 00:10,60,3,Donetsk
544,537,15,282,250,12,262,0,262,6,238,18,21.04.2019 23:55,60,3,Donetsk
576,554,36,258,287,31,318,0,318,8,292,18,22.04.2019 00:05,60,3,Donetsk
464,447,28,229,212,23,235,0,235,8,201,26,22.04.2019 00:20,60,3,Donetsk
672,651,54,254,379,39,418,0,418,11,360,47,21.04.2019 21:37,60,3,Donetsk
1088,1074,50,486,557,45,602,0,602,16,546,40,21.04.2019 21:30,60,3,Donetsk
1264,1248,103,419,744,101,845,0,845,18,792,35,22.04.2019 00:20,60,3,Donetsk
352,119,39,236,79,37,116,0,116,2,104,10,22.04.2019 00:15,60,3,Donetsk
368,358,29,125,216,27,243,0,243,2,238,3,22.04.2019 00:05,60,3,Donetsk
528,508,52,133,344,51,395,0,395,3,369,23,21.04.2019 20:49,60,3,Donetsk
368,372,24,133,218,17,235,0,235,2,216,17,21.04.2019 20:50,60,3,Donetsk
1904,1884,86,710,1115,79,1194,0,1194,20,1106,68,21.04.2019 21:46,60,3,Donetsk
1088,1055,76,438,582,68,650,0,650,11,620,19,22.04.2019 00:15,60,3,Donetsk
400,389,46,180,177,43,220,0,220,5,206,9,22.04.2019 00:10,60,3,Donetsk
1056,1059,31,344,683,29,712,0,712,8,649,55,21.04.2019 20:35,60,3,Donetsk
656,638,27,275,358,23,381,0,381,7,340,34,22.04.2019 00:43,60,3,Donetsk
192,190,8,66,118,8,126,0,126,2,117,7,21.04.2019 22:50,60,3,Donetsk
2080,2038,96,1033,985,62,1047,0,1047,12,991,44,21.04.2019 21:20,60,3,Donetsk
448,432,21,241,194,13,207,0,207,2,185,20,21.04.2019 21:00,60,3,Donetsk
32,5,0,27,5,0,5,0,5,1,3,1,21.04.2019 20:45,62,4,Zhitomir
1344,1329,12,457,877,10,887,0,887,11,640,236,22.04.2019 00:01,62,4,Zhitomir
1344,1337,19,439,891,14,905,0,905,17,694,194,22.04.2019 00:05,62,4,Zhitomir
1312,1343,39,438,851,23,874,0,874,14,654,206,21.04.2019 22:07,62,4,Zhitomir
128,56,20,72,39,17,56,0,56,0,48,8,21.04.2019 21:00,62,4,Zhitomir
832,748,0,93,739,0,739,0,738,32,646,60,21.04.2019 21:00,62,4,Zhitomir
1264,1232,3,480,783,1,784,0,784,22,585,177,22.04.2019 00:25,62,4,Zhitomir
2064,2029,9,776,1279,9,1288,0,1288,36,986,266,22.04.2019 00:07,62,4,Zhitomir
1584,1568,5,508,1072,4,1076,0,1076,44,776,256,21.04.2019 23:50,62,4,Zhitomir
1040,1006,3,394,643,3,646,0,646,17,434,195,21.04.2019 20:58,62,4,Zhitomir
1232,1214,4,406,823,3,826,0,826,35,555,236,22.04.2019 00:10,62,4,Zhitomir
2064,2049,7,731,1327,6,1333,0,1333,37,982,314,21.04.2019 22:30,62,4,Zhitomir
960,948,2,304,655,1,656,0,656,15,474,167,21.04.2019 22:00,62,4,Zhitomir
1072,1051,0,556,516,0,516,0,516,11,410,95,21.04.2019 23:36,62,4,Zhitomir
1296,1270,9,548,742,6,748,0,748,27,563,158,22.04.2019 00:05,62,4,Zhitomir
768,754,1,291,476,1,477,0,477,10,330,137,21.04.2019 23:30,62,4,Zhitomir
1872,1855,3,581,1289,2,1291,0,1291,26,929,336,21.04.2019 22:40,62,4,Zhitomir
2160,2137,3,954,1203,3,1206,0,1206,34,895,277,21.04.2019 22:30,62,4,Zhitomir
1552,1549,1,644,907,1,908,0,908,29,707,172,21.04.2019 21:10,62,4,Zhitomir
2208,2165,7,868,1336,4,1340,0,1340,32,975,333,21.04.2019 22:30,62,4,Zhitomir
1744,1715,4,745,996,3,999,0,999,23,753,223,21.04.2019 22:30,62,4,Zhitomir
816,231,131,623,78,115,193,0,193,1,154,38,21.04.2019 21:30,62,4,Zhitomir
240,25,0,216,24,0,24,0,24,0,18,6,21.04.2019 22:00,62,4,Zhitomir
992,972,38,398,562,32,594,0,594,8,478,108,21.04.2019 22:10,63,4,Zhitomir
864,860,23,320,522,22,544,0,544,9,416,119,22.04.2019 00:10,63,4,Zhitomir
1120,1112,49,487,584,49,633,0,633,16,442,175,22.04.2019 00:02,63,4,Zhitomir
592,580,43,249,304,39,343,0,343,13,239,91,22.04.2019 00:17,63,4,Zhitomir
304,300,27,123,158,23,181,0,181,1,117,63,21.04.2019 21:35,63,4,Zhitomir
352,336,38,137,177,38,215,0,215,3,158,54,22.04.2019 00:15,63,4,Zhitomir
432,415,26,149,260,23,283,0,283,5,181,97,21.04.2019 21:30,63,4,Zhitomir
656,652,71,298,296,62,358,0,358,6,249,103,21.04.2019 22:23,63,4,Zhitomir
256,251,11,106,141,9,150,0,150,1,100,49,21.04.2019 20:50,63,4,Zhitomir
384,383,44,149,197,38,235,0,235,3,171,61,21.04.2019 20:35,63,4,Zhitomir
176,169,6,35,135,6,141,0,141,2,103,36,21.04.2019 20:57,63,4,Zhitomir
896,914,51,380,471,45,516,0,516,11,305,200,21.04.2019 22:00,63,4,Zhitomir
288,272,18,141,130,17,147,0,147,4,83,60,21.04.2019 21:30,63,4,Zhitomir
656,641,21,304,334,18,352,0,352,11,242,99,21.04.2019 22:00,63,4,Zhitomir
112,45,11,77,29,6,35,0,35,0,26,9,21.04.2019 20:20,63,4,Zhitomir
320,301,30,105,189,26,215,0,215,2,100,113,21.04.2019 22:40,63,4,Zhitomir
720,691,37,275,414,31,445,0,445,12,314,119,21.04.2019 21:41,63,4,Zhitomir
1264,1238,11,464,791,9,800,0,800,12,618,170,22.04.2019 00:00,63,4,Zhitomir
1488,1476,81,660,757,71,828,0,828,27,646,155,21.04.2019 21:10,63,4,Zhitomir
256,247,28,107,127,22,149,0,149,2,81,66,21.04.2019 21:05,63,4,Zhitomir
320,335,22,119,183,18,201,0,201,2,147,52,21.04.2019 20:40,63,4,Zhitomir
400,387,36,145,222,33,255,0,255,4,182,69,21.04.2019 22:35,63,4,Zhitomir
608,590,48,221,344,43,387,0,387,9,288,90,21.04.2019 21:05,63,4,Zhitomir
368,355,14,123,231,14,245,0,245,4,164,77,21.04.2019 23:00,63,4,Zhitomir
464,459,44,187,240,37,277,0,277,9,203,65,21.04.2019 21:00,63,4,Zhitomir
464,447,21,169,275,20,295,0,295,6,228,61,21.04.2019 20:45,63,4,Zhitomir
464,461,30,163,274,27,301,0,301,10,200,91,21.04.2019 22:48,63,4,Zhitomir
192,189,10,81,105,6,111,0,111,3,82,26,21.04.2019 20:50,63,4,Zhitomir
576,575,61,112,407,57,464,0,464,12,385,67,21.04.2019 21:30,63,4,Zhitomir
208,207,34,77,100,31,131,0,131,0,88,43,21.04.2019 21:15,63,4,Zhitomir
128,134,11,43,76,9,85,0,85,3,70,12,22.04.2019 00:00,64,4,Zhitomir
400,381,13,196,191,13,204,0,204,3,159,42,22.04.2019 00:20,64,4,Zhitomir
128,116,3,52,73,3,76,0,76,1,54,21,22.04.2019 00:25,64,4,Zhitomir
176,171,2,79,95,2,97,0,97,1,86,10,22.04.2019 00:37,64,4,Zhitomir
384,372,10,154,220,10,230,0,230,6,165,59,22.04.2019 00:30,64,4,Zhitomir
240,237,23,81,136,23,159,0,159,1,87,71,22.04.2019 00:54,64,4,Zhitomir
528,510,21,238,269,21,290,0,290,5,203,82,22.04.2019 00:15,64,4,Zhitomir
592,565,8,232,355,5,360,0,360,4,272,84,22.04.2019 00:30,64,4,Zhitomir
160,153,17,57,87,16,103,0,103,2,67,34,22.04.2019 00:15,64,4,Zhitomir
112,103,12,51,49,12,61,0,61,0,43,18,22.04.2019 00:25,64,4,Zhitomir
736,727,29,336,375,25,400,0,400,3,346,51,22.04.2019 00:20,64,4,Zhitomir
416,409,17,151,249,16,265,0,265,7,212,46,22.04.2019 00:15,64,4,Zhitomir
160,154,1,70,89,1,90,0,90,1,74,15,22.04.2019 00:30,64,4,Zhitomir
192,183,12,89,91,12,103,0,103,1,51,51,22.04.2019 01:00,64,4,Zhitomir
336,324,16,134,187,15,202,0,202,4,172,26,22.04.2019 00:10,64,4,Zhitomir
96,91,2,46,48,2,50,0,50,2,34,14,22.04.2019 00:30,64,4,Zhitomir
608,590,11,294,307,7,314,0,314,1,268,45,22.04.2019 00:05,64,4,Zhitomir
1024,1012,35,441,549,34,583,0,583,7,473,103,22.04.2019 00:15,64,4,Zhitomir
160,143,9,62,89,9,98,0,98,0,78,20,22.04.2019 00:15,64,4,Zhitomir
256,261,18,102,137,17,154,0,154,0,90,64,22.04.2019 00:45,64,4,Zhitomir
240,239,19,116,105,19,124,0,124,1,90,33,22.04.2019 00:10,64,4,Zhitomir
320,310,24,120,178,22,200,0,200,1,152,47,22.04.2019 00:15,64,4,Zhitomir
96,94,12,38,46,12,58,0,58,0,34,24,22.04.2019 00:40,64,4,Zhitomir
80,79,0,17,63,0,63,0,63,2,35,26,22.04.2019 00:20,64,4,Zhitomir
224,220,11,93,120,11,131,0,131,0,96,35,22.04.2019 00:15,64,4,Zhitomir
240,227,2,99,139,2,141,0,141,3,121,17,22.04.2019 00:03,64,4,Zhitomir
112,107,0,52,60,0,60,0,60,1,46,13,22.04.2019 01:10,64,4,Zhitomir
192,191,4,79,110,3,113,0,113,0,93,20,22.04.2019 00:00,64,4,Zhitomir
336,330,2,133,201,2,203,0,203,4,181,18,22.04.2019 00:20,64,4,Zhitomir
576,568,30,240,307,29,336,0,336,5,259,72,22.04.2019 00:05,64,4,Zhitomir
416,408,1,178,237,1,238,0,238,4,176,58,22.04.2019 00:19,64,4,Zhitomir
128,119,1,66,61,1,62,0,62,1,40,21,22.04.2019 00:20,64,4,Zhitomir
128,118,12,69,47,12,59,0,59,3,35,21,22.04.2019 01:00,64,4,Zhitomir
112,110,9,49,54,9,63,0,63,0,46,17,22.04.2019 00:34,64,4,Zhitomir
592,574,50,202,340,50,390,0,390,5,281,104,22.04.2019 00:12,64,4,Zhitomir
112,103,9,48,55,9,64,0,64,0,45,19,22.04.2019 00:15,64,4,Zhitomir
64,62,10,15,39,10,49,0,49,1,29,19,22.04.2019 00:05,64,4,Zhitomir
800,793,5,442,354,4,358,0,358,7,274,77,22.04.2019 01:22,64,4,Zhitomir
448,436,13,226,213,9,222,0,222,4,164,54,22.04.2019 00:32,64,4,Zhitomir
48,50,0,16,32,0,32,0,32,0,22,10,22.04.2019 00:15,64,4,Zhitomir
880,870,20,314,547,19,566,0,566,13,453,100,22.04.2019 00:15,64,4,Zhitomir
256,248,9,126,124,6,130,0,130,4,100,26,22.04.2019 00:43,64,4,Zhitomir
208,199,7,88,113,7,120,0,120,2,88,30,22.04.2019 00:45,64,4,Zhitomir
224,214,32,75,117,32,149,0,149,3,75,71,22.04.2019 00:25,64,4,Zhitomir
336,323,26,149,161,26,187,0,187,1,133,53,22.04.2019 00:14,64,4,Zhitomir
48,43,7,17,24,7,31,0,31,1,18,12,22.04.2019 00:10,64,4,Zhitomir
208,194,19,86,103,19,122,0,122,2,93,27,22.04.2019 00:35,64,4,Zhitomir
416,401,9,200,208,8,216,0,216,1,170,45,22.04.2019 00:00,64,4,Zhitomir
848,828,3,346,499,3,502,0,502,5,379,118,22.04.2019 00:20,64,4,Zhitomir
320,317,19,127,175,18,193,0,193,3,162,28,22.04.2019 00:10,64,4,Zhitomir
96,90,0,46,50,0,50,0,50,2,27,21,22.04.2019 00:05,64,4,Zhitomir
304,291,6,132,166,6,172,0,172,2,130,40,22.04.2019 00:27,64,4,Zhitomir
112,106,2,52,59,1,60,0,60,0,41,19,22.04.2019 00:20,64,4,Zhitomir
80,80,8,27,47,6,53,0,53,0,32,21,22.04.2019 00:05,64,4,Zhitomir
1008,985,26,386,596,26,622,0,622,10,484,128,22.04.2019 00:40,64,4,Zhitomir
128,122,18,44,66,18,84,0,84,0,69,15,22.04.2019 00:15,64,4,Zhitomir
144,143,5,36,103,5,108,0,108,4,80,24,22.04.2019 00:05,64,4,Zhitomir
256,241,8,79,169,8,177,0,177,2,145,30,22.04.2019 00:10,64,4,Zhitomir
160,153,21,71,68,21,89,0,89,3,66,20,22.04.2019 00:10,64,4,Zhitomir
144,144,8,64,73,7,80,0,80,2,51,27,22.04.2019 00:35,64,4,Zhitomir
320,313,20,128,172,20,192,0,192,4,131,57,22.04.2019 00:02,64,4,Zhitomir
192,181,12,80,101,11,112,0,112,1,78,33,22.04.2019 00:05,64,4,Zhitomir
64,64,3,29,34,1,35,0,35,1,21,13,22.04.2019 00:07,64,4,Zhitomir
192,186,17,90,85,17,102,0,102,2,89,11,22.04.2019 00:06,64,4,Zhitomir
32,38,0,2,30,0,30,0,30,0,23,7,22.04.2019 00:06,64,4,Zhitomir
352,340,27,132,193,27,220,0,220,9,177,34,22.04.2019 00:22,64,4,Zhitomir
96,82,8,47,41,8,49,0,49,0,29,20,22.04.2019 00:03,64,4,Zhitomir
192,185,9,81,103,8,111,0,111,0,84,27,22.04.2019 00:10,64,4,Zhitomir
80,72,3,30,47,3,50,0,50,0,40,10,22.04.2019 00:15,64,4,Zhitomir
112,103,1,46,65,1,66,0,66,2,45,19,22.04.2019 00:06,64,4,Zhitomir
208,203,12,84,112,12,124,0,124,3,89,32,22.04.2019 00:03,64,4,Zhitomir
48,46,2,22,24,2,26,0,26,1,17,8,22.04.2019 00:10,64,4,Zhitomir
336,317,20,128,188,20,208,0,208,1,152,55,22.04.2019 00:20,64,4,Zhitomir
528,522,4,244,280,4,284,0,284,5,244,35,22.04.2019 00:18,64,4,Zhitomir
32,14,0,18,14,0,14,0,14,0,11,3,22.04.2019 00:10,64,4,Zhitomir
32,15,0,18,14,0,14,0,14,1,8,5,22.04.2019 00:04,64,4,Zhitomir
384,372,1,171,212,1,213,0,213,2,159,52,22.04.2019 00:20,64,4,Zhitomir
320,308,4,167,150,3,153,0,153,1,107,45,22.04.2019 00:20,64,4,Zhitomir
304,281,2,174,130,0,130,0,130,0,110,20,22.04.2019 00:25,64,4,Zhitomir
80,80,8,26,48,6,54,0,54,1,30,23,22.04.2019 00:15,64,4,Zhitomir
112,101,8,38,66,8,74,0,74,0,51,23,22.04.2019 00:55,64,4,Zhitomir
208,195,20,81,108,19,127,0,127,3,83,41,22.04.2019 00:30,64,4,Zhitomir
272,266,32,143,100,29,129,0,129,2,107,20,22.04.2019 00:15,64,4,Zhitomir
544,534,3,241,301,2,303,0,303,5,224,74,22.04.2019 00:15,64,4,Zhitomir
256,252,20,127,109,20,129,0,129,2,92,35,22.04.2019 00:45,64,4,Zhitomir
544,525,8,286,251,7,258,0,258,0,211,47,22.04.2019 00:30,64,4,Zhitomir
112,102,3,60,50,2,52,0,52,0,42,10,22.04.2019 00:10,64,4,Zhitomir
80,72,1,32,47,1,48,0,48,1,26,21,22.04.2019 00:30,64,4,Zhitomir
256,243,17,88,151,17,168,0,168,9,94,65,22.04.2019 00:30,64,4,Zhitomir
144,132,0,71,73,0,73,0,73,0,51,22,22.04.2019 00:10,64,4,Zhitomir
288,286,3,140,146,2,148,0,148,0,112,36,22.04.2019 00:45,64,4,Zhitomir
656,632,1,298,357,1,358,0,358,11,300,47,22.04.2019 00:18,64,4,Zhitomir
112,111,5,72,35,5,40,0,40,0,29,11,22.04.2019 00:25,64,4,Zhitomir
272,256,1,111,160,1,161,0,161,2,120,39,22.04.2019 01:08,64,4,Zhitomir
320,297,3,175,142,3,145,0,145,3,97,45,22.04.2019 00:30,64,4,Zhitomir
432,423,11,220,203,9,212,0,212,3,157,52,22.04.2019 00:30,64,4,Zhitomir
736,714,8,364,368,4,372,0,372,9,271,92,22.04.2019 00:10,64,4,Zhitomir
400,389,6,235,159,6,165,0,165,4,109,52,22.04.2019 00:20,64,4,Zhitomir
688,671,3,351,334,3,337,0,337,6,212,119,22.04.2019 00:45,64,4,Zhitomir
288,284,0,146,142,0,142,0,142,1,98,43,22.04.2019 00:16,64,4,Zhitomir
240,226,1,111,128,1,129,0,129,4,83,42,22.04.2019 00:20,64,4,Zhitomir
224,216,1,113,110,1,111,0,111,0,82,29,22.04.2019 00:40,64,4,Zhitomir
80,21,2,61,17,2,19,0,19,0,16,3,22.04.2019 00:42,64,4,Zhitomir
2288,2231,11,890,1390,8,1398,0,1398,29,1129,240,22.04.2019 00:03,64,4,Zhitomir
1264,1235,5,537,724,3,727,0,727,9,591,127,22.04.2019 01:00,64,4,Zhitomir
304,294,25,105,174,25,199,0,199,2,144,53,22.04.2019 00:10,64,4,Zhitomir
432,419,15,169,249,14,263,0,263,6,212,45,22.04.2019 00:00,64,4,Zhitomir
272,258,9,57,206,9,215,0,215,6,113,96,22.04.2019 00:30,64,4,Zhitomir
448,436,5,141,302,5,307,0,307,5,190,112,22.04.2019 00:02,64,4,Zhitomir
1264,1245,14,568,682,14,696,0,696,16,568,112,22.04.2019 00:10,64,4,Zhitomir
144,134,0,63,81,0,81,0,81,1,66,14,22.04.2019 00:05,64,4,Zhitomir
608,588,11,296,301,11,312,0,312,5,267,40,22.04.2019 00:45,64,4,Zhitomir
304,281,13,171,120,13,133,0,133,0,115,18,22.04.2019 00:20,64,4,Zhitomir
128,125,8,49,71,8,79,0,79,2,52,25,22.04.2019 00:01,64,4,Zhitomir
96,86,6,40,50,6,56,0,56,1,48,7,22.04.2019 00:41,64,4,Zhitomir
560,548,6,187,367,6,373,0,373,3,305,65,22.04.2019 00:30,64,4,Zhitomir
272,255,9,92,171,9,180,0,180,5,139,36,22.04.2019 01:19,64,4,Zhitomir
448,431,4,203,241,4,245,0,245,5,209,31,22.04.2019 01:05,64,4,Zhitomir
32,29,1,14,17,1,18,0,18,0,12,6,22.04.2019 00:05,64,4,Zhitomir
336,326,32,136,168,32,200,0,200,1,174,25,22.04.2019 00:20,64,4,Zhitomir
560,554,25,196,340,24,364,0,364,13,265,86,22.04.2019 00:15,64,4,Zhitomir
176,168,20,40,117,19,136,0,136,2,114,20,22.04.2019 00:20,64,4,Zhitomir
144,140,0,53,91,0,91,0,91,1,75,15,22.04.2019 00:10,64,4,Zhitomir
224,207,15,65,145,14,159,0,159,4,54,101,22.04.2019 00:30,64,4,Zhitomir
48,34,1,18,29,1,30,0,30,0,17,13,22.04.2019 00:15,64,4,Zhitomir
144,123,4,40,100,4,104,0,104,0,77,27,22.04.2019 00:00,64,4,Zhitomir
272,245,1,132,139,1,140,0,140,3,105,32,22.04.2019 00:15,64,4,Zhitomir
1136,1112,9,530,598,8,606,0,606,18,462,126,22.04.2019 00:05,64,4,Zhitomir
400,385,32,151,219,30,249,0,249,4,203,42,22.04.2019 00:10,64,4,Zhitomir
176,171,14,47,115,14,129,0,129,3,92,34,22.04.2019 00:15,64,4,Zhitomir
272,263,26,98,152,22,174,0,174,3,135,36,22.04.2019 00:25,64,4,Zhitomir
144,85,10,59,75,10,85,0,85,0,61,24,22.04.2019 00:25,64,4,Zhitomir
176,170,14,65,97,14,111,0,111,1,81,29,22.04.2019 00:30,64,4,Zhitomir
160,159,10,68,83,9,92,0,92,3,62,27,22.04.2019 00:25,64,4,Zhitomir
32,25,0,9,23,0,23,0,23,0,11,12,22.04.2019 00:44,64,4,Zhitomir
1056,1025,11,486,559,11,570,0,570,8,496,66,22.04.2019 00:45,64,4,Zhitomir
368,346,16,186,167,15,182,0,182,0,168,14,22.04.2019 00:40,64,4,Zhitomir
240,227,11,75,155,10,165,0,165,3,122,40,22.04.2019 01:00,64,4,Zhitomir
64,55,4,32,28,4,32,0,32,0,21,11,22.04.2019 00:15,64,4,Zhitomir
128,123,9,39,80,9,89,0,89,1,69,19,22.04.2019 00:40,64,4,Zhitomir
224,206,15,75,134,15,149,0,149,4,94,51,22.04.2019 00:30,64,4,Zhitomir
224,218,11,62,151,11,162,0,162,0,134,28,22.04.2019 00:25,64,4,Zhitomir
576,553,47,227,302,47,349,0,349,12,245,92,22.04.2019 00:15,64,4,Zhitomir
992,980,54,453,501,38,539,0,539,3,430,106,22.04.2019 00:10,64,4,Zhitomir
96,85,4,28,64,4,68,0,68,1,32,35,22.04.2019 00:15,64,4,Zhitomir
640,629,15,230,399,11,410,0,410,12,340,58,22.04.2019 00:30,64,4,Zhitomir
128,126,5,45,78,5,83,0,83,2,75,6,22.04.2019 00:10,64,4,Zhitomir
80,66,14,25,42,13,55,0,55,2,44,9,22.04.2019 00:05,64,4,Zhitomir
528,522,34,183,314,31,345,0,345,5,277,63,22.04.2019 00:15,64,4,Zhitomir
576,564,34,157,386,33,419,0,419,5,333,81,22.04.2019 00:15,64,4,Zhitomir
336,332,27,88,221,27,248,0,248,3,155,90,22.04.2019 00:05,64,4,Zhitomir
272,252,17,82,174,16,190,0,190,1,143,46,22.04.2019 00:10,64,4,Zhitomir
160,149,16,54,90,16,106,0,106,5,78,23,22.04.2019 02:00,64,4,Zhitomir
80,68,2,20,58,2,60,0,60,1,37,22,22.04.2019 00:20,64,4,Zhitomir
80,75,0,26,54,0,54,0,54,3,35,16,22.04.2019 00:34,64,4,Zhitomir
112,105,6,17,89,6,95,0,95,0,68,27,22.04.2019 00:50,64,4,Zhitomir
256,241,24,89,145,22,167,0,167,1,112,54,22.04.2019 00:05,64,4,Zhitomir
288,279,11,109,172,7,179,0,179,0,144,35,22.04.2019 01:00,64,4,Zhitomir
528,513,13,247,269,12,281,0,281,2,224,55,22.04.2019 00:30,64,4,Zhitomir
656,636,15,315,326,15,341,0,341,14,272,55,22.04.2019 01:10,64,4,Zhitomir
623,588,11,268,345,10,355,0,355,7,229,119,22.04.2019 00:30,64,4,Zhitomir
225,286,18,63,145,17,162,0,162,2,115,45,22.04.2019 00:15,64,4,Zhitomir
224,215,9,82,133,9,142,0,142,2,103,37,22.04.2019 00:35,64,4,Zhitomir
160,146,6,68,86,6,92,0,92,2,66,24,22.04.2019 00:00,64,4,Zhitomir
112,101,13,46,53,13,66,0,66,1,41,24,22.04.2019 00:31,64,4,Zhitomir
48,40,2,27,19,2,21,0,21,0,13,8,22.04.2019 00:10,64,4,Zhitomir
816,794,57,349,412,55,467,0,467,6,324,137,22.04.2019 00:30,64,4,Zhitomir
64,69,5,34,25,5,30,0,30,1,24,5,22.04.2019 00:10,64,4,Zhitomir
224,217,24,84,118,22,140,0,140,2,107,31,22.04.2019 00:30,64,4,Zhitomir
208,191,13,76,120,12,132,0,132,0,97,35,22.04.2019 00:05,64,4,Zhitomir
128,117,8,37,84,7,91,0,91,2,45,44,22.04.2019 00:20,64,4,Zhitomir
256,247,26,73,161,22,183,0,183,0,145,38,22.04.2019 00:30,64,4,Zhitomir
480,471,22,202,256,22,278,0,278,3,213,62,22.04.2019 00:18,64,4,Zhitomir
192,183,22,79,91,22,113,0,113,1,66,46,22.04.2019 00:20,64,4,Zhitomir
640,627,7,360,273,7,280,0,280,2,204,74,22.04.2019 00:24,64,4,Zhitomir
272,257,7,120,147,5,152,0,152,0,136,16,22.04.2019 00:30,64,4,Zhitomir
128,119,5,57,66,5,71,0,71,1,57,13,22.04.2019 00:15,64,4,Zhitomir
208,47,15,166,29,13,42,0,42,1,30,11,22.04.2019 00:46,64,4,Zhitomir
80,20,4,61,15,4,19,0,19,0,11,8,22.04.2019 00:05,64,4,Zhitomir
128,76,1,84,43,1,44,0,44,1,29,14,22.04.2019 00:10,64,4,Zhitomir
608,591,17,290,302,16,318,0,318,3,226,89,22.04.2019 00:25,64,4,Zhitomir
432,421,2,219,212,1,213,0,213,0,142,71,22.04.2019 00:00,64,4,Zhitomir
144,132,1,46,97,1,98,0,98,2,75,21,22.04.2019 00:30,64,4,Zhitomir
1328,1287,2,718,608,2,610,0,610,10,491,109,22.04.2019 00:15,64,4,Zhitomir
1104,1087,0,590,514,0,514,0,514,14,375,125,22.04.2019 00:17,64,4,Zhitomir
48,43,0,19,29,0,29,0,29,0,13,16,22.04.2019 00:40,64,4,Zhitomir
80,71,1,33,47,0,47,0,47,2,14,31,22.04.2019 00:32,64,4,Zhitomir
400,386,0,201,199,0,199,0,199,2,166,31,22.04.2019 00:10,64,4,Zhitomir
736,733,2,301,433,2,435,0,435,4,353,78,22.04.2019 00:03,64,4,Zhitomir
144,137,0,57,87,0,87,0,87,1,73,13,22.04.2019 00:17,64,4,Zhitomir
1200,1177,18,584,598,18,616,0,616,11,505,100,22.04.2019 00:15,64,4,Zhitomir
208,207,0,41,167,0,167,0,167,7,133,27,22.04.2019 00:15,64,4,Zhitomir
256,242,1,95,160,1,161,0,161,2,100,59,22.04.2019 01:30,64,4,Zhitomir
192,179,8,64,120,8,128,0,128,4,107,17,22.04.2019 00:45,64,4,Zhitomir
272,255,0,115,157,0,157,0,157,1,127,29,22.04.2019 00:50,64,4,Zhitomir
160,149,0,58,102,0,102,0,102,0,69,33,22.04.2019 00:17,64,4,Zhitomir
112,105,0,37,75,0,75,0,75,0,62,13,22.04.2019 01:15,64,4,Zhitomir
128,114,7,46,75,7,82,0,82,1,63,18,22.04.2019 00:20,64,4,Zhitomir
944,909,27,399,520,25,545,0,545,4,417,124,22.04.2019 00:15,64,4,Zhitomir
288,274,2,146,140,2,142,0,142,3,105,34,22.04.2019 00:57,64,4,Zhitomir
448,444,1,155,292,1,293,0,293,5,220,68,22.04.2019 01:25,64,4,Zhitomir
48,42,0,24,24,0,24,0,24,0,14,10,22.04.2019 01:15,64,4,Zhitomir
464,460,1,234,229,1,230,0,230,5,177,48,22.04.2019 02:00,64,4,Zhitomir
1395,1471,2,529,864,2,866,0,866,18,682,166,22.04.2019 01:10,64,4,Zhitomir
1664,1633,7,730,928,6,934,0,934,18,751,165,22.04.2019 01:30,64,4,Zhitomir
176,21,9,159,11,6,17,0,17,0,12,5,22.04.2019 00:20,64,4,Zhitomir
640,613,3,294,343,3,346,0,346,4,295,47,22.04.2019 00:10,64,4,Zhitomir
736,720,6,332,402,2,404,0,404,14,324,66,22.04.2019 00:52,64,4,Zhitomir
2256,2218,29,895,1340,21,1361,0,1361,37,1061,263,22.04.2019 00:20,64,4,Zhitomir
1872,1848,14,761,1101,10,1111,0,1111,27,915,169,22.04.2019 00:15,64,4,Zhitomir
1424,1401,147,529,761,134,895,0,895,25,692,178,22.04.2019 00:34,64,4,Zhitomir
1952,1926,19,701,1238,13,1251,0,1251,28,1036,187,22.04.2019 00:15,64,4,Zhitomir
2256,2224,27,808,1424,24,1448,0,1448,31,1172,245,22.04.2019 00:01,64,4,Zhitomir
1568,1558,23,599,949,20,969,0,969,22,777,170,22.04.2019 00:05,64,4,Zhitomir
2144,2102,19,830,1299,15,1314,0,1314,22,1060,232,22.04.2019 00:46,64,4,Zhitomir
720,713,10,253,459,8,467,0,467,10,373,84,22.04.2019 00:20,64,4,Zhitomir
1392,1376,13,504,878,10,888,0,888,34,689,165,22.04.2019 00:20,64,4,Zhitomir
1952,1926,19,726,1209,17,1226,0,1226,15,1007,204,22.04.2019 00:20,64,4,Zhitomir
1424,1396,5,580,841,3,844,0,844,19,691,134,22.04.2019 00:15,64,4,Zhitomir
1792,1748,10,706,1078,8,1086,0,1086,30,864,192,22.04.2019 00:11,64,4,Zhitomir
1584,1551,15,598,975,11,986,0,986,29,736,221,22.04.2019 00:03,64,4,Zhitomir
2032,1995,25,745,1267,20,1287,0,1287,32,1026,229,22.04.2019 00:25,64,4,Zhitomir
1952,1929,19,678,1264,10,1274,0,1274,28,1025,221,22.04.2019 00:33,64,4,Zhitomir
1536,1515,19,578,941,17,958,0,958,40,774,144,22.04.2019 00:10,64,4,Zhitomir
2016,1996,10,806,1202,8,1210,0,1210,31,993,186,22.04.2019 00:01,64,4,Zhitomir
2096,2072,17,907,1180,9,1189,0,1189,37,1003,149,22.04.2019 01:00,64,4,Zhitomir
2208,2182,13,958,1239,11,1250,0,1250,22,1022,206,22.04.2019 00:35,64,4,Zhitomir
1376,1348,9,597,774,5,779,0,779,12,637,130,22.04.2019 00:26,64,4,Zhitomir
1360,1337,9,551,803,6,809,0,809,26,663,120,22.04.2019 00:42,64,4,Zhitomir
1616,1559,11,668,940,8,948,0,948,20,775,153,22.04.2019 00:30,64,4,Zhitomir
1408,1379,18,655,736,17,753,0,753,10,627,116,22.04.2019 00:00,64,4,Zhitomir
1488,1476,10,660,820,8,828,0,828,13,680,135,22.04.2019 00:15,64,4,Zhitomir
896,877,5,387,506,3,509,0,509,11,423,75,22.04.2019 00:10,64,4,Zhitomir
1104,1076,9,461,637,6,643,0,643,18,544,81,22.04.2019 00:05,64,4,Zhitomir
400,381,5,185,210,5,215,0,215,4,174,37,22.04.2019 00:02,64,4,Zhitomir
368,62,34,312,24,32,56,0,56,2,47,7,22.04.2019 00:30,64,4,Zhitomir
128,35,18,96,16,16,32,0,32,0,23,9,22.04.2019 00:34,64,4,Zhitomir
864,779,0,185,679,0,679,0,679,28,617,34,22.04.2019 00:00,64,4,Zhitomir
80,73,0,35,45,0,45,0,45,0,27,18,22.04.2019 01:15,64,4,Zhitomir
368,354,24,155,189,24,213,0,213,6,169,38,22.04.2019 00:30,65,4,Zhitomir
112,108,11,46,55,11,66,0,66,2,49,15,22.04.2019 00:30,65,4,Zhitomir
80,63,1,30,49,1,50,0,50,0,35,15,22.04.2019 00:30,65,4,Zhitomir
48,40,1,19,28,1,29,0,29,0,24,5,22.04.2019 00:20,65,4,Zhitomir
320,301,16,128,177,15,192,0,192,2,152,38,22.04.2019 01:05,65,4,Zhitomir
256,242,30,104,128,24,152,0,152,2,98,52,22.04.2019 00:30,65,4,Zhitomir
96,84,12,45,43,8,51,0,51,1,33,17,22.04.2019 00:10,65,4,Zhitomir
432,411,18,199,216,17,233,0,233,2,163,68,22.04.2019 00:22,65,4,Zhitomir
112,101,4,51,57,4,61,0,61,5,36,20,22.04.2019 00:20,65,4,Zhitomir
48,46,0,5,43,0,43,0,43,0,18,25,22.04.2019 00:02,65,4,Zhitomir
96,83,1,63,33,0,33,0,33,0,12,21,21.04.2019 20:35,65,4,Zhitomir
176,33,19,150,12,14,26,0,26,0,20,6,22.04.2019 01:40,65,4,Zhitomir
224,213,16,91,117,16,133,0,133,0,95,38,22.04.2019 00:07,65,4,Zhitomir
288,274,17,72,199,17,216,0,216,2,147,67,22.04.2019 00:10,65,4,Zhitomir
976,955,42,417,517,42,559,0,559,8,385,166,22.04.2019 00:30,65,4,Zhitomir
144,140,7,69,70,5,75,0,75,2,52,21,22.04.2019 00:03,65,4,Zhitomir
816,807,43,407,366,43,409,0,409,4,301,104,22.04.2019 00:15,65,4,Zhitomir
256,245,16,112,131,13,144,0,144,9,77,58,22.04.2019 00:10,65,4,Zhitomir
288,273,9,116,163,9,172,0,172,4,128,40,22.04.2019 00:24,65,4,Zhitomir
208,206,17,84,107,17,124,0,124,0,93,31,22.04.2019 00:10,65,4,Zhitomir
416,404,29,172,217,27,244,0,244,8,146,90,22.04.2019 00:10,65,4,Zhitomir
624,607,27,237,360,27,387,0,387,5,301,81,22.04.2019 00:10,65,4,Zhitomir
352,343,34,184,134,34,168,0,168,1,111,56,22.04.2019 00:10,65,4,Zhitomir
144,137,5,50,89,5,94,0,94,2,55,37,22.04.2019 00:03,65,4,Zhitomir
208,194,11,97,100,11,111,0,111,0,78,33,22.04.2019 00:20,65,4,Zhitomir
240,238,7,60,173,7,180,0,180,2,116,62,22.04.2019 00:17,65,4,Zhitomir
240,221,1,114,125,1,126,0,126,2,97,27,22.04.2019 00:14,65,4,Zhitomir
576,561,33,262,282,32,314,0,314,6,197,111,22.04.2019 00:15,65,4,Zhitomir
800,790,18,291,491,18,509,0,509,6,390,113,22.04.2019 00:15,65,4,Zhitomir
496,497,27,236,233,27,260,0,260,5,162,93,22.04.2019 00:05,65,4,Zhitomir
352,344,24,132,197,23,220,0,220,3,158,59,22.04.2019 00:35,65,4,Zhitomir
640,614,44,264,332,44,376,0,376,11,241,124,22.04.2019 01:45,65,4,Zhitomir
128,126,2,53,73,2,75,0,75,2,54,19,22.04.2019 00:35,65,4,Zhitomir
144,143,5,59,80,5,85,0,85,0,49,36,22.04.2019 00:55,65,4,Zhitomir
112,101,1,57,54,1,55,0,55,0,35,20,22.04.2019 00:45,65,4,Zhitomir
208,195,6,98,105,5,110,0,110,2,74,34,21.04.2019 23:25,65,4,Zhitomir
64,55,8,13,43,8,51,0,51,0,39,12,22.04.2019 00:16,65,4,Zhitomir
160,154,3,58,99,3,102,0,102,3,68,31,22.04.2019 00:05,65,4,Zhitomir
304,289,12,103,189,12,201,0,201,5,168,28,22.04.2019 00:35,65,4,Zhitomir
528,508,22,247,259,22,281,0,281,4,226,51,22.04.2019 00:20,65,4,Zhitomir
128,20,2,108,18,2,20,0,20,0,13,7,22.04.2019 00:40,65,4,Zhitomir
2160,2055,10,810,1340,10,1350,0,1350,29,1013,308,22.04.2019 00:35,65,4,Zhitomir
1104,1088,23,483,598,23,621,0,621,16,456,149,22.04.2019 00:41,65,4,Zhitomir
2288,2245,36,995,1266,27,1293,0,1293,21,970,302,22.04.2019 00:09,65,4,Zhitomir
1888,1848,24,758,1108,22,1130,0,1130,18,877,235,22.04.2019 00:10,65,4,Zhitomir
1504,1456,24,624,865,15,880,0,880,30,642,208,22.04.2019 00:45,65,4,Zhitomir
2048,2013,19,826,1208,14,1222,0,1222,30,870,322,22.04.2019 00:10,65,4,Zhitomir
1872,1825,15,688,1174,10,1184,0,1184,24,797,363,22.04.2019 00:10,65,4,Zhitomir
848,821,16,390,443,15,458,0,458,15,340,103,22.04.2019 00:45,65,4,Zhitomir
400,237,102,204,108,88,196,0,196,4,143,49,22.04.2019 00:10,65,4,Zhitomir
1104,1110,19,567,523,14,537,0,537,15,336,186,22.04.2019 02:30,66,4,Zhitomir
320,323,23,120,177,23,200,0,200,1,137,62,22.04.2019 00:02,66,4,Zhitomir
176,191,25,39,112,25,137,0,137,1,98,38,22.04.2019 00:30,66,4,Zhitomir
224,220,17,94,114,16,130,0,130,1,77,52,22.04.2019 00:02,66,4,Zhitomir
288,285,25,107,160,21,181,0,181,0,119,62,22.04.2019 00:10,66,4,Zhitomir
544,535,22,233,292,19,311,0,311,9,223,79,22.04.2019 00:15,66,4,Zhitomir
160,155,3,57,100,3,103,0,103,3,58,42,22.04.2019 00:10,66,4,Zhitomir
192,185,3,85,106,1,107,0,107,0,84,23,22.04.2019 00:10,66,4,Zhitomir
208,204,9,89,110,9,119,0,119,0,86,33,22.04.2019 00:10,66,4,Zhitomir
560,555,39,264,262,34,296,0,296,4,221,71,22.04.2019 02:05,66,4,Zhitomir
400,394,19,157,224,19,243,0,243,10,175,58,22.04.2019 00:05,66,4,Zhitomir
144,145,12,39,93,12,105,0,105,3,84,18,22.04.2019 00:09,66,4,Zhitomir
288,276,25,111,159,18,177,0,177,4,120,53,22.04.2019 00:01,66,4,Zhitomir
64,69,3,11,50,3,53,0,53,2,36,15,22.04.2019 02:00,66,4,Zhitomir
112,114,12,37,63,12,75,0,75,0,41,34,22.04.2019 00:05,66,4,Zhitomir
224,238,25,65,135,24,159,0,159,2,117,40,22.04.2019 00:26,66,4,Zhitomir
80,30,20,50,10,20,30,0,30,4,20,6,22.04.2019 00:15,66,4,Zhitomir
1232,1210,18,526,693,13,706,0,706,16,519,171,22.04.2019 00:45,66,4,Zhitomir
304,299,24,114,170,20,190,0,190,2,116,72,22.04.2019 00:15,66,4,Zhitomir
448,431,16,154,279,15,294,0,294,0,187,107,22.04.2019 00:30,66,4,Zhitomir
528,518,20,267,245,16,261,0,261,5,204,52,22.04.2019 00:50,66,4,Zhitomir
336,320,16,167,157,12,169,0,169,2,95,72,22.04.2019 00:37,66,4,Zhitomir
192,183,9,74,109,9,118,0,118,1,97,20,22.04.2019 00:20,66,4,Zhitomir
224,203,13,103,109,12,121,0,121,3,98,20,22.04.2019 00:05,66,4,Zhitomir
288,286,22,125,148,15,163,0,163,4,116,43,22.04.2019 00:02,66,4,Zhitomir
160,148,12,77,73,10,83,0,83,1,60,22,22.04.2019 00:15,66,4,Zhitomir
320,311,29,139,156,25,181,0,181,3,156,22,22.04.2019 00:20,66,4,Zhitomir
256,252,40,108,111,37,148,0,148,3,98,47,21.04.2019 23:30,66,4,Zhitomir
144,41,12,105,28,11,39,0,39,0,20,19,22.04.2019 00:25,66,4,Zhitomir
128,117,17,48,66,14,80,0,80,0,60,20,22.04.2019 01:05,66,4,Zhitomir
64,63,9,25,31,8,39,0,39,0,10,29,22.04.2019 00:15,66,4,Zhitomir
128,115,12,52,66,10,76,0,76,2,51,23,22.04.2019 00:15,66,4,Zhitomir
112,109,19,37,56,19,75,0,75,1,54,20,22.04.2019 00:30,66,4,Zhitomir
240,229,4,103,136,1,137,0,137,3,102,32,22.04.2019 00:45,66,4,Zhitomir
192,187,6,59,128,5,133,0,133,1,93,39,22.04.2019 00:05,66,4,Zhitomir
416,411,18,181,217,18,235,0,235,3,173,59,22.04.2019 00:05,66,4,Zhitomir
224,227,13,74,137,13,150,0,150,1,101,48,22.04.2019 00:15,66,4,Zhitomir
192,178,14,94,84,14,98,0,98,0,61,37,22.04.2019 00:15,66,4,Zhitomir
256,240,9,141,108,7,115,0,115,0,79,36,22.04.2019 00:15,66,4,Zhitomir
448,435,25,187,236,25,261,0,261,2,181,78,22.04.2019 00:15,66,4,Zhitomir
304,300,16,129,160,15,175,0,175,2,128,45,22.04.2019 00:10,66,4,Zhitomir
112,95,5,43,64,5,69,0,69,0,36,33,22.04.2019 00:15,66,4,Zhitomir
336,322,36,106,195,35,230,0,230,7,155,68,22.04.2019 00:15,66,4,Zhitomir
144,130,11,54,79,11,90,0,90,1,69,20,22.04.2019 00:02,66,4,Zhitomir
240,224,10,91,140,9,149,0,149,1,108,40,22.04.2019 00:15,66,4,Zhitomir
96,90,6,42,48,6,54,0,54,0,29,25,22.04.2019 01:50,66,4,Zhitomir
144,135,8,65,71,8,79,0,79,3,46,30,22.04.2019 00:05,66,4,Zhitomir
96,82,0,51,45,0,45,0,45,3,27,15,22.04.2019 00:15,66,4,Zhitomir
288,283,19,106,163,19,182,0,182,4,128,50,22.04.2019 00:18,66,4,Zhitomir
112,101,11,34,67,11,78,0,78,0,67,11,22.04.2019 00:10,66,4,Zhitomir
544,534,48,239,257,48,305,0,305,1,243,61,22.04.2019 00:07,66,4,Zhitomir
304,310,23,90,192,22,214,0,214,1,146,67,22.04.2019 00:03,66,4,Zhitomir
224,224,12,96,116,12,128,0,128,0,77,51,22.04.2019 00:02,66,4,Zhitomir
720,713,8,272,442,6,448,0,448,6,311,131,22.04.2019 00:50,66,4,Zhitomir
208,195,15,92,101,15,116,0,116,1,80,35,22.04.2019 00:30,66,4,Zhitomir
176,172,14,71,91,14,105,0,105,0,81,24,22.04.2019 00:00,66,4,Zhitomir
160,159,14,78,71,11,82,0,82,0,53,29,22.04.2019 00:03,66,4,Zhitomir
160,160,24,86,53,21,74,0,74,2,45,27,22.04.2019 00:15,66,4,Zhitomir
416,408,41,157,221,38,259,0,259,3,187,69,22.04.2019 00:35,66,4,Zhitomir
144,135,7,48,89,7,96,0,96,0,76,20,22.04.2019 00:05,66,4,Zhitomir
416,415,22,145,249,22,271,0,271,6,203,62,22.04.2019 00:20,66,4,Zhitomir
240,223,5,100,137,3,140,0,140,4,98,38,22.04.2019 01:25,66,4,Zhitomir
144,144,14,52,78,14,92,0,92,1,57,34,22.04.2019 00:02,66,4,Zhitomir
640,630,39,259,342,39,381,0,381,8,252,121,22.04.2019 00:01,66,4,Zhitomir
208,207,24,71,114,23,137,0,137,4,81,52,22.04.2019 00:16,66,4,Zhitomir
496,480,23,213,260,23,283,0,283,6,199,78,22.04.2019 00:15,66,4,Zhitomir
48,14,0,34,14,0,14,0,14,1,7,6,22.04.2019 00:05,66,4,Zhitomir
1936,1934,9,879,1049,8,1057,0,1057,28,894,135,22.04.2019 00:05,66,4,Zhitomir
176,162,0,79,97,0,97,0,97,0,76,21,21.04.2019 21:35,66,4,Zhitomir
352,338,0,171,181,0,181,0,181,11,129,41,22.04.2019 00:15,66,4,Zhitomir
96,94,0,50,46,0,46,0,46,0,33,13,22.04.2019 00:27,66,4,Zhitomir
96,89,0,44,52,0,52,0,52,0,40,12,22.04.2019 00:15,66,4,Zhitomir
160,152,13,66,83,11,94,0,94,1,62,31,22.04.2019 00:10,66,4,Zhitomir
272,259,6,158,108,6,114,0,114,2,72,40,22.04.2019 00:05,66,4,Zhitomir
288,273,1,111,176,1,177,0,177,0,138,39,22.04.2019 00:10,66,4,Zhitomir
176,168,11,57,108,11,119,0,119,0,73,46,22.04.2019 00:15,66,4,Zhitomir
240,219,1,112,127,1,128,0,128,5,91,32,22.04.2019 00:10,66,4,Zhitomir
160,144,0,81,79,0,79,0,79,3,44,32,22.04.2019 00:15,66,4,Zhitomir
208,193,10,75,123,10,133,0,133,2,82,49,22.04.2019 00:10,66,4,Zhitomir
224,209,13,81,130,13,143,0,143,4,111,28,22.04.2019 00:05,66,4,Zhitomir
336,342,8,149,179,8,187,0,187,1,157,29,22.04.2019 00:10,66,4,Zhitomir
192,183,4,72,116,4,120,0,120,1,97,22,21.04.2019 21:12,66,4,Zhitomir
192,182,14,69,109,14,123,0,123,2,99,22,22.04.2019 00:20,66,4,Zhitomir
64,21,8,45,12,7,19,0,19,0,16,3,22.04.2019 00:15,66,4,Zhitomir
1216,1204,8,563,647,6,653,0,653,18,442,193,22.04.2019 01:00,66,4,Zhitomir
1232,1214,1,540,691,1,692,0,692,18,523,151,22.04.2019 01:20,66,4,Zhitomir
480,458,2,210,268,2,270,0,270,5,173,92,22.04.2019 00:15,66,4,Zhitomir
160,151,11,53,96,11,107,0,107,5,68,34,22.04.2019 00:07,66,4,Zhitomir
528,521,39,191,298,39,337,0,337,6,191,140,22.04.2019 00:20,66,4,Zhitomir
608,589,30,212,368,28,396,0,396,8,248,140,22.04.2019 00:10,66,4,Zhitomir
192,182,16,89,88,15,103,0,103,0,60,43,22.04.2019 00:15,66,4,Zhitomir
432,422,30,154,251,27,278,0,278,8,179,91,22.04.2019 00:20,66,4,Zhitomir
1040,1023,38,473,529,38,567,0,567,11,369,187,22.04.2019 01:10,66,4,Zhitomir
80,66,7,34,39,7,46,0,46,2,28,16,22.04.2019 01:35,66,4,Zhitomir
64,61,6,24,34,6,40,0,40,1,20,19,22.04.2019 00:15,66,4,Zhitomir
352,340,35,176,141,35,176,0,176,3,105,68,22.04.2019 00:20,66,4,Zhitomir
464,452,27,211,229,24,253,0,253,5,165,83,22.04.2019 00:20,66,4,Zhitomir
320,315,34,101,187,32,219,0,219,2,97,120,22.04.2019 00:30,66,4,Zhitomir
496,499,46,217,235,44,279,0,279,5,174,100,22.04.2019 00:25,66,4,Zhitomir
688,671,59,273,356,59,415,0,415,8,310,97,22.04.2019 00:08,66,4,Zhitomir
208,198,34,63,111,34,145,0,145,1,76,68,22.04.2019 00:05,66,4,Zhitomir
1024,1005,4,501,519,4,523,0,523,17,369,137,22.04.2019 00:12,66,4,Zhitomir
209,198,7,90,112,7,119,0,119,6,75,38,22.04.2019 00:10,66,4,Zhitomir
512,495,11,240,261,11,272,0,272,6,193,73,22.04.2019 00:15,66,4,Zhitomir
160,144,5,89,66,5,71,0,71,1,45,25,22.04.2019 00:10,66,4,Zhitomir
64,64,4,26,34,4,38,0,38,0,20,18,22.04.2019 00:02,66,4,Zhitomir
160,158,6,68,86,6,92,0,92,3,43,46,22.04.2019 00:10,66,4,Zhitomir
80,77,18,23,39,18,57,0,57,1,23,33,22.04.2019 00:15,66,4,Zhitomir
288,268,19,129,140,19,159,0,159,3,110,46,22.04.2019 00:10,66,4,Zhitomir
80,67,6,38,36,6,42,0,42,0,29,13,22.04.2019 00:06,66,4,Zhitomir
352,349,23,132,197,23,220,0,220,4,107,109,21.04.2019 20:40,66,4,Zhitomir
144,129,15,44,85,15,100,0,100,2,62,36,22.04.2019 00:58,66,4,Zhitomir
208,197,23,85,100,23,123,0,123,1,62,60,22.04.2019 01:02,66,4,Zhitomir
416,417,50,128,241,47,288,0,288,5,145,138,22.04.2019 00:15,66,4,Zhitomir
144,17,1,127,16,1,17,0,17,0,11,6,22.04.2019 00:15,66,4,Zhitomir
1792,1750,12,769,1013,10,1023,0,1023,26,800,197,22.04.2019 00:10,66,4,Zhitomir
432,415,8,201,223,8,231,0,231,5,174,52,22.04.2019 00:35,66,4,Zhitomir
928,905,18,373,538,17,555,0,555,7,389,159,22.04.2019 00:15,66,4,Zhitomir
384,374,23,109,253,22,275,0,275,4,121,150,22.04.2019 02:40,66,4,Zhitomir
512,491,43,245,231,36,267,0,267,7,190,70,22.04.2019 02:13,66,4,Zhitomir
160,150,16,60,84,16,100,0,100,1,64,35,22.04.2019 00:20,66,4,Zhitomir
784,766,39,400,346,38,384,0,384,8,246,130,22.04.2019 00:40,66,4,Zhitomir
480,472,14,262,206,12,218,0,218,1,140,77,22.04.2019 00:15,66,4,Zhitomir
256,243,10,104,146,6,152,0,152,4,88,60,22.04.2019 00:40,66,4,Zhitomir
320,309,17,121,184,15,199,0,199,3,130,66,22.04.2019 01:00,66,4,Zhitomir
176,167,8,70,98,8,106,0,106,2,62,42,22.04.2019 00:10,66,4,Zhitomir
288,282,18,120,151,17,168,0,168,3,117,48,22.04.2019 00:15,66,4,Zhitomir
496,478,44,217,242,37,279,0,279,9,199,71,22.04.2019 00:45,66,4,Zhitomir
240,226,14,99,129,12,141,0,141,0,85,56,22.04.2019 00:10,66,4,Zhitomir
160,159,21,43,100,17,117,0,117,0,92,25,22.04.2019 00:10,66,4,Zhitomir
304,292,19,121,166,17,183,0,183,5,110,68,22.04.2019 00:45,66,4,Zhitomir
112,100,1,56,55,1,56,0,56,0,37,19,22.04.2019 00:10,66,4,Zhitomir
256,249,0,135,121,0,121,0,121,2,94,25,22.04.2019 00:45,66,4,Zhitomir
160,151,8,65,88,7,95,0,95,3,69,23,22.04.2019 00:10,66,4,Zhitomir
224,217,7,107,112,5,117,0,117,2,84,31,22.04.2019 00:20,66,4,Zhitomir
176,172,2,79,95,2,97,0,97,2,68,27,22.04.2019 01:15,66,4,Zhitomir
400,395,33,170,199,31,230,0,230,5,158,67,22.04.2019 00:10,66,4,Zhitomir
144,35,9,118,18,8,26,0,26,1,16,9,22.04.2019 00:15,66,4,Zhitomir
2400,2371,14,922,1466,12,1478,0,1478,38,1106,334,22.04.2019 00:20,66,4,Zhitomir
2192,2172,4,884,1304,4,1308,0,1308,32,916,360,22.04.2019 00:18,66,4,Zhitomir
2080,2042,10,790,1281,9,1290,0,1290,31,829,430,22.04.2019 00:05,66,4,Zhitomir
1824,1784,22,741,1068,15,1083,0,1083,20,718,345,22.04.2019 00:05,66,4,Zhitomir
2368,2355,20,884,1467,17,1484,0,1484,39,1001,444,22.04.2019 00:40,66,4,Zhitomir
2368,2334,7,947,1415,6,1421,0,1421,32,1018,371,22.04.2019 00:45,66,4,Zhitomir
224,19,2,206,16,2,18,0,18,0,9,9,22.04.2019 00:04,66,4,Zhitomir
208,206,19,78,113,17,130,0,130,4,92,34,22.04.2019 00:17,67,4,Zhitomir
1696,1670,17,665,1017,14,1031,0,1031,22,783,226,22.04.2019 01:30,67,4,Zhitomir
128,116,0,68,60,0,60,0,60,2,41,17,22.04.2019 00:15,67,4,Zhitomir
352,333,16,151,185,16,201,0,201,5,138,58,22.04.2019 01:20,67,4,Zhitomir
384,366,9,191,184,9,193,0,193,1,140,52,22.04.2019 00:03,67,4,Zhitomir
1312,1278,13,592,711,9,720,0,720,14,572,134,22.04.2019 00:18,67,4,Zhitomir
320,297,21,158,141,21,162,0,162,3,112,47,22.04.2019 00:20,67,4,Zhitomir
976,967,26,381,572,23,595,0,595,20,443,132,22.04.2019 00:10,67,4,Zhitomir
192,185,35,17,140,35,175,0,175,16,87,72,22.04.2019 00:15,67,4,Zhitomir
608,594,30,265,321,22,343,0,343,7,276,60,22.04.2019 01:15,67,4,Zhitomir
528,516,1,206,321,1,322,0,322,9,267,46,21.04.2019 23:20,67,4,Zhitomir
1520,1499,70,673,786,61,847,0,847,16,660,171,22.04.2019 02:15,67,4,Zhitomir
384,366,25,149,216,19,235,0,235,0,181,54,21.04.2019 20:50,67,4,Zhitomir
2352,2328,15,1060,1278,14,1292,0,1292,27,956,309,22.04.2019 00:15,67,4,Zhitomir
528,523,2,151,377,0,377,0,377,9,284,84,22.04.2019 00:15,67,4,Zhitomir
512,501,25,204,284,24,308,0,308,1,209,98,22.04.2019 02:00,67,4,Zhitomir
1072,1045,85,337,654,81,735,0,735,22,530,183,22.04.2019 01:10,67,4,Zhitomir
384,377,24,81,279,24,303,0,303,4,221,78,22.04.2019 00:45,67,4,Zhitomir
560,542,24,237,299,24,323,0,323,5,199,119,22.04.2019 00:10,67,4,Zhitomir
944,975,8,338,600,6,606,0,606,22,441,143,22.04.2019 00:05,67,4,Zhitomir
1920,1890,5,703,1212,5,1217,0,1217,32,990,195,22.04.2019 00:28,67,4,Zhitomir
576,566,43,264,273,39,312,0,312,10,231,71,22.04.2019 00:50,67,4,Zhitomir
1088,1063,74,263,751,74,825,0,825,22,655,148,22.04.2019 01:00,67,4,Zhitomir
144,141,21,35,88,21,109,0,109,1,67,41,22.04.2019 02:00,67,4,Zhitomir
656,635,23,250,386,20,406,0,406,14,331,61,22.04.2019 00:32,67,4,Zhitomir
256,243,19,117,120,19,139,0,139,4,113,22,22.04.2019 00:46,67,4,Zhitomir
480,324,41,208,234,38,272,0,272,18,181,73,22.04.2019 00:44,67,4,Zhitomir
1696,1664,15,683,1001,12,1013,0,1013,27,789,197,21.04.2019 22:45,67,4,Zhitomir
656,636,27,276,356,24,380,0,380,8,249,123,21.04.2019 21:33,67,4,Zhitomir
448,434,33,126,292,30,322,0,322,1,237,84,21.04.2019 22:30,67,4,Zhitomir
416,404,47,106,267,43,310,0,310,10,233,67,22.04.2019 00:30,67,4,Zhitomir
160,155,11,59,90,11,101,0,101,2,83,16,22.04.2019 00:15,67,4,Zhitomir
608,588,29,277,303,28,331,0,331,11,199,121,22.04.2019 00:20,67,4,Zhitomir
544,532,54,196,296,52,348,0,348,9,258,81,22.04.2019 00:50,67,4,Zhitomir
464,451,34,209,233,22,255,0,255,2,185,68,22.04.2019 00:04,67,4,Zhitomir
144,137,11,50,84,10,94,0,94,1,49,44,21.04.2019 22:35,67,4,Zhitomir
336,331,24,106,209,21,230,0,230,4,153,73,22.04.2019 00:10,67,4,Zhitomir
176,173,173,68,105,3,108,0,108,2,85,21,22.04.2019 01:10,67,4,Zhitomir
384,365,26,168,196,20,216,0,216,1,137,78,22.04.2019 00:40,67,4,Zhitomir
720,709,28,316,378,26,404,0,404,9,325,70,22.04.2019 00:18,67,4,Zhitomir
624,610,30,115,480,29,509,0,509,18,307,184,21.04.2019 20:40,67,4,Zhitomir
352,342,22,141,191,20,211,0,211,1,163,47,21.04.2019 20:30,67,4,Zhitomir
656,597,59,240,363,53,416,0,416,4,289,123,22.04.2019 00:10,67,4,Zhitomir
176,162,14,57,108,11,119,0,119,4,68,47,21.04.2019 23:15,67,4,Zhitomir
240,235,18,108,119,13,132,0,132,2,103,27,22.04.2019 00:35,67,4,Zhitomir
96,94,8,39,52,5,57,0,57,1,32,24,22.04.2019 00:12,67,4,Zhitomir
1024,1015,76,389,577,58,635,0,635,10,466,159,22.04.2019 00:15,67,4,Zhitomir
464,454,41,176,250,38,288,0,288,7,181,100,22.04.2019 01:22,67,4,Zhitomir
1152,1138,28,484,647,21,668,0,668,8,516,144,22.04.2019 00:15,67,4,Zhitomir
1200,1181,2,561,637,2,639,0,639,12,507,120,21.04.2019 23:15,67,4,Zhitomir
288,272,22,98,171,19,190,0,190,1,124,65,22.04.2019 00:25,67,4,Zhitomir
784,770,54,360,377,47,424,0,424,8,309,107,22.04.2019 00:30,67,4,Zhitomir
240,237,13,79,149,12,161,0,161,5,104,52,22.04.2019 01:26,67,4,Zhitomir
432,424,40,182,215,35,250,0,250,2,190,58,21.04.2019 20:30,67,4,Zhitomir
896,888,19,334,543,19,562,0,562,10,446,106,22.04.2019 00:30,67,4,Zhitomir
688,677,13,267,410,11,421,0,421,7,336,78,22.04.2019 01:25,67,4,Zhitomir
128,29,3,101,25,2,27,0,27,0,18,9,21.04.2019 22:11,67,4,Zhitomir
224,219,11,69,144,11,155,0,155,2,114,39,21.04.2019 21:20,67,4,Zhitomir
1616,1573,31,716,873,27,900,0,900,17,648,235,22.04.2019 00:20,67,4,Zhitomir
1584,1554,46,768,776,40,816,0,816,20,605,191,22.04.2019 00:25,67,4,Zhitomir
1040,1019,23,413,605,22,627,0,627,9,451,167,21.04.2019 21:54,67,4,Zhitomir
608,600,33,255,326,27,353,0,353,5,251,97,21.04.2019 21:30,67,4,Zhitomir
1072,1043,20,530,527,15,542,0,542,10,372,160,22.04.2019 00:10,67,4,Zhitomir
304,294,11,114,180,10,190,0,190,2,159,29,22.04.2019 00:27,67,4,Zhitomir
512,517,49,158,305,49,354,0,354,4,262,88,21.04.2019 20:55,67,4,Zhitomir
736,725,25,315,402,19,421,0,421,6,265,150,21.04.2019 21:22,67,4,Zhitomir
560,537,51,222,293,45,338,0,338,13,216,109,21.04.2019 21:00,67,4,Zhitomir
160,146,10,73,77,10,87,0,87,1,65,21,21.04.2019 20:30,67,4,Zhitomir
640,624,46,303,295,42,337,0,337,4,228,105,22.04.2019 00:05,67,4,Zhitomir
192,182,12,70,112,10,122,0,122,6,85,31,21.04.2019 22:30,67,4,Zhitomir
128,125,5,32,91,5,96,0,96,1,48,47,22.04.2019 00:40,67,4,Zhitomir
400,394,35,142,226,32,258,0,258,3,202,53,22.04.2019 00:12,67,4,Zhitomir
176,171,10,88,78,10,88,0,88,3,56,29,21.04.2019 22:00,67,4,Zhitomir
128,127,8,43,80,5,85,0,85,0,57,28,21.04.2019 23:15,67,4,Zhitomir
80,78,2,24,54,2,56,0,56,1,47,8,21.04.2019 20:40,67,4,Zhitomir
240,228,25,68,149,23,172,0,172,2,134,36,21.04.2019 21:30,67,4,Zhitomir
848,829,55,379,421,48,469,0,469,9,376,84,22.04.2019 00:12,67,4,Zhitomir
256,238,13,102,143,11,154,0,154,2,124,28,21.04.2019 22:20,67,4,Zhitomir
240,233,22,98,126,16,142,0,142,2,100,40,21.04.2019 20:30,67,4,Zhitomir
384,380,38,145,201,38,239,0,239,1,157,81,21.04.2019 21:00,67,4,Zhitomir
128,128,6,52,70,6,76,0,76,1,54,21,21.04.2019 22:00,67,4,Zhitomir
128,112,3,65,63,0,63,0,63,0,45,18,21.04.2019 21:45,67,4,Zhitomir
384,370,18,171,199,14,213,0,213,4,149,60,21.04.2019 21:20,67,4,Zhitomir
288,275,19,98,174,16,190,0,190,2,126,62,22.04.2019 00:20,67,4,Zhitomir
240,231,19,86,136,18,154,0,154,1,108,45,21.04.2019 21:05,67,4,Zhitomir
64,57,5,23,37,4,41,0,41,0,19,22,22.04.2019 00:08,67,4,Zhitomir
304,291,35,139,136,29,165,0,165,2,97,66,22.04.2019 00:18,67,4,Zhitomir
128,117,10,66,55,7,62,0,62,0,29,33,21.04.2019 21:20,67,4,Zhitomir
272,265,18,102,155,15,170,0,170,2,129,39,22.04.2019 00:20,67,4,Zhitomir
128,26,5,106,19,3,22,0,22,1,16,5,21.04.2019 20:35,67,4,Zhitomir
1152,1129,20,485,647,20,667,0,667,18,491,158,22.04.2019 01:10,67,4,Zhitomir
1184,1163,42,480,662,42,704,0,704,18,491,195,22.04.2019 00:45,67,4,Zhitomir
1168,1154,20,444,704,20,724,0,724,17,506,201,22.04.2019 00:15,67,4,Zhitomir
1424,1405,32,598,798,28,826,0,826,6,662,158,22.04.2019 00:25,67,4,Zhitomir
960,937,42,356,566,38,604,0,604,25,421,158,22.04.2019 00:45,67,4,Zhitomir
992,964,23,521,450,21,471,0,471,13,357,101,21.04.2019 21:10,67,4,Zhitomir
880,864,29,440,411,29,440,0,440,10,351,79,21.04.2019 22:00,67,4,Zhitomir
64,51,2,30,32,2,34,0,34,1,17,16,21.04.2019 22:30,67,4,Zhitomir
432,421,87,162,188,82,270,0,270,4,194,72,22.04.2019 00:25,67,4,Zhitomir
160,143,14,81,66,13,79,0,79,1,46,32,22.04.2019 00:18,67,4,Zhitomir
240,240,27,62,152,26,178,0,178,4,128,46,21.04.2019 23:05,67,4,Zhitomir
128,119,17,43,69,16,85,0,85,1,55,29,21.04.2019 21:15,67,4,Zhitomir
352,346,52,142,164,46,210,0,210,3,118,89,21.04.2019 22:45,67,4,Zhitomir
352,339,23,155,175,22,197,0,197,4,128,65,22.04.2019 01:20,67,4,Zhitomir
432,420,34,156,243,33,276,0,276,4,205,67,22.04.2019 00:15,67,4,Zhitomir
288,277,33,105,154,29,183,0,183,0,121,62,22.04.2019 00:09,67,4,Zhitomir
752,741,61,294,401,57,458,0,458,10,338,110,21.04.2019 21:07,67,4,Zhitomir
592,577,68,234,301,57,358,0,358,7,278,73,22.04.2019 00:20,67,4,Zhitomir
144,132,6,56,84,4,88,0,88,0,69,19,21.04.2019 21:05,67,4,Zhitomir
64,68,10,15,40,9,49,0,49,0,26,23,21.04.2019 20:25,67,4,Zhitomir
496,479,34,197,266,33,299,0,299,7,230,62,21.04.2019 23:55,67,4,Zhitomir
144,128,4,68,74,2,76,0,76,2,46,28,21.04.2019 23:20,67,4,Zhitomir
608,598,34,293,288,27,315,0,315,4,135,176,22.04.2019 00:20,67,4,Zhitomir
192,179,4,81,108,3,111,0,111,0,44,67,21.04.2019 22:40,67,4,Zhitomir
112,102,3,52,58,2,60,0,60,0,36,24,22.04.2019 00:10,67,4,Zhitomir
336,326,32,161,146,29,175,0,175,2,107,66,21.04.2019 20:40,67,4,Zhitomir
576,559,52,241,290,45,335,0,335,10,255,70,22.04.2019 00:20,67,4,Zhitomir
64,45,4,19,42,3,45,0,45,0,36,9,22.04.2019 00:05,67,4,Zhitomir
624,606,42,304,281,39,320,0,320,3,240,77,22.04.2019 00:05,67,4,Zhitomir
320,303,17,151,152,17,169,0,169,3,103,63,21.04.2019 20:50,67,4,Zhitomir
208,200,12,85,112,11,123,0,123,1,74,48,21.04.2019 20:50,67,4,Zhitomir
384,380,41,50,297,37,334,0,334,5,235,94,21.04.2019 20:30,67,4,Zhitomir
320,299,19,130,174,16,190,0,190,2,136,52,21.04.2019 21:05,67,4,Zhitomir
128,116,7,49,74,5,79,0,79,2,70,7,22.04.2019 02:20,67,4,Zhitomir
176,62,13,146,17,13,30,0,30,2,19,9,22.04.2019 00:10,67,4,Zhitomir
2320,2410,8,705,1610,5,1615,0,1615,49,1092,474,22.04.2019 00:01,67,4,Zhitomir
2128,2087,10,728,1394,6,1400,0,1400,35,1002,363,22.04.2019 00:46,67,4,Zhitomir
1728,1716,15,592,1124,12,1136,0,1136,31,886,219,22.04.2019 00:10,67,4,Zhitomir
1888,1868,9,702,1180,6,1186,0,1186,41,897,248,22.04.2019 00:40,67,4,Zhitomir
2080,1223,15,857,1211,12,1223,0,1223,38,936,249,22.04.2019 01:00,67,4,Zhitomir
1680,1673,6,651,1023,6,1029,0,1029,19,767,243,22.04.2019 00:15,67,4,Zhitomir
1728,1717,7,654,1068,6,1074,0,1074,19,801,254,22.04.2019 00:10,67,4,Zhitomir
2384,2374,7,862,1520,2,1522,0,1522,40,1166,316,22.04.2019 01:34,67,4,Zhitomir
1440,1410,12,547,884,9,893,0,893,23,668,202,22.04.2019 00:17,67,4,Zhitomir
2320,2286,20,889,1417,14,1431,0,1431,44,1064,323,22.04.2019 00:15,67,4,Zhitomir
1696,1674,21,565,1119,12,1131,0,1131,30,799,302,22.04.2019 00:15,67,4,Zhitomir
2448,2408,12,860,1578,10,1588,0,1588,43,1145,400,22.04.2019 00:35,67,4,Zhitomir
2336,2316,15,827,1498,11,1509,0,1509,37,1106,366,22.04.2019 00:30,67,4,Zhitomir
2432,2404,16,953,1470,9,1479,0,1479,44,1114,321,22.04.2019 00:07,67,4,Zhitomir
336,320,0,18,318,0,318,0,318,41,254,23,22.04.2019 00:10,68,5,Zakarpatie
464,459,6,147,315,2,317,0,317,8,245,64,22.04.2019 00:25,68,5,Zakarpatie
480,465,17,151,315,14,329,0,329,5,258,66,22.04.2019 00:03,68,5,Zakarpatie
368,349,12,132,226,10,236,0,236,2,190,44,21.04.2019 22:25,68,5,Zakarpatie
208,203,7,102,101,5,106,0,106,4,67,35,21.04.2019 21:10,68,5,Zakarpatie
240,233,8,77,156,7,163,0,163,2,125,36,21.04.2019 20:41,68,5,Zakarpatie
832,823,13,312,511,9,520,0,520,15,386,119,22.04.2019 00:30,68,5,Zakarpatie
528,533,6,178,345,5,350,0,350,6,266,78,22.04.2019 00:05,68,5,Zakarpatie
496,478,27,192,283,21,304,0,304,7,212,85,22.04.2019 00:05,68,5,Zakarpatie
96,87,1,50,45,1,46,0,46,1,32,13,21.04.2019 21:58,68,5,Zakarpatie
320,309,10,136,176,8,184,0,184,6,123,55,21.04.2019 21:00,68,5,Zakarpatie
368,364,3,146,219,3,222,0,222,5,153,64,22.04.2019 00:10,68,5,Zakarpatie
592,588,6,242,344,6,350,0,350,8,290,52,21.04.2019 22:00,68,5,Zakarpatie
464,451,9,246,209,9,218,0,218,4,178,36,21.04.2019 20:40,68,5,Zakarpatie
672,656,17,302,355,15,370,0,370,15,279,76,21.04.2019 21:40,68,5,Zakarpatie
1312,1308,6,590,717,5,722,0,722,20,556,146,21.04.2019 21:20,68,5,Zakarpatie
1168,1151,34,689,453,26,479,0,479,9,424,46,22.04.2019 00:05,68,5,Zakarpatie
224,220,0,110,114,0,114,0,114,5,101,8,22.04.2019 00:05,68,5,Zakarpatie
640,671,6,390,246,4,250,0,250,3,240,7,21.04.2019 21:30,68,5,Zakarpatie
528,521,2,362,166,0,166,0,166,4,157,5,21.04.2019 20:10,68,5,Zakarpatie
320,310,20,180,121,19,140,0,140,2,129,9,21.04.2019 20:28,68,5,Zakarpatie
2160,2148,7,1655,499,6,505,0,505,9,483,13,22.04.2019 00:20,68,5,Zakarpatie
2176,2162,9,1588,579,9,588,0,588,15,544,29,22.04.2019 00:30,68,5,Zakarpatie
304,297,3,157,144,3,147,0,147,3,119,25,21.04.2019 22:40,68,5,Zakarpatie
480,462,4,279,198,3,201,0,201,2,172,27,21.04.2019 23:00,68,5,Zakarpatie
400,388,11,191,198,11,209,0,209,4,189,16,21.04.2019 21:30,68,5,Zakarpatie
192,185,4,93,95,4,99,0,99,3,84,12,21.04.2019 21:10,68,5,Zakarpatie
336,321,16,157,166,13,179,0,179,6,161,12,21.04.2019 20:15,68,5,Zakarpatie
496,480,23,292,188,16,204,0,204,2,186,16,21.04.2019 21:12,68,5,Zakarpatie
1936,1938,4,749,1184,3,1187,0,1187,38,791,358,22.04.2019 00:25,68,5,Zakarpatie
800,805,0,492,308,0,308,0,308,10,215,83,22.04.2019 00:04,68,5,Zakarpatie
1536,1543,0,650,886,0,886,0,886,36,604,246,21.04.2019 21:20,68,5,Zakarpatie
1520,1546,3,613,905,2,907,0,907,34,574,299,22.04.2019 00:10,68,5,Zakarpatie
1856,1826,8,847,1004,5,1009,0,1009,28,757,224,21.04.2019 21:45,68,5,Zakarpatie
1328,1322,7,567,757,4,761,0,761,33,531,197,22.04.2019 00:21,68,5,Zakarpatie
1696,1702,5,649,1042,5,1047,0,1047,48,708,291,22.04.2019 00:03,68,5,Zakarpatie
1792,1771,6,707,1082,3,1085,0,1085,35,728,322,22.04.2019 00:35,68,5,Zakarpatie
1952,1958,3,759,1192,1,1193,0,1193,45,795,353,21.04.2019 22:23,68,5,Zakarpatie
1472,1464,6,589,879,4,883,0,883,30,612,241,21.04.2019 21:30,68,5,Zakarpatie
1632,1632,3,651,978,3,981,0,981,29,659,293,22.04.2019 00:05,68,5,Zakarpatie
1664,1656,3,703,958,3,961,0,961,40,657,264,22.04.2019 00:17,68,5,Zakarpatie
1408,1377,3,621,785,2,787,0,787,15,529,243,21.04.2019 20:45,68,5,Zakarpatie
128,41,10,89,29,10,39,0,39,0,34,5,21.04.2019 21:05,68,5,Zakarpatie
384,154,66,242,88,54,142,0,142,6,102,34,21.04.2019 20:50,68,5,Zakarpatie
96,39,0,60,36,0,36,0,36,0,29,7,22.04.2019 00:05,68,5,Zakarpatie
256,87,15,188,56,12,68,0,68,0,52,16,22.04.2019 00:15,68,5,Zakarpatie
176,54,0,133,43,0,43,0,43,0,33,10,21.04.2019 22:40,68,5,Zakarpatie
560,563,23,306,231,23,254,0,254,4,240,10,21.04.2019 23:35,69,5,Zakarpatie
1344,1333,22,914,422,8,430,0,430,8,413,9,21.04.2019 20:30,69,5,Zakarpatie
816,805,17,600,212,4,216,0,216,11,197,8,21.04.2019 21:13,69,5,Zakarpatie
1040,1028,21,663,359,18,377,0,377,5,353,19,21.04.2019 20:45,69,5,Zakarpatie
656,639,25,286,345,25,370,0,370,4,319,47,21.04.2019 20:35,69,5,Zakarpatie
128,116,2,57,69,2,71,0,71,2,52,17,21.04.2019 21:30,69,5,Zakarpatie
1376,1361,29,583,773,20,793,0,793,12,688,93,21.04.2019 23:25,69,5,Zakarpatie
496,490,17,195,284,17,301,0,301,7,238,56,21.04.2019 20:40,69,5,Zakarpatie
640,623,38,275,335,30,365,0,365,9,314,42,21.04.2019 21:30,69,5,Zakarpatie
208,203,7,105,96,7,103,0,103,1,69,33,21.04.2019 20:30,69,5,Zakarpatie
80,77,3,31,46,3,49,0,49,2,26,21,21.04.2019 22:40,69,5,Zakarpatie
848,832,10,408,433,7,440,0,440,19,341,80,22.04.2019 00:07,69,5,Zakarpatie
144,132,1,90,53,1,54,0,54,0,37,17,21.04.2019 22:45,69,5,Zakarpatie
304,299,4,129,171,4,175,0,175,3,151,21,21.04.2019 22:35,69,5,Zakarpatie
1536,1519,47,1056,433,47,480,0,480,9,405,66,21.04.2019 22:36,69,5,Zakarpatie
1648,1623,22,1163,463,22,485,0,485,7,426,52,22.04.2019 00:15,69,5,Zakarpatie
2400,2378,8,1006,1387,7,1394,0,1394,36,1071,287,22.04.2019 00:10,69,5,Zakarpatie
1904,1898,3,851,1050,3,1053,0,1053,37,824,192,22.04.2019 00:40,69,5,Zakarpatie
1824,1838,11,1138,675,11,686,0,686,32,534,120,22.04.2019 00:18,70,5,Zakarpatie
576,564,4,303,269,4,273,0,273,9,224,40,21.04.2019 20:48,70,5,Zakarpatie
176,158,4,70,102,4,106,0,106,0,82,24,21.04.2019 21:20,70,5,Zakarpatie
240,238,1,110,129,1,130,0,130,3,113,14,21.04.2019 21:30,70,5,Zakarpatie
848,828,8,431,409,8,417,0,417,18,333,66,22.04.2019 00:30,70,5,Zakarpatie
352,346,3,83,266,3,269,0,269,9,221,39,22.04.2019 01:10,70,5,Zakarpatie
208,198,0,105,103,0,103,0,103,0,80,23,21.04.2019 21:55,70,5,Zakarpatie
352,329,12,159,181,12,193,0,193,0,177,16,22.04.2019 00:17,70,5,Zakarpatie
1152,1135,23,561,570,21,591,0,591,12,453,126,22.04.2019 00:05,70,5,Zakarpatie
496,485,12,264,226,6,232,0,232,3,182,47,22.04.2019 00:30,70,5,Zakarpatie
672,662,16,342,314,16,330,0,330,7,265,58,22.04.2019 01:30,70,5,Zakarpatie
432,429,3,233,196,3,199,0,199,4,136,59,21.04.2019 22:10,70,5,Zakarpatie
512,517,9,259,246,7,253,0,253,3,208,42,22.04.2019 00:50,70,5,Zakarpatie
1376,1345,19,609,751,16,767,0,767,23,541,203,22.04.2019 01:10,70,5,Zakarpatie
784,773,15,316,453,15,468,0,468,8,394,66,21.04.2019 21:05,70,5,Zakarpatie
1872,1836,8,981,884,7,891,0,891,18,712,161,22.04.2019 00:20,70,5,Zakarpatie
320,310,3,162,155,3,158,0,158,0,138,20,22.04.2019 00:10,70,5,Zakarpatie
784,765,9,400,378,6,384,0,384,7,295,82,21.04.2019 21:30,70,5,Zakarpatie
176,171,6,81,90,5,95,0,95,2,80,13,22.04.2019 00:23,70,5,Zakarpatie
672,656,44,291,338,43,381,0,381,6,307,68,22.04.2019 00:15,70,5,Zakarpatie
432,421,23,168,241,23,264,0,264,5,217,42,21.04.2019 23:50,70,5,Zakarpatie
464,458,35,180,253,31,284,0,284,11,185,88,22.04.2019 00:45,70,5,Zakarpatie
64,57,3,27,34,3,37,0,37,0,23,14,22.04.2019 00:15,70,5,Zakarpatie
112,107,4,47,61,4,65,0,65,0,45,20,21.04.2019 22:30,70,5,Zakarpatie
1008,996,53,542,416,50,466,0,466,15,349,102,22.04.2019 01:05,70,5,Zakarpatie
528,522,27,197,304,27,331,0,331,3,221,107,22.04.2019 00:20,70,5,Zakarpatie
304,300,21,117,167,20,187,0,187,3,142,42,22.04.2019 00:30,70,5,Zakarpatie
1408,1397,28,850,530,28,558,0,558,26,419,113,22.04.2019 00:10,70,5,Zakarpatie
1248,1240,23,538,692,18,710,0,710,18,540,152,21.04.2019 21:00,70,5,Zakarpatie
2272,2255,34,1092,1157,23,1180,0,1180,34,958,188,21.04.2019 22:30,70,5,Zakarpatie
240,222,7,52,181,7,188,0,188,3,132,53,21.04.2019 21:15,70,5,Zakarpatie
1024,1020,1,512,511,1,512,0,512,18,370,124,22.04.2019 00:15,70,5,Zakarpatie
288,277,0,78,210,0,210,0,210,2,159,49,22.04.2019 00:10,70,5,Zakarpatie
192,191,0,61,131,0,131,0,131,1,103,27,21.04.2019 22:20,70,5,Zakarpatie
256,246,6,97,153,6,159,0,159,5,108,46,22.04.2019 00:20,70,5,Zakarpatie
768,763,7,375,387,6,393,0,393,7,348,38,22.04.2019 00:45,70,5,Zakarpatie
1600,1585,37,788,775,37,812,0,812,15,680,117,21.04.2019 20:45,70,5,Zakarpatie
208,212,8,64,137,7,144,0,144,1,115,28,22.04.2019 01:10,70,5,Zakarpatie
640,630,18,157,465,18,483,0,483,10,345,128,22.04.2019 00:25,70,5,Zakarpatie
624,603,16,218,393,13,406,0,406,8,312,86,21.04.2019 20:50,70,5,Zakarpatie
720,711,10,428,282,10,292,0,292,7,236,49,22.04.2019 01:05,70,5,Zakarpatie
752,737,18,377,360,15,375,0,375,8,321,46,22.04.2019 00:10,70,5,Zakarpatie
576,558,18,262,296,18,314,0,314,4,281,29,22.04.2019 00:25,70,5,Zakarpatie
96,90,5,22,69,5,74,0,74,2,47,25,22.04.2019 00:35,70,5,Zakarpatie
208,193,3,83,122,3,125,0,125,3,109,13,22.04.2019 00:18,70,5,Zakarpatie
1632,1622,39,850,747,35,782,0,782,20,638,124,21.04.2019 22:10,70,5,Zakarpatie
416,401,16,129,272,15,287,0,287,4,246,37,21.04.2019 21:50,70,5,Zakarpatie
1376,1363,18,608,750,18,768,0,768,16,645,107,22.04.2019 00:06,70,5,Zakarpatie
192,190,5,87,102,3,105,0,105,1,90,14,21.04.2019 20:25,70,5,Zakarpatie
64,51,2,44,20,0,20,0,20,0,11,9,21.04.2019 20:45,70,5,Zakarpatie
96,86,1,38,57,1,58,0,58,2,42,14,21.04.2019 21:50,70,5,Zakarpatie
80,86,8,8,64,8,72,0,72,0,48,24,21.04.2019 21:50,70,5,Zakarpatie
240,238,4,121,115,4,119,0,119,5,95,19,22.04.2019 00:40,70,5,Zakarpatie
128,124,1,29,98,1,99,0,99,2,63,34,22.04.2019 00:30,70,5,Zakarpatie
1696,1650,4,742,950,4,954,0,954,32,718,204,22.04.2019 00:25,70,5,Zakarpatie
1728,1721,15,1083,636,9,645,0,645,17,516,112,22.04.2019 00:50,70,5,Zakarpatie
1568,1541,12,789,773,6,779,0,779,30,618,131,22.04.2019 00:15,70,5,Zakarpatie
1440,1424,6,738,699,3,702,0,702,17,535,150,22.04.2019 00:20,70,5,Zakarpatie
448,441,6,220,224,4,228,0,228,7,195,26,21.04.2019 21:50,70,5,Zakarpatie
2096,2098,30,1029,1041,26,1067,0,1067,24,915,128,22.04.2019 01:40,70,5,Zakarpatie
880,1003,5,275,601,4,605,0,605,18,495,92,22.04.2019 00:10,70,5,Zakarpatie
1184,1172,10,564,610,10,620,0,620,13,555,52,22.04.2019 00:30,70,5,Zakarpatie
1696,1676,0,986,710,0,710,0,710,14,634,62,22.04.2019 00:10,70,5,Zakarpatie
576,569,5,302,269,5,274,0,274,2,264,8,22.04.2019 00:10,70,5,Zakarpatie
192,180,2,67,123,2,125,0,125,0,91,34,22.04.2019 00:10,70,5,Zakarpatie
928,911,7,479,444,5,449,0,449,10,397,42,22.04.2019 00:15,70,5,Zakarpatie
336,324,5,147,184,5,189,0,189,2,170,17,22.04.2019 00:05,70,5,Zakarpatie
272,265,7,127,138,7,145,0,145,1,120,24,22.04.2019 00:10,70,5,Zakarpatie
2112,2280,41,697,1375,40,1415,0,1415,32,1155,228,22.04.2019 00:20,70,5,Zakarpatie
320,319,10,73,237,10,247,0,247,6,220,21,22.04.2019 00:12,70,5,Zakarpatie
624,609,4,327,293,4,297,0,297,0,248,49,22.04.2019 00:40,70,5,Zakarpatie
416,401,17,142,257,17,274,0,274,5,222,47,22.04.2019 00:05,70,5,Zakarpatie
1952,1934,21,1028,903,21,924,0,924,22,822,80,22.04.2019 00:10,70,5,Zakarpatie
448,441,0,198,250,0,250,0,250,2,221,27,22.04.2019 00:15,70,5,Zakarpatie
1088,1070,4,543,541,4,545,0,545,12,487,46,22.04.2019 00:10,70,5,Zakarpatie
688,675,18,296,375,17,392,0,392,2,351,39,22.04.2019 01:10,70,5,Zakarpatie
640,633,9,218,414,8,422,0,422,5,371,46,22.04.2019 00:05,70,5,Zakarpatie
1856,1830,20,1018,826,12,838,0,838,21,710,107,22.04.2019 00:15,71,5,Zakarpatie
1760,1745,18,891,853,16,869,0,869,24,690,155,22.04.2019 00:05,71,5,Zakarpatie
2096,2077,12,1015,1071,10,1081,0,1081,38,875,168,22.04.2019 01:40,71,5,Zakarpatie
1040,1025,5,569,466,5,471,0,471,13,401,57,22.04.2019 00:50,71,5,Zakarpatie
1664,1643,14,769,885,10,895,0,895,24,775,96,22.04.2019 00:30,71,5,Zakarpatie
1200,1187,4,657,539,4,543,0,543,18,458,67,22.04.2019 00:40,71,5,Zakarpatie
2208,2178,11,1238,960,10,970,0,970,15,832,123,22.04.2019 00:35,71,5,Zakarpatie
2400,2379,30,1344,1030,26,1056,0,1056,32,871,153,22.04.2019 00:15,71,5,Zakarpatie
1504,1491,9,912,583,9,592,0,592,10,510,72,22.04.2019 00:15,71,5,Zakarpatie
2320,2281,21,1571,730,19,749,0,749,20,647,82,22.04.2019 00:20,71,5,Zakarpatie
1504,1481,16,717,771,16,787,0,787,13,626,148,22.04.2019 00:20,71,5,Zakarpatie
1952,1938,5,950,997,5,1002,0,1002,23,878,101,22.04.2019 00:20,71,5,Zakarpatie
896,896,30,428,439,29,468,0,468,14,382,72,22.04.2019 00:35,71,5,Zakarpatie
448,443,20,186,242,20,262,0,262,6,198,58,22.04.2019 00:17,71,5,Zakarpatie
1008,1001,7,508,495,5,500,0,500,6,433,61,22.04.2019 00:25,71,5,Zakarpatie
2304,2285,43,1229,1034,41,1075,0,1075,27,924,124,22.04.2019 00:35,71,5,Zakarpatie
400,391,7,209,185,6,191,0,191,6,120,65,22.04.2019 00:36,71,5,Zakarpatie
2224,2185,26,1351,850,23,873,0,873,11,756,106,22.04.2019 01:20,71,5,Zakarpatie
2080,2064,12,1185,885,10,895,0,895,31,684,180,22.04.2019 00:15,71,5,Zakarpatie
1840,1825,10,1031,803,6,809,0,809,22,641,146,22.04.2019 00:15,71,5,Zakarpatie
2240,2209,10,1331,899,10,909,0,909,24,712,173,22.04.2019 00:17,71,5,Zakarpatie
1824,1812,15,1065,750,9,759,0,759,19,672,68,22.04.2019 00:10,71,5,Zakarpatie
2112,2086,23,1413,685,14,699,0,699,21,595,83,22.04.2019 00:16,71,5,Zakarpatie
864,849,1,580,283,1,284,0,284,4,257,23,22.04.2019 00:10,71,5,Zakarpatie
1360,1335,14,791,556,13,569,0,569,13,488,68,22.04.2019 00:15,71,5,Zakarpatie
1424,1407,12,871,541,12,553,0,553,21,500,32,22.04.2019 00:05,71,5,Zakarpatie
1424,1400,23,638,768,18,786,0,786,16,665,105,22.04.2019 00:20,71,5,Zakarpatie
1232,1211,16,630,588,14,602,0,602,12,480,110,22.04.2019 00:10,71,5,Zakarpatie
1312,1294,26,746,549,17,566,0,566,13,456,97,22.04.2019 01:05,71,5,Zakarpatie
1168,1142,25,780,377,11,388,0,388,4,359,25,22.04.2019 00:45,71,5,Zakarpatie
672,655,11,405,256,11,267,0,267,1,215,51,22.04.2019 00:20,71,5,Zakarpatie
2016,1992,17,1334,674,8,682,0,682,17,572,93,22.04.2019 00:45,71,5,Zakarpatie
1616,1599,9,1152,459,5,464,0,464,19,396,49,22.04.2019 00:55,71,5,Zakarpatie
2192,2165,19,1439,739,14,753,0,753,25,660,68,22.04.2019 00:38,71,5,Zakarpatie
1072,1064,10,640,422,10,432,0,432,9,367,56,22.04.2019 00:27,71,5,Zakarpatie
880,892,6,483,392,5,397,0,397,8,351,38,22.04.2019 00:15,71,5,Zakarpatie
720,762,3,338,380,2,382,0,382,5,305,72,22.04.2019 00:05,71,5,Zakarpatie
1856,1830,36,1122,713,21,734,0,734,22,621,91,22.04.2019 00:22,71,5,Zakarpatie
1584,1576,33,883,679,22,701,0,701,21,623,57,22.04.2019 00:10,71,5,Zakarpatie
1888,1863,23,971,898,19,917,0,917,21,822,74,22.04.2019 00:15,71,5,Zakarpatie
1248,1233,19,733,498,17,515,0,515,9,459,47,22.04.2019 01:55,71,5,Zakarpatie
1392,1372,43,642,707,43,750,0,750,18,667,65,22.04.2019 00:58,71,5,Zakarpatie
1856,1838,31,1202,631,23,654,0,654,20,510,124,22.04.2019 00:56,71,5,Zakarpatie
2368,2340,39,1465,876,27,903,0,903,8,765,130,22.04.2019 01:15,71,5,Zakarpatie
688,670,13,427,251,10,261,0,261,4,212,45,22.04.2019 00:30,71,5,Zakarpatie
1456,1445,8,927,521,8,529,0,529,11,469,49,22.04.2019 00:10,71,5,Zakarpatie
1616,1588,26,872,722,22,744,0,744,26,647,71,22.04.2019 00:01,71,5,Zakarpatie
1520,1495,44,910,572,38,610,0,610,23,528,59,22.04.2019 00:20,71,5,Zakarpatie
2384,2358,34,1258,1100,26,1126,0,1126,17,1013,96,22.04.2019 00:45,71,5,Zakarpatie
2032,2020,27,1144,870,18,888,0,888,25,816,47,22.04.2019 00:45,71,5,Zakarpatie
1056,1033,11,545,500,11,511,0,511,6,438,67,22.04.2019 00:15,71,5,Zakarpatie
2208,2194,26,1130,1055,23,1078,0,1078,18,1001,59,22.04.2019 00:15,71,5,Zakarpatie
1264,1251,22,698,547,19,566,0,566,7,485,74,22.04.2019 00:50,71,5,Zakarpatie
992,979,28,457,512,23,535,0,535,15,424,96,22.04.2019 00:15,71,5,Zakarpatie
1760,1744,14,947,799,14,813,0,813,23,746,44,22.04.2019 00:05,71,5,Zakarpatie
1136,1118,9,671,456,9,465,0,465,26,403,36,22.04.2019 00:25,71,5,Zakarpatie
1824,1798,32,1009,799,16,815,0,815,25,741,49,22.04.2019 00:45,71,5,Zakarpatie
1792,1762,25,992,788,12,800,0,800,24,735,41,22.04.2019 00:10,71,5,Zakarpatie
1056,1036,24,547,493,16,509,0,509,12,473,24,22.04.2019 00:45,71,5,Zakarpatie
1152,1136,15,630,510,12,522,0,522,9,497,16,22.04.2019 01:20,71,5,Zakarpatie
1408,1391,36,780,602,26,628,0,628,14,565,49,22.04.2019 00:50,71,5,Zakarpatie
848,827,38,409,401,38,439,0,439,9,337,93,22.04.2019 00:25,71,5,Zakarpatie
224,216,8,119,97,8,105,0,105,2,75,28,22.04.2019 00:50,71,5,Zakarpatie
352,349,15,64,273,15,288,0,288,8,191,89,22.04.2019 00:20,71,5,Zakarpatie
1744,1718,56,901,788,55,843,0,843,39,749,55,22.04.2019 00:15,71,5,Zakarpatie
2256,2233,36,1176,1052,28,1080,0,1080,40,944,96,22.04.2019 00:15,71,5,Zakarpatie
1984,1956,18,1180,791,13,804,0,804,24,616,164,22.04.2019 00:30,71,5,Zakarpatie
1680,1652,26,933,727,20,747,0,747,33,563,151,22.04.2019 00:42,71,5,Zakarpatie
336,322,1,188,147,1,148,0,148,3,103,42,22.04.2019 00:20,71,5,Zakarpatie
2096,2073,27,1142,928,26,954,0,954,31,810,113,22.04.2019 00:05,71,5,Zakarpatie
1904,1874,36,1162,715,27,742,0,742,21,645,76,22.04.2019 00:25,71,5,Zakarpatie
1600,1578,32,886,696,18,714,0,714,19,590,105,22.04.2019 00:10,71,5,Zakarpatie
1376,1366,5,785,586,5,591,0,591,23,511,57,22.04.2019 00:17,71,5,Zakarpatie
640,627,0,291,349,0,349,0,349,9,290,50,22.04.2019 00:15,71,5,Zakarpatie
1680,1654,9,703,971,6,977,0,977,39,761,177,22.04.2019 00:42,71,5,Zakarpatie
1488,1475,10,673,807,8,815,0,815,22,621,172,22.04.2019 00:15,71,5,Zakarpatie
1424,1411,3,663,759,2,761,0,761,20,603,138,22.04.2019 00:15,71,5,Zakarpatie
1328,1309,8,675,648,5,653,0,653,24,494,135,22.04.2019 00:30,71,5,Zakarpatie
1072,1055,8,518,549,5,554,0,554,25,380,149,22.04.2019 00:25,71,5,Zakarpatie
1344,1334,4,773,567,4,571,0,571,15,471,85,22.04.2019 00:15,71,5,Zakarpatie
1568,1558,8,734,827,7,834,0,834,25,646,163,22.04.2019 00:42,71,5,Zakarpatie
1680,1646,19,775,892,13,905,0,905,28,677,200,22.04.2019 00:10,71,5,Zakarpatie
1184,1185,7,516,662,6,668,0,668,31,525,112,22.04.2019 00:22,71,5,Zakarpatie
1456,1445,10,700,748,8,756,0,756,19,605,132,22.04.2019 00:20,71,5,Zakarpatie
2000,1974,8,1049,943,8,951,0,951,36,778,137,22.04.2019 00:34,71,5,Zakarpatie
1584,1579,29,751,830,3,833,0,833,23,653,157,22.04.2019 00:52,71,5,Zakarpatie
2112,2094,4,1029,1079,4,1083,0,1083,40,836,207,22.04.2019 00:35,71,5,Zakarpatie
1200,1185,1,708,491,1,492,0,492,13,433,46,22.04.2019 00:20,71,5,Zakarpatie
800,782,13,420,367,13,380,0,380,6,331,43,22.04.2019 00:40,71,5,Zakarpatie
288,280,1,238,49,1,50,0,50,0,46,4,22.04.2019 00:15,72,5,Zakarpatie
896,885,0,785,111,0,111,0,111,3,81,27,22.04.2019 00:10,72,5,Zakarpatie
1616,1595,5,934,678,4,682,0,682,17,536,129,22.04.2019 00:15,72,5,Zakarpatie
1936,1920,25,1172,742,22,764,0,764,12,657,95,22.04.2019 00:18,72,5,Zakarpatie
1280,1262,13,861,414,5,419,0,419,10,381,28,22.04.2019 00:15,72,5,Zakarpatie
1008,989,0,937,71,0,71,0,71,0,61,10,22.04.2019 00:11,72,5,Zakarpatie
1840,1824,60,999,781,60,841,0,841,22,661,158,22.04.2019 00:13,72,5,Zakarpatie
2384,2357,39,1512,836,36,872,0,872,9,775,88,22.04.2019 00:15,72,5,Zakarpatie
704,684,11,451,242,11,253,0,253,3,214,36,22.04.2019 00:10,72,5,Zakarpatie
960,943,13,497,453,10,463,0,463,4,411,48,22.04.2019 00:13,72,5,Zakarpatie
2400,2370,9,1537,857,6,863,0,863,10,735,118,22.04.2019 00:20,72,5,Zakarpatie
1840,1822,0,1657,183,0,183,0,183,3,158,22,22.04.2019 00:20,72,5,Zakarpatie
496,517,6,309,183,4,187,0,187,4,172,11,22.04.2019 00:30,73,5,Zakarpatie
1040,1026,11,689,343,8,351,0,351,9,333,9,22.04.2019 00:20,73,5,Zakarpatie
752,754,12,479,264,9,273,0,273,8,256,9,21.04.2019 21:50,73,5,Zakarpatie
704,684,8,434,265,5,270,0,270,1,258,11,21.04.2019 21:10,73,5,Zakarpatie
1520,1499,16,965,547,8,555,0,555,12,508,35,21.04.2019 22:10,73,5,Zakarpatie
560,545,13,315,234,11,245,0,245,5,210,30,22.04.2019 00:11,73,5,Zakarpatie
448,441,12,240,196,12,208,0,208,1,170,37,22.04.2019 00:10,73,5,Zakarpatie
592,575,4,408,183,1,184,0,184,3,172,9,21.04.2019 20:35,73,5,Zakarpatie
704,694,13,446,249,9,258,0,258,4,233,21,22.04.2019 00:57,73,5,Zakarpatie
2224,2205,4,1020,1200,4,1204,0,1204,26,970,208,21.04.2019 22:30,73,5,Zakarpatie
1552,1532,7,922,625,5,630,0,630,15,552,63,22.04.2019 00:12,73,5,Zakarpatie
2448,2419,5,1612,831,5,836,0,836,13,676,147,22.04.2019 01:30,73,5,Zakarpatie
720,715,4,304,412,4,416,0,416,9,356,51,22.04.2019 00:44,73,5,Zakarpatie
1744,1716,6,1177,562,5,567,0,567,28,470,69,22.04.2019 00:04,73,5,Zakarpatie
1360,1342,8,701,651,8,659,0,659,17,540,102,22.04.2019 00:12,73,5,Zakarpatie
1184,1167,12,621,553,10,563,0,563,18,470,75,22.04.2019 00:06,73,5,Zakarpatie
1344,1340,15,1013,317,14,331,0,331,3,324,4,21.04.2019 22:15,73,5,Zakarpatie
1568,1548,7,777,784,7,791,0,791,9,697,85,21.04.2019 22:20,73,5,Zakarpatie
448,443,3,225,221,2,223,0,223,3,185,35,22.04.2019 00:03,73,5,Zakarpatie
1520,1500,2,887,631,2,633,0,633,19,547,67,22.04.2019 00:15,73,5,Zakarpatie
976,967,37,487,455,34,489,0,489,13,409,67,21.04.2019 21:00,73,5,Zakarpatie
672,654,2,387,283,2,285,0,285,7,270,8,21.04.2019 21:07,73,5,Zakarpatie
288,279,0,162,126,0,126,0,126,6,119,1,21.04.2019 21:00,73,5,Zakarpatie
416,411,0,290,126,0,126,0,126,2,121,3,21.04.2019 20:05,73,5,Zakarpatie
240,229,0,170,70,0,70,0,70,0,57,13,21.04.2019 21:20,73,5,Zakarpatie
976,962,42,556,383,37,420,0,420,6,368,46,21.04.2019 22:15,73,5,Zakarpatie
1376,1364,21,869,486,21,507,0,507,16,459,32,21.04.2019 21:03,73,5,Zakarpatie
560,557,1,304,255,1,256,0,256,5,246,5,21.04.2019 20:45,73,5,Zakarpatie
304,302,1,163,140,1,141,0,141,5,127,9,21.04.2019 21:15,73,5,Zakarpatie
592,575,0,422,170,0,170,0,170,3,162,5,21.04.2019 20:37,73,5,Zakarpatie
1120,1097,16,647,457,16,473,0,473,13,388,72,21.04.2019 21:30,73,5,Zakarpatie
1792,1768,18,837,940,15,955,0,955,29,805,121,22.04.2019 00:10,73,5,Zakarpatie
432,417,3,241,189,2,191,0,191,3,169,19,22.04.2019 00:01,73,5,Zakarpatie
1216,1201,19,666,534,16,550,0,550,18,477,55,21.04.2019 22:10,73,5,Zakarpatie
1680,1656,11,992,678,10,688,0,688,12,618,58,22.04.2019 00:05,73,5,Zakarpatie
1664,1637,8,987,669,8,677,0,677,15,630,32,22.04.2019 00:20,73,5,Zakarpatie
1296,1281,7,723,566,7,573,0,573,22,488,63,22.04.2019 01:35,73,5,Zakarpatie
640,624,6,316,319,5,324,0,324,9,296,19,22.04.2019 00:05,73,5,Zakarpatie
304,287,3,183,118,3,121,0,121,2,104,15,21.04.2019 23:19,73,5,Zakarpatie
1664,1650,23,999,650,15,665,0,665,11,598,56,21.04.2019 21:28,73,5,Zakarpatie
528,509,23,244,264,20,284,0,284,7,253,24,21.04.2019 21:45,73,5,Zakarpatie
1632,1618,14,866,752,14,766,0,766,31,651,84,21.04.2019 22:00,73,5,Zakarpatie
2288,2263,13,1533,744,11,755,0,755,18,698,39,21.04.2019 21:40,73,5,Zakarpatie
1856,1842,28,1144,685,27,712,0,712,21,612,79,22.04.2019 01:00,73,5,Zakarpatie
1200,1227,4,773,424,3,427,0,427,9,390,28,21.04.2019 21:00,73,5,Zakarpatie
2320,2297,4,1251,1066,3,1069,0,1069,34,854,181,22.04.2019 00:15,73,5,Zakarpatie
2448,2448,167,1226,1081,141,1222,0,1222,45,974,203,22.04.2019 00:20,73,5,Zakarpatie
1472,1459,7,791,674,7,681,0,681,24,559,98,22.04.2019 00:05,73,5,Zakarpatie
1744,1725,8,862,875,7,882,0,882,31,716,135,21.04.2019 21:50,73,5,Zakarpatie
1584,1592,9,861,717,6,723,0,723,13,615,95,22.04.2019 00:05,73,5,Zakarpatie
2032,1996,6,1089,939,4,943,0,943,19,780,144,22.04.2019 00:10,73,5,Zakarpatie
2048,2026,7,1054,988,6,994,0,994,26,800,168,22.04.2019 00:20,73,5,Zakarpatie
2160,2133,3,1081,1077,2,1079,0,1079,34,830,215,21.04.2019 21:30,73,5,Zakarpatie
784,767,1,443,340,1,341,0,341,11,292,38,22.04.2019 00:03,73,5,Zakarpatie
416,40,29,378,11,27,38,0,38,1,31,6,21.04.2019 21:15,73,5,Zakarpatie
640,621,0,253,387,0,387,0,387,11,330,46,21.04.2019 21:20,73,5,Zakarpatie
1472,1442,45,892,537,43,580,0,580,11,510,59,21.04.2019 21:00,73,5,Zakarpatie
992,992,9,437,550,5,555,0,555,24,340,191,21.04.2019 20:30,73,5,Zakarpatie
1776,1764,55,858,863,55,918,0,918,11,795,112,22.04.2019 00:05,73,5,Zakarpatie
544,529,24,313,207,24,231,0,231,0,208,23,22.04.2019 00:10,73,5,Zakarpatie
944,935,18,440,486,18,504,0,504,6,409,89,22.04.2019 00:45,73,5,Zakarpatie
1600,1586,6,959,635,6,641,0,641,22,501,118,22.04.2019 00:15,73,5,Zakarpatie
368,357,9,168,191,9,200,0,200,7,168,25,22.04.2019 00:40,73,5,Zakarpatie
176,169,0,100,76,0,76,0,76,0,69,7,22.04.2019 00:05,73,5,Zakarpatie
624,605,14,324,286,14,300,0,300,12,244,44,22.04.2019 00:11,73,5,Zakarpatie
2272,2250,17,1334,929,9,938,0,938,18,752,168,22.04.2019 00:10,73,5,Zakarpatie
1216,1240,4,658,555,3,558,0,558,12,442,104,22.04.2019 00:05,73,5,Zakarpatie
384,379,10,148,228,8,236,0,236,3,197,36,22.04.2019 00:15,73,5,Zakarpatie
176,23,12,155,9,12,21,0,21,0,19,2,22.04.2019 00:05,73,5,Zakarpatie
832,680,0,155,677,0,677,0,677,83,575,19,22.04.2019 00:05,74,6,Zaporozhie
1984,1973,30,572,1389,23,1412,0,1412,35,1141,236,22.04.2019 00:20,74,6,Zaporozhie
2272,2257,14,683,1580,9,1589,0,1589,36,1285,268,22.04.2019 00:01,74,6,Zaporozhie
2144,2111,19,790,1343,11,1354,0,1354,38,1053,263,22.04.2019 00:05,74,6,Zaporozhie
2192,2157,15,800,1382,10,1392,0,1392,29,1165,198,22.04.2019 00:06,74,6,Zaporozhie
2096,2053,13,904,1183,9,1192,0,1192,20,960,212,22.04.2019 01:00,74,6,Zaporozhie
128,27,0,102,26,0,26,0,26,0,23,3,22.04.2019 00:06,74,6,Zaporozhie
208,27,0,183,25,0,25,0,25,0,20,5,21.04.2019 20:35,74,6,Zaporozhie
1632,1614,4,661,969,2,971,0,971,13,851,107,22.04.2019 00:02,74,6,Zaporozhie
1568,1543,5,682,884,2,886,0,886,7,785,94,22.04.2019 00:03,74,6,Zaporozhie
2335,2295,14,735,1589,11,1600,0,1600,27,1369,204,22.04.2019 00:30,74,6,Zaporozhie
2224,2193,8,1113,1104,7,1111,0,1111,29,942,140,22.04.2019 00:10,74,6,Zaporozhie
1952,1918,1,1010,941,1,942,0,942,25,819,98,22.04.2019 00:07,74,6,Zaporozhie
2288,2263,15,964,1311,13,1324,0,1324,29,1135,160,22.04.2019 00:05,74,6,Zaporozhie
2272,2243,11,880,1385,7,1392,0,1392,23,1173,196,22.04.2019 00:05,74,6,Zaporozhie
2240,2218,18,851,1376,13,1389,0,1389,36,1197,156,22.04.2019 00:30,74,6,Zaporozhie
2288,2251,13,794,1483,11,1494,0,1494,19,1280,195,22.04.2019 00:10,74,6,Zaporozhie
2192,2181,16,786,1394,12,1406,0,1406,30,1177,199,22.04.2019 00:15,74,6,Zaporozhie
2304,2298,12,722,1573,9,1582,0,1582,37,1326,217,22.04.2019 00:05,74,6,Zaporozhie
2160,2144,15,692,1457,11,1468,0,1468,47,1205,216,22.04.2019 00:10,74,6,Zaporozhie
2016,1986,12,686,1321,9,1330,0,1330,15,1097,218,22.04.2019 00:20,74,6,Zaporozhie
1968,1945,2,727,1239,2,1241,0,1241,23,1065,153,22.04.2019 00:10,74,6,Zaporozhie
2112,2070,20,734,1361,17,1378,0,1378,28,1141,209,22.04.2019 00:10,74,6,Zaporozhie
2128,2102,7,675,1449,4,1453,0,1453,43,1196,214,22.04.2019 00:20,74,6,Zaporozhie
2192,2163,17,681,1500,11,1511,0,1511,28,1241,242,22.04.2019 02:10,74,6,Zaporozhie
2128,2101,15,758,1360,10,1370,0,1370,28,1132,210,22.04.2019 00:20,74,6,Zaporozhie
2128,2121,200,623,1317,188,1505,0,1505,42,1228,235,22.04.2019 00:06,74,6,Zaporozhie
2224,2181,21,722,1484,18,1502,0,1502,19,1262,221,22.04.2019 00:06,74,6,Zaporozhie
2096,2069,14,775,1309,12,1321,0,1321,25,1141,155,22.04.2019 00:10,74,6,Zaporozhie
2160,2116,11,702,1448,10,1458,0,1458,21,1211,226,22.04.2019 00:13,74,6,Zaporozhie
2048,2023,16,648,1391,9,1400,0,1400,27,1167,206,22.04.2019 00:10,74,6,Zaporozhie
832,270,176,604,80,148,228,0,228,6,207,15,22.04.2019 00:20,74,6,Zaporozhie
464,319,0,174,290,0,290,0,290,14,238,38,22.04.2019 00:02,74,6,Zaporozhie
320,101,11,240,74,6,80,0,80,1,69,10,22.04.2019 00:20,74,6,Zaporozhie
240,61,13,180,48,12,60,0,60,3,49,8,22.04.2019 00:35,74,6,Zaporozhie
176,115,1,62,114,0,114,0,114,3,91,20,22.04.2019 00:20,74,6,Zaporozhie
80,28,0,52,28,0,28,0,28,1,25,2,22.04.2019 00:05,74,6,Zaporozhie
64,50,0,16,48,0,48,0,48,0,40,8,22.04.2019 00:13,74,6,Zaporozhie
992,973,14,360,620,12,632,0,632,14,560,58,21.04.2019 22:30,75,6,Zaporozhie
2224,2197,12,802,1413,9,1422,0,1422,28,1224,170,21.04.2019 21:39,75,6,Zaporozhie
2128,2099,10,770,1350,8,1358,0,1358,37,1195,126,21.04.2019 22:10,75,6,Zaporozhie
1984,1944,12,669,1311,4,1315,0,1315,29,1146,140,21.04.2019 22:12,75,6,Zaporozhie
2112,2085,20,712,1382,18,1400,0,1400,22,1254,124,21.04.2019 20:50,75,6,Zaporozhie
224,17,0,207,17,0,17,0,17,0,16,1,21.04.2019 22:30,75,6,Zaporozhie
2096,2062,19,710,1379,7,1386,0,1386,28,1107,251,22.04.2019 00:05,75,6,Zaporozhie
1840,1810,26,661,1161,18,1179,0,1179,32,906,241,22.04.2019 00:05,75,6,Zaporozhie
2384,2366,10,683,1694,7,1701,0,1701,41,1385,275,22.04.2019 00:03,75,6,Zaporozhie
2272,2243,13,643,1619,10,1629,0,1629,45,1303,281,22.04.2019 00:05,75,6,Zaporozhie
2208,2185,21,703,1490,15,1505,0,1505,30,1241,234,22.04.2019 00:05,75,6,Zaporozhie
2368,2349,12,762,1595,11,1606,0,1606,29,1307,270,21.04.2019 22:08,75,6,Zaporozhie
2224,2199,21,628,1584,12,1596,0,1596,47,1308,241,21.04.2019 21:45,75,6,Zaporozhie
2272,2248,22,793,1465,14,1479,0,1479,38,1211,230,22.04.2019 00:01,75,6,Zaporozhie
2256,2234,16,773,1470,13,1483,0,1483,27,1268,188,22.04.2019 00:10,75,6,Zaporozhie
2000,1967,8,670,1323,7,1330,0,1330,33,1098,199,21.04.2019 21:15,75,6,Zaporozhie
2224,2189,26,775,1429,20,1449,0,1449,44,1102,303,22.04.2019 00:00,75,6,Zaporozhie
48,10,0,38,10,0,10,0,10,0,7,3,21.04.2019 22:11,76,6,Zaporozhie
2256,2216,36,753,1473,30,1503,0,1503,32,1241,230,22.04.2019 00:01,76,6,Zaporozhie
2064,2059,9,711,1344,9,1353,0,1353,30,1101,222,22.04.2019 00:10,76,6,Zaporozhie
2112,2083,23,760,1336,16,1352,0,1352,27,1104,221,21.04.2019 22:55,76,6,Zaporozhie
304,43,32,262,11,31,42,0,42,0,34,8,21.04.2019 22:10,76,6,Zaporozhie
800,141,58,675,70,55,125,0,125,1,109,15,22.04.2019 00:01,76,6,Zaporozhie
144,57,11,92,41,11,52,0,52,0,42,10,22.04.2019 00:05,76,6,Zaporozhie
1424,1408,14,455,959,10,969,0,969,24,819,126,22.04.2019 00:05,76,6,Zaporozhie
1728,1700,3,566,1159,3,1162,0,1162,25,980,157,22.04.2019 00:15,77,6,Zaporozhie
2016,1988,8,725,1283,8,1291,0,1291,26,1076,189,22.04.2019 00:20,77,6,Zaporozhie
2016,2003,5,637,1374,5,1379,0,1379,41,1168,170,22.04.2019 00:15,77,6,Zaporozhie
1952,1942,23,548,1386,18,1404,0,1404,42,1170,192,22.04.2019 00:15,77,6,Zaporozhie
176,51,28,125,23,28,51,0,51,1,43,7,22.04.2019 00:05,77,6,Zaporozhie
144,16,0,128,16,0,16,0,16,0,13,3,22.04.2019 00:04,77,6,Zaporozhie
80,26,7,54,19,7,26,0,26,0,24,2,22.04.2019 00:10,77,6,Zaporozhie
320,286,146,40,137,143,280,0,280,5,237,38,22.04.2019 00:17,78,6,Zaporozhie
784,771,46,340,400,44,444,0,444,5,415,24,22.04.2019 00:12,78,6,Zaporozhie
448,442,21,192,239,17,256,0,256,2,231,23,22.04.2019 00:24,78,6,Zaporozhie
992,961,34,429,532,31,563,0,563,9,519,35,22.04.2019 00:55,78,6,Zaporozhie
192,197,21,74,97,21,118,0,118,1,107,10,22.04.2019 00:10,78,6,Zaporozhie
656,632,32,213,412,31,443,0,443,4,408,31,22.04.2019 00:08,78,6,Zaporozhie
416,404,50,140,226,50,276,0,276,6,256,14,22.04.2019 00:07,78,6,Zaporozhie
576,559,36,204,336,36,372,0,372,7,326,39,22.04.2019 00:15,78,6,Zaporozhie
1808,1775,81,767,977,64,1041,0,1041,13,986,42,22.04.2019 00:35,78,6,Zaporozhie
128,117,3,60,67,1,68,0,68,4,57,7,22.04.2019 00:15,78,6,Zaporozhie
464,453,27,212,225,27,252,0,252,3,232,17,22.04.2019 00:10,78,6,Zaporozhie
752,738,16,325,414,13,427,0,427,4,379,44,22.04.2019 00:05,78,6,Zaporozhie
2000,2138,36,773,1201,26,1227,0,1227,18,1109,100,21.04.2019 21:32,78,6,Zaporozhie
1312,1313,40,597,684,31,715,0,715,13,632,70,22.04.2019 00:55,78,6,Zaporozhie
336,345,21,112,205,19,224,0,224,2,207,15,22.04.2019 00:10,78,6,Zaporozhie
1264,1244,24,531,712,21,733,0,733,17,594,122,21.04.2019 21:18,78,6,Zaporozhie
1136,1117,137,413,601,122,723,0,723,15,637,71,22.04.2019 00:10,78,6,Zaporozhie
416,395,59,85,272,59,331,0,331,0,289,42,22.04.2019 00:10,78,6,Zaporozhie
832,811,61,348,432,52,484,0,484,14,401,69,22.04.2019 00:50,78,6,Zaporozhie
384,373,29,163,203,18,221,0,221,4,201,16,22.04.2019 02:10,78,6,Zaporozhie
288,278,38,100,155,33,188,0,188,2,159,27,22.04.2019 01:40,78,6,Zaporozhie
1776,1748,35,715,1026,35,1061,0,1061,21,947,93,22.04.2019 00:03,78,6,Zaporozhie
352,337,54,117,184,51,235,0,235,3,217,15,22.04.2019 00:20,78,6,Zaporozhie
304,303,24,109,172,23,195,0,195,4,169,22,21.04.2019 21:00,78,6,Zaporozhie
624,595,103,236,285,103,388,0,388,3,347,38,21.04.2019 23:15,78,6,Zaporozhie
400,392,29,128,244,28,272,0,272,2,250,20,22.04.2019 00:18,78,6,Zaporozhie
352,340,27,155,170,27,197,0,197,1,174,22,21.04.2019 23:00,78,6,Zaporozhie
2240,2219,34,772,1440,28,1468,0,1468,33,1328,107,22.04.2019 00:10,78,6,Zaporozhie
2112,2098,13,782,1320,10,1330,0,1330,37,1186,107,22.04.2019 00:05,78,6,Zaporozhie
2304,2277,40,856,1419,29,1448,0,1448,25,1286,137,22.04.2019 00:25,78,6,Zaporozhie
1296,1271,32,529,747,20,767,0,767,15,679,73,22.04.2019 00:15,78,6,Zaporozhie
1520,1488,14,610,898,12,910,0,910,17,812,81,22.04.2019 00:10,78,6,Zaporozhie
2224,2214,15,821,1393,10,1403,0,1403,24,1242,137,22.04.2019 00:07,78,6,Zaporozhie
2144,2122,15,734,1400,10,1410,0,1410,18,1241,151,22.04.2019 00:46,78,6,Zaporozhie
1792,1760,16,711,1068,13,1081,0,1081,16,953,112,22.04.2019 00:10,78,6,Zaporozhie
2048,2023,20,817,1217,14,1231,0,1231,20,1091,120,21.04.2019 22:30,78,6,Zaporozhie
2160,2125,14,758,1391,11,1402,0,1402,34,1223,145,22.04.2019 00:15,78,6,Zaporozhie
1824,1815,22,678,1128,18,1146,0,1146,18,991,137,22.04.2019 00:03,78,6,Zaporozhie
2128,2115,15,757,1361,10,1371,0,1371,30,1176,165,22.04.2019 00:07,78,6,Zaporozhie
2048,2024,16,680,1355,13,1368,0,1368,28,1190,150,22.04.2019 00:10,78,6,Zaporozhie
1936,1916,9,729,1202,5,1207,0,1207,30,1038,139,22.04.2019 00:05,78,6,Zaporozhie
1984,1955,16,739,1235,10,1245,0,1245,29,1048,168,22.04.2019 00:05,78,6,Zaporozhie
1904,1879,7,769,1130,5,1135,0,1135,26,1003,106,22.04.2019 00:20,78,6,Zaporozhie
2128,2094,8,694,1428,6,1434,0,1434,32,1240,162,22.04.2019 00:05,78,6,Zaporozhie
2112,2068,22,738,1356,18,1374,0,1374,22,1245,107,22.04.2019 00:20,78,6,Zaporozhie
1584,1600,9,608,972,4,976,0,976,13,883,80,22.04.2019 00:10,78,6,Zaporozhie
1872,1854,29,728,1122,22,1144,0,1144,28,1030,86,22.04.2019 00:01,78,6,Zaporozhie
1504,1503,28,616,865,23,888,0,888,13,789,86,22.04.2019 01:00,78,6,Zaporozhie
2112,2117,21,746,1350,16,1366,0,1366,20,1199,147,22.04.2019 00:05,78,6,Zaporozhie
2256,2251,21,831,1408,17,1425,0,1425,30,1264,131,22.04.2019 00:02,78,6,Zaporozhie
2080,2055,9,755,1318,7,1325,0,1325,38,1127,160,22.04.2019 00:01,78,6,Zaporozhie
944,1020,10,298,637,9,646,0,646,21,543,82,22.04.2019 00:03,78,6,Zaporozhie
2144,2166,16,757,1379,8,1387,0,1387,30,1192,165,22.04.2019 00:30,78,6,Zaporozhie
768,829,6,209,554,5,559,0,559,18,467,74,22.04.2019 00:01,78,6,Zaporozhie
1312,1310,15,511,793,8,801,0,801,21,704,76,22.04.2019 00:08,78,6,Zaporozhie
1600,1604,25,568,1013,19,1032,0,1032,25,916,91,22.04.2019 00:10,78,6,Zaporozhie
1184,1194,9,396,781,7,788,0,788,12,716,60,22.04.2019 00:02,78,6,Zaporozhie
1024,1013,10,449,567,8,575,0,575,8,517,50,22.04.2019 00:55,78,6,Zaporozhie
1072,1055,15,394,667,11,678,0,678,7,610,61,22.04.2019 00:30,78,6,Zaporozhie
1840,1821,19,648,1178,14,1192,0,1192,15,1055,122,22.04.2019 00:07,78,6,Zaporozhie
1792,1774,22,718,1056,18,1074,0,1074,17,981,76,22.04.2019 00:10,78,6,Zaporozhie
144,53,0,92,52,0,52,0,52,1,45,6,22.04.2019 00:15,78,6,Zaporozhie
127,40,0,89,38,0,38,0,38,1,34,3,22.04.2019 00:10,78,6,Zaporozhie
592,82,82,511,0,81,81,0,81,0,75,6,22.04.2019 00:01,78,6,Zaporozhie
656,362,0,324,332,0,332,0,332,4,262,66,22.04.2019 00:05,78,6,Zaporozhie
1696,1683,50,567,1098,31,1129,0,1129,12,971,146,22.04.2019 00:10,79,6,Zaporozhie
1392,1364,10,562,823,7,830,0,830,21,752,57,21.04.2019 21:30,79,6,Zaporozhie
1248,1228,17,524,711,13,724,0,724,19,656,49,22.04.2019 00:15,79,6,Zaporozhie
976,955,17,361,599,16,615,0,615,9,571,35,22.04.2019 00:10,79,6,Zaporozhie
736,723,16,274,448,14,462,0,462,8,427,27,22.04.2019 00:10,79,6,Zaporozhie
448,437,8,166,275,7,282,0,282,4,268,10,22.04.2019 00:30,79,6,Zaporozhie
1056,1041,53,406,598,52,650,0,650,14,562,74,21.04.2019 21:10,79,6,Zaporozhie
608,601,24,226,360,22,382,0,382,8,333,41,22.04.2019 00:15,79,6,Zaporozhie
336,325,17,136,184,16,200,0,200,3,164,33,22.04.2019 00:15,79,6,Zaporozhie
320,307,24,118,178,24,202,0,202,0,189,13,22.04.2019 00:05,79,6,Zaporozhie
176,11,0,165,11,0,11,0,11,0,6,5,22.04.2019 00:02,79,6,Zaporozhie
992,984,56,405,531,56,587,0,587,1,564,22,22.04.2019 00:05,79,6,Zaporozhie
736,725,47,225,464,47,511,0,511,7,485,19,22.04.2019 00:10,79,6,Zaporozhie
896,883,44,354,498,44,542,0,542,4,520,18,22.04.2019 00:38,79,6,Zaporozhie
1120,1093,54,209,857,54,911,0,911,10,825,76,22.04.2019 00:15,79,6,Zaporozhie
208,204,12,73,125,10,135,0,135,2,127,6,22.04.2019 00:05,79,6,Zaporozhie
112,102,7,42,63,7,70,0,70,1,68,1,21.04.2019 23:59,79,6,Zaporozhie
672,656,9,287,380,5,385,0,385,2,354,29,22.04.2019 00:15,79,6,Zaporozhie
288,276,31,114,145,29,174,0,174,2,155,17,22.04.2019 00:01,79,6,Zaporozhie
848,852,13,294,542,12,554,0,554,7,516,31,21.04.2019 21:31,80,6,Zaporozhie
880,869,22,374,485,21,506,0,506,2,486,18,21.04.2019 21:25,80,6,Zaporozhie
224,219,7,79,138,7,145,0,145,0,138,7,21.04.2019 20:35,80,6,Zaporozhie
2256,2234,15,914,1327,15,1342,0,1342,23,1265,54,22.04.2019 01:40,80,6,Zaporozhie
1824,1800,16,626,1183,15,1198,0,1198,8,1135,55,21.04.2019 22:10,80,6,Zaporozhie
1760,1731,9,658,1096,6,1102,0,1102,19,1033,50,22.04.2019 00:05,80,6,Zaporozhie
1776,1759,13,667,1100,9,1109,0,1109,18,1020,71,22.04.2019 00:00,80,6,Zaporozhie
1936,1906,17,716,1207,13,1220,0,1220,19,1121,80,22.04.2019 00:15,80,6,Zaporozhie
736,717,16,253,468,15,483,0,483,10,454,19,22.04.2019 00:12,80,6,Zaporozhie
496,484,18,161,318,17,335,0,335,5,302,28,21.04.2019 20:45,80,6,Zaporozhie
1440,1414,17,648,775,17,792,0,792,14,710,68,21.04.2019 23:40,80,6,Zaporozhie
1088,1058,16,466,607,15,622,0,622,8,566,48,21.04.2019 22:00,80,6,Zaporozhie
496,489,21,179,297,20,317,0,317,4,271,42,21.04.2019 21:15,80,6,Zaporozhie
240,236,25,77,138,25,163,0,163,1,144,18,22.04.2019 00:07,80,6,Zaporozhie
1376,1378,52,518,809,49,858,0,858,2,791,65,22.04.2019 00:05,80,6,Zaporozhie
512,504,11,206,295,11,306,0,306,5,291,10,21.04.2019 21:55,80,6,Zaporozhie
720,703,30,280,416,24,440,0,440,6,407,27,21.04.2019 20:45,80,6,Zaporozhie
240,234,6,99,136,5,141,0,141,1,131,9,21.04.2019 21:00,80,6,Zaporozhie
592,572,36,257,305,30,335,0,335,4,299,32,21.04.2019 22:40,80,6,Zaporozhie
624,616,20,262,345,17,362,0,362,5,322,35,22.04.2019 00:10,80,6,Zaporozhie
528,516,35,185,310,33,343,0,343,6,313,24,21.04.2019 21:20,80,6,Zaporozhie
352,351,7,145,202,5,207,0,207,2,167,38,22.04.2019 01:05,80,6,Zaporozhie
192,181,18,78,99,15,114,0,114,1,108,5,21.04.2019 23:40,80,6,Zaporozhie
160,163,4,48,108,4,112,0,112,2,98,12,21.04.2019 21:30,80,6,Zaporozhie
816,798,15,358,446,12,458,0,458,4,434,20,22.04.2019 00:10,80,6,Zaporozhie
256,18,0,238,18,0,18,0,18,0,11,7,22.04.2019 00:05,80,6,Zaporozhie
2064,2048,6,809,1250,5,1255,0,1255,15,1107,133,22.04.2019 00:05,80,6,Zaporozhie
2096,2075,23,824,1253,19,1272,0,1272,17,1131,124,22.04.2019 00:07,80,6,Zaporozhie
2336,2316,2,940,1395,1,1396,0,1396,12,1247,137,22.04.2019 00:12,80,6,Zaporozhie
2272,2237,5,829,1438,5,1443,0,1443,27,1233,183,22.04.2019 01:15,80,6,Zaporozhie
1424,1406,7,535,883,6,889,0,889,20,802,67,21.04.2019 23:23,80,6,Zaporozhie
1856,1836,17,810,1031,15,1046,0,1046,18,906,122,22.04.2019 00:30,80,6,Zaporozhie
2160,2138,11,852,1301,7,1308,0,1308,31,1125,152,22.04.2019 01:25,80,6,Zaporozhie
1552,1542,14,602,940,10,950,0,950,17,846,87,22.04.2019 00:43,80,6,Zaporozhie
1840,1824,16,735,1092,13,1105,0,1105,19,968,118,22.04.2019 00:02,80,6,Zaporozhie
1040,1027,7,412,624,4,628,0,628,9,556,63,22.04.2019 00:10,80,6,Zaporozhie
1584,1568,6,546,1032,6,1038,0,1038,12,931,95,22.04.2019 00:50,80,6,Zaporozhie
816,793,3,284,531,1,532,0,532,7,463,62,22.04.2019 00:16,80,6,Zaporozhie
1792,1761,7,603,1185,4,1189,0,1189,19,1010,160,22.04.2019 01:50,80,6,Zaporozhie
1760,1730,5,595,1160,5,1165,0,1165,34,974,157,22.04.2019 00:02,80,6,Zaporozhie
2016,1979,7,718,1291,7,1298,0,1298,36,1135,127,22.04.2019 00:09,80,6,Zaporozhie
752,738,0,273,479,0,479,0,479,9,405,65,21.04.2019 21:40,80,6,Zaporozhie
2128,2104,13,664,1451,13,1464,0,1464,28,1259,177,22.04.2019 00:25,80,6,Zaporozhie
1840,1788,11,886,946,8,954,0,954,17,862,75,21.04.2019 21:33,80,6,Zaporozhie
1760,1746,11,656,1093,11,1104,0,1104,19,987,98,21.04.2019 23:59,80,6,Zaporozhie
2032,2008,20,756,1261,15,1276,0,1276,21,1143,112,21.04.2019 21:25,80,6,Zaporozhie
2016,1991,13,792,1212,12,1224,0,1224,23,1052,149,22.04.2019 00:03,80,6,Zaporozhie
2240,2206,9,877,1354,9,1363,0,1363,21,1219,123,21.04.2019 21:34,80,6,Zaporozhie
2272,2239,18,804,1452,16,1468,0,1468,23,1322,123,21.04.2019 22:00,80,6,Zaporozhie
1936,1911,12,740,1184,12,1196,0,1196,18,1108,70,21.04.2019 21:25,80,6,Zaporozhie
2208,2183,5,959,1245,4,1249,0,1249,24,1096,129,22.04.2019 00:10,80,6,Zaporozhie
2016,1987,7,940,1074,2,1076,0,1076,19,952,105,22.04.2019 00:10,80,6,Zaporozhie
2048,2005,14,902,1134,12,1146,0,1146,17,1019,110,21.04.2019 23:10,80,6,Zaporozhie
2096,2095,9,774,1313,9,1322,0,1322,22,1105,195,21.04.2019 22:50,80,6,Zaporozhie
2240,2214,2,1013,1225,2,1227,0,1227,16,1100,111,21.04.2019 22:15,80,6,Zaporozhie
1536,1516,10,606,920,10,930,0,930,14,854,62,22.04.2019 00:02,80,6,Zaporozhie
1600,1585,10,587,1004,9,1013,0,1013,20,908,85,21.04.2019 23:30,80,6,Zaporozhie
2288,2268,12,826,1450,12,1462,0,1462,33,1319,110,22.04.2019 00:05,80,6,Zaporozhie
144,9,0,136,8,0,8,0,8,1,7,0,21.04.2019 22:45,80,6,Zaporozhie
112,5,2,107,3,2,5,0,5,0,4,1,21.04.2019 21:55,80,6,Zaporozhie
96,23,9,75,14,7,21,0,21,2,18,1,22.04.2019 00:08,80,6,Zaporozhie
208,9,0,199,9,0,9,0,9,0,8,1,21.04.2019 23:45,80,6,Zaporozhie
176,73,0,103,73,0,73,0,73,0,66,7,21.04.2019 22:30,80,6,Zaporozhie
176,169,4,60,113,3,116,0,116,1,103,12,21.04.2019 21:20,81,6,Zaporozhie
176,176,7,42,129,5,134,0,134,0,123,11,21.04.2019 20:50,81,6,Zaporozhie
240,221,9,99,133,8,141,0,141,4,116,21,21.04.2019 21:00,81,6,Zaporozhie
496,476,30,173,294,29,323,0,323,6,253,64,21.04.2019 21:45,81,6,Zaporozhie
256,239,14,113,130,13,143,0,143,0,108,35,21.04.2019 22:15,81,6,Zaporozhie
304,303,14,104,188,12,200,0,200,3,152,45,22.04.2019 00:15,81,6,Zaporozhie
928,909,26,357,550,21,571,0,571,11,508,52,21.04.2019 23:30,81,6,Zaporozhie
48,14,2,35,12,1,13,0,13,0,10,3,22.04.2019 00:10,81,6,Zaporozhie
576,567,4,270,302,4,306,0,306,10,274,22,21.04.2019 21:45,81,6,Zaporozhie
1104,1091,14,422,672,10,682,0,682,14,592,76,22.04.2019 00:20,81,6,Zaporozhie
1056,1026,11,403,643,10,653,0,653,11,582,60,22.04.2019 00:07,81,6,Zaporozhie
880,878,9,367,507,6,513,0,513,2,460,51,22.04.2019 00:10,81,6,Zaporozhie
160,45,21,121,22,17,39,0,39,0,32,7,21.04.2019 21:30,81,6,Zaporozhie
1072,1038,28,392,655,25,680,0,680,10,617,53,21.04.2019 20:50,82,6,Zaporozhie
640,625,48,223,373,44,417,0,417,8,381,28,21.04.2019 22:30,82,6,Zaporozhie
736,718,14,285,439,12,451,0,451,8,418,25,21.04.2019 23:20,82,6,Zaporozhie
864,852,56,382,435,47,482,0,482,8,430,44,21.04.2019 21:10,82,6,Zaporozhie
992,987,30,310,656,26,682,0,682,13,632,37,21.04.2019 20:35,82,6,Zaporozhie
112,103,9,37,66,9,75,0,75,1,66,8,22.04.2019 00:10,82,6,Zaporozhie
480,468,51,174,265,41,306,0,306,2,274,30,21.04.2019 22:30,82,6,Zaporozhie
208,207,28,72,111,25,136,0,136,0,120,16,21.04.2019 22:28,82,6,Zaporozhie
80,40,1,42,37,1,38,0,38,0,32,6,21.04.2019 21:15,82,6,Zaporozhie
1376,1357,45,414,920,42,962,0,962,15,832,115,21.04.2019 21:00,82,6,Zaporozhie
416,399,19,185,214,17,231,0,231,4,195,32,21.04.2019 22:40,82,6,Zaporozhie
448,437,34,213,208,27,235,0,235,1,226,8,22.04.2019 00:05,82,6,Zaporozhie
640,627,8,312,321,7,328,0,328,7,301,20,21.04.2019 21:34,82,6,Zaporozhie
688,672,52,285,358,45,403,0,403,2,370,31,21.04.2019 21:37,82,6,Zaporozhie
736,716,59,317,364,55,419,0,419,8,370,41,21.04.2019 23:30,82,6,Zaporozhie
928,915,21,343,564,21,585,0,585,2,520,63,22.04.2019 00:10,82,6,Zaporozhie
960,938,15,291,656,13,669,0,669,6,600,63,21.04.2019 20:50,82,6,Zaporozhie
400,387,29,174,199,27,226,0,226,4,202,20,21.04.2019 21:50,82,6,Zaporozhie
1088,1075,18,419,654,15,669,0,669,9,608,52,21.04.2019 21:20,82,6,Zaporozhie
560,541,9,260,295,5,300,0,300,4,269,27,21.04.2019 22:00,82,6,Zaporozhie
224,35,7,192,26,6,32,0,32,0,25,7,22.04.2019 00:10,82,6,Zaporozhie
352,339,42,127,189,36,225,0,225,3,201,21,21.04.2019 22:30,82,6,Zaporozhie
1808,1787,12,700,1098,10,1108,0,1108,37,482,589,22.04.2019 00:02,83,7,Ivano-Frankovsk
192,29,7,167,18,7,25,0,25,0,15,10,22.04.2019 00:05,83,7,Ivano-Frankovsk
320,41,15,282,26,12,38,0,38,0,21,17,21.04.2019 20:15,83,7,Ivano-Frankovsk
256,40,30,229,5,22,27,0,27,2,13,12,22.04.2019 00:27,83,7,Ivano-Frankovsk
96,1,0,95,1,0,1,0,1,0,0,1,22.04.2019 00:15,83,7,Ivano-Frankovsk
1072,1042,11,419,643,10,653,0,653,15,308,330,22.04.2019 00:09,83,7,Ivano-Frankovsk
128,129,7,23,98,7,105,0,105,1,49,55,21.04.2019 20:20,84,7,Ivano-Frankovsk
112,111,7,13,93,6,99,0,99,5,53,41,21.04.2019 20:30,84,7,Ivano-Frankovsk
112,110,5,32,75,5,80,0,80,1,35,44,21.04.2019 20:45,84,7,Ivano-Frankovsk
384,382,20,97,267,20,287,0,287,6,176,105,21.04.2019 22:30,84,7,Ivano-Frankovsk
1008,992,49,331,628,49,677,0,677,13,294,370,21.04.2019 23:45,84,7,Ivano-Frankovsk
928,917,7,442,479,7,486,0,486,21,223,242,22.04.2019 00:13,84,7,Ivano-Frankovsk
976,973,20,333,623,20,643,0,643,32,312,299,21.04.2019 22:00,84,7,Ivano-Frankovsk
448,443,45,143,260,45,305,0,305,3,106,196,21.04.2019 21:50,84,7,Ivano-Frankovsk
1072,1062,21,148,903,21,924,0,924,17,365,542,22.04.2019 00:10,84,7,Ivano-Frankovsk
1872,1849,55,771,1046,55,1101,0,1101,40,583,478,21.04.2019 21:00,84,7,Ivano-Frankovsk
1456,1431,86,615,760,81,841,0,841,17,351,473,21.04.2019 22:15,84,7,Ivano-Frankovsk
608,597,55,246,307,55,362,0,362,8,151,203,21.04.2019 21:30,84,7,Ivano-Frankovsk
656,648,40,176,440,40,480,0,480,5,174,301,21.04.2019 21:15,84,7,Ivano-Frankovsk
80,26,3,58,19,3,22,0,22,2,12,8,21.04.2019 20:20,84,7,Ivano-Frankovsk
1648,1629,5,819,824,5,829,0,829,23,505,301,21.04.2019 23:15,84,7,Ivano-Frankovsk
1616,1598,8,721,889,6,895,0,895,26,541,328,21.04.2019 23:50,84,7,Ivano-Frankovsk
1616,1606,66,694,874,48,922,0,922,23,628,271,22.04.2019 00:15,84,7,Ivano-Frankovsk
192,180,12,49,131,12,143,0,143,3,51,89,22.04.2019 00:02,84,7,Ivano-Frankovsk
256,262,22,114,120,22,142,0,142,4,89,49,22.04.2019 00:05,84,7,Ivano-Frankovsk
224,91,36,139,54,31,85,0,85,4,47,34,22.04.2019 00:15,84,7,Ivano-Frankovsk
2192,2172,6,865,1323,4,1327,0,1327,30,609,688,21.04.2019 21:15,84,7,Ivano-Frankovsk
2400,2352,10,971,1421,8,1429,0,1429,37,504,888,21.04.2019 21:31,84,7,Ivano-Frankovsk
592,574,3,243,347,2,349,0,349,11,115,223,21.04.2019 22:29,84,7,Ivano-Frankovsk
560,545,21,171,368,21,389,0,389,5,186,198,22.04.2019 00:35,85,7,Ivano-Frankovsk
336,329,19,107,210,19,229,0,229,2,106,121,22.04.2019 00:10,85,7,Ivano-Frankovsk
880,858,31,259,592,29,621,0,621,27,230,364,22.04.2019 00:45,85,7,Ivano-Frankovsk
1200,1191,44,284,873,43,916,0,916,24,523,369,22.04.2019 00:20,85,7,Ivano-Frankovsk
336,322,8,133,195,8,203,0,203,5,157,41,22.04.2019 00:15,85,7,Ivano-Frankovsk
352,335,19,171,164,17,181,0,181,8,135,38,22.04.2019 00:45,85,7,Ivano-Frankovsk
1952,1926,74,944,938,70,1008,0,1008,7,621,380,22.04.2019 00:10,85,7,Ivano-Frankovsk
2128,2102,53,977,1099,52,1151,0,1151,26,657,468,22.04.2019 00:50,85,7,Ivano-Frankovsk
1152,1140,48,393,713,46,759,0,759,16,456,287,22.04.2019 00:15,85,7,Ivano-Frankovsk
992,973,46,453,495,44,539,0,539,16,315,208,22.04.2019 00:30,85,7,Ivano-Frankovsk
1312,1290,85,599,630,83,713,0,713,19,457,237,22.04.2019 00:15,85,7,Ivano-Frankovsk
336,330,29,103,204,29,233,0,233,4,131,98,22.04.2019 00:10,85,7,Ivano-Frankovsk
1072,1062,37,505,530,37,567,0,567,10,334,223,22.04.2019 00:20,85,7,Ivano-Frankovsk
224,215,7,54,163,7,170,0,170,3,114,53,22.04.2019 01:00,85,7,Ivano-Frankovsk
1616,1589,78,625,913,78,991,0,991,32,528,431,22.04.2019 00:10,85,7,Ivano-Frankovsk
112,103,10,42,60,10,70,0,70,2,30,38,22.04.2019 00:12,85,7,Ivano-Frankovsk
288,277,27,80,183,25,208,0,208,6,121,81,22.04.2019 00:15,85,7,Ivano-Frankovsk
400,394,16,120,266,14,280,0,280,3,178,99,22.04.2019 00:20,85,7,Ivano-Frankovsk
1376,1361,48,613,716,47,763,0,763,25,460,278,22.04.2019 01:54,85,7,Ivano-Frankovsk
768,756,67,308,396,64,460,0,460,20,276,164,22.04.2019 00:20,85,7,Ivano-Frankovsk
160,150,13,57,90,13,103,0,103,3,65,35,22.04.2019 00:10,85,7,Ivano-Frankovsk
448,439,32,164,254,30,284,0,284,6,177,101,22.04.2019 00:10,85,7,Ivano-Frankovsk
2192,2149,78,768,1354,70,1424,0,1424,34,803,587,22.04.2019 00:10,85,7,Ivano-Frankovsk
1664,1649,32,658,974,32,1006,0,1006,31,447,528,22.04.2019 00:30,85,7,Ivano-Frankovsk
688,672,26,278,386,24,410,0,410,12,190,208,22.04.2019 00:35,85,7,Ivano-Frankovsk
528,512,22,206,300,22,322,0,322,6,212,104,22.04.2019 00:03,85,7,Ivano-Frankovsk
608,591,43,178,387,43,430,0,430,4,272,154,22.04.2019 00:10,85,7,Ivano-Frankovsk
288,274,21,86,181,21,202,0,202,2,144,56,22.04.2019 00:06,85,7,Ivano-Frankovsk
528,517,20,188,320,20,340,0,340,8,129,203,22.04.2019 00:30,85,7,Ivano-Frankovsk
224,215,19,104,101,19,120,0,120,3,59,58,22.04.2019 00:30,85,7,Ivano-Frankovsk
1312,1286,39,528,745,39,784,0,784,13,442,329,22.04.2019 00:17,85,7,Ivano-Frankovsk
384,375,10,116,258,10,268,0,268,9,143,116,22.04.2019 00:15,85,7,Ivano-Frankovsk
544,538,28,196,320,28,348,0,348,7,197,144,21.04.2019 21:09,85,7,Ivano-Frankovsk
96,21,1,77,18,1,19,0,19,0,10,9,22.04.2019 00:10,85,7,Ivano-Frankovsk
144,128,13,37,94,13,107,0,107,2,47,58,22.04.2019 00:40,85,7,Ivano-Frankovsk
720,705,15,256,449,15,464,0,464,12,288,164,22.04.2019 00:15,85,7,Ivano-Frankovsk
80,73,6,28,46,6,52,0,52,2,35,15,22.04.2019 00:15,85,7,Ivano-Frankovsk
192,190,21,67,105,20,125,0,125,6,68,51,22.04.2019 00:30,85,7,Ivano-Frankovsk
144,142,10,48,86,10,96,0,96,1,69,26,22.04.2019 00:10,85,7,Ivano-Frankovsk
208,207,15,71,122,15,137,0,137,2,96,39,22.04.2019 00:10,85,7,Ivano-Frankovsk
128,123,9,46,73,9,82,0,82,1,26,55,22.04.2019 00:10,85,7,Ivano-Frankovsk
80,67,12,27,41,12,53,0,53,0,22,31,22.04.2019 00:08,85,7,Ivano-Frankovsk
288,283,38,99,156,33,189,0,189,9,96,84,22.04.2019 00:38,85,7,Ivano-Frankovsk
96,94,1,11,84,1,85,0,85,1,53,31,22.04.2019 00:20,85,7,Ivano-Frankovsk
560,557,8,82,470,8,478,0,478,16,164,298,22.04.2019 00:10,85,7,Ivano-Frankovsk
608,600,68,97,444,67,511,0,511,13,226,272,22.04.2019 00:05,85,7,Ivano-Frankovsk
416,406,25,82,309,25,334,0,334,3,97,234,22.04.2019 00:10,85,7,Ivano-Frankovsk
160,152,14,59,87,14,101,0,101,1,67,33,22.04.2019 00:30,85,7,Ivano-Frankovsk
64,58,4,17,43,4,47,0,47,0,24,23,22.04.2019 00:05,85,7,Ivano-Frankovsk
208,202,13,53,142,13,155,0,155,1,73,81,22.04.2019 00:05,85,7,Ivano-Frankovsk
160,160,14,29,118,13,131,0,131,4,49,78,22.04.2019 00:20,85,7,Ivano-Frankovsk
432,415,41,150,241,41,282,0,282,6,211,65,22.04.2019 00:05,85,7,Ivano-Frankovsk
320,310,19,98,204,18,222,0,222,6,132,84,22.04.2019 00:15,85,7,Ivano-Frankovsk
272,268,9,79,184,9,193,0,193,7,129,57,22.04.2019 00:15,85,7,Ivano-Frankovsk
144,138,6,32,106,6,112,0,112,0,60,52,22.04.2019 01:15,85,7,Ivano-Frankovsk
336,327,25,76,235,25,260,0,260,7,136,117,22.04.2019 00:44,85,7,Ivano-Frankovsk
336,322,24,113,203,20,223,0,223,5,120,98,22.04.2019 00:06,85,7,Ivano-Frankovsk
288,279,34,66,188,34,222,0,222,5,122,95,22.04.2019 00:05,85,7,Ivano-Frankovsk
704,708,37,204,465,35,500,0,500,20,281,199,22.04.2019 00:10,85,7,Ivano-Frankovsk
672,670,26,140,506,26,532,0,532,3,303,226,22.04.2019 01:40,85,7,Ivano-Frankovsk
320,302,28,82,210,28,238,0,238,5,168,65,22.04.2019 00:20,85,7,Ivano-Frankovsk
224,214,18,76,130,18,148,0,148,3,82,63,22.04.2019 00:40,85,7,Ivano-Frankovsk
160,150,14,22,124,14,138,0,138,2,50,86,22.04.2019 00:30,85,7,Ivano-Frankovsk
176,160,15,68,93,15,108,0,108,2,67,39,22.04.2019 00:32,85,7,Ivano-Frankovsk
320,303,36,140,146,34,180,0,180,5,91,84,22.04.2019 00:25,85,7,Ivano-Frankovsk
224,47,23,181,20,23,43,0,43,1,21,21,22.04.2019 00:37,85,7,Ivano-Frankovsk
48,8,0,41,7,0,7,0,7,0,3,4,22.04.2019 00:22,85,7,Ivano-Frankovsk
2355,2324,11,1101,1246,8,1254,0,1254,48,707,499,22.04.2019 00:10,85,7,Ivano-Frankovsk
528,63,48,468,15,45,60,0,60,1,30,29,21.04.2019 20:50,85,7,Ivano-Frankovsk
1648,1623,15,691,944,13,957,0,957,39,431,487,21.04.2019 21:00,86,7,Ivano-Frankovsk
2272,2234,36,990,1252,30,1282,0,1282,49,612,621,22.04.2019 00:05,86,7,Ivano-Frankovsk
1536,1505,14,672,857,7,864,0,864,26,453,385,22.04.2019 00:30,86,7,Ivano-Frankovsk
2080,2036,12,851,1221,8,1229,0,1229,33,578,618,22.04.2019 00:23,86,7,Ivano-Frankovsk
1760,1714,3,883,874,3,877,0,877,32,467,378,22.04.2019 01:22,86,7,Ivano-Frankovsk
1392,1358,11,580,803,9,812,0,812,26,381,405,22.04.2019 00:21,86,7,Ivano-Frankovsk
2106,2047,7,889,1211,6,1217,0,1217,36,609,572,22.04.2019 00:15,86,7,Ivano-Frankovsk
1392,1370,17,633,744,15,759,0,759,29,406,324,22.04.2019 00:22,86,7,Ivano-Frankovsk
1328,1313,17,554,762,12,774,0,774,34,401,339,22.04.2019 00:30,86,7,Ivano-Frankovsk
640,621,17,237,390,13,403,0,403,13,216,174,22.04.2019 00:05,86,7,Ivano-Frankovsk
704,691,32,212,461,31,492,0,492,5,298,189,22.04.2019 01:00,86,7,Ivano-Frankovsk
2400,2357,31,1253,1120,27,1147,0,1147,28,602,517,22.04.2019 00:15,86,7,Ivano-Frankovsk
1024,1005,17,392,615,17,632,0,632,10,377,245,22.04.2019 00:15,86,7,Ivano-Frankovsk
1744,1706,25,672,1049,23,1072,0,1072,48,513,511,22.04.2019 01:10,86,7,Ivano-Frankovsk
864,855,60,254,556,54,610,0,610,6,371,233,22.04.2019 00:15,86,7,Ivano-Frankovsk
496,489,6,210,280,6,286,0,286,18,143,125,22.04.2019 00:02,86,7,Ivano-Frankovsk
240,229,6,56,178,6,184,0,184,3,70,111,22.04.2019 00:08,86,7,Ivano-Frankovsk
464,456,22,173,269,22,291,0,291,4,168,119,22.04.2019 00:40,86,7,Ivano-Frankovsk
1104,1081,12,468,625,11,636,0,636,31,380,225,22.04.2019 01:20,86,7,Ivano-Frankovsk
976,960,13,385,580,11,591,0,591,18,320,253,22.04.2019 00:20,86,7,Ivano-Frankovsk
432,424,21,184,229,19,248,0,248,11,123,114,22.04.2019 00:15,86,7,Ivano-Frankovsk
976,960,74,242,660,74,734,0,734,21,325,388,22.04.2019 00:05,86,7,Ivano-Frankovsk
480,456,30,190,261,29,290,0,290,5,143,142,22.04.2019 00:10,86,7,Ivano-Frankovsk
848,824,26,350,472,26,498,0,498,13,260,225,22.04.2019 00:05,86,7,Ivano-Frankovsk
224,223,10,79,135,10,145,0,145,4,68,73,22.04.2019 00:20,86,7,Ivano-Frankovsk
272,258,9,75,189,8,197,0,197,3,117,77,22.04.2019 00:15,86,7,Ivano-Frankovsk
544,523,54,273,220,51,271,0,271,5,135,131,21.04.2019 21:00,86,7,Ivano-Frankovsk
272,36,25,242,11,19,30,0,30,0,20,10,22.04.2019 00:03,86,7,Ivano-Frankovsk
2240,2222,34,786,1422,32,1454,0,1454,31,651,772,22.04.2019 00:15,86,7,Ivano-Frankovsk
1984,1968,61,778,1146,60,1206,0,1206,46,539,621,22.04.2019 00:20,86,7,Ivano-Frankovsk
1488,1470,10,541,937,10,947,0,947,30,569,348,22.04.2019 00:45,86,7,Ivano-Frankovsk
928,915,67,282,579,67,646,0,646,16,273,357,22.04.2019 00:02,86,7,Ivano-Frankovsk
832,821,25,296,511,25,536,0,536,17,251,268,22.04.2019 00:05,86,7,Ivano-Frankovsk
800,782,70,252,481,67,548,0,548,13,251,284,22.04.2019 00:17,86,7,Ivano-Frankovsk
352,348,9,117,227,8,235,0,235,4,136,95,22.04.2019 00:09,86,7,Ivano-Frankovsk
528,522,10,181,337,10,347,0,347,18,205,124,22.04.2019 00:05,86,7,Ivano-Frankovsk
224,215,5,71,148,5,153,0,153,7,99,47,22.04.2019 00:16,86,7,Ivano-Frankovsk
1392,1374,82,402,914,76,990,0,990,31,612,347,22.04.2019 00:10,86,7,Ivano-Frankovsk
912,905,43,240,631,41,672,0,672,12,365,295,22.04.2019 01:45,86,7,Ivano-Frankovsk
112,104,10,42,60,10,70,0,70,0,47,23,22.04.2019 00:10,86,7,Ivano-Frankovsk
704,686,25,323,363,18,381,0,381,12,234,135,22.04.2019 00:10,86,7,Ivano-Frankovsk
640,633,52,198,392,50,442,0,442,14,245,183,22.04.2019 00:02,86,7,Ivano-Frankovsk
1920,1906,58,807,1063,50,1113,0,1113,31,743,339,22.04.2019 00:10,86,7,Ivano-Frankovsk
336,322,25,116,196,24,220,0,220,10,142,68,22.04.2019 00:15,86,7,Ivano-Frankovsk
528,521,33,177,318,33,351,0,351,6,183,162,22.04.2019 00:10,86,7,Ivano-Frankovsk
448,442,37,115,298,35,333,0,333,5,155,173,22.04.2019 00:05,86,7,Ivano-Frankovsk
1712,1676,27,776,913,23,936,0,936,24,515,397,22.04.2019 00:30,86,7,Ivano-Frankovsk
128,127,10,25,93,10,103,0,103,4,50,49,22.04.2019 01:05,86,7,Ivano-Frankovsk
1072,1048,15,500,557,15,572,0,572,18,236,318,22.04.2019 00:40,86,7,Ivano-Frankovsk
1008,985,33,391,585,32,617,0,617,28,384,205,21.04.2019 20:45,87,7,Ivano-Frankovsk
848,827,22,365,462,21,483,0,483,19,287,177,21.04.2019 20:25,87,7,Ivano-Frankovsk
1184,1159,30,514,641,29,670,0,670,13,424,233,21.04.2019 21:20,87,7,Ivano-Frankovsk
976,965,27,392,557,27,584,0,584,19,402,163,21.04.2019 23:00,87,7,Ivano-Frankovsk
608,596,21,265,322,21,343,0,343,13,220,110,22.04.2019 00:10,87,7,Ivano-Frankovsk
576,557,23,270,283,23,306,0,306,5,190,111,22.04.2019 00:10,87,7,Ivano-Frankovsk
960,950,75,451,438,71,509,0,509,16,310,183,21.04.2019 23:45,87,7,Ivano-Frankovsk
1968,1925,92,908,974,86,1060,0,1060,36,502,522,22.04.2019 00:45,87,7,Ivano-Frankovsk
1552,1530,72,682,804,66,870,0,870,25,609,236,22.04.2019 00:15,87,7,Ivano-Frankovsk
688,674,22,286,381,21,402,0,402,12,177,213,22.04.2019 00:10,87,7,Ivano-Frankovsk
464,461,31,177,256,31,287,0,287,6,187,94,21.04.2019 22:00,87,7,Ivano-Frankovsk
496,489,30,171,297,28,325,0,325,7,170,148,22.04.2019 00:04,87,7,Ivano-Frankovsk
288,279,14,108,167,13,180,0,180,2,101,77,22.04.2019 00:15,87,7,Ivano-Frankovsk
384,383,27,137,224,23,247,0,247,6,130,111,22.04.2019 00:07,87,7,Ivano-Frankovsk
1712,1695,53,764,896,52,948,0,948,32,588,328,22.04.2019 00:20,87,7,Ivano-Frankovsk
992,971,57,451,486,55,541,0,541,18,327,196,21.04.2019 22:45,87,7,Ivano-Frankovsk
736,713,5,277,455,4,459,0,459,11,283,165,22.04.2019 00:25,87,7,Ivano-Frankovsk
1536,1510,65,564,911,61,972,0,972,21,644,307,22.04.2019 00:14,87,7,Ivano-Frankovsk
176,177,13,39,126,11,137,0,137,3,53,81,22.04.2019 00:30,87,7,Ivano-Frankovsk
944,928,58,392,498,54,552,0,552,17,282,253,22.04.2019 00:40,87,7,Ivano-Frankovsk
240,229,22,70,148,22,170,0,170,2,116,52,22.04.2019 00:20,87,7,Ivano-Frankovsk
384,378,31,153,200,31,231,0,231,3,153,75,21.04.2019 21:15,87,7,Ivano-Frankovsk
1648,1632,13,692,945,11,956,0,956,40,506,410,22.04.2019 00:05,87,7,Ivano-Frankovsk
2112,2082,13,861,1240,11,1251,0,1251,45,610,596,22.04.2019 00:05,87,7,Ivano-Frankovsk
1648,1638,16,660,973,15,988,0,988,41,526,421,22.04.2019 00:10,87,7,Ivano-Frankovsk
2368,2341,39,944,1393,31,1424,0,1424,58,755,611,22.04.2019 00:15,87,7,Ivano-Frankovsk
1440,1409,6,636,800,4,804,0,804,34,381,389,22.04.2019 00:10,87,7,Ivano-Frankovsk
1296,1270,8,618,670,8,678,0,678,23,340,315,22.04.2019 01:20,87,7,Ivano-Frankovsk
208,198,7,88,113,7,120,0,120,5,50,65,22.04.2019 00:30,87,7,Ivano-Frankovsk
2304,2272,133,1278,994,32,1026,0,1026,32,651,343,22.04.2019 00:15,87,7,Ivano-Frankovsk
1360,1336,14,725,623,12,635,0,635,24,405,206,22.04.2019 00:30,87,7,Ivano-Frankovsk
1440,1418,11,822,607,11,618,0,618,17,435,166,22.04.2019 00:20,87,7,Ivano-Frankovsk
1168,1068,2,595,573,0,573,0,573,16,378,179,22.04.2019 00:40,87,7,Ivano-Frankovsk
1712,1697,33,996,683,33,716,0,716,18,468,230,22.04.2019 00:03,87,7,Ivano-Frankovsk
1968,1956,32,1098,838,32,870,0,870,40,535,295,22.04.2019 00:03,87,7,Ivano-Frankovsk
1664,1647,65,918,682,64,746,0,746,29,461,256,21.04.2019 21:15,87,7,Ivano-Frankovsk
1664,1645,13,819,832,13,845,0,845,35,494,316,22.04.2019 00:04,87,7,Ivano-Frankovsk
1872,1848,4,895,973,4,977,0,977,36,538,403,22.04.2019 00:40,87,7,Ivano-Frankovsk
1248,1216,38,631,580,37,617,0,617,17,391,209,22.04.2019 00:14,87,7,Ivano-Frankovsk
1856,1835,40,373,1443,40,1483,0,1483,23,600,860,22.04.2019 01:30,87,7,Ivano-Frankovsk
1120,1101,18,593,510,17,527,0,527,13,273,241,22.04.2019 00:30,87,7,Ivano-Frankovsk
1568,1543,24,753,791,24,815,0,815,26,450,339,22.04.2019 00:50,87,7,Ivano-Frankovsk
1440,1421,45,633,762,45,807,0,807,11,451,345,22.04.2019 00:45,87,7,Ivano-Frankovsk
656,642,35,299,322,35,357,0,357,0,251,106,22.04.2019 00:20,87,7,Ivano-Frankovsk
816,812,24,289,503,24,527,0,527,40,242,245,22.04.2019 00:03,87,7,Ivano-Frankovsk
1392,1369,11,449,932,11,943,0,943,26,543,374,22.04.2019 00:25,87,7,Ivano-Frankovsk
1200,1180,11,436,754,10,764,0,764,30,513,221,22.04.2019 00:15,87,7,Ivano-Frankovsk
1312,1299,28,679,605,28,633,0,633,16,396,221,22.04.2019 01:12,87,7,Ivano-Frankovsk
1264,1242,43,537,686,41,727,0,727,19,453,255,22.04.2019 00:06,87,7,Ivano-Frankovsk
1872,1847,7,735,1130,7,1137,0,1137,34,741,362,22.04.2019 00:30,87,7,Ivano-Frankovsk
224,214,13,62,149,13,162,0,162,3,104,55,21.04.2019 23:20,87,7,Ivano-Frankovsk
1216,1202,26,553,637,26,663,0,663,15,504,144,22.04.2019 00:15,87,7,Ivano-Frankovsk
2480,2444,29,1402,1051,27,1078,0,1078,20,782,276,22.04.2019 01:45,87,7,Ivano-Frankovsk
1792,1763,74,661,1058,73,1131,0,1131,89,517,525,21.04.2019 23:00,87,7,Ivano-Frankovsk
2080,2068,16,962,1105,13,1118,0,1118,32,722,364,22.04.2019 00:30,87,7,Ivano-Frankovsk
800,783,6,351,443,6,449,0,449,13,363,73,22.04.2019 00:30,87,7,Ivano-Frankovsk
1312,1299,14,501,797,14,811,0,811,28,489,294,22.04.2019 00:30,87,7,Ivano-Frankovsk
1248,1229,9,458,781,9,790,0,790,32,431,327,22.04.2019 00:30,87,7,Ivano-Frankovsk
32,30,0,8,24,0,24,0,24,0,15,9,22.04.2019 00:15,87,7,Ivano-Frankovsk
192,187,7,84,101,7,108,0,108,1,76,31,22.04.2019 00:10,87,7,Ivano-Frankovsk
112,102,6,42,64,6,70,0,70,0,29,41,22.04.2019 00:05,87,7,Ivano-Frankovsk
2336,2298,102,1052,1182,102,1284,0,1284,39,698,547,22.04.2019 01:00,87,7,Ivano-Frankovsk
1152,1085,54,317,781,54,835,0,835,23,340,472,22.04.2019 00:20,87,7,Ivano-Frankovsk
768,758,37,267,465,36,501,0,501,15,171,315,22.04.2019 00:03,87,7,Ivano-Frankovsk
352,23,0,335,17,0,17,0,17,0,9,8,22.04.2019 00:10,87,7,Ivano-Frankovsk
1584,1591,32,633,924,27,951,0,951,35,500,416,22.04.2019 00:05,87,7,Ivano-Frankovsk
976,961,6,463,507,6,513,0,513,9,334,170,22.04.2019 00:05,87,7,Ivano-Frankovsk
1904,1889,33,858,1013,33,1046,0,1046,20,766,260,22.04.2019 00:30,87,7,Ivano-Frankovsk
1168,1169,25,428,717,23,740,0,740,21,492,227,22.04.2019 00:10,87,7,Ivano-Frankovsk
1520,1494,17,755,751,14,765,0,765,26,472,267,22.04.2019 00:05,87,7,Ivano-Frankovsk
1616,1668,18,733,865,18,883,0,883,21,594,268,22.04.2019 00:15,87,7,Ivano-Frankovsk
1536,1515,19,709,815,12,827,0,827,28,496,303,22.04.2019 01:30,88,7,Ivano-Frankovsk
608,602,46,216,347,45,392,0,392,19,174,199,21.04.2019 21:10,88,7,Ivano-Frankovsk
688,677,60,284,349,55,404,0,404,9,227,168,22.04.2019 00:30,88,7,Ivano-Frankovsk
224,207,14,86,125,13,138,0,138,1,77,60,21.04.2019 21:30,88,7,Ivano-Frankovsk
896,888,78,179,639,78,717,0,717,18,280,419,22.04.2019 00:10,88,7,Ivano-Frankovsk
1776,1763,48,676,1053,47,1100,0,1100,19,636,445,22.04.2019 01:15,88,7,Ivano-Frankovsk
608,586,42,166,400,42,442,0,442,11,271,160,22.04.2019 00:05,88,7,Ivano-Frankovsk
48,47,10,15,24,9,33,0,33,0,13,20,22.04.2019 00:05,88,7,Ivano-Frankovsk
64,62,16,25,23,16,39,0,39,1,28,10,22.04.2019 00:20,88,7,Ivano-Frankovsk
512,515,38,187,289,36,325,0,325,4,201,120,22.04.2019 00:10,88,7,Ivano-Frankovsk
352,344,24,128,201,23,224,0,224,5,137,82,22.04.2019 00:20,88,7,Ivano-Frankovsk
864,852,32,375,457,32,489,0,489,14,332,143,22.04.2019 00:05,88,7,Ivano-Frankovsk
112,99,0,42,70,0,70,0,70,1,38,31,22.04.2019 00:15,88,7,Ivano-Frankovsk
416,404,25,126,265,25,290,0,290,8,167,115,21.04.2019 22:01,88,7,Ivano-Frankovsk
1120,1100,48,442,631,47,678,0,678,10,469,199,21.04.2019 21:35,88,7,Ivano-Frankovsk
144,138,4,54,86,4,90,0,90,0,66,24,21.04.2019 23:45,88,7,Ivano-Frankovsk
1472,1454,82,486,906,80,986,0,986,20,566,400,22.04.2019 00:04,88,7,Ivano-Frankovsk
912,892,59,269,584,59,643,0,643,12,388,243,22.04.2019 00:20,88,7,Ivano-Frankovsk
1248,1233,26,613,612,23,635,0,635,5,398,232,22.04.2019 01:05,88,7,Ivano-Frankovsk
304,76,43,243,29,32,61,0,61,1,37,23,21.04.2019 21:30,88,7,Ivano-Frankovsk
976,953,56,486,436,54,490,0,490,7,332,151,21.04.2019 22:35,88,7,Ivano-Frankovsk
304,293,14,87,203,14,217,0,217,9,133,75,21.04.2019 20:48,88,7,Ivano-Frankovsk
1264,1240,57,597,617,50,667,0,667,21,335,311,22.04.2019 00:15,88,7,Ivano-Frankovsk
816,805,57,374,388,54,442,0,442,15,268,159,22.04.2019 00:20,88,7,Ivano-Frankovsk
768,745,65,340,369,59,428,0,428,11,227,190,22.04.2019 01:00,88,7,Ivano-Frankovsk
320,305,18,117,188,15,203,0,203,5,105,93,21.04.2019 23:30,88,7,Ivano-Frankovsk
1152,1128,51,561,540,51,591,0,591,17,408,166,21.04.2019 23:20,88,7,Ivano-Frankovsk
1168,1146,44,411,717,40,757,0,757,23,379,355,22.04.2019 01:15,88,7,Ivano-Frankovsk
608,588,17,149,442,17,459,0,459,9,275,175,22.04.2019 00:30,88,7,Ivano-Frankovsk
448,432,41,229,182,37,219,0,219,4,114,101,21.04.2019 22:08,88,7,Ivano-Frankovsk
1248,1222,98,506,646,96,742,0,742,16,406,320,22.04.2019 00:05,88,7,Ivano-Frankovsk
816,799,53,365,398,53,451,0,451,17,237,197,22.04.2019 00:10,88,7,Ivano-Frankovsk
1184,1177,47,529,610,45,655,0,655,30,340,285,22.04.2019 00:15,88,7,Ivano-Frankovsk
1280,1243,50,583,653,44,697,0,697,23,420,254,22.04.2019 00:30,88,7,Ivano-Frankovsk
112,54,7,58,47,7,54,0,54,0,35,19,22.04.2019 00:38,88,7,Ivano-Frankovsk
528,515,33,228,269,31,300,0,300,5,206,89,22.04.2019 00:50,88,7,Ivano-Frankovsk
240,226,21,61,162,17,179,0,179,8,84,87,22.04.2019 00:10,88,7,Ivano-Frankovsk
1744,1727,49,757,945,42,987,0,987,23,434,530,22.04.2019 00:20,88,7,Ivano-Frankovsk
144,139,12,51,81,12,93,0,93,0,52,41,22.04.2019 00:40,88,7,Ivano-Frankovsk
848,818,37,366,447,35,482,0,482,21,246,215,21.04.2019 22:15,88,7,Ivano-Frankovsk
544,530,24,189,335,20,355,0,355,11,146,198,21.04.2019 21:25,88,7,Ivano-Frankovsk
688,668,47,322,326,40,366,0,366,6,175,185,22.04.2019 00:10,88,7,Ivano-Frankovsk
496,487,26,214,259,23,282,0,282,14,184,84,22.04.2019 00:20,88,7,Ivano-Frankovsk
400,392,21,197,182,21,203,0,203,4,122,77,22.04.2019 00:05,88,7,Ivano-Frankovsk
1120,1107,43,575,505,40,545,0,545,12,358,175,22.04.2019 00:15,88,7,Ivano-Frankovsk
2032,2010,64,996,979,57,1036,0,1036,26,472,538,22.04.2019 00:55,88,7,Ivano-Frankovsk
832,816,42,430,364,38,402,0,402,10,193,199,22.04.2019 00:15,88,7,Ivano-Frankovsk
1264,1232,47,609,609,46,655,0,655,11,498,146,22.04.2019 00:20,88,7,Ivano-Frankovsk
576,565,38,219,322,35,357,0,357,10,200,147,22.04.2019 00:15,88,7,Ivano-Frankovsk
80,79,8,19,54,7,61,0,61,0,44,17,21.04.2019 23:55,88,7,Ivano-Frankovsk
816,800,29,298,489,29,518,0,518,17,237,264,22.04.2019 00:18,88,7,Ivano-Frankovsk
64,21,2,43,19,2,21,0,21,0,13,8,22.04.2019 00:20,88,7,Ivano-Frankovsk
64,20,3,45,16,3,19,0,19,1,7,11,21.04.2019 20:50,88,7,Ivano-Frankovsk
1680,1642,15,752,914,14,928,0,928,36,456,436,22.04.2019 00:05,88,7,Ivano-Frankovsk
1424,1398,21,662,744,18,762,0,762,28,360,374,22.04.2019 00:14,88,7,Ivano-Frankovsk
1664,1628,31,756,892,16,908,0,908,29,464,415,22.04.2019 00:30,88,7,Ivano-Frankovsk
1952,1915,33,889,1039,24,1063,0,1063,38,533,492,22.04.2019 00:10,88,7,Ivano-Frankovsk
2048,2002,27,962,1066,20,1086,0,1086,30,579,477,22.04.2019 00:20,88,7,Ivano-Frankovsk
2080,2035,21,971,1096,13,1109,0,1109,48,537,524,22.04.2019 00:45,88,7,Ivano-Frankovsk
2000,1900,19,1011,974,15,989,0,989,20,559,410,22.04.2019 00:08,88,7,Ivano-Frankovsk
1648,1622,34,714,906,28,934,0,934,33,439,462,22.04.2019 00:10,88,7,Ivano-Frankovsk
1744,1728,25,794,929,21,950,0,950,30,419,501,22.04.2019 00:20,88,7,Ivano-Frankovsk
1760,1738,16,823,926,11,937,0,937,35,505,397,21.04.2019 23:10,88,7,Ivano-Frankovsk
1568,1541,32,716,826,26,852,0,852,28,442,382,22.04.2019 00:12,88,7,Ivano-Frankovsk
1456,1420,25,694,742,20,762,0,762,29,397,336,22.04.2019 00:15,88,7,Ivano-Frankovsk
1920,1892,23,791,1109,20,1129,0,1129,33,547,549,22.04.2019 01:10,88,7,Ivano-Frankovsk
1872,1847,26,789,1060,23,1083,0,1083,48,488,547,22.04.2019 00:20,88,7,Ivano-Frankovsk
48,17,5,32,12,4,16,0,16,0,9,7,22.04.2019 00:20,88,7,Ivano-Frankovsk
112,13,0,101,11,0,11,0,11,0,3,8,22.04.2019 00:05,88,7,Ivano-Frankovsk
80,12,0,68,12,0,12,0,12,0,4,8,21.04.2019 21:49,88,7,Ivano-Frankovsk
96,23,3,73,20,3,23,0,23,0,11,12,22.04.2019 00:10,88,7,Ivano-Frankovsk
464,76,45,395,29,40,69,0,69,2,35,32,22.04.2019 00:10,88,7,Ivano-Frankovsk
256,243,31,95,132,29,161,0,161,3,102,56,22.04.2019 00:30,89,7,Ivano-Frankovsk
592,575,37,304,260,28,288,0,288,7,193,88,22.04.2019 00:40,89,7,Ivano-Frankovsk
1376,1355,46,585,745,46,791,0,791,21,521,249,22.04.2019 00:45,89,7,Ivano-Frankovsk
608,592,47,274,288,46,334,0,334,12,218,104,22.04.2019 00:23,89,7,Ivano-Frankovsk
1904,1873,8,906,990,8,998,0,998,28,577,393,22.04.2019 00:20,89,7,Ivano-Frankovsk
1920,1899,98,898,930,92,1022,0,1022,60,703,259,22.04.2019 00:15,89,7,Ivano-Frankovsk
1504,1481,32,630,844,30,874,0,874,24,535,315,22.04.2019 00:15,89,7,Ivano-Frankovsk
1008,990,10,415,584,9,593,0,593,30,363,200,22.04.2019 00:22,89,7,Ivano-Frankovsk
1568,1525,9,735,825,8,833,0,833,19,658,156,22.04.2019 00:10,89,7,Ivano-Frankovsk
1456,1431,34,678,744,34,778,0,778,30,535,213,22.04.2019 00:10,89,7,Ivano-Frankovsk
1456,1435,47,606,804,46,850,0,850,29,519,302,22.04.2019 00:10,89,7,Ivano-Frankovsk
928,918,54,409,467,52,519,0,519,19,345,155,22.04.2019 00:15,89,7,Ivano-Frankovsk
528,518,37,210,283,35,318,0,318,12,210,96,22.04.2019 00:10,89,7,Ivano-Frankovsk
544,529,35,217,292,35,327,0,327,23,179,125,22.04.2019 00:20,89,7,Ivano-Frankovsk
176,166,12,56,108,12,120,0,120,4,88,28,22.04.2019 00:15,89,7,Ivano-Frankovsk
912,894,43,358,511,43,554,0,554,16,395,143,22.04.2019 00:47,89,7,Ivano-Frankovsk
768,769,40,360,368,40,408,0,408,15,220,173,22.04.2019 00:50,89,7,Ivano-Frankovsk
1696,1679,79,795,822,79,901,0,901,33,590,278,22.04.2019 00:05,89,7,Ivano-Frankovsk
80,67,4,25,51,4,55,0,55,0,33,22,22.04.2019 00:55,89,7,Ivano-Frankovsk
160,156,5,49,106,5,111,0,111,6,77,28,22.04.2019 00:10,89,7,Ivano-Frankovsk
1408,1374,61,555,792,61,853,0,853,25,504,324,22.04.2019 00:35,89,7,Ivano-Frankovsk
1104,1083,59,512,537,55,592,0,592,14,466,112,22.04.2019 00:11,89,7,Ivano-Frankovsk
432,412,28,144,260,28,288,0,288,5,185,98,22.04.2019 00:10,89,7,Ivano-Frankovsk
1008,998,69,307,632,69,701,0,701,15,525,161,22.04.2019 00:10,89,7,Ivano-Frankovsk
736,717,46,189,501,46,547,0,547,24,393,130,22.04.2019 00:25,89,7,Ivano-Frankovsk
448,438,4,154,290,4,294,0,294,18,189,87,22.04.2019 00:19,89,7,Ivano-Frankovsk
512,500,21,200,291,21,312,0,312,10,222,80,22.04.2019 00:03,89,7,Ivano-Frankovsk
1152,1124,53,401,698,53,751,0,751,12,478,261,22.04.2019 01:30,89,7,Ivano-Frankovsk
864,848,22,364,481,19,500,0,500,14,300,186,22.04.2019 00:31,89,7,Ivano-Frankovsk
1120,1105,28,578,516,26,542,0,542,21,303,218,22.04.2019 00:15,89,7,Ivano-Frankovsk
736,731,42,386,310,40,350,0,350,5,275,70,22.04.2019 00:15,89,7,Ivano-Frankovsk
672,665,37,278,360,34,394,0,394,10,293,91,22.04.2019 00:15,89,7,Ivano-Frankovsk
976,953,42,531,405,40,445,0,445,14,320,111,22.04.2019 00:11,89,7,Ivano-Frankovsk
288,274,6,137,145,6,151,0,151,4,101,46,22.04.2019 00:09,89,7,Ivano-Frankovsk
416,400,14,152,250,14,264,0,264,6,140,118,22.04.2019 00:10,89,7,Ivano-Frankovsk
960,938,51,414,495,51,546,0,546,22,371,153,22.04.2019 00:45,89,7,Ivano-Frankovsk
608,588,29,219,360,29,389,0,389,8,243,138,22.04.2019 00:10,89,7,Ivano-Frankovsk
656,641,26,198,433,25,458,0,458,21,281,156,22.04.2019 00:30,89,7,Ivano-Frankovsk
896,886,17,421,458,17,475,0,475,16,307,152,22.04.2019 00:15,89,7,Ivano-Frankovsk
304,302,11,112,181,11,192,0,192,7,126,59,22.04.2019 00:20,89,7,Ivano-Frankovsk
272,257,14,125,133,14,147,0,147,4,95,48,22.04.2019 00:48,89,7,Ivano-Frankovsk
64,34,12,41,15,8,23,0,23,0,7,16,22.04.2019 00:05,89,7,Ivano-Frankovsk
48,19,3,29,16,3,19,0,19,1,7,11,22.04.2019 00:07,89,7,Ivano-Frankovsk
1376,1364,23,394,962,20,982,0,982,31,656,295,22.04.2019 00:05,90,8,Kiev
2112,2087,15,748,1355,9,1364,0,1364,36,981,347,22.04.2019 00:07,90,8,Kiev
1664,1628,2,771,891,2,893,0,893,29,714,150,21.04.2019 22:20,90,8,Kiev
2272,2252,6,716,1550,6,1556,0,1556,42,1107,407,21.04.2019 21:50,90,8,Kiev
2352,2342,15,847,1495,10,1505,0,1505,22,1151,332,21.04.2019 23:00,90,8,Kiev
80,24,7,60,15,5,20,0,20,0,15,5,21.04.2019 21:10,90,8,Kiev
208,28,1,180,27,1,28,0,28,2,19,7,21.04.2019 20:20,90,8,Kiev
1376,1374,14,536,826,14,840,0,840,16,592,232,21.04.2019 22:04,91,8,Kiev
176,160,0,55,121,0,121,0,121,1,76,44,21.04.2019 20:30,91,8,Kiev
896,893,1,329,567,0,567,0,567,7,386,174,21.04.2019 21:30,91,8,Kiev
2256,2275,4,791,1461,4,1465,0,1465,38,882,545,22.04.2019 00:05,91,8,Kiev
1392,1392,1,505,886,1,887,0,887,20,612,255,21.04.2019 21:15,91,8,Kiev
1392,1386,18,470,907,15,922,0,922,17,647,258,21.04.2019 22:10,91,8,Kiev
720,711,8,288,426,6,432,0,432,13,309,110,21.04.2019 21:15,91,8,Kiev
448,433,9,131,308,9,317,0,317,9,205,103,21.04.2019 22:00,91,8,Kiev
752,745,5,240,508,4,512,0,512,15,324,173,21.04.2019 21:00,91,8,Kiev
1168,1153,24,431,715,22,737,0,737,13,469,255,21.04.2019 21:00,91,8,Kiev
352,347,3,134,215,3,218,0,218,0,151,67,21.04.2019 22:30,91,8,Kiev
560,561,8,177,375,8,383,0,383,13,229,141,21.04.2019 22:00,91,8,Kiev
1760,1766,3,618,1139,3,1142,0,1142,22,674,446,21.04.2019 21:30,91,8,Kiev
752,763,3,226,523,3,526,0,526,6,329,191,21.04.2019 23:59,91,8,Kiev
640,639,0,224,416,0,416,0,416,6,308,102,21.04.2019 20:57,91,8,Kiev
2320,2300,1,880,1439,1,1440,0,1440,39,952,449,22.04.2019 01:35,91,8,Kiev
1840,1851,0,702,1138,0,1138,0,1138,29,751,358,22.04.2019 00:49,91,8,Kiev
1792,1802,5,536,1251,5,1256,0,1256,39,767,450,21.04.2019 21:10,91,8,Kiev
1040,1017,4,370,667,3,670,0,670,17,406,247,21.04.2019 21:15,91,8,Kiev
1824,1817,14,770,1048,6,1054,0,1054,29,675,350,21.04.2019 21:10,91,8,Kiev
464,459,1,160,303,1,304,0,304,5,198,101,21.04.2019 23:05,91,8,Kiev
208,209,4,68,137,3,140,0,140,3,91,46,21.04.2019 21:30,91,8,Kiev
1056,1040,37,424,596,36,632,0,632,6,469,157,22.04.2019 00:10,91,8,Kiev
144,134,11,63,70,11,81,0,81,1,52,28,21.04.2019 22:20,91,8,Kiev
656,670,24,234,399,23,422,0,422,14,274,134,21.04.2019 22:20,91,8,Kiev
2416,2405,33,916,1470,30,1500,0,1500,22,1098,380,21.04.2019 21:50,91,8,Kiev
2320,2339,2,837,1482,1,1483,0,1483,36,1067,380,21.04.2019 22:17,91,8,Kiev
1680,1637,6,752,922,6,928,0,928,23,677,228,21.04.2019 21:40,91,8,Kiev
1920,1935,5,708,1209,3,1212,0,1212,29,845,338,21.04.2019 22:10,91,8,Kiev
784,768,49,314,425,45,470,0,470,16,324,130,21.04.2019 20:40,91,8,Kiev
448,455,2,192,254,2,256,0,256,3,180,73,21.04.2019 21:20,91,8,Kiev
544,538,29,204,312,28,340,0,340,6,245,89,21.04.2019 22:45,91,8,Kiev
320,314,7,110,204,6,210,0,210,0,129,81,21.04.2019 23:00,91,8,Kiev
608,594,6,314,289,5,294,0,294,7,246,41,21.04.2019 21:11,91,8,Kiev
688,696,46,249,398,41,439,0,439,8,338,93,21.04.2019 21:15,91,8,Kiev
704,708,68,301,335,68,403,0,403,10,279,114,21.04.2019 21:20,91,8,Kiev
640,640,35,239,366,35,401,0,401,4,295,102,21.04.2019 21:30,91,8,Kiev
176,170,15,71,90,15,105,0,105,2,72,31,21.04.2019 20:40,91,8,Kiev
816,879,36,238,546,32,578,0,578,7,368,203,22.04.2019 01:40,91,8,Kiev
352,344,23,119,214,19,233,0,233,5,156,72,21.04.2019 21:20,91,8,Kiev
432,418,20,158,254,20,274,0,274,12,187,75,21.04.2019 23:40,91,8,Kiev
912,919,12,394,506,12,518,0,518,9,349,160,22.04.2019 00:35,91,8,Kiev
192,187,14,73,105,14,119,0,119,1,78,40,21.04.2019 21:12,91,8,Kiev
656,652,25,297,335,24,359,0,359,8,199,152,21.04.2019 21:57,91,8,Kiev
96,90,6,39,51,6,57,0,57,0,26,31,21.04.2019 22:05,91,8,Kiev
816,802,7,387,424,5,429,0,429,7,315,107,21.04.2019 21:30,91,8,Kiev
400,397,4,132,264,4,268,0,268,7,203,58,21.04.2019 20:45,91,8,Kiev
240,244,0,80,160,0,160,0,160,1,127,32,21.04.2019 20:50,91,8,Kiev
320,311,24,118,178,24,202,0,202,3,175,24,22.04.2019 00:30,91,8,Kiev
672,655,7,224,441,7,448,0,448,12,314,122,21.04.2019 20:37,91,8,Kiev
576,561,25,244,307,25,332,0,332,4,233,95,21.04.2019 20:37,91,8,Kiev
256,245,10,85,162,9,171,0,171,5,117,49,21.04.2019 21:20,91,8,Kiev
816,815,18,388,410,18,428,0,428,11,287,130,21.04.2019 20:45,91,8,Kiev
640,653,47,211,382,47,429,0,429,3,322,104,21.04.2019 20:50,91,8,Kiev
352,347,1,151,200,1,201,0,201,7,144,50,21.04.2019 21:30,91,8,Kiev
528,531,1,188,339,1,340,0,340,3,270,67,21.04.2019 22:30,91,8,Kiev
768,761,22,332,416,20,436,0,436,12,322,102,21.04.2019 21:20,91,8,Kiev
288,279,14,100,174,14,188,0,188,5,147,36,21.04.2019 22:00,91,8,Kiev
736,740,37,269,430,37,467,0,467,8,333,126,21.04.2019 20:45,91,8,Kiev
496,504,40,146,310,40,350,0,350,9,246,95,21.04.2019 20:50,91,8,Kiev
352,349,31,121,202,28,231,0,231,5,138,88,21.04.2019 22:00,91,8,Kiev
512,509,36,179,301,32,333,0,333,4,209,120,21.04.2019 21:05,91,8,Kiev
448,436,27,199,223,26,249,0,249,1,190,58,22.04.2019 00:30,91,8,Kiev
528,535,45,147,338,43,381,0,381,9,302,70,21.04.2019 20:50,91,8,Kiev
464,456,39,182,243,39,282,0,282,3,195,84,21.04.2019 21:00,91,8,Kiev
352,344,8,105,239,8,247,0,247,5,162,80,21.04.2019 20:40,91,8,Kiev
416,428,23,160,235,21,256,0,256,2,171,83,21.04.2019 20:55,91,8,Kiev
160,154,11,61,88,11,99,0,99,1,59,39,21.04.2019 20:43,91,8,Kiev
544,534,32,236,281,27,308,0,308,5,203,100,21.04.2019 23:45,91,8,Kiev
480,501,26,133,321,26,347,0,347,5,225,117,21.04.2019 20:55,91,8,Kiev
192,70,30,140,39,13,52,0,52,0,44,8,21.04.2019 20:30,91,8,Kiev
384,397,33,97,254,33,287,0,287,2,198,87,21.04.2019 21:00,91,8,Kiev
528,521,55,172,301,55,356,0,356,0,225,131,21.04.2019 20:39,91,8,Kiev
240,237,20,52,168,20,188,0,188,0,129,59,21.04.2019 20:45,91,8,Kiev
272,274,31,73,168,31,199,0,199,1,132,66,21.04.2019 23:40,91,8,Kiev
272,271,25,85,163,24,187,0,187,1,148,38,22.04.2019 00:15,91,8,Kiev
400,368,22,169,209,22,231,0,231,6,182,43,21.04.2019 20:30,91,8,Kiev
560,543,30,211,322,27,349,0,349,7,243,99,21.04.2019 20:55,91,8,Kiev
576,561,16,241,319,16,335,0,335,4,231,100,21.04.2019 21:40,91,8,Kiev
368,364,15,153,201,14,215,0,215,3,173,39,22.04.2019 00:00,91,8,Kiev
176,174,14,29,133,14,147,0,147,2,98,47,21.04.2019 23:50,91,8,Kiev
448,441,50,135,270,43,313,0,313,5,235,73,21.04.2019 21:48,91,8,Kiev
880,866,35,405,441,34,475,0,475,6,373,96,21.04.2019 20:50,91,8,Kiev
432,408,24,201,209,22,231,0,231,3,168,60,21.04.2019 23:53,91,8,Kiev
624,603,57,314,260,50,310,0,310,4,239,67,21.04.2019 20:30,91,8,Kiev
576,564,47,219,314,43,357,0,357,4,265,88,21.04.2019 21:10,91,8,Kiev
128,128,17,42,72,14,86,0,86,1,65,20,21.04.2019 20:40,91,8,Kiev
272,258,31,92,150,30,180,0,180,3,103,74,21.04.2019 20:47,91,8,Kiev
1136,1127,23,520,597,19,616,0,616,12,475,129,21.04.2019 22:10,91,8,Kiev
560,557,15,239,308,13,321,0,321,5,253,63,21.04.2019 22:00,91,8,Kiev
480,474,21,188,275,17,292,0,292,6,233,53,21.04.2019 22:23,91,8,Kiev
496,481,39,107,350,39,389,0,389,8,128,253,21.04.2019 21:06,91,8,Kiev
672,657,66,271,345,56,401,0,401,8,301,92,21.04.2019 21:05,91,8,Kiev
240,232,30,107,105,28,133,0,133,2,108,23,21.04.2019 21:30,91,8,Kiev
560,558,50,204,306,50,356,0,356,8,270,78,21.04.2019 23:00,91,8,Kiev
512,529,41,163,311,38,349,0,349,2,253,94,22.04.2019 00:10,91,8,Kiev
880,857,24,429,431,20,451,0,451,6,334,111,22.04.2019 00:20,91,8,Kiev
272,251,17,96,159,17,176,0,176,1,150,25,21.04.2019 23:45,91,8,Kiev
432,423,33,146,258,28,286,0,286,3,157,126,22.04.2019 00:15,91,8,Kiev
1520,1507,56,718,764,38,802,0,802,21,580,201,22.04.2019 01:00,91,8,Kiev
1056,1030,24,463,570,23,593,0,593,8,439,146,21.04.2019 23:37,91,8,Kiev
192,188,6,56,131,5,136,0,136,2,104,30,21.04.2019 21:00,91,8,Kiev
1504,1491,24,615,869,20,889,0,889,25,618,246,21.04.2019 21:00,91,8,Kiev
512,498,14,232,267,13,280,0,280,7,224,49,21.04.2019 21:30,91,8,Kiev
80,67,0,35,45,0,45,0,45,0,24,21,21.04.2019 21:00,91,8,Kiev
1600,1587,8,610,983,7,990,0,990,25,744,221,22.04.2019 00:20,91,8,Kiev
1904,1892,4,708,1194,2,1196,0,1196,29,891,276,22.04.2019 00:25,91,8,Kiev
1760,1737,4,698,1059,3,1062,0,1062,25,858,179,22.04.2019 00:04,91,8,Kiev
1936,1914,16,797,1123,16,1139,0,1139,32,875,232,22.04.2019 00:50,91,8,Kiev
1872,1843,14,676,1184,12,1196,0,1196,36,838,322,22.04.2019 00:12,91,8,Kiev
2048,2028,8,771,1269,8,1277,0,1277,41,869,367,22.04.2019 00:05,91,8,Kiev
1568,1557,7,596,967,5,972,0,972,21,710,241,22.04.2019 00:20,91,8,Kiev
1712,1683,5,587,1123,2,1125,0,1125,26,774,325,22.04.2019 00:01,91,8,Kiev
352,107,59,248,58,46,104,0,104,4,80,20,21.04.2019 21:00,91,8,Kiev
1776,1738,11,716,1052,8,1060,0,1060,27,824,209,22.04.2019 00:15,92,8,Kiev
656,651,6,315,337,4,341,0,341,9,267,65,21.04.2019 21:00,92,8,Kiev
1168,1134,4,532,633,3,636,0,636,19,464,153,21.04.2019 23:45,92,8,Kiev
368,363,38,110,222,36,258,0,258,7,175,76,21.04.2019 20:40,92,8,Kiev
480,470,40,163,278,39,317,0,317,5,272,40,21.04.2019 21:30,92,8,Kiev
208,198,34,51,123,34,157,0,157,4,97,56,21.04.2019 21:01,92,8,Kiev
784,763,60,190,534,60,594,0,594,11,472,111,21.04.2019 22:10,92,8,Kiev
256,254,23,73,160,23,183,0,183,5,139,39,21.04.2019 21:50,92,8,Kiev
256,255,38,75,143,38,181,0,181,0,98,83,21.04.2019 21:01,92,8,Kiev
144,142,20,37,87,20,107,0,107,0,73,34,21.04.2019 21:50,92,8,Kiev
400,398,55,104,241,55,296,0,296,8,184,104,21.04.2019 21:15,92,8,Kiev
400,399,26,140,234,26,260,0,260,12,190,58,21.04.2019 23:50,92,8,Kiev
560,544,11,223,327,10,337,0,337,4,264,69,21.04.2019 21:40,92,8,Kiev
992,969,99,328,569,95,664,0,664,10,529,125,21.04.2019 21:50,92,8,Kiev
448,441,41,166,241,41,282,0,282,5,225,52,21.04.2019 21:50,92,8,Kiev
1344,1333,39,633,672,39,711,0,711,24,519,168,21.04.2019 22:30,92,8,Kiev
224,217,12,85,127,12,139,0,139,4,98,37,21.04.2019 21:20,92,8,Kiev
400,389,31,90,280,30,310,0,310,3,218,89,21.04.2019 20:30,92,8,Kiev
432,433,66,128,239,65,304,0,304,6,227,71,21.04.2019 21:00,92,8,Kiev
336,320,43,105,188,43,231,0,231,7,155,69,21.04.2019 20:25,92,8,Kiev
592,583,59,178,355,59,414,0,414,5,253,156,21.04.2019 21:00,92,8,Kiev
496,485,31,185,282,29,311,0,311,4,220,87,21.04.2019 22:05,92,8,Kiev
176,180,12,58,106,12,118,0,118,2,86,30,22.04.2019 00:30,92,8,Kiev
336,325,30,41,265,30,295,0,295,4,159,132,21.04.2019 21:00,92,8,Kiev
496,491,25,190,283,23,306,0,306,7,225,74,21.04.2019 21:10,92,8,Kiev
400,403,39,118,243,39,282,0,282,5,180,97,21.04.2019 20:40,92,8,Kiev
144,150,29,33,83,28,111,0,111,0,92,19,21.04.2019 20:40,92,8,Kiev
256,250,26,60,170,26,196,0,196,5,157,34,21.04.2019 20:45,92,8,Kiev
576,574,65,219,292,65,357,0,357,12,252,93,21.04.2019 22:20,92,8,Kiev
752,747,36,308,417,27,444,0,444,9,330,105,22.04.2019 00:25,92,8,Kiev
400,390,36,118,249,33,282,0,282,0,238,44,21.04.2019 21:35,92,8,Kiev
496,504,53,167,281,48,329,0,329,8,225,96,21.04.2019 21:00,92,8,Kiev
160,150,14,38,111,11,122,0,122,1,99,22,21.04.2019 21:20,92,8,Kiev
400,387,27,135,241,24,265,0,265,2,213,50,21.04.2019 22:40,92,8,Kiev
400,392,29,175,199,26,225,0,225,4,163,58,22.04.2019 00:05,92,8,Kiev
240,236,19,83,140,17,157,0,157,4,102,51,21.04.2019 21:20,92,8,Kiev
400,391,23,166,214,20,234,0,234,5,170,59,21.04.2019 21:00,92,8,Kiev
592,580,40,283,269,40,309,0,309,5,243,61,21.04.2019 22:10,92,8,Kiev
112,111,5,17,90,5,95,0,95,0,73,22,21.04.2019 21:45,92,8,Kiev
256,252,18,63,175,18,193,0,193,1,143,49,22.04.2019 00:15,92,8,Kiev
176,169,6,74,96,6,102,0,102,1,72,29,21.04.2019 21:00,92,8,Kiev
512,506,50,176,286,50,336,0,336,2,267,67,21.04.2019 21:05,92,8,Kiev
416,417,29,142,248,26,274,0,274,2,198,74,21.04.2019 20:45,92,8,Kiev
256,255,34,91,134,31,165,0,165,7,112,46,21.04.2019 21:00,92,8,Kiev
832,832,68,320,452,60,512,0,512,16,374,122,21.04.2019 21:15,92,8,Kiev
208,207,41,47,123,38,161,0,161,3,136,22,21.04.2019 21:06,92,8,Kiev
304,297,23,96,188,20,208,0,208,8,133,67,22.04.2019 00:10,92,8,Kiev
400,398,50,133,217,50,267,0,267,6,183,78,21.04.2019 22:30,92,8,Kiev
496,479,56,186,254,56,310,0,310,3,247,60,21.04.2019 20:34,92,8,Kiev
528,533,45,193,292,43,335,0,335,17,226,92,21.04.2019 21:00,92,8,Kiev
272,261,36,86,152,34,186,0,186,5,148,33,21.04.2019 21:00,92,8,Kiev
128,127,10,43,77,8,85,0,85,5,60,20,21.04.2019 21:30,92,8,Kiev
176,176,13,59,104,13,117,0,117,5,66,46,21.04.2019 20:28,92,8,Kiev
208,208,36,63,114,31,145,0,145,1,91,53,21.04.2019 21:00,93,8,Kiev
464,471,55,147,268,49,317,0,317,7,234,76,21.04.2019 21:10,93,8,Kiev
208,211,23,42,143,23,166,1,166,1,115,50,21.04.2019 21:00,93,8,Kiev
368,366,36,93,239,36,275,0,275,0,219,56,21.04.2019 20:32,93,8,Kiev
448,464,43,74,335,39,374,0,374,5,154,215,21.04.2019 22:35,93,8,Kiev
96,92,14,11,71,14,85,0,85,1,43,41,21.04.2019 21:10,93,8,Kiev
336,341,27,82,227,27,254,0,254,2,187,65,21.04.2019 22:30,93,8,Kiev
624,604,22,250,353,21,374,0,374,4,301,69,21.04.2019 22:00,93,8,Kiev
528,522,35,161,332,35,367,0,367,8,284,75,22.04.2019 00:30,93,8,Kiev
288,286,20,101,167,20,187,0,187,2,125,60,22.04.2019 00:15,93,8,Kiev
592,582,43,187,362,43,405,0,405,11,317,77,21.04.2019 20:30,94,8,Kiev
352,347,22,75,255,22,277,0,277,5,167,105,21.04.2019 20:20,94,8,Kiev
464,460,34,190,243,31,274,0,274,6,196,72,21.04.2019 20:37,94,8,Kiev
192,195,37,53,102,37,139,0,139,0,99,40,21.04.2019 20:50,94,8,Kiev
416,410,18,167,231,18,249,0,249,7,175,67,21.04.2019 21:07,94,8,Kiev
1232,1205,19,556,657,19,676,0,676,12,463,201,21.04.2019 20:50,94,8,Kiev
448,435,38,132,278,38,316,0,316,7,227,82,21.04.2019 20:55,94,8,Kiev
112,103,12,32,68,12,80,0,80,0,62,18,21.04.2019 20:22,94,8,Kiev
272,254,24,108,140,24,164,0,164,6,95,63,21.04.2019 20:20,94,8,Kiev
400,393,22,126,252,22,274,0,274,7,202,65,21.04.2019 20:50,94,8,Kiev
112,113,9,31,72,9,81,0,81,0,57,24,21.04.2019 20:20,94,8,Kiev
720,734,20,256,444,20,464,0,464,11,336,117,21.04.2019 21:45,94,8,Kiev
592,588,36,193,369,30,399,0,399,8,271,120,21.04.2019 20:58,94,8,Kiev
2128,2151,4,586,1539,3,1542,0,1542,42,1080,420,21.04.2019 22:10,94,8,Kiev
96,91,0,35,61,0,61,0,61,1,46,14,21.04.2019 22:00,94,8,Kiev
400,410,3,100,298,2,300,0,300,2,211,87,21.04.2019 20:55,94,8,Kiev
1184,1174,3,362,819,3,822,0,822,27,506,289,21.04.2019 21:40,95,8,Kiev
2224,2198,12,855,1358,11,1369,0,1369,53,865,451,21.04.2019 21:33,95,8,Kiev
1936,1931,2,587,1347,2,1349,0,1349,42,820,487,21.04.2019 22:00,95,8,Kiev
832,815,28,355,449,28,477,0,477,4,339,134,21.04.2019 21:30,95,8,Kiev
2048,2042,12,657,1379,12,1391,0,1391,26,943,422,21.04.2019 21:55,95,8,Kiev
1232,1228,0,426,806,0,806,0,806,13,492,301,21.04.2019 20:43,95,8,Kiev
2416,2568,6,769,1643,4,1647,0,1647,30,1065,552,21.04.2019 22:01,95,8,Kiev
2432,2535,9,757,1669,6,1675,0,1675,46,1125,504,21.04.2019 22:05,95,8,Kiev
2432,2527,5,773,1655,4,1659,0,1659,44,1068,547,21.04.2019 23:00,95,8,Kiev
2048,2035,2,837,1209,2,1211,0,1211,38,847,326,21.04.2019 23:35,95,8,Kiev
336,103,0,233,103,0,103,0,103,6,75,22,21.04.2019 20:14,95,8,Kiev
2560,2647,2,814,1744,2,1746,0,1746,23,1008,715,21.04.2019 21:02,95,8,Kiev
1072,1079,9,480,588,4,592,0,592,13,467,112,21.04.2019 22:10,96,8,Kiev
1024,1015,5,449,573,2,575,0,575,15,455,105,22.04.2019 00:30,96,8,Kiev
256,242,5,127,128,1,129,0,129,1,108,20,22.04.2019 01:15,96,8,Kiev
2224,2201,7,852,1370,2,1372,0,1372,37,1013,322,21.04.2019 23:10,96,8,Kiev
2112,2093,25,844,1246,22,1268,0,1268,24,948,296,21.04.2019 23:00,96,8,Kiev
1664,1652,6,684,977,3,980,0,980,12,714,254,22.04.2019 00:40,96,8,Kiev
1664,1650,6,721,938,5,943,0,943,20,658,265,22.04.2019 00:30,96,8,Kiev
96,86,0,34,62,0,62,0,62,0,44,18,21.04.2019 20:20,96,8,Kiev
864,861,22,290,557,17,574,0,574,10,452,112,21.04.2019 21:15,96,8,Kiev
144,128,13,43,88,13,101,0,101,0,82,19,21.04.2019 20:45,96,8,Kiev
128,128,11,35,82,11,93,0,93,0,59,34,21.04.2019 21:52,96,8,Kiev
160,159,3,47,111,2,113,0,113,2,80,31,21.04.2019 23:30,96,8,Kiev
800,790,55,264,487,49,536,0,536,5,407,124,21.04.2019 22:00,96,8,Kiev
192,183,17,88,87,17,104,0,104,0,62,42,21.04.2019 21:00,96,8,Kiev
80,66,2,35,43,2,45,0,45,0,36,9,22.04.2019 00:32,96,8,Kiev
304,295,9,110,185,9,194,0,194,1,105,88,22.04.2019 00:40,96,8,Kiev
944,940,44,321,580,43,623,0,623,15,427,181,22.04.2019 01:30,96,8,Kiev
576,570,7,249,322,5,327,0,327,6,242,79,22.04.2019 00:20,96,8,Kiev
496,489,36,213,249,34,283,0,283,3,210,70,21.04.2019 23:02,96,8,Kiev
128,117,27,50,51,27,78,0,78,0,47,31,21.04.2019 20:55,96,8,Kiev
272,268,6,112,154,6,160,0,160,7,120,33,21.04.2019 20:50,96,8,Kiev
656,647,36,303,317,36,353,0,353,12,252,89,22.04.2019 00:26,96,8,Kiev
400,394,35,87,278,35,313,0,313,5,237,71,21.04.2019 22:50,96,8,Kiev
688,677,8,178,502,8,510,0,510,9,406,95,21.04.2019 21:15,96,8,Kiev
1088,1086,25,412,651,25,676,0,676,17,543,116,21.04.2019 21:41,96,8,Kiev
240,28,16,214,12,14,26,0,26,0,17,9,21.04.2019 20:20,96,8,Kiev
2304,2446,8,589,1708,7,1715,0,1715,35,1039,641,22.04.2019 00:10,96,8,Kiev
2304,2533,11,480,1816,8,1824,0,1824,39,1163,622,22.04.2019 00:30,96,8,Kiev
2336,2364,11,759,1569,8,1577,0,1577,48,997,532,22.04.2019 00:40,96,8,Kiev
2272,2309,6,625,1643,4,1647,0,1647,42,981,624,22.04.2019 01:15,96,8,Kiev
2208,2251,11,665,1534,9,1543,0,1543,47,934,562,21.04.2019 21:25,96,8,Kiev
1904,1893,9,524,1379,1,1380,0,1380,39,923,418,21.04.2019 21:30,96,8,Kiev
2272,2260,14,887,1372,13,1385,0,1385,36,972,377,22.04.2019 00:05,96,8,Kiev
2160,2131,14,895,1254,11,1265,0,1265,35,924,306,22.04.2019 00:30,96,8,Kiev
160,153,10,62,88,10,98,0,98,2,69,27,21.04.2019 20:25,96,8,Kiev
128,123,2,53,73,2,75,0,75,2,45,28,21.04.2019 20:30,96,8,Kiev
192,180,33,43,116,33,149,0,149,3,113,33,22.04.2019 00:15,96,8,Kiev
192,182,17,38,137,17,154,0,154,0,119,35,22.04.2019 00:08,96,8,Kiev
592,578,29,206,358,28,386,0,386,6,291,89,22.04.2019 00:20,96,8,Kiev
352,335,3,154,195,3,198,0,198,3,159,36,22.04.2019 00:05,96,8,Kiev
704,691,33,278,394,32,426,0,426,12,339,75,21.04.2019 21:40,96,8,Kiev
1680,1645,10,681,992,7,999,0,999,38,699,262,21.04.2019 21:30,96,8,Kiev
1232,1214,20,495,719,18,737,0,737,14,535,188,22.04.2019 00:15,96,8,Kiev
64,63,5,19,41,4,45,0,45,0,36,9,21.04.2019 20:30,96,8,Kiev
1328,1326,20,553,761,14,775,0,775,13,592,170,21.04.2019 21:30,96,8,Kiev
1008,1023,27,346,638,24,662,0,662,7,474,181,21.04.2019 22:06,96,8,Kiev
1040,1035,14,368,661,11,672,0,672,11,498,163,22.04.2019 00:30,96,8,Kiev
336,340,17,160,163,13,176,0,176,4,132,40,21.04.2019 21:45,96,8,Kiev
2096,2098,29,670,1398,28,1426,0,1426,36,986,404,22.04.2019 00:35,96,8,Kiev
144,146,12,22,110,12,122,0,122,1,66,55,22.04.2019 00:15,96,8,Kiev
1008,1013,19,395,600,13,613,0,613,11,441,161,21.04.2019 22:40,96,8,Kiev
2240,2274,4,711,1525,4,1529,0,1529,42,1013,474,22.04.2019 00:45,96,8,Kiev
2016,2035,8,686,1323,7,1330,0,1330,31,930,369,22.04.2019 00:07,96,8,Kiev
1728,1798,3,491,1235,2,1237,0,1237,31,872,334,21.04.2019 22:11,96,8,Kiev
1264,1253,6,454,805,5,810,0,810,26,559,225,22.04.2019 00:00,96,8,Kiev
592,611,2,143,447,2,449,0,449,9,317,123,21.04.2019 21:50,96,8,Kiev
480,479,28,131,322,27,349,0,349,10,261,78,21.04.2019 20:45,96,8,Kiev
416,412,24,132,260,24,284,0,284,2,192,90,22.04.2019 00:03,96,8,Kiev
384,384,33,136,219,29,248,0,248,2,195,51,21.04.2019 21:00,96,8,Kiev
992,993,3,397,592,3,595,0,595,11,452,132,22.04.2019 00:00,96,8,Kiev
160,157,21,36,105,19,124,0,124,1,95,28,22.04.2019 00:05,96,8,Kiev
272,266,47,87,138,47,185,0,185,3,122,60,21.04.2019 23:30,96,8,Kiev
256,265,16,50,193,13,206,0,206,0,161,45,21.04.2019 20:40,96,8,Kiev
1072,1054,5,313,755,4,759,0,759,12,562,185,22.04.2019 00:35,96,8,Kiev
304,303,25,111,171,22,193,0,193,6,134,53,22.04.2019 00:02,96,8,Kiev
128,43,9,85,34,9,43,0,43,0,26,17,21.04.2019 21:10,96,8,Kiev
176,54,0,130,46,0,46,0,46,4,31,11,22.04.2019 00:15,96,8,Kiev
2272,2234,24,874,1379,19,1398,0,1398,29,954,415,22.04.2019 00:30,96,8,Kiev
2208,2158,38,866,1307,35,1342,0,1342,32,930,380,21.04.2019 21:30,96,8,Kiev
1952,1917,10,739,1206,7,1213,0,1213,16,776,421,22.04.2019 00:15,96,8,Kiev
864,843,40,376,454,34,488,0,488,18,345,125,21.04.2019 21:00,96,8,Kiev
1024,1016,166,221,653,150,803,0,803,14,495,294,21.04.2019 21:24,96,8,Kiev
704,700,40,272,395,37,432,0,432,3,313,116,21.04.2019 20:40,96,8,Kiev
576,562,28,256,301,19,320,0,320,5,236,79,22.04.2019 00:20,96,8,Kiev
496,498,53,201,252,43,295,0,295,3,214,78,21.04.2019 21:14,96,8,Kiev
832,822,38,386,420,26,446,0,446,4,365,77,22.04.2019 00:15,96,8,Kiev
352,360,37,126,196,30,226,0,226,7,169,50,21.04.2019 21:30,96,8,Kiev
368,360,16,89,267,12,279,0,279,3,239,37,22.04.2019 00:35,96,8,Kiev
352,356,26,139,194,19,213,0,213,5,145,63,21.04.2019 21:20,96,8,Kiev
288,279,20,110,162,16,178,0,178,5,112,61,22.04.2019 00:05,96,8,Kiev
304,287,18,126,164,14,178,0,178,0,141,37,22.04.2019 00:08,96,8,Kiev
272,259,12,135,126,11,137,0,137,3,81,53,22.04.2019 00:30,96,8,Kiev
256,253,9,88,159,9,168,0,168,4,104,60,22.04.2019 00:05,96,8,Kiev
208,205,20,98,91,19,110,0,110,5,80,25,22.04.2019 00:55,96,8,Kiev
80,69,10,33,40,7,47,0,47,1,30,16,21.04.2019 22:10,96,8,Kiev
144,143,14,48,84,12,96,0,96,2,60,34,22.04.2019 01:10,96,8,Kiev
144,141,14,52,82,10,92,0,92,1,65,26,21.04.2019 20:50,96,8,Kiev
128,125,30,38,62,28,90,0,90,7,42,41,22.04.2019 00:10,96,8,Kiev
128,119,3,52,73,3,76,0,76,0,58,18,21.04.2019 20:30,96,8,Kiev
128,114,13,45,71,12,83,0,83,1,43,39,21.04.2019 21:30,96,8,Kiev
128,117,14,52,62,14,76,0,76,2,48,26,21.04.2019 23:00,96,8,Kiev
160,151,8,93,61,6,67,0,67,0,48,19,22.04.2019 00:10,96,8,Kiev
160,161,13,56,92,12,104,0,104,2,83,19,22.04.2019 00:15,96,8,Kiev
112,108,10,45,57,10,67,0,67,1,48,18,21.04.2019 21:15,96,8,Kiev
96,89,7,39,50,7,57,0,57,1,40,16,21.04.2019 21:50,96,8,Kiev
144,146,20,27,97,20,117,0,117,2,58,57,22.04.2019 00:40,96,8,Kiev
144,141,22,48,75,21,96,0,96,0,61,35,21.04.2019 22:05,96,8,Kiev
96,94,13,27,57,12,69,0,69,0,50,19,22.04.2019 00:20,96,8,Kiev
80,73,8,34,39,7,46,0,46,0,31,15,22.04.2019 00:30,96,8,Kiev
80,81,1,23,56,1,57,0,57,1,26,30,21.04.2019 22:37,96,8,Kiev
64,60,14,34,19,11,30,0,30,0,25,5,21.04.2019 21:30,96,8,Kiev
64,53,1,35,29,0,29,0,29,0,21,8,21.04.2019 20:40,96,8,Kiev
64,52,5,30,29,5,34,0,34,1,25,8,21.04.2019 20:15,96,8,Kiev
128,35,9,94,25,9,34,0,34,1,19,14,21.04.2019 21:30,96,8,Kiev
624,609,30,276,325,23,348,0,348,6,238,104,22.04.2019 00:05,96,8,Kiev
304,292,25,138,145,21,166,0,166,1,145,20,21.04.2019 21:50,96,8,Kiev
144,141,10,45,89,10,99,0,99,3,74,22,22.04.2019 00:30,96,8,Kiev
704,682,62,311,335,58,393,0,393,4,290,99,22.04.2019 00:15,96,8,Kiev
144,133,17,54,74,16,90,0,90,2,58,30,22.04.2019 00:10,96,8,Kiev
48,15,2,36,12,0,12,0,12,0,6,6,22.04.2019 00:05,96,8,Kiev
784,832,6,214,565,5,570,0,570,20,340,210,22.04.2019 00:35,96,8,Kiev
2320,2361,10,702,1611,7,1618,0,1618,26,1027,565,22.04.2019 00:10,96,8,Kiev
1488,1516,14,451,1028,9,1037,0,1037,29,646,362,21.04.2019 22:15,96,8,Kiev
2096,2207,8,546,1546,4,1550,0,1550,31,1003,516,22.04.2019 00:30,96,8,Kiev
2224,2319,6,665,1555,4,1559,0,1559,50,1024,485,22.04.2019 00:11,96,8,Kiev
2416,2468,6,702,1709,5,1714,0,1714,48,1092,574,22.04.2019 01:00,96,8,Kiev
2208,2284,3,784,1423,1,1424,0,1424,35,851,538,22.04.2019 00:15,96,8,Kiev
1056,1040,0,350,706,0,706,0,706,27,499,180,21.04.2019 21:20,96,8,Kiev
1072,1074,8,386,680,6,686,0,686,14,469,203,22.04.2019 00:10,97,8,Kiev
608,602,16,224,373,11,384,0,384,13,257,114,22.04.2019 00:15,97,8,Kiev
672,662,24,252,396,24,420,0,420,3,321,96,22.04.2019 00:05,97,8,Kiev
864,847,24,431,415,18,433,0,433,12,333,88,22.04.2019 00:10,97,8,Kiev
1216,1191,18,561,643,12,655,0,655,11,475,169,22.04.2019 00:30,97,8,Kiev
336,325,26,131,179,26,205,0,205,1,152,52,22.04.2019 00:05,97,8,Kiev
688,677,60,251,384,53,437,0,437,13,298,126,22.04.2019 00:20,97,8,Kiev
384,378,23,136,231,17,248,0,248,10,196,42,22.04.2019 00:10,97,8,Kiev
768,758,52,370,359,39,398,0,398,5,294,99,22.04.2019 00:15,97,8,Kiev
912,908,50,388,487,37,524,0,524,15,390,119,22.04.2019 00:05,97,8,Kiev
528,513,39,190,299,39,338,0,338,6,227,105,22.04.2019 00:01,97,8,Kiev
240,221,21,100,119,21,140,0,140,1,92,47,21.04.2019 21:00,97,8,Kiev
432,432,9,195,229,8,237,0,237,3,168,66,22.04.2019 00:25,97,8,Kiev
960,999,140,345,493,122,615,0,615,11,383,221,22.04.2019 00:10,97,8,Kiev
560,548,57,225,285,50,335,0,335,4,242,89,22.04.2019 00:10,97,8,Kiev
160,163,14,43,108,9,117,0,117,4,87,26,22.04.2019 00:20,97,8,Kiev
720,715,44,267,413,40,453,0,453,12,334,107,22.04.2019 00:05,97,8,Kiev
128,123,8,38,82,8,90,0,90,0,81,9,22.04.2019 00:23,97,8,Kiev
608,603,45,231,334,43,377,0,377,7,279,91,22.04.2019 00:31,97,8,Kiev
1536,1522,8,652,876,8,884,0,884,19,716,149,22.04.2019 00:30,97,8,Kiev
96,90,0,22,74,0,74,0,74,2,51,21,22.04.2019 00:05,97,8,Kiev
464,450,8,191,265,8,273,0,273,5,223,45,22.04.2019 00:20,97,8,Kiev
1680,1679,7,758,917,5,922,0,922,3,760,159,22.04.2019 00:20,97,8,Kiev
2304,2289,6,941,1359,4,1363,0,1363,30,1107,226,22.04.2019 01:20,97,8,Kiev
1104,1085,12,581,511,12,523,0,523,16,385,122,22.04.2019 00:05,97,8,Kiev
912,898,5,405,503,4,507,0,507,14,403,90,22.04.2019 00:04,97,8,Kiev
208,203,2,97,109,2,111,0,111,2,92,17,22.04.2019 00:10,97,8,Kiev
256,260,14,100,143,13,156,0,156,0,120,36,22.04.2019 00:13,97,8,Kiev
96,84,4,50,42,4,46,0,46,0,35,11,21.04.2019 22:05,97,8,Kiev
112,108,9,28,75,9,84,0,84,1,58,25,22.04.2019 00:10,97,8,Kiev
1008,1006,28,336,648,24,672,0,672,14,508,150,22.04.2019 00:05,97,8,Kiev
208,202,14,91,103,14,117,0,117,1,96,20,22.04.2019 00:03,97,8,Kiev
1168,1185,15,420,733,15,748,0,748,8,531,209,22.04.2019 00:05,97,8,Kiev
352,342,36,92,226,34,260,0,260,5,180,75,22.04.2019 01:10,97,8,Kiev
704,689,39,296,371,37,408,0,408,3,305,100,22.04.2019 00:30,97,8,Kiev
144,133,19,66,59,19,78,0,78,0,62,16,22.04.2019 00:10,97,8,Kiev
1968,1954,8,657,1303,8,1311,0,1311,19,889,403,22.04.2019 00:27,97,8,Kiev
416,418,15,103,299,14,313,0,313,5,191,117,22.04.2019 00:17,97,8,Kiev
1040,1039,36,376,635,29,664,0,664,12,465,187,22.04.2019 00:25,97,8,Kiev
1312,1293,50,626,638,48,686,0,686,9,517,160,22.04.2019 00:46,97,8,Kiev
816,802,44,353,419,44,463,0,463,18,335,110,22.04.2019 00:30,97,8,Kiev
1232,1187,2,477,753,2,755,0,755,6,527,222,22.04.2019 00:31,97,8,Kiev
2064,2071,2,698,1365,1,1366,0,1366,30,920,416,22.04.2019 00:02,97,8,Kiev
1760,1778,9,550,1205,5,1210,0,1210,36,814,360,22.04.2019 00:45,97,8,Kiev
1840,1846,8,610,1225,5,1230,0,1230,34,823,373,22.04.2019 00:07,97,8,Kiev
1936,2066,4,496,1437,3,1440,0,1440,23,907,510,22.04.2019 00:12,97,8,Kiev
1856,1850,11,635,1210,11,1221,0,1221,38,770,413,22.04.2019 00:05,97,8,Kiev
2096,2109,10,672,1417,7,1424,0,1424,33,975,416,22.04.2019 00:01,97,8,Kiev
2080,2071,25,655,1405,20,1425,0,1425,32,993,400,22.04.2019 00:10,97,8,Kiev
2048,2053,3,754,1292,2,1294,0,1294,35,919,340,22.04.2019 00:04,97,8,Kiev
768,146,59,625,90,53,143,0,143,3,101,39,22.04.2019 00:05,97,8,Kiev
1744,1753,5,510,1230,4,1234,0,1234,35,855,344,22.04.2019 00:10,97,8,Kiev
144,134,14,34,96,14,110,0,110,1,70,39,21.04.2019 20:14,98,8,Kiev
320,318,24,118,178,24,202,0,202,6,158,38,21.04.2019 22:45,98,8,Kiev
576,576,47,225,304,47,351,0,351,6,270,75,21.04.2019 20:50,98,8,Kiev
496,496,6,218,272,6,278,0,278,4,187,87,21.04.2019 20:22,98,8,Kiev
288,283,26,94,168,26,194,0,194,3,140,51,21.04.2019 20:40,98,8,Kiev
320,306,46,122,157,41,198,0,198,3,127,68,21.04.2019 20:30,98,8,Kiev
1264,1247,43,583,646,35,681,0,681,16,514,151,21.04.2019 21:45,98,8,Kiev
448,449,66,134,252,62,314,0,314,8,189,117,21.04.2019 20:55,98,8,Kiev
384,390,37,99,252,33,285,0,285,3,158,124,21.04.2019 20:30,98,8,Kiev
160,158,29,28,107,25,132,0,132,4,48,80,21.04.2019 21:00,98,8,Kiev
720,577,5,144,571,5,576,0,576,56,466,54,22.04.2019 01:55,99,9,Kirov
1296,1265,5,468,824,4,828,0,828,27,607,194,22.04.2019 00:45,99,9,Kirov
1168,1132,0,757,411,0,411,0,411,13,322,76,22.04.2019 00:11,99,9,Kirov
1408,1384,6,519,886,3,889,0,889,26,683,180,22.04.2019 00:10,99,9,Kirov
1664,1625,5,627,1033,4,1037,0,1037,20,807,210,22.04.2019 00:15,99,9,Kirov
2416,2372,12,959,1450,7,1457,0,1457,44,1122,291,21.04.2019 21:30,99,9,Kirov
1312,1312,3,435,874,3,877,0,877,16,625,236,22.04.2019 00:30,99,9,Kirov
1488,1472,5,646,840,2,842,0,842,16,655,171,22.04.2019 00:03,99,9,Kirov
1440,1405,9,675,760,5,765,0,765,14,599,152,22.04.2019 00:35,99,9,Kirov
1632,1590,8,655,970,7,977,0,977,23,785,169,22.04.2019 00:10,99,9,Kirov
2160,2106,6,876,1279,5,1284,0,1284,22,963,299,22.04.2019 02:15,99,9,Kirov
752,728,2,285,465,2,467,0,467,9,370,88,22.04.2019 00:05,99,9,Kirov
1808,1767,5,668,1136,4,1140,0,1140,25,887,228,21.04.2019 21:30,99,9,Kirov
2272,2222,4,863,1407,2,1409,0,1409,34,1061,314,22.04.2019 00:50,99,9,Kirov
1408,1384,7,457,947,4,951,0,951,24,751,176,22.04.2019 00:10,99,9,Kirov
1728,1712,13,616,1101,11,1112,0,1112,27,819,266,22.04.2019 00:40,99,9,Kirov
1760,1728,4,547,1210,3,1213,0,1213,31,873,309,22.04.2019 00:10,99,9,Kirov
2032,2002,8,773,1255,4,1259,0,1259,23,951,285,22.04.2019 00:05,99,9,Kirov
1616,1585,6,549,1062,5,1067,0,1067,24,789,254,22.04.2019 00:05,99,9,Kirov
2112,2078,7,746,1362,4,1366,0,1366,33,1053,280,22.04.2019 00:20,99,9,Kirov
2208,2164,8,725,1479,4,1483,0,1483,26,1142,315,22.04.2019 01:55,99,9,Kirov
2336,2284,9,894,1436,6,1442,0,1442,24,1115,303,21.04.2019 22:50,99,9,Kirov
2336,2275,5,916,1416,4,1420,0,1420,35,1060,325,21.04.2019 22:15,99,9,Kirov
224,182,12,53,160,11,171,0,171,4,120,47,21.04.2019 23:37,99,9,Kirov
320,105,90,224,15,81,96,0,96,0,85,11,21.04.2019 23:00,99,9,Kirov
144,87,23,61,60,23,83,0,83,1,68,14,21.04.2019 22:20,99,9,Kirov
816,296,203,559,87,170,257,0,257,9,213,35,21.04.2019 22:45,99,9,Kirov
256,29,3,227,26,3,29,0,29,1,18,10,22.04.2019 00:15,99,9,Kirov
1552,1540,10,610,934,8,942,0,942,21,744,177,22.04.2019 01:23,99,9,Kirov
976,956,3,387,587,2,589,0,589,10,472,107,22.04.2019 00:20,99,9,Kirov
2128,2105,8,784,1341,3,1344,0,1344,27,1023,294,22.04.2019 01:15,99,9,Kirov
2256,2211,3,915,1339,2,1341,0,1341,30,1077,234,22.04.2019 00:07,99,9,Kirov
1184,1162,25,443,720,21,741,0,741,15,583,143,22.04.2019 00:30,99,9,Kirov
1712,1694,8,749,955,8,963,0,963,26,738,199,22.04.2019 00:25,99,9,Kirov
1184,1160,4,441,741,2,743,0,743,23,569,151,22.04.2019 00:20,99,9,Kirov
928,924,9,326,595,7,602,0,602,20,431,151,21.04.2019 21:40,99,9,Kirov
1408,1454,15,487,910,11,921,0,921,36,628,257,21.04.2019 21:55,99,9,Kirov
768,748,2,313,455,0,455,0,455,8,355,92,21.04.2019 23:00,99,9,Kirov
688,666,0,309,379,0,379,0,379,4,276,99,22.04.2019 00:30,99,9,Kirov
2176,2146,5,817,1355,4,1359,0,1359,40,1071,248,22.04.2019 00:30,99,9,Kirov
1856,1823,7,684,1168,4,1172,0,1172,37,826,309,21.04.2019 21:50,99,9,Kirov
1728,1711,5,766,958,4,962,0,962,31,712,219,22.04.2019 00:05,99,9,Kirov
2064,2031,11,750,1307,7,1314,0,1314,31,951,332,22.04.2019 00:20,99,9,Kirov
288,48,18,242,30,16,46,0,46,0,32,14,21.04.2019 21:00,99,9,Kirov
416,21,0,402,14,0,14,0,14,0,12,2,21.04.2019 21:04,99,9,Kirov
976,492,0,484,492,0,492,0,492,29,434,29,22.04.2019 01:26,99,9,Kirov
1824,1801,31,824,972,28,1000,0,1000,28,818,154,22.04.2019 00:05,100,9,Kirov
1792,1772,45,741,1013,38,1051,0,1051,26,833,192,22.04.2019 01:05,100,9,Kirov
1792,1755,14,666,1114,12,1126,0,1126,16,918,192,22.04.2019 00:10,100,9,Kirov
1952,1935,23,832,1098,22,1120,0,1120,24,932,164,22.04.2019 01:10,100,9,Kirov
1328,1300,12,659,657,12,669,0,669,30,563,76,22.04.2019 00:35,100,9,Kirov
240,231,6,101,134,5,139,0,139,2,121,16,21.04.2019 21:00,100,9,Kirov
256,249,14,118,127,11,138,0,138,3,113,22,21.04.2019 22:15,100,9,Kirov
256,248,23,99,134,23,157,0,157,4,87,66,21.04.2019 20:56,100,9,Kirov
48,36,1,27,20,1,21,0,21,0,15,6,21.04.2019 20:40,100,9,Kirov
320,314,19,142,159,19,178,0,178,1,148,29,21.04.2019 21:15,100,9,Kirov
336,317,9,115,212,9,221,0,221,2,161,58,22.04.2019 00:04,100,9,Kirov
688,682,37,309,345,34,379,0,379,6,268,105,21.04.2019 22:10,100,9,Kirov
96,95,4,34,59,3,62,0,62,0,44,18,22.04.2019 00:31,100,9,Kirov
192,177,4,72,117,3,120,0,120,2,103,15,21.04.2019 20:30,100,9,Kirov
496,476,40,189,267,40,307,0,307,1,210,96,21.04.2019 20:45,100,9,Kirov
384,364,31,139,214,31,245,0,245,4,188,53,22.04.2019 00:10,100,9,Kirov
336,323,16,110,212,14,226,0,226,7,190,29,21.04.2019 20:55,100,9,Kirov
128,121,5,50,73,5,78,0,78,0,71,7,21.04.2019 20:55,100,9,Kirov
432,412,17,183,234,15,249,0,249,5,165,79,22.04.2019 00:15,100,9,Kirov
128,127,9,35,88,5,93,0,93,5,50,38,22.04.2019 00:10,100,9,Kirov
208,195,4,109,98,1,99,0,99,2,66,31,21.04.2019 22:30,100,9,Kirov
400,395,16,156,230,14,244,0,244,3,216,25,22.04.2019 00:20,100,9,Kirov
96,90,1,32,63,1,64,0,64,2,51,11,22.04.2019 00:10,100,9,Kirov
576,554,37,247,294,35,329,0,329,0,279,50,21.04.2019 21:11,100,9,Kirov
208,194,7,79,124,5,129,0,129,2,81,46,21.04.2019 20:35,100,9,Kirov
16,15,3,8,6,2,8,0,8,0,5,3,21.04.2019 21:40,100,9,Kirov
432,417,21,136,278,18,296,0,296,3,258,35,22.04.2019 00:10,100,9,Kirov
256,252,13,110,137,9,146,0,146,3,111,32,21.04.2019 20:20,100,9,Kirov
320,312,28,103,191,26,217,0,217,2,171,44,22.04.2019 00:17,100,9,Kirov
448,444,28,166,257,25,282,0,282,4,209,69,22.04.2019 00:05,100,9,Kirov
80,78,2,36,42,2,44,0,44,2,33,9,21.04.2019 21:05,100,9,Kirov
160,153,13,57,90,13,103,0,103,3,65,35,21.04.2019 22:30,100,9,Kirov
320,303,13,135,172,13,185,0,185,5,135,45,22.04.2019 00:45,100,9,Kirov
416,409,15,159,242,15,257,0,257,3,209,45,21.04.2019 20:30,100,9,Kirov
384,379,17,129,238,17,255,0,255,5,231,19,22.04.2019 00:10,100,9,Kirov
384,383,21,101,266,17,283,0,283,3,197,83,21.04.2019 20:45,100,9,Kirov
560,545,40,222,298,40,338,0,338,4,276,58,22.04.2019 00:10,100,9,Kirov
208,196,4,78,126,4,130,0,130,2,95,33,21.04.2019 23:10,100,9,Kirov
64,53,2,36,28,0,28,0,28,0,21,7,22.04.2019 00:20,100,9,Kirov
240,231,6,124,111,5,116,0,116,1,95,20,21.04.2019 20:40,100,9,Kirov
224,218,15,78,134,12,146,0,146,2,121,23,21.04.2019 23:15,100,9,Kirov
720,710,36,286,400,34,434,0,434,7,360,67,22.04.2019 00:15,100,9,Kirov
160,155,11,66,85,9,94,0,94,0,73,21,21.04.2019 21:00,100,9,Kirov
1120,1051,35,502,590,28,618,0,618,11,499,108,21.04.2019 23:38,100,9,Kirov
1872,1852,20,742,1110,20,1130,0,1130,24,932,174,21.04.2019 23:50,100,9,Kirov
768,772,43,332,394,42,436,0,436,6,358,72,22.04.2019 00:30,100,9,Kirov
1088,1058,25,373,690,25,715,0,715,11,565,139,22.04.2019 00:15,100,9,Kirov
128,123,10,38,80,10,90,0,90,4,63,23,22.04.2019 00:10,100,9,Kirov
688,680,21,337,330,21,351,0,351,6,298,47,22.04.2019 00:20,100,9,Kirov
304,298,24,145,138,21,159,0,159,3,129,27,21.04.2019 21:30,100,9,Kirov
720,713,11,241,468,11,479,0,479,13,343,123,21.04.2019 21:30,100,9,Kirov
400,399,23,168,214,18,232,0,232,5,170,57,21.04.2019 22:00,100,9,Kirov
288,285,26,111,151,26,177,0,177,2,153,22,21.04.2019 20:40,100,9,Kirov
912,898,70,419,428,65,493,0,493,9,414,70,21.04.2019 21:10,100,9,Kirov
416,409,7,190,222,4,226,0,226,2,180,44,21.04.2019 21:30,100,9,Kirov
336,314,10,131,195,10,205,0,205,0,165,40,21.04.2019 23:50,100,9,Kirov
224,204,2,102,120,2,122,0,122,5,97,20,21.04.2019 22:30,100,9,Kirov
672,659,47,271,359,42,401,0,401,3,356,42,22.04.2019 01:00,100,9,Kirov
240,233,31,115,98,27,125,0,125,3,80,42,21.04.2019 22:00,100,9,Kirov
512,497,31,239,250,23,273,0,273,7,198,68,21.04.2019 21:35,100,9,Kirov
208,203,15,76,117,15,132,0,132,2,109,21,21.04.2019 21:00,100,9,Kirov
320,306,13,103,204,13,217,0,217,2,180,35,22.04.2019 00:45,100,9,Kirov
272,267,18,53,201,18,219,0,219,3,192,24,21.04.2019 23:59,100,9,Kirov
272,268,15,90,168,14,182,0,182,2,154,26,21.04.2019 23:00,100,9,Kirov
352,346,16,101,236,15,251,0,251,9,199,43,22.04.2019 01:00,100,9,Kirov
224,221,12,89,123,12,135,0,135,2,96,37,22.04.2019 00:25,100,9,Kirov
224,215,11,109,105,10,115,0,115,1,96,18,21.04.2019 22:10,100,9,Kirov
688,677,51,306,337,45,382,0,382,4,299,79,22.04.2019 00:30,100,9,Kirov
704,683,32,276,399,29,428,0,428,7,348,73,22.04.2019 00:20,100,9,Kirov
320,307,18,144,161,15,176,0,176,5,144,27,22.04.2019 00:05,100,9,Kirov
400,389,19,157,224,19,243,0,243,2,205,36,22.04.2019 01:05,100,9,Kirov
112,98,10,54,48,10,58,0,58,4,46,8,21.04.2019 22:00,100,9,Kirov
144,132,0,77,67,0,67,0,67,0,54,13,21.04.2019 21:42,100,9,Kirov
784,777,25,290,472,22,494,0,494,1,416,77,22.04.2019 00:30,100,9,Kirov
288,283,15,118,161,9,170,0,170,3,140,27,22.04.2019 00:05,100,9,Kirov
496,475,32,170,295,31,326,0,326,4,279,43,21.04.2019 21:00,100,9,Kirov
560,541,53,197,316,47,363,0,363,4,287,72,21.04.2019 22:30,100,9,Kirov
544,520,52,181,311,52,363,0,363,1,320,42,21.04.2019 20:30,100,9,Kirov
368,158,26,267,83,18,101,0,101,1,86,14,21.04.2019 22:30,100,9,Kirov
2336,2297,30,838,1476,22,1498,0,1498,26,1255,217,22.04.2019 00:20,100,9,Kirov
1520,1492,19,633,868,19,887,0,887,15,760,112,22.04.2019 01:30,100,9,Kirov
416,409,5,194,218,4,222,0,222,6,194,22,21.04.2019 23:50,100,9,Kirov
304,296,8,114,182,8,190,0,190,2,123,65,22.04.2019 00:20,100,9,Kirov
224,215,7,94,125,5,130,0,130,4,80,46,21.04.2019 21:00,100,9,Kirov
352,335,9,142,202,8,210,0,210,1,180,29,21.04.2019 22:00,100,9,Kirov
128,125,4,42,83,3,86,0,86,2,65,19,21.04.2019 21:20,100,9,Kirov
304,292,11,106,188,10,198,0,198,10,146,42,21.04.2019 21:05,100,9,Kirov
464,450,40,174,254,36,290,0,290,3,211,76,21.04.2019 23:30,100,9,Kirov
288,284,16,146,126,16,142,0,142,0,110,32,22.04.2019 00:10,100,9,Kirov
528,512,32,217,280,31,311,0,311,1,268,42,22.04.2019 00:14,100,9,Kirov
720,704,19,259,443,18,461,0,461,8,372,81,21.04.2019 21:10,100,9,Kirov
288,277,3,149,137,2,139,0,139,0,121,18,22.04.2019 00:05,100,9,Kirov
432,416,29,198,210,24,234,0,234,8,181,45,21.04.2019 22:30,100,9,Kirov
464,444,38,186,248,30,278,0,278,7,225,46,21.04.2019 22:10,100,9,Kirov
208,203,18,82,108,18,126,0,126,0,91,35,22.04.2019 00:30,100,9,Kirov
80,74,0,36,44,0,44,0,44,0,26,18,21.04.2019 20:30,100,9,Kirov
528,517,6,211,313,4,317,0,317,3,243,71,21.04.2019 21:00,100,9,Kirov
400,392,9,175,218,7,225,0,225,3,165,57,21.04.2019 21:30,100,9,Kirov
336,322,20,129,193,14,207,0,207,5,163,39,22.04.2019 00:30,100,9,Kirov
656,644,37,280,340,36,376,0,376,3,301,72,22.04.2019 00:10,100,9,Kirov
512,497,4,244,264,4,268,0,268,1,213,54,22.04.2019 00:05,100,9,Kirov
288,276,9,125,156,7,163,0,163,1,140,22,21.04.2019 21:30,100,9,Kirov
848,827,28,396,432,20,452,0,452,9,377,66,22.04.2019 02:06,100,9,Kirov
432,430,30,178,225,29,254,0,254,9,198,47,21.04.2019 20:51,100,9,Kirov
352,346,16,143,196,13,209,0,209,4,174,31,22.04.2019 00:45,100,9,Kirov
848,826,62,392,402,54,456,0,456,5,388,63,22.04.2019 00:05,100,9,Kirov
256,252,23,87,149,20,169,0,169,3,136,30,22.04.2019 01:20,100,9,Kirov
384,374,42,148,199,37,236,0,236,4,182,50,21.04.2019 20:47,100,9,Kirov
752,731,31,276,450,26,476,0,476,3,431,42,22.04.2019 00:33,100,9,Kirov
416,401,21,154,247,15,262,0,262,4,220,38,21.04.2019 22:30,100,9,Kirov
2128,2100,4,827,1298,3,1301,0,1301,16,1099,186,22.04.2019 00:15,100,9,Kirov
1296,1263,8,659,633,4,637,0,637,21,502,114,22.04.2019 01:20,100,9,Kirov
1696,1653,6,628,1064,4,1068,0,1068,15,856,197,22.04.2019 00:12,100,9,Kirov
1680,1651,5,657,1019,4,1023,0,1023,29,776,218,22.04.2019 00:35,100,9,Kirov
736,376,121,376,250,110,360,0,360,7,277,76,22.04.2019 00:15,100,9,Kirov
1408,1375,9,497,903,8,911,0,911,17,742,152,22.04.2019 00:30,100,9,Kirov
1728,1691,14,657,1059,12,1071,0,1071,19,805,247,22.04.2019 00:15,100,9,Kirov
1392,1368,5,572,815,5,820,0,820,10,719,91,21.04.2019 21:00,101,9,Kirov
1008,982,12,468,530,10,540,0,540,15,415,110,21.04.2019 22:30,101,9,Kirov
304,308,22,119,164,21,185,0,185,5,130,50,21.04.2019 23:30,101,9,Kirov
688,681,35,313,340,35,375,0,375,5,270,100,21.04.2019 22:00,101,9,Kirov
240,225,10,112,118,10,128,0,128,1,96,31,22.04.2019 00:05,101,9,Kirov
464,452,45,182,242,40,282,0,282,3,214,65,22.04.2019 00:01,101,9,Kirov
320,312,22,114,184,22,206,0,206,1,134,71,22.04.2019 00:19,101,9,Kirov
1536,1537,40,682,819,35,854,0,854,21,666,167,22.04.2019 00:07,101,9,Kirov
1456,1414,5,637,814,5,819,0,819,23,610,186,22.04.2019 00:15,101,9,Kirov
1840,1836,25,727,1091,22,1113,0,1113,29,805,279,22.04.2019 00:15,101,9,Kirov
1440,1420,5,597,840,3,843,0,843,21,621,201,22.04.2019 01:10,101,9,Kirov
528,518,4,219,306,3,309,0,309,9,220,80,22.04.2019 00:10,101,9,Kirov
2176,2133,37,919,1221,36,1257,0,1257,25,1031,201,21.04.2019 22:55,101,9,Kirov
2208,2154,43,993,1187,28,1215,0,1215,31,1013,171,22.04.2019 00:55,101,9,Kirov
320,324,21,118,185,17,202,0,202,3,127,72,21.04.2019 21:00,101,9,Kirov
416,414,18,177,221,18,239,0,239,5,180,54,22.04.2019 00:15,101,9,Kirov
384,368,3,159,222,3,225,0,225,2,161,62,22.04.2019 00:35,101,9,Kirov
384,388,24,150,210,24,234,150,234,6,163,65,21.04.2019 20:30,101,9,Kirov
560,538,24,220,316,24,340,0,340,7,263,70,21.04.2019 20:50,101,9,Kirov
496,476,10,200,287,9,296,0,296,7,195,94,22.04.2019 00:45,101,9,Kirov
368,354,23,138,207,23,230,0,230,7,151,72,22.04.2019 00:05,101,9,Kirov
400,388,5,187,208,5,213,0,213,2,181,30,21.04.2019 20:20,101,9,Kirov
128,122,1,60,67,1,68,0,68,1,58,9,22.04.2019 00:05,101,9,Kirov
400,394,37,164,204,32,236,0,236,2,183,51,22.04.2019 00:10,101,9,Kirov
400,385,29,139,232,29,261,0,261,2,222,37,21.04.2019 21:02,101,9,Kirov
176,175,0,77,99,0,99,0,99,0,55,44,21.04.2019 21:40,101,9,Kirov
320,315,5,113,202,5,207,0,207,6,181,20,21.04.2019 20:55,101,9,Kirov
368,345,13,139,217,12,229,0,229,4,185,40,22.04.2019 00:50,101,9,Kirov
176,176,2,61,113,2,115,0,115,2,85,28,22.04.2019 00:18,101,9,Kirov
112,98,3,63,46,3,49,0,49,0,38,11,22.04.2019 00:20,101,9,Kirov
544,524,27,228,289,27,316,0,316,6,231,79,21.04.2019 20:30,101,9,Kirov
240,230,4,98,140,2,142,0,142,1,119,22,21.04.2019 22:00,101,9,Kirov
496,486,4,197,296,3,299,0,299,2,248,49,22.04.2019 00:05,101,9,Kirov
544,523,10,229,306,9,315,0,315,6,259,50,22.04.2019 00:15,101,9,Kirov
720,709,30,344,351,25,376,0,376,7,325,44,22.04.2019 00:12,101,9,Kirov
496,489,12,221,270,5,275,0,275,2,235,38,21.04.2019 23:35,101,9,Kirov
1072,1046,24,507,544,21,565,0,565,9,454,102,22.04.2019 00:20,101,9,Kirov
64,55,1,21,42,1,43,0,43,0,28,15,22.04.2019 00:30,101,9,Kirov
320,310,31,131,158,31,189,0,189,0,148,41,21.04.2019 23:00,101,9,Kirov
368,355,0,180,188,0,188,0,188,2,152,34,21.04.2019 20:50,101,9,Kirov
48,48,5,20,25,3,28,0,28,0,22,6,21.04.2019 22:25,101,9,Kirov
896,884,36,426,441,29,470,0,470,9,407,54,21.04.2019 22:45,101,9,Kirov
1056,1032,21,440,596,20,616,0,616,8,497,111,22.04.2019 00:07,101,9,Kirov
560,549,36,190,334,36,370,0,370,7,282,81,21.04.2019 20:40,101,9,Kirov
80,76,9,38,37,5,42,0,42,2,23,17,21.04.2019 20:31,101,9,Kirov
448,441,22,176,254,18,272,0,272,5,228,39,21.04.2019 21:30,101,9,Kirov
144,134,3,41,100,3,103,0,103,3,64,36,21.04.2019 21:15,101,9,Kirov
160,158,14,49,98,13,111,0,111,3,68,40,21.04.2019 23:20,101,9,Kirov
384,385,22,170,194,20,214,0,214,13,143,58,21.04.2019 21:15,101,9,Kirov
64,62,1,33,31,0,31,0,31,2,27,2,21.04.2019 20:35,101,9,Kirov
352,347,22,144,191,17,208,0,208,4,157,47,22.04.2019 00:02,101,9,Kirov
80,82,6,24,52,4,56,0,56,0,49,7,22.04.2019 00:10,101,9,Kirov
448,435,22,230,202,16,218,0,218,8,174,36,22.04.2019 00:15,101,9,Kirov
192,181,8,84,100,8,108,0,108,2,77,29,22.04.2019 00:40,101,9,Kirov
1008,998,57,442,522,44,566,0,566,5,449,112,21.04.2019 23:30,101,9,Kirov
720,711,41,357,331,32,363,0,362,3,275,84,21.04.2019 21:50,101,9,Kirov
672,668,54,297,329,46,375,0,375,10,258,107,21.04.2019 22:00,101,9,Kirov
1904,1889,55,804,1054,46,1100,0,1100,34,833,233,22.04.2019 00:30,101,9,Kirov
1552,1527,33,692,830,30,860,0,860,22,683,155,21.04.2019 23:59,101,9,Kirov
1312,1282,43,558,711,43,754,0,754,13,624,117,22.04.2019 00:30,101,9,Kirov
960,930,77,382,514,64,578,0,578,9,482,87,22.04.2019 00:13,102,9,Kirov
176,164,6,80,90,6,96,0,96,0,83,13,21.04.2019 20:45,102,9,Kirov
112,97,15,48,51,13,64,0,64,4,52,8,21.04.2019 20:45,102,9,Kirov
608,603,57,208,347,53,400,0,400,3,359,38,21.04.2019 21:35,102,9,Kirov
128,120,11,60,57,11,68,0,68,5,51,12,21.04.2019 22:00,102,9,Kirov
448,438,39,109,303,36,339,0,339,10,256,73,21.04.2019 20:24,102,9,Kirov
320,306,41,126,156,38,194,0,194,2,151,41,21.04.2019 21:00,102,9,Kirov
1184,1165,166,502,529,153,682,0,682,11,574,97,21.04.2019 21:05,102,9,Kirov
128,117,17,37,76,15,91,0,91,0,82,9,21.04.2019 20:56,102,9,Kirov
608,600,57,220,342,46,388,0,388,6,328,54,21.04.2019 21:30,102,9,Kirov
272,259,21,111,142,19,161,0,161,0,128,33,22.04.2019 00:10,102,9,Kirov
1056,1043,80,391,595,70,665,0,665,12,554,99,21.04.2019 23:30,102,9,Kirov
144,138,10,61,73,10,83,0,83,0,74,9,21.04.2019 20:40,102,9,Kirov
224,220,10,81,133,10,143,0,143,1,121,21,22.04.2019 00:05,102,9,Kirov
64,48,4,37,23,4,27,0,27,0,25,2,21.04.2019 23:30,102,9,Kirov
944,920,64,438,450,56,506,0,506,7,376,123,21.04.2019 21:46,102,9,Kirov
224,211,14,90,123,11,134,0,134,2,94,38,21.04.2019 20:50,102,9,Kirov
432,415,22,162,253,17,270,0,270,6,226,38,22.04.2019 00:10,102,9,Kirov
80,79,7,29,44,7,51,0,51,2,33,16,22.04.2019 00:30,102,9,Kirov
416,411,42,142,234,40,274,0,274,5,182,87,22.04.2019 00:05,102,9,Kirov
192,184,20,39,133,20,153,0,153,3,108,42,22.04.2019 00:20,102,9,Kirov
64,62,0,26,38,0,38,0,38,0,28,10,21.04.2019 20:50,102,9,Kirov
224,212,21,62,141,21,162,0,162,0,140,22,21.04.2019 21:33,102,9,Kirov
80,79,17,27,36,17,53,0,53,1,35,17,22.04.2019 00:35,102,9,Kirov
96,84,0,12,84,0,84,0,84,12,57,15,21.04.2019 23:50,102,9,Kirov
784,767,62,236,486,62,548,0,548,3,475,70,21.04.2019 21:45,102,9,Kirov
768,762,16,335,419,14,433,0,433,6,393,34,21.04.2019 21:20,102,9,Kirov
736,712,60,276,406,54,460,0,460,3,435,22,21.04.2019 22:40,102,9,Kirov
464,461,41,178,247,39,286,0,286,5,217,64,21.04.2019 20:44,102,9,Kirov
208,190,6,102,100,6,106,0,106,1,75,30,21.04.2019 20:39,102,9,Kirov
272,265,19,48,205,19,224,0,224,5,162,57,21.04.2019 21:45,102,9,Kirov
48,47,4,12,32,4,36,0,36,0,26,10,22.04.2019 00:03,102,9,Kirov
736,716,4,267,465,4,469,0,469,6,402,61,22.04.2019 00:40,102,9,Kirov
1168,1155,31,489,655,24,679,0,679,7,610,62,22.04.2019 00:30,102,9,Kirov
208,200,8,47,153,8,161,0,161,1,124,36,21.04.2019 21:53,102,9,Kirov
80,72,4,37,39,4,43,0,43,1,27,15,21.04.2019 20:30,103,9,Kirov
496,488,8,248,240,8,248,0,248,3,201,44,21.04.2019 21:00,103,9,Kirov
592,570,17,282,293,17,310,0,310,4,254,52,21.04.2019 21:00,103,9,Kirov
1312,1281,34,606,673,33,706,0,706,10,570,126,21.04.2019 22:10,103,9,Kirov
1008,984,61,482,467,59,526,0,526,10,434,82,21.04.2019 22:00,103,9,Kirov
832,812,52,324,457,51,508,0,508,12,423,73,21.04.2019 20:50,103,9,Kirov
1136,1118,33,457,649,30,679,0,679,8,562,109,21.04.2019 21:22,103,9,Kirov
1168,1138,15,463,690,15,705,0,705,21,533,151,21.04.2019 20:44,103,9,Kirov
560,560,43,207,314,39,353,0,353,4,304,45,21.04.2019 20:45,103,9,Kirov
352,347,43,140,173,39,212,0,212,3,147,62,21.04.2019 20:32,103,9,Kirov
96,97,11,34,53,9,62,0,62,2,39,21,21.04.2019 21:55,103,9,Kirov
384,377,27,174,187,23,210,0,210,0,172,38,21.04.2019 20:55,103,9,Kirov
816,784,36,302,478,36,514,0,514,5,430,79,21.04.2019 21:00,103,9,Kirov
768,759,44,299,427,42,469,0,469,3,398,68,21.04.2019 21:30,103,9,Kirov
800,788,54,290,456,54,510,0,510,5,356,149,21.04.2019 21:00,103,9,Kirov
656,631,39,235,387,34,421,0,421,7,269,145,21.04.2019 20:55,103,9,Kirov
336,335,31,117,190,29,219,0,219,2,164,53,22.04.2019 00:05,103,9,Kirov
656,644,55,210,396,50,446,0,446,4,391,51,21.04.2019 21:35,103,9,Kirov
144,141,4,59,82,3,85,0,85,2,60,23,21.04.2019 21:10,103,9,Kirov
704,691,36,217,452,35,487,0,487,7,385,95,21.04.2019 22:00,103,9,Kirov
816,798,55,325,440,51,491,0,491,4,427,60,21.04.2019 21:20,103,9,Kirov
256,255,20,122,118,16,134,0,134,1,108,25,21.04.2019 22:15,103,9,Kirov
368,359,36,128,204,36,240,0,240,5,197,38,21.04.2019 22:00,103,9,Kirov
608,604,56,175,382,51,433,0,433,7,372,54,21.04.2019 23:30,103,9,Kirov
544,533,3,304,237,3,240,0,240,2,208,30,22.04.2019 00:02,103,9,Kirov
128,114,9,33,86,9,95,0,95,0,44,51,22.04.2019 00:15,103,9,Kirov
192,185,3,47,143,2,145,0,145,1,58,86,22.04.2019 00:01,103,9,Kirov
128,129,6,30,93,5,98,0,98,3,59,36,22.04.2019 00:05,103,9,Kirov
544,532,53,217,280,47,327,0,327,1,278,48,21.04.2019 21:00,103,9,Kirov
512,495,39,212,263,37,300,0,300,4,262,34,22.04.2019 00:15,103,9,Kirov
80,79,6,29,45,6,51,0,51,3,41,7,21.04.2019 21:40,103,9,Kirov
288,283,14,124,150,14,164,0,164,2,124,38,21.04.2019 22:00,103,9,Kirov
624,615,20,321,287,16,303,0,303,2,278,23,21.04.2019 20:45,103,9,Kirov
1008,981,17,475,516,17,533,0,533,13,445,75,21.04.2019 20:50,103,9,Kirov
416,403,31,169,220,27,247,0,247,0,220,27,21.04.2019 21:55,103,9,Kirov
144,134,10,56,78,10,88,0,88,3,81,4,21.04.2019 22:20,103,9,Kirov
464,448,21,199,245,20,265,0,265,10,214,41,21.04.2019 20:44,103,9,Kirov
112,104,7,58,47,7,54,0,54,0,50,4,22.04.2019 00:06,103,9,Kirov
1200,1177,113,445,645,110,755,0,755,16,629,110,21.04.2019 21:20,103,9,Kirov
144,133,12,73,59,12,71,0,71,1,62,8,21.04.2019 22:00,103,9,Kirov
480,477,32,165,287,28,315,0,315,5,282,28,21.04.2019 20:50,103,9,Kirov
304,297,12,111,183,10,193,0,193,7,153,33,22.04.2019 01:48,103,9,Kirov
640,624,34,259,350,31,381,0,381,11,333,37,21.04.2019 20:50,103,9,Kirov
256,248,4,68,184,4,188,0,188,2,158,28,21.04.2019 21:00,103,9,Kirov
400,390,23,171,211,18,229,0,229,2,185,42,22.04.2019 00:05,103,9,Kirov
144,141,8,43,96,5,101,0,101,3,73,25,21.04.2019 22:10,103,9,Kirov
720,695,9,344,370,6,376,0,376,14,309,53,21.04.2019 22:00,103,9,Kirov
288,274,0,105,183,0,183,0,183,3,141,39,21.04.2019 22:00,103,9,Kirov
544,532,9,246,291,7,298,0,298,4,243,51,21.04.2019 20:55,103,9,Kirov
832,812,13,356,463,13,476,0,476,4,406,66,21.04.2019 22:25,103,9,Kirov
576,553,25,296,257,23,280,0,280,3,228,49,21.04.2019 20:50,103,9,Kirov
112,97,6,45,61,6,67,0,67,0,50,17,21.04.2019 22:25,103,9,Kirov
192,180,13,88,91,13,104,0,104,0,85,19,22.04.2019 00:10,103,9,Kirov
752,735,54,230,470,52,522,0,522,4,457,61,21.04.2019 22:08,103,9,Kirov
320,314,13,125,188,7,195,0,195,0,167,28,21.04.2019 21:00,103,9,Kirov
528,510,3,227,299,2,301,0,301,1,225,75,21.04.2019 21:45,103,9,Kirov
352,340,5,119,228,5,233,0,233,0,202,31,21.04.2019 21:32,103,9,Kirov
144,42,30,107,12,25,37,0,37,0,32,5,21.04.2019 20:20,103,9,Kirov
384,357,0,33,351,0,351,0,351,13,273,65,21.04.2019 20:40,103,9,Kirov
1632,1619,25,624,985,23,1008,0,1008,29,836,143,21.04.2019 21:30,103,9,Kirov
2000,1965,17,738,1246,16,1262,0,1262,27,1038,197,22.04.2019 00:03,103,9,Kirov
1632,1623,34,677,935,20,955,0,955,18,779,158,22.04.2019 00:20,103,9,Kirov
1584,1558,19,611,955,18,973,0,973,17,817,139,21.04.2019 21:50,103,9,Kirov
2464,2369,20,1003,1443,18,1461,0,1461,17,1275,169,21.04.2019 22:30,103,9,Kirov
2064,2033,24,826,1222,16,1238,0,1238,23,1042,173,21.04.2019 21:55,103,9,Kirov
1920,1878,19,806,1097,17,1114,0,1114,29,948,137,21.04.2019 21:35,103,9,Kirov
1850,1805,24,696,1132,22,1154,0,1154,31,988,135,21.04.2019 21:55,103,9,Kirov
2336,2307,16,977,1345,14,1359,0,1359,27,1175,157,21.04.2019 23:20,103,9,Kirov
2288,2255,12,887,1389,12,1401,0,1401,32,1158,211,21.04.2019 21:55,103,9,Kirov
1568,1546,9,613,947,8,955,0,955,19,799,137,22.04.2019 00:20,103,9,Kirov
2336,2286,8,981,1349,6,1355,0,1355,29,1167,159,21.04.2019 21:53,103,9,Kirov
1424,1417,10,527,887,10,897,0,897,19,788,90,21.04.2019 22:33,103,9,Kirov
1360,1323,15,662,685,13,698,0,698,19,588,91,21.04.2019 21:30,103,9,Kirov
2096,2083,22,885,1194,17,1211,0,1211,28,1041,142,21.04.2019 21:55,103,9,Kirov
2032,1997,25,913,1098,21,1119,0,1119,25,965,129,21.04.2019 21:25,103,9,Kirov
1264,1243,5,582,677,5,682,0,682,20,580,82,21.04.2019 22:03,103,9,Kirov
848,843,20,347,484,17,501,0,501,6,447,48,21.04.2019 21:10,103,9,Kirov
784,784,5,299,482,3,485,0,485,11,434,40,21.04.2019 21:36,103,9,Kirov
1744,1707,47,741,959,44,1003,0,1003,18,867,118,22.04.2019 00:50,103,9,Kirov
416,55,35,367,18,31,49,0,49,0,44,5,21.04.2019 20:40,103,9,Kirov
192,55,10,139,43,10,53,0,53,2,43,8,21.04.2019 21:20,103,9,Kirov
64,36,0,29,35,0,35,0,35,2,25,8,21.04.2019 20:42,103,9,Kirov
576,553,0,60,516,0,516,0,516,16,248,252,21.04.2019 22:15,105,10,Lugansk
1968,1919,9,1124,835,9,844,0,844,26,746,72,22.04.2019 00:15,105,10,Lugansk
1808,1822,23,933,861,14,875,0,875,14,784,77,22.04.2019 00:20,105,10,Lugansk
128,15,0,113,15,0,15,0,15,0,13,2,22.04.2019 00:20,105,10,Lugansk
224,205,0,19,205,0,205,0,205,23,130,52,21.04.2019 21:10,106,10,Lugansk
1712,1646,0,314,1398,0,1398,0,1398,47,711,640,21.04.2019 22:20,106,10,Lugansk
848,783,0,225,623,0,623,0,623,23,276,324,21.04.2019 22:15,106,10,Lugansk
384,372,7,144,234,6,240,0,240,5,225,10,21.04.2019 21:50,106,10,Lugansk
464,457,25,202,238,24,262,0,262,5,248,9,21.04.2019 20:20,106,10,Lugansk
608,621,33,281,302,25,327,0,327,3,266,58,21.04.2019 22:40,106,10,Lugansk
752,747,21,371,367,14,381,0,381,4,349,28,22.04.2019 00:15,106,10,Lugansk
336,334,21,153,169,14,183,0,183,1,173,9,21.04.2019 21:30,106,10,Lugansk
1328,1304,33,690,608,30,638,0,638,13,586,39,21.04.2019 22:25,106,10,Lugansk
144,133,2,43,99,2,101,0,101,0,85,16,21.04.2019 23:00,106,10,Lugansk
128,119,2,69,58,1,59,0,59,0,56,3,22.04.2019 00:05,106,10,Lugansk
1040,1015,60,563,442,35,477,0,477,14,442,21,21.04.2019 22:50,106,10,Lugansk
288,272,15,139,134,15,149,0,149,3,136,10,21.04.2019 23:50,106,10,Lugansk
288,282,12,127,149,12,161,0,161,1,152,8,21.04.2019 23:10,106,10,Lugansk
320,305,21,161,140,19,159,0,159,2,151,6,22.04.2019 00:30,106,10,Lugansk
224,216,12,97,115,12,127,0,127,2,117,8,22.04.2019 00:05,106,10,Lugansk
224,220,0,146,78,0,78,0,78,0,72,6,22.04.2019 00:10,106,10,Lugansk
288,285,27,112,149,27,176,0,176,2,167,7,22.04.2019 00:20,106,10,Lugansk
384,369,7,253,126,5,131,0,131,4,120,7,21.04.2019 22:35,106,10,Lugansk
368,357,22,207,141,20,161,0,161,5,148,8,21.04.2019 23:15,106,10,Lugansk
1824,1822,29,687,1117,20,1137,0,1137,27,976,134,21.04.2019 21:18,106,10,Lugansk
1568,1608,45,541,998,29,1027,0,1027,35,883,109,21.04.2019 21:00,106,10,Lugansk
2161,2174,48,819,1307,35,1342,0,1342,29,1190,123,21.04.2019 22:07,106,10,Lugansk
1376,1354,27,621,734,21,755,0,755,16,683,56,21.04.2019 23:15,106,10,Lugansk
2000,2026,58,759,1193,48,1241,0,1241,24,1089,128,21.04.2019 22:00,106,10,Lugansk
2368,2374,49,987,1341,40,1381,0,1381,25,1254,102,22.04.2019 00:27,106,10,Lugansk
2320,2355,54,900,1382,38,1420,0,1420,26,1279,115,21.04.2019 21:40,106,10,Lugansk
2368,2410,41,904,1436,28,1464,0,1464,31,1324,109,21.04.2019 21:58,106,10,Lugansk
2112,2128,54,768,1303,41,1344,0,1344,32,1210,102,21.04.2019 21:30,106,10,Lugansk
1584,1570,14,662,912,10,922,0,922,20,826,76,22.04.2019 00:30,106,10,Lugansk
1888,1882,8,877,1003,8,1011,0,1011,25,914,72,22.04.2019 00:03,106,10,Lugansk
2432,2453,60,851,1543,38,1581,0,1581,46,1339,196,22.04.2019 00:10,106,10,Lugansk
1632,1688,36,544,1065,23,1088,0,1088,22,937,129,21.04.2019 22:22,106,10,Lugansk
2112,2125,45,900,1177,35,1212,0,1212,18,1104,90,22.04.2019 00:10,106,10,Lugansk
1744,1741,23,689,1041,14,1055,0,1055,20,947,88,21.04.2019 21:15,106,10,Lugansk
2256,2290,73,902,1306,48,1354,0,1354,29,1211,114,22.04.2019 00:15,106,10,Lugansk
1872,1881,67,744,1075,53,1128,0,1128,24,1008,96,22.04.2019 00:10,106,10,Lugansk
1712,1705,62,635,1034,43,1077,0,1077,19,963,95,21.04.2019 22:02,106,10,Lugansk
2096,2141,42,714,1356,26,1382,0,1382,38,1217,127,22.04.2019 00:15,106,10,Lugansk
1616,1634,39,621,968,27,995,0,995,25,883,87,21.04.2019 22:48,106,10,Lugansk
1440,1481,32,469,946,25,971,0,971,38,857,76,22.04.2019 00:05,106,10,Lugansk
2112,2157,38,769,1314,29,1343,0,1343,30,1184,129,21.04.2019 22:18,106,10,Lugansk
1360,1365,35,614,722,24,746,0,746,18,669,59,22.04.2019 00:01,106,10,Lugansk
464,453,9,183,274,7,281,0,281,8,245,28,21.04.2019 20:39,106,10,Lugansk
2192,2238,39,823,1343,26,1369,0,1369,22,1206,141,21.04.2019 22:35,106,10,Lugansk
2320,2332,59,903,1380,37,1417,0,1417,35,1249,133,22.04.2019 01:29,106,10,Lugansk
2352,2388,62,793,1517,42,1559,0,1559,34,1404,121,21.04.2019 22:25,106,10,Lugansk
2368,2360,39,912,1431,25,1456,0,1456,46,1291,119,21.04.2019 21:40,106,10,Lugansk
2336,2361,46,835,1464,37,1501,0,1501,29,1339,133,21.04.2019 22:10,106,10,Lugansk
2096,2110,38,672,1395,29,1424,0,1424,36,1260,128,21.04.2019 22:14,106,10,Lugansk
2208,2226,60,744,1419,45,1464,0,1464,40,1271,153,21.04.2019 22:30,106,10,Lugansk
2096,2092,40,774,1298,24,1322,0,1322,27,1185,110,21.04.2019 21:10,106,10,Lugansk
2352,2373,22,922,1415,15,1430,0,1430,32,1285,113,21.04.2019 22:10,106,10,Lugansk
1968,1964,20,729,1228,11,1239,0,1239,23,1077,139,21.04.2019 22:30,106,10,Lugansk
2128,2102,23,814,1300,14,1314,0,1314,28,1165,121,21.04.2019 22:19,106,10,Lugansk
1728,1714,20,643,1070,15,1085,0,1085,16,955,114,22.04.2019 00:02,106,10,Lugansk
2080,2041,15,811,1256,13,1269,0,1269,14,1125,130,21.04.2019 21:05,106,10,Lugansk
2400,2371,30,867,1511,22,1533,0,1533,33,1356,144,21.04.2019 22:10,106,10,Lugansk
2400,2387,34,838,1545,17,1562,0,1562,45,1382,135,21.04.2019 22:35,106,10,Lugansk
2224,2204,22,781,1424,19,1443,0,1442,21,1273,148,22.04.2019 00:01,106,10,Lugansk
624,617,25,231,371,22,393,0,393,4,355,34,21.04.2019 21:10,106,10,Lugansk
592,581,27,260,312,20,332,0,332,5,311,16,21.04.2019 22:27,106,10,Lugansk
640,622,23,336,286,18,304,0,304,7,280,17,21.04.2019 20:40,106,10,Lugansk
1136,1115,57,467,623,46,669,0,669,5,625,39,21.04.2019 20:58,106,10,Lugansk
1808,1778,94,943,797,68,865,0,865,17,823,25,21.04.2019 22:04,106,10,Lugansk
1968,1943,121,949,914,105,1019,0,1019,24,975,20,21.04.2019 21:17,106,10,Lugansk
160,160,10,82,69,9,78,0,78,0,75,3,21.04.2019 21:00,106,10,Lugansk
528,517,21,219,291,18,309,0,309,4,286,19,21.04.2019 21:10,106,10,Lugansk
224,52,39,173,14,37,51,0,51,0,46,5,21.04.2019 20:43,106,10,Lugansk
1056,1036,0,89,967,0,967,0,967,64,399,504,21.04.2019 20:59,107,10,Lugansk
688,621,0,83,605,0,605,0,605,27,256,322,22.04.2019 00:15,107,10,Lugansk
2096,2049,19,1029,1052,15,1067,0,1067,15,980,72,22.04.2019 00:10,107,10,Lugansk
2240,2184,15,1211,1018,11,1029,0,1029,32,936,61,22.04.2019 00:05,107,10,Lugansk
2176,2132,26,1115,1047,14,1061,0,1061,27,953,81,22.04.2019 00:05,107,10,Lugansk
2144,2100,12,1076,1057,11,1068,0,1068,39,952,77,22.04.2019 00:10,107,10,Lugansk
2176,2167,21,944,1215,17,1232,0,1232,23,1091,118,22.04.2019 00:10,107,10,Lugansk
2176,2165,20,898,1262,16,1278,0,1278,32,1131,115,22.04.2019 00:30,107,10,Lugansk
496,452,0,54,442,0,442,0,442,12,128,302,21.04.2019 21:00,112,10,Lugansk
928,897,13,611,306,11,317,0,317,6,298,13,21.04.2019 22:07,112,10,Lugansk
704,675,16,378,311,15,326,0,326,4,312,10,22.04.2019 00:05,112,10,Lugansk
1232,1218,13,625,599,8,607,0,607,12,572,23,21.04.2019 21:30,112,10,Lugansk
1312,1298,18,729,578,5,583,0,583,12,538,33,21.04.2019 21:45,112,10,Lugansk
736,715,10,355,371,10,381,0,381,9,363,9,21.04.2019 21:05,112,10,Lugansk
1696,1675,23,922,758,16,774,0,774,22,720,32,21.04.2019 22:01,112,10,Lugansk
976,960,39,536,409,31,440,0,440,7,420,13,21.04.2019 22:15,112,10,Lugansk
1968,1940,12,831,1132,5,1137,0,1137,34,1028,75,21.04.2019 21:50,112,10,Lugansk
2080,2070,11,836,1238,6,1244,0,1244,29,1138,77,21.04.2019 21:40,112,10,Lugansk
2224,2214,20,834,1376,14,1390,0,1390,33,1260,97,21.04.2019 21:33,112,10,Lugansk
2128,2100,15,939,1176,13,1189,0,1189,33,1081,75,22.04.2019 00:15,112,10,Lugansk
2320,2299,20,1036,1271,13,1284,0,1284,32,1187,65,21.04.2019 23:06,112,10,Lugansk
2144,2127,19,835,1290,19,1309,0,1309,30,1160,119,21.04.2019 22:45,112,10,Lugansk
1984,1972,27,880,1084,20,1104,0,1104,27,995,82,21.04.2019 22:47,112,10,Lugansk
2352,2349,33,1038,1288,26,1314,0,1314,28,1181,105,22.04.2019 00:03,112,10,Lugansk
1472,1451,7,768,700,4,704,0,704,18,659,27,21.04.2019 22:32,112,10,Lugansk
352,42,21,316,19,17,36,0,36,1,34,1,21.04.2019 21:40,112,10,Lugansk
544,544,0,18,526,0,526,0,526,12,181,333,21.04.2019 21:10,113,10,Lugansk
160,158,11,45,104,11,115,0,115,3,103,9,22.04.2019 00:40,113,10,Lugansk
320,309,15,97,208,15,223,0,223,5,169,49,22.04.2019 01:50,113,10,Lugansk
256,256,23,71,166,19,185,0,185,3,167,15,22.04.2019 00:22,113,10,Lugansk
144,138,11,47,86,11,97,0,97,1,72,24,22.04.2019 00:01,113,10,Lugansk
144,136,2,57,85,2,87,0,87,2,79,6,22.04.2019 00:11,113,10,Lugansk
592,591,50,262,285,45,330,0,330,10,302,18,22.04.2019 00:40,113,10,Lugansk
720,715,118,280,326,114,440,0,440,5,397,38,22.04.2019 01:20,113,10,Lugansk
336,323,17,116,206,14,220,0,220,2,200,18,22.04.2019 00:15,113,10,Lugansk
176,178,7,25,144,7,151,0,151,2,126,23,22.04.2019 00:05,113,10,Lugansk
1328,1308,22,501,812,15,827,0,827,15,776,36,22.04.2019 00:51,113,10,Lugansk
1056,1030,16,374,669,13,682,0,682,12,636,34,22.04.2019 00:15,113,10,Lugansk
1488,1474,34,553,908,27,935,0,935,19,857,59,22.04.2019 00:20,113,10,Lugansk
576,563,45,185,352,39,391,0,391,4,371,16,22.04.2019 00:20,113,10,Lugansk
128,123,7,25,96,7,103,0,103,0,100,3,22.04.2019 00:20,113,10,Lugansk
208,205,28,73,111,24,135,0,135,0,131,4,22.04.2019 01:15,113,10,Lugansk
288,276,41,125,128,35,163,0,163,2,148,13,22.04.2019 00:10,113,10,Lugansk
928,909,24,365,542,21,563,0,563,9,525,29,22.04.2019 00:30,113,10,Lugansk
384,379,9,127,248,9,257,0,257,3,245,9,22.04.2019 00:20,113,10,Lugansk
96,87,4,41,51,4,55,0,55,0,53,2,22.04.2019 00:10,113,10,Lugansk
400,386,24,139,241,20,261,0,261,1,253,7,22.04.2019 00:30,113,10,Lugansk
80,77,5,32,43,5,48,0,48,1,43,4,22.04.2019 00:15,113,10,Lugansk
304,289,19,131,159,14,173,0,173,4,161,8,22.04.2019 00:11,113,10,Lugansk
416,396,17,161,241,14,255,0,255,2,225,28,22.04.2019 00:15,113,10,Lugansk
784,761,28,195,566,23,589,0,589,6,518,65,22.04.2019 00:40,113,10,Lugansk
256,242,5,121,131,4,135,0,135,3,127,5,22.04.2019 00:10,113,10,Lugansk
304,296,39,127,144,33,177,0,177,1,161,15,22.04.2019 00:05,113,10,Lugansk
400,388,44,143,221,36,257,0,257,0,232,25,22.04.2019 00:00,113,10,Lugansk
624,609,94,170,364,90,454,0,454,9,411,34,22.04.2019 00:05,113,10,Lugansk
256,234,22,91,146,19,165,0,165,5,155,5,22.04.2019 00:33,113,10,Lugansk
176,166,6,66,104,6,110,0,110,1,106,3,22.04.2019 00:10,113,10,Lugansk
784,779,0,17,767,0,767,0,767,20,207,540,22.04.2019 00:01,114,10,Lugansk
384,372,0,18,366,0,366,0,366,9,222,135,22.04.2019 00:25,114,10,Lugansk
720,712,0,28,692,0,692,0,692,45,389,258,21.04.2019 21:20,114,10,Lugansk
1392,1444,22,479,896,17,913,0,913,21,845,47,22.04.2019 00:30,114,10,Lugansk
1408,1417,12,533,865,10,875,0,875,20,792,63,22.04.2019 00:30,114,10,Lugansk
1168,1154,12,492,665,11,676,0,676,15,623,38,22.04.2019 01:55,114,10,Lugansk
672,655,20,239,413,20,433,0,433,13,387,33,22.04.2019 00:10,114,10,Lugansk
192,181,4,65,123,4,127,0,127,0,113,14,22.04.2019 00:52,114,10,Lugansk
432,423,25,186,224,22,246,0,246,2,223,21,22.04.2019 00:10,114,10,Lugansk
416,407,17,170,233,13,246,0,246,6,221,19,22.04.2019 01:05,114,10,Lugansk
896,871,20,316,562,18,580,0,580,8,551,21,22.04.2019 00:30,114,10,Lugansk
752,730,16,271,467,14,481,0,481,12,450,19,22.04.2019 00:10,114,10,Lugansk
336,319,17,141,179,16,195,0,195,4,176,15,22.04.2019 00:30,114,10,Lugansk
304,284,0,157,147,0,147,0,147,0,137,10,22.04.2019 00:30,114,10,Lugansk
256,240,14,117,128,11,139,0,139,4,130,5,22.04.2019 01:15,114,10,Lugansk
384,367,13,123,248,13,261,0,261,2,249,10,22.04.2019 00:45,114,10,Lugansk
816,805,38,349,440,27,467,0,467,6,432,29,22.04.2019 00:30,114,10,Lugansk
1360,1335,99,519,747,94,841,0,841,24,755,62,22.04.2019 01:45,114,10,Lugansk
928,913,52,401,480,47,527,0,527,11,506,10,22.04.2019 00:10,114,10,Lugansk
368,370,40,166,165,37,202,0,202,7,176,19,22.04.2019 01:05,114,10,Lugansk
256,251,4,132,120,4,124,0,124,2,96,26,22.04.2019 00:05,114,10,Lugansk
1728,1707,40,1010,687,31,718,0,718,17,670,31,22.04.2019 00:35,114,10,Lugansk
224,26,11,201,14,9,23,0,23,1,15,7,22.04.2019 00:30,114,10,Lugansk
1072,1105,4,281,787,4,791,0,791,30,223,538,22.04.2019 00:10,115,11,Lvov
1680,1721,7,519,1154,7,1161,0,1161,27,392,742,22.04.2019 00:20,115,11,Lvov
2208,2209,19,777,1418,13,1431,0,1431,32,463,936,22.04.2019 00:02,115,11,Lvov
1712,1753,5,526,1181,5,1186,0,1186,33,365,788,22.04.2019 00:14,115,11,Lvov
1616,1642,12,508,1100,8,1108,0,1108,31,398,679,21.04.2019 23:00,115,11,Lvov
1776,1783,6,534,1237,5,1242,0,1242,37,356,849,22.04.2019 00:45,115,11,Lvov
1168,1153,7,399,764,5,769,0,769,30,263,476,22.04.2019 00:12,115,11,Lvov
1600,1573,4,493,1104,3,1107,0,1107,27,196,884,22.04.2019 00:15,115,11,Lvov
2128,2099,3,784,1343,1,1344,0,1344,29,377,938,22.04.2019 00:15,115,11,Lvov
1872,1857,9,601,1262,9,1271,0,1271,27,312,932,22.04.2019 00:15,115,11,Lvov
1664,1674,2,579,1084,1,1085,0,1085,25,336,724,22.04.2019 00:15,115,11,Lvov
2336,2325,15,769,1553,14,1567,0,1567,32,400,1135,22.04.2019 00:07,115,11,Lvov
1328,1308,5,433,891,4,895,0,895,11,197,687,22.04.2019 00:20,115,11,Lvov
320,28,0,293,27,0,27,1,27,1,7,19,22.04.2019 00:10,115,11,Lvov
208,43,0,173,35,0,35,0,35,1,9,25,22.04.2019 00:07,115,11,Lvov
384,157,125,250,30,104,134,0,134,1,41,92,22.04.2019 00:20,115,11,Lvov
1904,1897,9,535,1360,9,1369,0,1369,50,385,934,22.04.2019 00:20,115,11,Lvov
1952,1947,7,630,1316,6,1322,0,1322,42,354,926,22.04.2019 01:29,115,11,Lvov
1856,1859,15,637,1207,12,1219,0,1219,22,322,875,22.04.2019 00:30,115,11,Lvov
1696,1682,24,588,1089,19,1108,0,1108,18,301,789,22.04.2019 00:45,115,11,Lvov
2352,2379,22,719,1615,18,1633,0,1633,46,407,1180,22.04.2019 00:20,115,11,Lvov
1232,1226,3,609,621,2,623,0,623,14,209,400,22.04.2019 00:41,115,11,Lvov
2256,2233,34,787,1445,24,1469,0,1469,40,491,938,22.04.2019 00:07,115,11,Lvov
2176,2174,30,679,1478,19,1497,0,1497,45,521,931,22.04.2019 00:06,115,11,Lvov
2384,2373,27,878,1492,14,1506,0,1506,50,392,1064,22.04.2019 00:05,115,11,Lvov
2000,2006,18,612,1371,17,1388,0,1388,54,307,1027,22.04.2019 00:30,115,11,Lvov
1968,1957,8,623,1339,6,1345,0,1345,35,439,871,22.04.2019 01:10,115,11,Lvov
2192,2165,11,754,1430,8,1438,0,1438,31,368,1039,22.04.2019 00:20,115,11,Lvov
1904,1894,17,481,1407,16,1423,0,1419,31,268,1120,21.04.2019 22:00,115,11,Lvov
1760,1743,16,528,1223,9,1232,0,1232,41,327,864,22.04.2019 00:52,115,11,Lvov
2128,2106,16,619,1494,15,1509,0,1509,31,407,1071,22.04.2019 00:50,115,11,Lvov
2080,2064,17,637,1428,15,1443,0,1443,36,383,1024,21.04.2019 21:42,115,11,Lvov
1936,1936,15,560,1363,13,1376,0,1376,35,393,948,22.04.2019 00:15,115,11,Lvov
2320,2297,25,716,1583,21,1604,0,1604,52,417,1135,22.04.2019 00:10,115,11,Lvov
2256,2270,15,614,1630,12,1642,0,1642,50,440,1152,22.04.2019 00:20,115,11,Lvov
2400,2404,16,721,1670,9,1679,0,1679,51,474,1154,22.04.2019 00:05,115,11,Lvov
2064,2055,15,530,1523,11,1534,0,1534,31,378,1125,22.04.2019 00:42,115,11,Lvov
2128,2137,10,610,1508,10,1518,0,1518,35,432,1051,21.04.2019 22:30,115,11,Lvov
2096,2066,17,660,1421,15,1436,0,1436,28,392,1016,22.04.2019 00:10,115,11,Lvov
2400,2381,12,726,1664,10,1674,0,1674,49,449,1176,22.04.2019 00:15,115,11,Lvov
2352,2354,24,853,1480,19,1499,0,1499,48,527,924,22.04.2019 00:07,115,11,Lvov
1376,1372,12,406,960,10,970,0,970,27,313,630,22.04.2019 00:15,115,11,Lvov
2048,2050,13,589,1448,11,1459,0,1459,35,393,1031,22.04.2019 00:40,115,11,Lvov
2304,2288,16,731,1562,11,1573,0,1573,32,409,1132,22.04.2019 00:05,115,11,Lvov
2352,2337,17,706,1634,12,1646,0,1646,44,404,1198,22.04.2019 00:30,115,11,Lvov
1872,1855,11,551,1313,8,1321,0,1321,32,375,914,22.04.2019 00:10,115,11,Lvov
2432,2413,25,689,1721,22,1743,0,1743,45,429,1269,22.04.2019 00:15,115,11,Lvov
2432,2442,10,601,1825,6,1831,0,1831,40,418,1372,22.04.2019 00:45,115,11,Lvov
2352,2338,16,611,1729,12,1741,0,1741,38,437,1266,22.04.2019 00:05,115,11,Lvov
2304,2285,16,633,1658,13,1671,0,1671,41,410,1220,22.04.2019 00:10,115,11,Lvov
2416,2404,12,662,1744,10,1754,0,1754,34,480,1240,22.04.2019 00:05,115,11,Lvov
2240,2232,15,738,1489,13,1502,0,1502,30,516,956,22.04.2019 00:05,115,11,Lvov
2512,2510,9,811,1694,7,1701,0,1701,42,529,1130,22.04.2019 00:10,115,11,Lvov
2464,2441,7,904,1555,5,1560,0,1560,41,497,1022,22.04.2019 00:15,115,11,Lvov
560,154,154,423,0,137,137,0,137,3,53,81,22.04.2019 00:15,115,11,Lvov
688,200,24,520,144,24,168,0,168,4,59,105,22.04.2019 00:20,115,11,Lvov
96,59,0,44,52,0,52,0,52,1,18,33,22.04.2019 00:15,115,11,Lvov
1664,1644,3,546,1117,1,1118,0,1118,24,290,804,22.04.2019 00:30,115,11,Lvov
1376,1366,9,418,950,8,958,0,958,27,178,753,22.04.2019 00:30,116,11,Lvov
1984,1964,24,691,1273,20,1293,0,1293,48,357,888,22.04.2019 00:05,116,11,Lvov
1968,1954,25,701,1249,18,1267,0,1267,42,372,853,22.04.2019 00:02,116,11,Lvov
2144,2176,21,781,1347,16,1363,0,1363,46,439,878,22.04.2019 00:10,116,11,Lvov
2112,2094,21,651,1442,19,1461,0,1461,39,399,1023,22.04.2019 00:05,116,11,Lvov
1968,1962,13,627,1330,11,1341,0,1341,31,353,957,22.04.2019 00:02,116,11,Lvov
2000,1996,17,601,1386,13,1399,0,1399,52,364,983,21.04.2019 21:34,116,11,Lvov
2224,2316,15,684,1530,10,1540,0,1540,50,478,1012,22.04.2019 00:20,116,11,Lvov
1984,2015,27,599,1365,20,1385,0,1385,36,369,980,22.04.2019 01:05,116,11,Lvov
2224,2227,25,711,1492,21,1513,0,1513,35,469,1009,22.04.2019 00:11,116,11,Lvov
2256,2232,17,750,1489,17,1506,0,1506,48,508,950,21.04.2019 23:20,116,11,Lvov
2192,2227,20,698,1479,15,1494,0,1494,42,440,1012,22.04.2019 00:05,116,11,Lvov
2144,2159,18,619,1514,11,1525,0,1525,47,417,1061,22.04.2019 00:05,116,11,Lvov
2256,2237,13,658,1587,11,1598,0,1598,47,428,1123,21.04.2019 23:45,116,11,Lvov
2400,2383,12,866,1524,10,1534,0,1534,35,460,1039,22.04.2019 00:22,116,11,Lvov
2272,2249,20,805,1451,16,1467,0,1467,29,377,1061,22.04.2019 00:10,116,11,Lvov
2176,2130,13,750,1418,8,1426,0,1426,49,386,991,22.04.2019 00:04,116,11,Lvov
2080,2089,27,671,1388,21,1409,0,1409,41,425,943,22.04.2019 00:05,116,11,Lvov
2160,2133,17,773,1373,14,1387,0,1387,43,417,927,22.04.2019 00:22,116,11,Lvov
2256,2209,26,904,1338,14,1352,0,1352,41,366,945,22.04.2019 00:15,116,11,Lvov
2256,2269,29,667,1573,16,1589,0,1589,48,397,1144,22.04.2019 00:01,116,11,Lvov
2272,2291,19,617,1640,15,1655,0,1655,48,462,1145,22.04.2019 00:02,116,11,Lvov
1952,1987,13,538,1404,10,1414,0,1414,32,403,979,22.04.2019 00:10,116,11,Lvov
2288,2298,18,745,1529,14,1543,0,1543,30,411,1102,22.04.2019 00:15,116,11,Lvov
2240,2237,16,667,1563,10,1573,0,1573,51,412,1110,22.04.2019 00:26,116,11,Lvov
2448,2446,12,788,1649,11,1660,0,1660,47,431,1182,21.04.2019 22:15,116,11,Lvov
2240,2239,19,774,1448,18,1466,0,1466,45,444,977,22.04.2019 00:05,116,11,Lvov
2432,2422,8,770,1654,8,1662,0,1662,48,396,1218,22.04.2019 00:10,116,11,Lvov
1984,1984,10,527,1449,8,1457,0,1457,43,306,1108,22.04.2019 00:10,116,11,Lvov
2192,2169,16,758,1418,16,1434,0,1434,28,399,1007,22.04.2019 00:22,116,11,Lvov
2208,2207,13,675,1521,12,1533,0,1533,36,410,1087,21.04.2019 22:30,116,11,Lvov
2384,2379,13,802,1572,10,1582,0,1582,47,403,1132,21.04.2019 23:45,116,11,Lvov
2096,2070,7,650,1442,4,1446,0,1446,37,312,1097,22.04.2019 00:30,116,11,Lvov
2048,2048,17,733,1300,15,1315,0,1315,39,341,935,22.04.2019 00:15,116,11,Lvov
1600,1575,7,503,1092,5,1097,0,1097,28,255,814,22.04.2019 00:02,116,11,Lvov
2272,2245,13,660,1601,11,1612,0,1612,44,348,1220,22.04.2019 00:07,116,11,Lvov
2368,2346,18,758,1594,16,1610,0,1610,44,405,1161,22.04.2019 00:12,116,11,Lvov
2240,2206,9,676,1556,8,1564,0,1564,33,364,1167,22.04.2019 00:13,116,11,Lvov
2016,2019,25,712,1286,18,1304,0,1304,32,472,800,22.04.2019 00:05,117,11,Lvov
1568,1623,9,544,1016,8,1024,0,1024,25,347,652,21.04.2019 21:57,117,11,Lvov
1984,1980,7,699,1279,6,1285,0,1285,29,422,834,22.04.2019 00:10,117,11,Lvov
2064,2075,6,770,1288,6,1294,0,1294,36,357,901,22.04.2019 00:20,117,11,Lvov
2208,2196,8,870,1332,6,1338,0,1338,38,444,856,22.04.2019 00:19,117,11,Lvov
2160,2169,5,820,1336,4,1340,0,1340,27,412,901,22.04.2019 00:20,117,11,Lvov
1456,1477,11,490,958,8,966,0,966,33,271,662,22.04.2019 00:15,117,11,Lvov
1648,1659,7,523,1118,7,1125,0,1125,34,348,743,22.04.2019 00:08,117,11,Lvov
2032,2036,16,684,1336,12,1348,0,1348,38,499,811,22.04.2019 00:03,117,11,Lvov
1488,1487,7,494,988,6,994,0,994,33,363,598,21.04.2019 21:24,117,11,Lvov
1680,1698,16,522,1142,16,1158,0,1158,32,373,753,22.04.2019 00:05,117,11,Lvov
2080,2074,24,655,1405,20,1425,0,1425,53,474,898,22.04.2019 00:03,117,11,Lvov
1408,1419,8,502,899,7,906,0,906,23,247,636,22.04.2019 00:25,117,11,Lvov
208,73,61,138,12,58,70,0,70,0,22,48,22.04.2019 00:07,117,11,Lvov
544,177,72,395,84,65,149,0,149,4,59,86,22.04.2019 00:15,117,11,Lvov
240,101,13,143,84,13,97,0,97,1,34,62,22.04.2019 00:05,117,11,Lvov
176,24,11,152,13,11,24,0,24,0,6,18,22.04.2019 00:40,117,11,Lvov
1791,1783,13,636,1145,10,1155,0,1155,30,442,683,22.04.2019 00:37,117,11,Lvov
2032,2096,20,589,1429,14,1443,0,1443,38,491,914,22.04.2019 00:22,117,11,Lvov
2048,2053,21,590,1439,19,1458,0,1458,41,517,900,22.04.2019 00:03,117,11,Lvov
1808,1793,8,726,1077,5,1082,0,1082,29,414,639,22.04.2019 00:05,117,11,Lvov
1824,1828,27,522,1284,18,1302,0,1302,50,509,743,22.04.2019 00:45,117,11,Lvov
1600,1586,13,308,1279,13,1292,0,1292,46,333,913,21.04.2019 22:00,117,11,Lvov
1904,1893,20,600,1292,12,1304,0,1304,35,459,810,22.04.2019 00:57,117,11,Lvov
2032,2054,26,722,1291,19,1310,0,1310,40,418,852,22.04.2019 00:45,117,11,Lvov
1904,1908,26,638,1247,19,1266,0,1266,37,422,807,22.04.2019 00:20,117,11,Lvov
1488,1479,7,487,996,5,1001,0,1001,33,365,603,22.04.2019 00:10,117,11,Lvov
1600,1592,12,550,1041,9,1050,0,1050,33,362,655,22.04.2019 00:05,117,11,Lvov
2000,2003,21,671,1315,14,1329,0,1329,36,372,921,22.04.2019 00:20,117,11,Lvov
2416,2401,21,829,1574,13,1587,0,1587,51,506,1030,22.04.2019 00:20,117,11,Lvov
2176,2097,3,1023,1150,3,1153,0,1153,29,528,596,21.04.2019 23:40,117,11,Lvov
2240,2208,12,629,1606,5,1611,0,1611,60,532,1019,22.04.2019 00:30,117,11,Lvov
2400,2359,5,962,1433,5,1438,0,1438,47,660,731,22.04.2019 00:15,117,11,Lvov
2624,2527,0,1281,1343,0,1343,0,1343,37,580,726,22.04.2019 00:05,117,11,Lvov
2176,2120,3,946,1229,1,1230,0,1230,40,534,656,22.04.2019 00:12,117,11,Lvov
2752,2710,8,848,1898,6,1904,0,1904,38,646,1220,22.04.2019 00:05,117,11,Lvov
1712,1707,17,454,1244,14,1258,0,1258,53,300,905,21.04.2019 20:54,117,11,Lvov
1824,1821,9,680,1139,5,1144,0,1144,33,322,789,22.04.2019 00:30,117,11,Lvov
2320,2303,21,790,1516,14,1530,0,1530,41,369,1120,22.04.2019 00:30,117,11,Lvov
1856,1826,15,637,1204,15,1219,0,1219,44,372,803,22.04.2019 00:30,117,11,Lvov
1552,1552,12,436,1108,8,1116,0,1116,38,320,758,22.04.2019 00:07,117,11,Lvov
1888,1836,20,631,1241,16,1257,0,1257,31,456,770,22.04.2019 00:06,117,11,Lvov
1792,1790,17,517,1260,15,1275,0,1275,36,392,847,22.04.2019 00:12,117,11,Lvov
1792,1818,30,571,1201,20,1221,0,1221,32,331,858,22.04.2019 00:11,117,11,Lvov
1952,1925,18,612,1322,18,1340,0,1340,32,382,926,22.04.2019 00:05,117,11,Lvov
2208,2224,16,570,1627,11,1638,0,1638,37,412,1189,22.04.2019 00:05,117,11,Lvov
1664,1650,13,555,1097,12,1109,0,1109,38,284,787,22.04.2019 00:05,117,11,Lvov
1984,1969,18,602,1372,10,1382,0,1382,42,322,1018,22.04.2019 00:01,117,11,Lvov
1728,1778,14,500,1218,10,1228,0,1228,31,389,808,22.04.2019 00:45,117,11,Lvov
2000,1975,7,633,1361,6,1367,0,1367,44,385,938,22.04.2019 00:05,117,11,Lvov
1504,1495,17,435,1056,13,1069,0,1069,26,330,713,22.04.2019 00:05,117,11,Lvov
2096,2072,14,704,1383,9,1392,0,1392,43,398,951,22.04.2019 00:30,117,11,Lvov
1488,1456,11,517,964,7,971,0,971,25,230,716,22.04.2019 00:59,117,11,Lvov
1920,1910,8,612,1303,5,1308,0,1308,42,316,950,22.04.2019 01:30,117,11,Lvov
1488,1470,10,495,988,5,993,0,993,42,257,694,22.04.2019 00:27,117,11,Lvov
1728,1704,8,537,1188,3,1191,0,1191,28,349,814,22.04.2019 00:05,117,11,Lvov
2160,2126,10,696,1457,7,1464,0,1464,54,383,1027,22.04.2019 00:30,117,11,Lvov
2320,2290,9,690,1623,7,1630,0,1630,50,452,1128,22.04.2019 00:20,117,11,Lvov
416,88,49,345,31,40,71,0,71,0,23,48,22.04.2019 00:10,117,11,Lvov
224,135,25,99,105,20,125,0,125,6,31,88,22.04.2019 00:05,117,11,Lvov
1280,669,315,710,303,267,570,0,570,31,169,370,22.04.2019 00:05,117,11,Lvov
1472,1510,10,478,984,10,994,0,994,17,343,634,22.04.2019 00:20,117,11,Lvov
1456,1272,15,583,865,8,873,0,873,28,320,525,22.04.2019 00:15,117,11,Lvov
2304,2316,18,748,1542,14,1556,0,1556,35,437,1084,22.04.2019 00:30,117,11,Lvov
1104,1077,2,760,343,1,344,0,344,11,133,200,22.04.2019 01:05,117,11,Lvov
1504,1436,2,535,967,2,969,0,969,12,387,570,22.04.2019 00:10,117,11,Lvov
1328,1356,2,329,997,2,999,0,999,20,261,718,22.04.2019 00:15,117,11,Lvov
672,682,13,125,536,11,547,0,547,12,128,407,22.04.2019 00:05,118,11,Lvov
1120,1105,15,383,724,13,737,0,737,21,153,563,21.04.2019 22:00,118,11,Lvov
1600,1577,16,466,1120,14,1134,0,1134,22,246,866,22.04.2019 00:10,118,11,Lvov
144,136,7,20,117,7,124,0,124,2,20,102,22.04.2019 00:15,118,11,Lvov
272,270,11,76,187,9,196,0,196,2,37,157,22.04.2019 00:05,118,11,Lvov
80,72,5,28,47,5,52,0,52,0,8,44,22.04.2019 00:10,118,11,Lvov
80,70,10,35,36,9,45,0,45,1,6,38,22.04.2019 00:10,118,11,Lvov
464,456,10,123,331,10,341,0,341,4,82,255,21.04.2019 22:15,118,11,Lvov
144,134,8,23,113,8,121,0,121,1,18,102,22.04.2019 00:10,118,11,Lvov
928,911,23,190,717,21,738,0,738,11,112,615,21.04.2019 21:10,118,11,Lvov
2064,2051,34,525,1505,34,1539,0,1539,159,200,1180,22.04.2019 00:15,118,11,Lvov
1920,1895,19,499,1403,18,1421,0,1421,44,273,1104,22.04.2019 00:20,118,11,Lvov
240,223,1,62,177,1,178,0,178,11,31,136,22.04.2019 00:10,118,11,Lvov
448,433,28,116,304,28,332,0,332,5,61,266,21.04.2019 21:45,118,11,Lvov
496,483,19,178,300,18,318,0,318,6,63,249,21.04.2019 21:56,118,11,Lvov
528,520,20,126,382,20,402,0,402,10,105,287,22.04.2019 00:07,118,11,Lvov
256,250,6,76,174,6,180,0,180,0,40,140,21.04.2019 21:05,118,11,Lvov
624,602,9,172,443,9,452,0,452,11,156,285,22.04.2019 00:15,118,11,Lvov
80,73,3,19,58,3,61,0,61,2,12,47,22.04.2019 00:05,118,11,Lvov
1968,1970,14,639,1319,10,1329,0,1329,35,251,1043,22.04.2019 00:20,118,11,Lvov
2240,2248,14,763,1467,10,1477,0,1477,50,374,1053,21.04.2019 21:30,118,11,Lvov
2032,1998,7,677,1349,6,1355,0,1355,37,324,994,22.04.2019 00:05,118,11,Lvov
2448,2478,16,719,1715,14,1729,0,1729,55,450,1224,22.04.2019 00:07,118,11,Lvov
2352,2350,17,672,1666,14,1680,0,1680,56,471,1153,22.04.2019 00:10,118,11,Lvov
2448,2442,15,734,1704,10,1714,0,1714,56,463,1195,22.04.2019 00:10,118,11,Lvov
1120,674,10,453,657,10,667,0,667,47,533,87,22.04.2019 00:05,118,11,Lvov
1296,1285,34,243,1021,32,1053,0,1053,15,159,879,22.04.2019 00:32,118,11,Lvov
2256,2171,33,918,1306,32,1338,0,1338,24,561,753,22.04.2019 00:15,119,11,Lvov
1776,1742,33,726,1020,30,1050,0,1050,36,358,656,22.04.2019 00:08,119,11,Lvov
1520,1484,9,610,902,8,910,0,910,17,291,602,22.04.2019 01:10,119,11,Lvov
1872,1825,16,772,1086,14,1100,0,1100,33,393,674,22.04.2019 00:07,119,11,Lvov
2000,1957,19,747,1239,14,1253,0,1253,29,488,736,22.04.2019 00:25,119,11,Lvov
336,327,36,60,240,36,276,0,276,7,106,163,22.04.2019 00:50,119,11,Lvov
112,112,7,22,83,7,90,0,90,0,30,60,22.04.2019 01:30,119,11,Lvov
320,301,19,95,206,19,225,0,225,1,98,126,22.04.2019 00:17,119,11,Lvov
224,208,14,59,152,13,165,0,165,2,91,72,22.04.2019 00:10,119,11,Lvov
288,267,23,74,191,23,214,0,214,9,58,147,22.04.2019 01:10,119,11,Lvov
464,452,28,138,301,25,326,0,326,7,126,193,22.04.2019 00:13,119,11,Lvov
384,371,15,105,264,15,279,0,279,9,132,138,21.04.2019 23:53,119,11,Lvov
336,325,27,90,221,25,246,0,246,2,68,176,22.04.2019 00:07,119,11,Lvov
112,100,13,50,54,8,62,0,62,1,20,41,22.04.2019 00:25,119,11,Lvov
432,426,22,142,268,22,290,0,290,5,122,163,22.04.2019 01:50,119,11,Lvov
336,329,20,125,192,19,211,0,211,7,135,69,22.04.2019 00:30,119,11,Lvov
64,62,0,20,44,0,44,0,44,2,20,22,22.04.2019 00:35,119,11,Lvov
160,151,13,58,90,12,102,0,102,5,62,35,22.04.2019 00:25,119,11,Lvov
96,94,9,33,54,9,63,0,63,3,29,31,22.04.2019 00:25,119,11,Lvov
448,431,25,101,324,23,347,0,347,2,102,243,22.04.2019 00:17,119,11,Lvov
160,148,22,42,97,21,118,0,118,6,45,67,22.04.2019 00:10,119,11,Lvov
272,269,15,70,188,14,202,0,202,7,92,103,22.04.2019 00:10,119,11,Lvov
144,143,10,41,93,10,103,0,103,3,51,49,22.04.2019 00:15,119,11,Lvov
304,296,20,48,237,19,256,0,256,3,91,162,22.04.2019 00:10,119,11,Lvov
144,141,14,31,99,14,113,0,113,2,48,63,22.04.2019 00:37,119,11,Lvov
128,127,11,40,78,10,88,0,88,2,46,40,22.04.2019 00:10,119,11,Lvov
272,262,21,83,168,21,189,0,189,3,69,117,22.04.2019 00:17,119,11,Lvov
112,102,10,34,68,10,78,0,78,4,23,51,22.04.2019 00:15,119,11,Lvov
560,537,57,201,302,57,359,0,359,10,159,190,22.04.2019 00:12,119,11,Lvov
368,349,35,136,197,35,232,0,232,3,102,127,22.04.2019 00:17,119,11,Lvov
160,148,20,48,92,20,112,0,112,0,48,64,22.04.2019 00:20,119,11,Lvov
352,338,15,128,210,14,224,0,224,2,116,106,22.04.2019 00:11,119,11,Lvov
144,127,10,34,100,10,110,0,110,0,33,77,22.04.2019 00:55,119,11,Lvov
192,187,18,68,106,18,124,0,124,0,34,90,22.04.2019 00:05,119,11,Lvov
368,352,17,99,254,15,269,0,269,9,139,121,22.04.2019 00:45,119,11,Lvov
480,463,22,150,308,22,330,0,330,4,171,155,22.04.2019 00:20,119,11,Lvov
624,601,62,199,363,62,425,0,425,13,176,236,22.04.2019 00:30,119,11,Lvov
192,177,8,65,119,8,127,0,127,2,62,63,22.04.2019 00:30,119,11,Lvov
304,285,33,85,186,33,219,0,219,3,96,120,22.04.2019 00:30,119,11,Lvov
128,117,14,27,89,12,101,0,101,0,31,70,22.04.2019 00:15,119,11,Lvov
576,562,22,143,411,22,433,0,433,8,180,245,22.04.2019 00:09,119,11,Lvov
224,217,14,72,139,13,152,0,152,2,40,110,22.04.2019 00:20,119,11,Lvov
96,101,6,24,66,6,72,0,72,1,30,41,22.04.2019 00:37,119,11,Lvov
96,83,5,51,40,5,45,0,45,1,19,25,22.04.2019 00:10,119,11,Lvov
416,400,23,126,267,23,290,0,290,1,115,174,22.04.2019 00:22,119,11,Lvov
224,223,35,63,126,35,161,0,161,2,56,103,22.04.2019 00:40,119,11,Lvov
288,277,11,74,203,11,214,0,214,0,52,162,22.04.2019 00:02,119,11,Lvov
208,206,3,63,142,3,145,0,145,5,74,66,22.04.2019 00:15,119,11,Lvov
576,572,53,157,367,52,419,0,419,4,187,228,22.04.2019 00:15,119,11,Lvov
224,49,24,187,14,23,37,0,37,1,13,23,22.04.2019 00:15,119,11,Lvov
272,268,22,57,193,22,215,0,215,4,80,131,22.04.2019 00:05,119,11,Lvov
544,527,33,98,413,33,446,0,446,21,108,317,22.04.2019 00:05,119,11,Lvov
288,273,16,107,165,16,181,0,181,5,71,105,22.04.2019 00:10,119,11,Lvov
224,219,16,56,154,14,168,0,168,3,74,91,22.04.2019 00:20,119,11,Lvov
208,207,1,79,129,0,129,0,129,10,54,65,22.04.2019 00:04,119,11,Lvov
336,339,20,75,242,19,261,0,261,4,70,187,22.04.2019 00:04,119,11,Lvov
400,387,6,75,319,6,325,0,325,6,115,204,22.04.2019 00:02,119,11,Lvov
304,294,33,98,173,33,206,0,206,3,52,151,22.04.2019 00:15,119,11,Lvov
128,118,7,47,74,7,81,0,81,3,30,48,22.04.2019 00:15,119,11,Lvov
176,166,5,59,112,5,117,0,117,2,72,43,22.04.2019 00:10,119,11,Lvov
496,485,29,116,351,29,380,0,380,3,76,301,22.04.2019 00:43,119,11,Lvov
384,369,12,80,292,12,304,0,304,0,108,196,21.04.2019 22:00,119,11,Lvov
320,315,33,85,203,32,235,0,235,2,63,170,22.04.2019 00:15,119,11,Lvov
160,160,16,45,102,13,115,0,115,1,36,78,22.04.2019 00:10,119,11,Lvov
176,165,12,45,119,12,131,0,131,1,56,74,22.04.2019 00:23,119,11,Lvov
1104,1089,52,364,693,47,740,0,740,41,291,408,22.04.2019 01:00,119,11,Lvov
224,219,27,71,131,22,153,0,153,2,47,104,22.04.2019 00:06,119,11,Lvov
128,127,11,39,78,11,89,0,89,1,35,53,22.04.2019 00:15,119,11,Lvov
1120,1101,98,395,632,93,725,0,725,20,331,374,22.04.2019 00:05,119,11,Lvov
256,241,23,54,179,23,202,0,202,0,99,103,22.04.2019 00:20,119,11,Lvov
400,392,64,113,226,61,287,0,287,4,121,162,22.04.2019 00:30,119,11,Lvov
640,625,13,254,373,13,386,0,386,11,173,202,22.04.2019 00:30,119,11,Lvov
464,451,24,146,298,20,318,0,318,6,152,160,21.04.2019 20:45,119,11,Lvov
272,50,38,224,12,36,48,0,48,0,20,28,22.04.2019 00:23,119,11,Lvov
528,523,28,178,322,28,350,0,350,13,132,205,22.04.2019 00:15,119,11,Lvov
544,526,32,144,369,31,400,0,400,11,122,267,22.04.2019 00:12,119,11,Lvov
272,264,15,78,180,14,194,0,194,2,69,123,21.04.2019 21:20,119,11,Lvov
96,94,4,19,73,4,77,0,77,0,46,31,22.04.2019 00:15,119,11,Lvov
240,226,16,73,153,14,167,0,167,3,44,120,22.04.2019 00:07,119,11,Lvov
192,80,40,115,38,39,77,0,77,2,29,46,22.04.2019 00:30,119,11,Lvov
256,237,19,101,138,17,155,0,155,2,62,91,22.04.2019 00:45,119,11,Lvov
704,680,66,173,467,64,531,0,531,15,299,217,21.04.2019 22:15,119,11,Lvov
160,145,9,38,113,9,122,0,122,0,57,65,21.04.2019 23:30,119,11,Lvov
1216,1195,47,385,786,45,831,0,831,11,319,501,22.04.2019 00:51,119,11,Lvov
512,502,30,121,361,30,391,0,391,9,145,237,22.04.2019 00:40,119,11,Lvov
240,227,8,87,145,8,153,0,153,0,73,80,22.04.2019 00:25,119,11,Lvov
240,170,20,70,151,19,170,0,170,2,72,96,22.04.2019 00:20,119,11,Lvov
320,307,19,79,225,16,241,0,241,5,106,130,22.04.2019 01:00,119,11,Lvov
496,497,53,95,355,46,401,0,401,14,157,230,22.04.2019 00:15,119,11,Lvov
256,240,19,106,133,17,150,0,150,4,77,69,22.04.2019 00:15,119,11,Lvov
480,459,16,200,265,15,280,0,280,4,130,146,21.04.2019 22:35,119,11,Lvov
592,584,22,237,336,19,355,0,355,5,169,181,22.04.2019 00:35,119,11,Lvov
400,384,16,78,306,16,322,0,322,9,130,183,21.04.2019 22:10,119,11,Lvov
368,361,28,85,257,26,283,0,283,3,107,173,21.04.2019 21:10,119,11,Lvov
336,316,21,131,187,18,205,0,205,6,84,115,22.04.2019 00:07,119,11,Lvov
96,86,2,39,56,1,57,0,57,0,22,35,22.04.2019 00:20,119,11,Lvov
176,172,20,60,99,17,116,0,116,4,59,53,22.04.2019 00:40,119,11,Lvov
512,504,43,129,344,39,383,0,383,11,190,182,22.04.2019 00:04,119,11,Lvov
64,32,6,38,20,6,26,0,26,0,11,15,21.04.2019 20:50,119,11,Lvov
240,224,18,81,143,16,159,0,159,1,49,109,21.04.2019 21:00,120,11,Lvov
816,801,37,232,547,37,584,0,584,16,148,420,21.04.2019 23:00,120,11,Lvov
240,230,27,50,163,27,190,0,190,3,26,161,22.04.2019 00:01,120,11,Lvov
576,558,29,122,426,28,454,0,454,13,54,387,21.04.2019 21:10,120,11,Lvov
128,131,11,26,91,11,102,0,102,1,18,83,21.04.2019 21:10,120,11,Lvov
1600,1580,19,570,1014,16,1030,0,1030,21,230,779,22.04.2019 00:20,120,11,Lvov
1968,1956,17,666,1288,14,1302,0,1302,31,379,892,22.04.2019 00:07,120,11,Lvov
752,743,34,174,544,34,578,0,578,11,167,400,22.04.2019 00:05,120,11,Lvov
240,235,22,71,149,20,169,0,169,7,35,127,22.04.2019 00:05,120,11,Lvov
304,308,24,115,167,22,189,0,189,5,41,143,21.04.2019 21:30,120,11,Lvov
480,465,40,119,325,36,361,0,361,7,106,248,21.04.2019 22:10,120,11,Lvov
272,259,24,64,184,24,208,0,208,1,57,150,21.04.2019 22:00,120,11,Lvov
288,275,17,50,222,16,238,0,238,8,64,166,22.04.2019 00:05,120,11,Lvov
192,189,12,44,136,12,148,0,148,1,50,97,22.04.2019 00:05,120,11,Lvov
176,171,16,28,132,16,148,0,148,9,20,119,22.04.2019 00:15,120,11,Lvov
432,427,7,113,312,7,319,0,319,0,85,234,21.04.2019 21:30,120,11,Lvov
304,294,9,119,176,9,185,0,185,2,31,152,21.04.2019 21:00,120,11,Lvov
400,381,32,125,244,31,275,0,275,9,82,184,21.04.2019 21:20,120,11,Lvov
320,321,63,88,174,58,232,0,232,12,52,168,21.04.2019 21:30,120,11,Lvov
320,322,30,110,183,27,210,0,210,3,53,154,21.04.2019 21:08,120,11,Lvov
224,32,20,193,11,20,31,0,31,1,11,19,21.04.2019 21:00,120,11,Lvov
1280,1269,5,543,732,5,737,0,737,13,366,358,21.04.2019 21:50,120,11,Lvov
1280,1263,3,590,688,2,690,0,690,22,373,295,21.04.2019 20:30,120,11,Lvov
1216,1204,11,436,769,11,780,0,780,15,259,506,21.04.2019 21:50,120,11,Lvov
256,251,24,77,155,24,179,0,179,3,48,128,21.04.2019 21:00,120,11,Lvov
720,710,52,258,415,47,462,0,462,22,180,260,21.04.2019 21:00,120,11,Lvov
496,487,39,127,332,37,369,0,369,12,100,257,21.04.2019 21:40,120,11,Lvov
224,221,25,55,149,20,169,0,169,6,51,112,22.04.2019 00:10,120,11,Lvov
368,356,11,92,265,11,276,0,276,2,121,153,22.04.2019 00:10,120,11,Lvov
400,400,28,122,250,28,278,0,278,3,109,166,21.04.2019 22:00,120,11,Lvov
64,49,6,35,23,6,29,0,29,2,16,11,21.04.2019 23:00,120,11,Lvov
544,520,15,222,308,14,322,0,322,5,186,131,21.04.2019 21:37,120,11,Lvov
400,379,30,189,183,28,211,0,211,3,31,177,22.04.2019 00:10,120,11,Lvov
160,144,16,48,96,16,112,0,112,4,29,79,21.04.2019 21:30,120,11,Lvov
128,116,18,36,76,16,92,0,92,4,28,60,22.04.2019 00:05,120,11,Lvov
576,565,25,241,310,25,335,0,335,7,127,201,21.04.2019 23:00,120,11,Lvov
576,563,55,276,251,49,300,0,300,9,99,192,22.04.2019 00:10,120,11,Lvov
512,492,29,123,360,29,389,0,389,6,205,178,21.04.2019 22:20,120,11,Lvov
480,470,35,151,294,35,329,0,329,11,86,232,21.04.2019 22:30,120,11,Lvov
608,591,31,165,413,30,443,0,443,20,206,217,21.04.2019 21:30,120,11,Lvov
240,234,14,25,202,13,215,0,215,2,91,122,21.04.2019 20:58,120,11,Lvov
160,153,7,23,130,7,137,0,137,8,46,83,21.04.2019 21:05,120,11,Lvov
112,102,2,18,92,2,94,0,94,5,32,57,21.04.2019 21:15,120,11,Lvov
384,374,13,106,266,12,278,0,278,8,76,194,21.04.2019 21:50,120,11,Lvov
224,218,13,90,121,13,134,0,134,3,61,70,21.04.2019 21:00,120,11,Lvov
240,226,16,47,177,16,193,0,193,0,40,153,21.04.2019 21:10,120,11,Lvov
304,286,21,122,162,20,182,0,182,4,70,108,21.04.2019 21:00,120,11,Lvov
192,186,8,40,144,8,152,0,152,0,77,75,21.04.2019 21:30,120,11,Lvov
128,122,5,31,92,5,97,0,97,3,22,72,21.04.2019 20:30,120,11,Lvov
320,306,7,102,211,7,218,0,218,2,69,147,21.04.2019 21:40,120,11,Lvov
176,158,12,46,118,12,130,0,130,1,60,69,21.04.2019 21:30,120,11,Lvov
240,236,19,92,132,16,148,0,148,8,78,62,21.04.2019 21:20,120,11,Lvov
256,239,25,82,153,21,174,0,174,2,49,123,21.04.2019 22:00,120,11,Lvov
480,465,35,109,339,32,371,0,371,7,235,129,21.04.2019 21:10,120,11,Lvov
384,369,16,147,225,12,237,0,237,8,124,105,21.04.2019 21:00,120,11,Lvov
480,485,35,181,265,34,299,0,299,6,146,147,21.04.2019 21:00,120,11,Lvov
272,271,20,47,206,19,225,0,225,43,35,147,21.04.2019 20:30,120,11,Lvov
528,520,19,134,375,19,394,0,394,1,196,197,21.04.2019 20:45,120,11,Lvov
208,201,13,72,123,13,136,0,136,1,37,98,22.04.2019 00:10,121,11,Lvov
1264,1245,64,328,872,64,936,0,936,18,267,651,22.04.2019 00:03,121,11,Lvov
272,240,8,159,105,8,113,0,113,1,46,66,22.04.2019 01:10,121,11,Lvov
1072,1052,89,299,686,87,773,0,773,6,290,477,22.04.2019 00:15,121,11,Lvov
592,586,24,227,341,24,365,0,365,8,159,198,22.04.2019 00:10,121,11,Lvov
848,831,26,220,602,26,628,0,628,18,119,491,22.04.2019 00:30,121,11,Lvov
720,707,33,215,472,33,505,0,505,9,220,276,22.04.2019 00:40,121,11,Lvov
112,112,10,30,72,10,82,0,82,1,20,61,22.04.2019 00:10,121,11,Lvov
896,876,39,255,602,39,641,0,641,13,157,471,22.04.2019 00:35,121,11,Lvov
608,593,26,166,417,25,442,0,442,5,153,284,22.04.2019 00:30,121,11,Lvov
80,67,1,22,57,1,58,0,58,0,20,38,22.04.2019 00:05,121,11,Lvov
624,602,35,107,482,35,517,0,517,26,164,327,22.04.2019 00:15,121,11,Lvov
1040,1023,22,390,628,22,650,0,650,13,266,371,22.04.2019 00:10,121,11,Lvov
384,374,12,108,264,12,276,0,276,11,69,196,22.04.2019 00:15,121,11,Lvov
112,105,3,37,72,3,75,0,75,1,48,26,22.04.2019 00:10,121,11,Lvov
1856,1837,47,753,1057,46,1103,0,1103,26,479,598,22.04.2019 00:10,121,11,Lvov
656,651,40,219,397,40,437,0,437,12,152,273,22.04.2019 00:10,121,11,Lvov
736,716,37,269,430,37,467,0,467,6,196,265,22.04.2019 00:50,121,11,Lvov
336,331,24,77,235,24,259,0,259,2,109,148,22.04.2019 00:10,121,11,Lvov
928,902,26,282,620,26,646,0,646,5,204,437,22.04.2019 00:45,121,11,Lvov
1056,1033,52,309,695,52,747,0,747,21,234,492,21.04.2019 23:05,121,11,Lvov
688,679,27,227,434,27,461,0,461,5,119,337,22.04.2019 00:10,121,11,Lvov
112,103,0,37,75,0,75,0,75,0,23,52,22.04.2019 00:05,121,11,Lvov
1040,1026,16,377,651,12,663,0,663,11,195,457,22.04.2019 00:10,121,11,Lvov
1248,1229,13,529,706,13,719,0,719,23,213,483,22.04.2019 00:25,121,11,Lvov
1248,1242,27,398,823,27,850,0,850,57,222,571,22.04.2019 00:25,121,11,Lvov
144,138,1,63,80,1,81,0,81,1,33,47,22.04.2019 00:10,121,11,Lvov
816,793,12,375,433,8,441,0,441,19,195,227,22.04.2019 00:15,121,11,Lvov
1280,1265,17,594,674,12,686,0,686,32,322,332,22.04.2019 00:30,121,11,Lvov
1264,1238,7,550,708,6,714,0,714,32,323,359,21.04.2019 22:00,121,11,Lvov
1600,1587,5,779,816,5,821,0,821,31,379,411,22.04.2019 00:15,121,11,Lvov
1040,1014,12,418,610,12,622,0,622,25,263,334,22.04.2019 00:30,121,11,Lvov
768,756,9,316,444,8,452,0,452,20,184,248,22.04.2019 00:45,121,11,Lvov
544,538,5,236,304,4,308,0,308,12,159,137,22.04.2019 00:40,121,11,Lvov
768,756,13,327,430,11,441,0,441,15,192,234,22.04.2019 00:25,121,11,Lvov
656,739,14,142,500,14,514,0,514,15,242,257,22.04.2019 00:05,121,11,Lvov
1584,1556,19,625,943,16,959,0,959,27,331,601,22.04.2019 00:27,121,11,Lvov
2288,2253,28,885,1381,22,1403,48,1403,48,539,816,22.04.2019 00:05,121,11,Lvov
2080,2061,14,877,1194,9,1203,0,1203,44,457,702,22.04.2019 00:05,121,11,Lvov
2352,2335,23,964,1369,19,1388,0,1388,43,516,829,22.04.2019 00:05,121,11,Lvov
2368,2354,24,863,1486,19,1505,0,1505,86,460,959,22.04.2019 00:30,121,11,Lvov
2336,2310,32,962,1351,23,1374,0,1374,58,457,859,22.04.2019 00:10,121,11,Lvov
2448,2473,31,868,1555,25,1580,0,1580,64,600,916,22.04.2019 00:15,121,11,Lvov
2336,2319,22,888,1432,16,1448,0,1448,64,628,756,22.04.2019 00:20,121,11,Lvov
336,52,40,289,12,35,47,0,47,2,16,29,22.04.2019 00:10,121,11,Lvov
512,478,0,45,467,0,467,0,467,44,299,124,22.04.2019 00:10,121,11,Lvov
2192,2202,18,838,1343,11,1354,0,1354,49,482,823,22.04.2019 00:20,121,11,Lvov
1776,1919,18,381,1382,13,1395,0,1395,31,682,682,21.04.2019 22:05,121,11,Lvov
2304,2319,24,866,1416,22,1438,0,1438,37,539,862,22.04.2019 00:10,121,11,Lvov
1136,1088,115,415,606,115,721,0,721,19,250,452,22.04.2019 00:35,121,11,Lvov
2032,1483,0,772,1260,0,1260,0,1260,64,555,641,21.04.2019 21:59,122,11,Lvov
464,453,15,171,278,15,293,0,293,6,126,161,21.04.2019 22:10,122,11,Lvov
1712,1679,79,693,945,74,1019,0,1019,20,475,524,21.04.2019 22:00,122,11,Lvov
288,277,28,72,188,28,216,0,216,2,117,97,21.04.2019 21:45,122,11,Lvov
304,291,28,80,200,24,224,0,224,4,138,82,21.04.2019 20:35,122,11,Lvov
192,182,22,43,127,22,149,0,149,3,54,92,21.04.2019 22:10,122,11,Lvov
320,311,28,92,202,26,228,0,228,4,104,120,21.04.2019 22:30,122,11,Lvov
688,673,60,206,425,57,482,0,482,8,174,300,21.04.2019 22:10,122,11,Lvov
464,459,36,132,303,29,332,0,332,9,122,201,21.04.2019 23:50,122,11,Lvov
448,436,44,152,255,41,296,0,296,5,123,168,21.04.2019 22:15,122,11,Lvov
336,324,19,105,212,19,231,0,231,7,67,157,21.04.2019 20:46,122,11,Lvov
368,354,13,118,237,13,250,0,250,2,102,146,21.04.2019 23:00,122,11,Lvov
464,461,16,111,337,16,353,0,353,8,153,192,21.04.2019 22:15,122,11,Lvov
336,323,18,91,227,18,245,0,245,7,60,178,21.04.2019 22:00,122,11,Lvov
1360,1336,35,429,896,35,931,0,931,24,206,701,21.04.2019 20:33,122,11,Lvov
1488,1477,7,536,945,7,952,0,952,47,348,557,22.04.2019 00:23,122,11,Lvov
1504,1480,12,520,973,11,984,0,984,28,320,636,22.04.2019 00:15,122,11,Lvov
128,117,18,36,76,16,92,1,92,1,34,57,22.04.2019 00:08,122,11,Lvov
928,911,39,279,611,38,649,0,649,6,278,365,22.04.2019 00:10,122,11,Lvov
1072,1058,49,344,679,49,728,0,728,15,310,403,22.04.2019 00:03,122,11,Lvov
288,284,11,107,176,5,181,0,181,4,38,139,22.04.2019 00:15,122,11,Lvov
368,357,17,148,203,17,220,0,220,3,90,127,22.04.2019 00:15,122,11,Lvov
336,334,22,79,237,20,257,0,257,10,74,173,22.04.2019 00:05,122,11,Lvov
368,359,29,117,222,29,251,0,251,2,139,110,21.04.2019 23:00,122,11,Lvov
240,54,9,212,19,9,28,0,28,1,7,20,22.04.2019 00:10,122,11,Lvov
416,75,63,349,12,55,67,0,67,2,17,48,22.04.2019 00:05,122,11,Lvov
96,13,0,83,13,0,13,0,13,0,2,11,22.04.2019 00:03,122,11,Lvov
368,366,27,99,242,27,269,0,269,7,82,180,22.04.2019 00:35,123,11,Lvov
240,223,12,45,183,12,195,0,195,5,50,140,22.04.2019 00:15,123,11,Lvov
64,52,3,24,37,3,40,0,40,0,11,29,22.04.2019 00:07,123,11,Lvov
80,82,1,31,48,1,49,0,49,2,15,32,22.04.2019 00:10,123,11,Lvov
224,218,28,30,166,28,194,0,194,2,63,129,22.04.2019 00:50,123,11,Lvov
256,249,13,105,138,13,151,0,151,4,65,82,22.04.2019 00:05,123,11,Lvov
64,55,3,19,42,3,45,0,45,1,30,14,22.04.2019 00:45,123,11,Lvov
288,283,15,94,179,15,194,0,194,2,49,143,22.04.2019 00:40,123,11,Lvov
288,275,18,84,186,18,204,0,204,5,78,121,22.04.2019 00:30,123,11,Lvov
144,134,4,50,90,4,94,0,94,1,45,48,22.04.2019 01:30,123,11,Lvov
288,281,25,79,184,25,209,0,209,2,81,126,22.04.2019 00:10,123,11,Lvov
976,967,40,274,663,39,702,0,702,14,190,498,22.04.2019 00:10,123,11,Lvov
96,92,9,30,58,8,66,0,66,0,11,55,22.04.2019 00:10,123,11,Lvov
208,202,20,43,145,20,165,0,165,1,22,142,22.04.2019 00:05,123,11,Lvov
304,295,13,100,191,13,204,0,204,5,79,120,22.04.2019 00:10,123,11,Lvov
480,495,37,137,308,35,343,0,343,9,112,222,22.04.2019 00:05,123,11,Lvov
208,207,13,48,147,13,160,0,160,7,40,113,22.04.2019 00:15,123,11,Lvov
256,251,7,101,149,6,155,0,155,5,91,59,22.04.2019 00:15,123,11,Lvov
96,83,8,29,59,8,67,0,67,3,27,37,22.04.2019 00:30,123,11,Lvov
80,82,7,27,46,7,53,0,53,0,25,28,22.04.2019 00:35,123,11,Lvov
848,828,56,349,444,55,499,0,499,9,294,196,22.04.2019 00:30,123,11,Lvov
112,106,9,29,75,8,83,0,83,0,45,38,22.04.2019 00:15,123,11,Lvov
256,242,11,69,176,11,187,0,187,6,88,93,22.04.2019 00:43,123,11,Lvov
400,397,31,91,278,31,309,0,309,9,108,192,22.04.2019 00:10,123,11,Lvov
144,129,10,47,87,10,97,0,97,1,34,62,22.04.2019 00:10,123,11,Lvov
320,315,26,89,205,26,231,0,231,3,68,160,22.04.2019 00:47,123,11,Lvov
960,947,39,210,711,39,750,0,750,18,294,438,22.04.2019 00:05,123,11,Lvov
80,72,3,30,47,3,50,0,50,0,26,24,22.04.2019 00:17,123,11,Lvov
192,183,6,69,117,6,123,0,123,4,77,42,22.04.2019 00:45,123,11,Lvov
208,195,11,83,114,11,125,0,125,4,60,61,22.04.2019 00:30,123,11,Lvov
304,35,17,277,17,10,27,0,27,1,11,15,22.04.2019 00:25,123,11,Lvov
176,32,1,144,31,1,32,0,32,1,26,5,22.04.2019 00:55,123,11,Lvov
272,256,12,68,192,12,204,0,204,3,38,163,22.04.2019 00:15,123,11,Lvov
112,105,11,24,79,9,88,0,88,2,21,65,22.04.2019 00:15,123,11,Lvov
496,488,25,144,327,25,352,0,352,6,127,219,22.04.2019 00:15,123,11,Lvov
2128,2129,28,707,1395,26,1421,0,1421,46,494,881,22.04.2019 00:35,123,11,Lvov
1568,1540,17,617,941,10,951,0,951,28,361,562,22.04.2019 00:34,123,11,Lvov
1504,1466,22,618,866,20,886,0,886,33,326,527,22.04.2019 00:15,123,11,Lvov
256,246,2,57,197,2,199,0,199,1,86,112,22.04.2019 00:15,123,11,Lvov
400,381,8,103,289,8,297,0,297,3,64,230,22.04.2019 00:05,123,11,Lvov
224,44,20,186,21,17,38,0,38,1,17,20,22.04.2019 00:45,123,11,Lvov
496,365,0,361,135,0,135,0,135,16,38,81,22.04.2019 00:20,123,11,Lvov
464,462,41,149,276,39,315,0,315,7,77,231,22.04.2019 00:06,123,11,Lvov
592,585,42,90,461,41,502,0,502,6,56,440,22.04.2019 00:26,123,11,Lvov
208,195,14,60,135,13,148,0,148,4,27,117,22.04.2019 00:35,123,11,Lvov
112,108,7,26,79,7,86,0,86,1,14,71,22.04.2019 00:15,123,11,Lvov
816,792,50,247,523,46,569,0,569,12,178,379,22.04.2019 00:53,123,11,Lvov
288,273,2,88,198,2,200,0,200,2,39,159,22.04.2019 00:07,123,11,Lvov
768,752,36,251,482,35,517,0,517,16,129,372,22.04.2019 00:40,123,11,Lvov
656,639,45,214,397,45,442,0,442,4,124,314,22.04.2019 00:05,123,11,Lvov
416,407,33,148,237,31,268,0,268,4,93,171,22.04.2019 00:20,123,11,Lvov
480,463,24,148,312,20,332,0,332,5,127,200,22.04.2019 00:15,123,11,Lvov
112,108,4,51,57,4,61,0,61,1,18,42,22.04.2019 00:30,123,11,Lvov
496,509,83,119,297,80,377,0,377,1,103,273,22.04.2019 00:31,123,11,Lvov
272,270,22,67,183,22,205,0,205,1,80,124,22.04.2019 00:05,123,11,Lvov
192,182,8,46,138,8,146,0,146,3,61,82,22.04.2019 00:30,123,11,Lvov
464,452,35,133,298,33,331,0,331,5,184,142,22.04.2019 00:25,123,11,Lvov
1968,1959,27,732,1212,24,1236,0,1236,45,489,702,22.04.2019 00:40,123,11,Lvov
304,299,17,98,189,17,206,0,206,9,78,119,22.04.2019 00:15,123,11,Lvov
320,304,16,47,257,16,273,0,273,1,76,196,22.04.2019 01:00,123,11,Lvov
160,158,16,22,123,15,138,0,138,0,27,111,22.04.2019 00:15,123,11,Lvov
160,150,22,21,117,22,139,0,139,5,19,115,22.04.2019 00:20,123,11,Lvov
256,237,7,51,198,7,205,0,205,4,69,132,22.04.2019 00:30,123,11,Lvov
448,432,35,129,286,33,319,0,319,2,124,193,22.04.2019 00:05,123,11,Lvov
464,458,24,104,337,23,360,0,360,5,116,239,22.04.2019 00:20,123,11,Lvov
208,24,12,185,12,11,23,0,23,0,12,11,22.04.2019 00:30,123,11,Lvov
1392,1387,43,475,879,38,917,0,917,20,377,520,22.04.2019 00:20,124,11,Lvov
1936,1908,12,751,1176,9,1185,0,1185,33,612,540,22.04.2019 00:05,124,11,Lvov
1600,1578,75,601,934,65,999,0,999,15,443,541,22.04.2019 01:30,124,11,Lvov
496,498,24,70,402,24,426,0,426,9,123,294,22.04.2019 00:30,124,11,Lvov
128,128,1,16,111,1,112,0,112,1,42,69,22.04.2019 00:59,124,11,Lvov
384,380,5,87,292,5,297,0,297,7,109,181,22.04.2019 00:30,124,11,Lvov
112,97,3,24,85,3,88,0,88,4,32,52,22.04.2019 00:15,124,11,Lvov
320,310,21,62,237,21,258,0,258,6,119,133,22.04.2019 00:03,124,11,Lvov
256,247,25,62,169,25,194,0,194,4,99,91,22.04.2019 00:15,124,11,Lvov
896,887,88,276,534,86,620,0,620,11,315,294,22.04.2019 00:35,124,11,Lvov
96,95,10,15,71,10,81,0,81,0,46,35,22.04.2019 00:15,124,11,Lvov
112,95,8,37,68,7,75,0,75,0,39,36,22.04.2019 00:10,124,11,Lvov
80,66,5,25,51,4,55,0,55,0,23,32,22.04.2019 00:03,124,11,Lvov
176,165,10,48,118,10,128,0,128,1,58,69,22.04.2019 00:45,124,11,Lvov
400,398,24,83,293,24,317,0,317,6,122,189,22.04.2019 00:20,124,11,Lvov
128,120,1,50,78,0,78,0,78,2,46,30,22.04.2019 01:05,124,11,Lvov
288,277,22,92,175,21,196,0,196,1,91,104,22.04.2019 00:15,124,11,Lvov
336,322,28,94,217,25,242,0,242,3,82,157,22.04.2019 00:28,124,11,Lvov
160,156,16,19,125,16,141,0,141,0,86,55,22.04.2019 00:48,124,11,Lvov
208,201,17,68,124,16,140,0,140,2,71,67,22.04.2019 00:35,124,11,Lvov
256,253,24,75,157,24,181,0,181,0,66,115,22.04.2019 00:02,124,11,Lvov
352,344,26,104,222,26,248,0,248,6,125,117,22.04.2019 00:15,124,11,Lvov
464,449,24,109,331,24,355,0,355,5,106,244,22.04.2019 00:50,124,11,Lvov
608,589,37,89,482,37,519,0,519,35,171,313,22.04.2019 00:15,124,11,Lvov
272,262,21,55,197,20,217,0,217,0,117,100,22.04.2019 00:10,124,11,Lvov
672,663,29,233,413,26,439,0,439,6,191,242,22.04.2019 00:10,124,11,Lvov
240,228,7,80,153,7,160,0,160,9,62,89,22.04.2019 00:48,124,11,Lvov
2208,2188,43,888,1283,37,1320,0,1320,48,572,700,22.04.2019 00:20,124,11,Lvov
2224,2204,37,912,1281,31,1312,0,1312,40,607,665,22.04.2019 00:27,124,11,Lvov
480,470,12,113,355,12,367,0,367,5,203,159,22.04.2019 00:05,124,11,Lvov
352,340,17,79,257,16,273,0,273,5,129,139,22.04.2019 00:06,124,11,Lvov
160,154,6,39,115,6,121,0,121,1,51,69,22.04.2019 00:05,124,11,Lvov
128,127,6,31,91,6,97,0,97,0,43,54,22.04.2019 00:05,124,11,Lvov
224,222,55,47,132,45,177,0,177,1,49,127,22.04.2019 00:25,124,11,Lvov
1376,1344,30,521,827,28,855,0,855,25,422,408,22.04.2019 00:40,124,11,Lvov
880,869,54,256,577,47,624,0,624,18,225,381,22.04.2019 00:05,124,11,Lvov
736,721,26,215,495,26,521,0,521,10,232,279,22.04.2019 00:15,124,11,Lvov
80,79,5,28,47,5,52,0,52,0,17,35,22.04.2019 00:04,124,11,Lvov
368,361,30,65,274,29,303,0,303,9,105,189,22.04.2019 00:05,124,11,Lvov
448,427,23,126,299,23,322,0,322,9,134,179,22.04.2019 00:10,124,11,Lvov
352,339,31,112,212,28,240,0,240,3,88,149,22.04.2019 00:15,124,11,Lvov
304,301,20,104,181,19,200,0,200,3,85,112,22.04.2019 00:20,124,11,Lvov
752,729,31,276,451,25,476,0,476,9,241,226,22.04.2019 00:10,124,11,Lvov
160,144,5,59,96,5,101,0,101,3,22,76,22.04.2019 00:40,124,11,Lvov
752,741,45,255,452,45,497,0,497,16,136,345,22.04.2019 00:30,124,11,Lvov
64,62,1,20,43,1,44,0,44,2,26,16,22.04.2019 00:35,124,11,Lvov
208,201,18,41,149,18,167,0,167,0,36,131,22.04.2019 00:15,124,11,Lvov
416,407,10,130,276,10,286,0,286,8,112,166,22.04.2019 00:10,124,11,Lvov
608,592,30,178,400,30,430,0,430,9,175,246,22.04.2019 00:10,124,11,Lvov
352,333,9,103,242,7,249,0,249,9,116,124,22.04.2019 00:05,124,11,Lvov
368,363,16,85,268,15,283,0,283,12,160,111,22.04.2019 00:40,124,11,Lvov
1344,1325,63,423,861,60,921,0,921,23,420,478,22.04.2019 00:15,124,11,Lvov
976,957,15,361,600,15,615,0,615,14,296,305,22.04.2019 00:30,124,11,Lvov
2288,2244,52,815,1427,46,1473,0,1473,60,595,818,22.04.2019 00:15,124,11,Lvov
80,14,0,66,14,0,14,0,14,0,7,7,22.04.2019 00:05,124,11,Lvov
2080,2037,11,795,1278,7,1285,0,1285,41,556,688,22.04.2019 00:33,124,11,Lvov
2192,2152,34,929,1243,20,1263,0,1263,46,593,624,22.04.2019 00:05,124,11,Lvov
2032,1997,35,872,1132,28,1160,0,1160,54,574,532,22.04.2019 00:45,124,11,Lvov
2272,2243,21,810,1450,12,1462,0,1462,50,617,795,22.04.2019 00:10,124,11,Lvov
1712,1670,20,662,1038,12,1050,0,1050,35,510,505,22.04.2019 00:30,124,11,Lvov
464,65,47,406,15,43,58,0,58,2,25,31,22.04.2019 00:05,124,11,Lvov
48,17,0,31,17,0,17,0,17,0,9,8,22.04.2019 00:15,124,11,Lvov
576,557,31,217,328,31,359,0,359,8,169,182,22.04.2019 00:05,125,11,Lvov
272,260,31,72,171,29,200,0,200,1,93,106,22.04.2019 00:10,125,11,Lvov
672,659,65,153,460,59,519,0,519,6,288,225,21.04.2019 23:40,125,11,Lvov
1616,1584,26,820,773,23,796,0,796,22,347,427,21.04.2019 21:50,125,11,Lvov
2304,2250,29,946,1329,29,1358,0,1358,36,600,722,22.04.2019 00:05,125,11,Lvov
2384,2348,27,1055,1308,21,1329,0,1329,36,656,637,22.04.2019 00:17,125,11,Lvov
1040,1018,51,389,603,48,651,0,651,24,333,294,21.04.2019 21:00,125,11,Lvov
1344,1321,70,536,748,60,808,0,808,20,387,401,21.04.2019 21:15,125,11,Lvov
832,811,35,230,569,33,602,0,602,20,239,343,21.04.2019 21:30,125,11,Lvov
544,531,28,173,343,28,371,0,371,6,135,230,22.04.2019 00:16,125,11,Lvov
224,220,20,86,119,19,138,0,138,0,37,101,21.04.2019 23:50,125,11,Lvov
288,281,21,99,168,21,189,0,189,1,68,120,21.04.2019 23:45,125,11,Lvov
304,290,13,128,165,11,176,0,176,2,77,97,21.04.2019 22:45,125,11,Lvov
368,346,49,95,224,49,273,0,273,2,99,172,21.04.2019 21:30,125,11,Lvov
304,292,33,60,212,32,244,0,244,10,86,148,22.04.2019 00:43,125,11,Lvov
960,935,61,182,717,61,778,0,778,21,274,483,22.04.2019 00:15,125,11,Lvov
928,912,51,319,558,51,609,0,609,15,296,298,22.04.2019 00:05,125,11,Lvov
752,736,31,213,508,31,539,0,539,17,177,345,22.04.2019 00:20,125,11,Lvov
464,448,51,190,228,46,274,0,274,1,143,130,21.04.2019 22:18,125,11,Lvov
224,210,28,52,144,28,172,0,172,0,52,120,21.04.2019 22:10,125,11,Lvov
688,652,42,308,340,40,380,0,380,4,126,250,21.04.2019 22:00,125,11,Lvov
480,458,45,206,233,41,274,0,274,5,114,155,22.04.2019 01:45,125,11,Lvov
336,324,19,61,256,19,275,0,275,8,100,167,22.04.2019 00:10,125,11,Lvov
480,469,12,165,303,12,315,0,315,6,147,162,22.04.2019 00:15,125,11,Lvov
576,568,44,153,381,42,423,0,423,3,183,237,22.04.2019 00:20,125,11,Lvov
512,507,25,175,314,23,337,0,337,9,97,231,22.04.2019 00:20,125,11,Lvov
480,463,56,108,316,56,372,0,372,4,190,178,21.04.2019 21:58,125,11,Lvov
688,660,45,128,517,43,560,0,560,15,234,311,22.04.2019 00:40,125,11,Lvov
432,414,27,69,336,27,363,0,363,10,147,206,22.04.2019 00:15,125,11,Lvov
208,193,4,44,160,4,164,0,164,7,48,109,22.04.2019 00:20,125,11,Lvov
128,127,7,14,107,7,114,0,114,2,44,68,22.04.2019 00:30,125,11,Lvov
96,79,9,53,35,8,43,0,43,1,8,34,21.04.2019 21:05,125,11,Lvov
464,447,23,109,332,23,355,0,355,6,162,187,22.04.2019 00:10,125,11,Lvov
912,891,37,312,565,35,600,0,600,20,340,240,21.04.2019 23:58,125,11,Lvov
112,101,4,30,78,4,82,0,82,5,48,29,22.04.2019 00:10,125,11,Lvov
368,352,7,132,229,7,236,0,236,3,150,83,22.04.2019 00:10,125,11,Lvov
528,510,24,180,328,20,348,0,348,10,180,158,22.04.2019 00:10,125,11,Lvov
512,490,23,196,294,22,316,0,316,10,210,96,22.04.2019 00:02,125,11,Lvov
800,794,48,312,440,48,488,0,488,8,246,234,22.04.2019 01:20,125,11,Lvov
464,449,21,205,238,21,259,0,259,6,79,174,22.04.2019 00:05,125,11,Lvov
1632,1577,75,647,912,73,985,0,985,15,501,469,22.04.2019 00:30,125,11,Lvov
1360,1330,83,561,724,75,799,0,799,16,401,382,21.04.2019 22:30,125,11,Lvov
848,832,56,192,600,56,656,0,656,13,345,298,22.04.2019 00:15,125,11,Lvov
720,720,40,243,441,36,477,0,477,7,285,185,21.04.2019 20:55,125,11,Lvov
736,733,29,264,443,29,472,0,472,12,173,287,22.04.2019 00:15,125,11,Lvov
144,143,1,19,124,1,125,0,125,0,34,91,21.04.2019 22:45,125,11,Lvov
400,381,5,147,249,4,253,0,253,9,123,121,22.04.2019 00:05,125,11,Lvov
304,302,13,83,208,13,221,0,221,9,95,117,22.04.2019 00:15,125,11,Lvov
160,156,16,15,129,16,145,0,145,2,22,121,22.04.2019 00:15,125,11,Lvov
736,732,26,248,463,25,488,0,488,15,198,275,21.04.2019 21:15,125,11,Lvov
256,267,12,73,173,10,183,0,183,1,86,96,21.04.2019 21:30,125,11,Lvov
624,612,35,228,361,35,396,0,396,8,184,204,21.04.2019 21:28,125,11,Lvov
384,372,34,136,214,34,248,0,248,4,134,110,22.04.2019 00:01,125,11,Lvov
624,608,55,123,446,55,501,0,501,12,216,273,22.04.2019 00:05,125,11,Lvov
176,166,29,31,116,29,145,0,145,2,72,71,22.04.2019 00:15,125,11,Lvov
192,187,32,56,104,32,136,0,136,2,41,93,22.04.2019 00:15,125,11,Lvov
656,638,23,254,380,22,402,0,402,7,196,199,21.04.2019 22:30,125,11,Lvov
480,470,21,185,274,21,295,0,295,7,114,174,21.04.2019 21:30,125,11,Lvov
176,164,7,73,97,6,103,0,103,2,57,44,21.04.2019 20:27,125,11,Lvov
176,51,17,125,34,17,51,0,51,1,20,30,22.04.2019 00:06,125,11,Lvov
96,21,11,75,10,11,21,0,21,0,9,12,22.04.2019 00:15,125,11,Lvov
48,26,0,22,26,0,26,0,26,0,11,15,22.04.2019 00:03,125,11,Lvov
48,24,0,24,24,0,24,0,24,0,11,13,22.04.2019 00:15,125,11,Lvov
32,15,0,17,15,0,15,0,15,0,4,11,22.04.2019 00:20,125,11,Lvov
48,23,0,26,22,0,22,0,22,0,9,13,21.04.2019 22:20,125,11,Lvov
944,925,99,485,371,88,459,0,459,4,167,288,22.04.2019 00:52,125,11,Lvov
1056,1010,48,478,530,48,578,0,578,13,254,311,21.04.2019 21:10,125,11,Lvov
112,18,4,94,14,4,18,0,18,0,11,7,22.04.2019 00:19,125,11,Lvov
1168,1142,23,495,651,22,673,0,673,26,273,374,22.04.2019 00:07,125,11,Lvov
1536,1514,25,645,872,19,891,0,891,27,362,502,22.04.2019 00:15,125,11,Lvov
1504,1470,30,649,830,25,855,0,855,24,397,434,22.04.2019 00:05,125,11,Lvov
1616,1595,31,641,945,30,975,0,975,37,458,480,22.04.2019 00:15,125,11,Lvov
1312,1296,29,532,757,23,780,0,780,36,324,420,21.04.2019 21:28,125,11,Lvov
1520,1513,36,645,842,33,875,0,875,45,393,437,22.04.2019 00:01,125,11,Lvov
1504,1474,18,623,866,15,881,0,881,30,378,473,22.04.2019 01:45,125,11,Lvov
1424,1409,41,580,806,38,844,0,844,22,324,498,21.04.2019 21:50,125,11,Lvov
336,80,62,277,13,46,59,0,59,3,27,29,22.04.2019 00:25,125,11,Lvov
48,37,3,14,31,3,34,0,34,0,10,24,22.04.2019 00:20,126,11,Lvov
80,66,3,29,48,3,51,0,51,1,14,36,22.04.2019 00:22,126,11,Lvov
768,761,16,256,496,16,512,0,512,28,143,341,22.04.2019 00:01,126,11,Lvov
448,436,13,74,361,13,374,0,374,17,187,170,22.04.2019 00:07,126,11,Lvov
80,76,0,23,57,0,57,0,57,0,30,27,22.04.2019 00:20,126,11,Lvov
272,262,11,71,190,11,201,0,201,1,76,124,22.04.2019 00:25,126,11,Lvov
192,176,10,62,120,10,130,0,130,3,75,52,22.04.2019 00:20,126,11,Lvov
528,521,25,189,314,25,339,0,339,12,124,203,22.04.2019 00:10,126,11,Lvov
288,277,9,63,217,8,225,0,225,3,81,141,22.04.2019 00:25,126,11,Lvov
64,64,5,4,55,5,60,0,60,1,12,47,22.04.2019 00:12,126,11,Lvov
336,321,10,56,270,10,280,0,280,4,131,145,22.04.2019 01:30,126,11,Lvov
144,144,6,24,114,6,120,0,120,8,66,46,22.04.2019 00:48,126,11,Lvov
240,230,19,55,167,18,185,0,185,10,74,101,22.04.2019 00:01,126,11,Lvov
176,45,35,133,10,33,43,0,43,1,16,26,22.04.2019 00:18,126,11,Lvov
1072,1046,34,254,784,34,818,0,818,9,283,526,22.04.2019 00:10,126,11,Lvov
624,611,19,135,471,18,489,0,489,13,181,295,22.04.2019 00:05,126,11,Lvov
816,802,37,275,505,36,541,0,541,15,146,380,22.04.2019 00:05,126,11,Lvov
304,285,10,65,229,10,239,0,239,1,98,140,22.04.2019 00:20,126,11,Lvov
864,840,20,265,581,18,599,0,599,15,258,326,22.04.2019 00:03,126,11,Lvov
240,230,11,57,172,11,183,0,183,14,35,134,22.04.2019 01:10,126,11,Lvov
432,423,25,92,315,25,340,0,340,14,73,253,22.04.2019 00:05,126,11,Lvov
272,270,10,57,206,9,215,0,215,0,60,155,22.04.2019 00:01,126,11,Lvov
1440,1413,35,434,973,33,1006,0,1006,23,336,647,22.04.2019 00:15,126,11,Lvov
1344,1310,51,390,907,47,954,0,954,17,305,632,22.04.2019 00:10,126,11,Lvov
928,909,39,190,700,38,738,0,738,14,169,555,22.04.2019 00:15,126,11,Lvov
656,655,21,64,571,21,592,0,592,14,329,249,22.04.2019 00:17,126,11,Lvov
224,223,7,51,166,7,173,0,173,2,37,134,22.04.2019 00:07,126,11,Lvov
640,634,13,54,573,13,586,0,586,43,74,469,22.04.2019 01:00,126,11,Lvov
896,882,31,235,631,30,661,0,661,9,168,484,22.04.2019 02:02,126,11,Lvov
272,259,12,64,196,12,208,0,208,3,86,119,22.04.2019 00:25,126,11,Lvov
608,592,12,139,458,11,469,0,469,9,156,304,22.04.2019 00:07,126,11,Lvov
256,245,11,43,203,10,213,0,213,4,41,168,22.04.2019 00:10,126,11,Lvov
288,274,10,88,190,10,200,0,200,5,63,132,22.04.2019 00:05,126,11,Lvov
752,733,48,125,580,47,627,0,627,43,119,465,22.04.2019 00:25,126,11,Lvov
320,307,3,95,222,3,225,0,225,18,69,138,22.04.2019 01:05,126,11,Lvov
160,158,0,23,137,0,137,0,137,3,20,114,22.04.2019 00:20,126,11,Lvov
320,303,22,85,213,22,235,0,235,2,137,96,22.04.2019 00:05,126,11,Lvov
784,772,16,241,527,16,543,0,543,16,192,335,22.04.2019 00:15,126,11,Lvov
560,548,9,201,350,9,359,0,359,6,176,177,22.04.2019 00:50,126,11,Lvov
400,396,17,56,327,17,344,0,344,5,115,224,22.04.2019 00:10,126,11,Lvov
480,461,12,90,378,12,390,0,390,14,130,246,22.04.2019 00:30,126,11,Lvov
992,965,26,199,769,24,793,0,793,20,286,487,22.04.2019 00:10,126,11,Lvov
1872,1958,24,594,1258,20,1278,0,1278,25,565,688,22.04.2019 00:05,126,11,Lvov
2192,2180,25,866,1305,21,1326,0,1326,35,556,735,22.04.2019 00:12,126,11,Lvov
1728,1713,22,629,1082,17,1099,0,1099,41,433,625,22.04.2019 00:10,126,11,Lvov
2144,2129,8,799,1340,5,1345,0,1345,52,553,740,22.04.2019 00:03,126,11,Lvov
1872,1868,19,742,1118,12,1130,0,1130,41,424,665,22.04.2019 00:30,126,11,Lvov
1248,1237,32,488,732,28,760,0,760,30,289,441,22.04.2019 00:15,126,11,Lvov
1600,1576,13,604,984,12,996,0,996,45,410,541,22.04.2019 00:30,126,11,Lvov
1232,1221,14,514,709,9,718,0,718,21,320,377,22.04.2019 00:40,126,11,Lvov
1344,1314,25,566,762,16,778,0,778,30,335,413,22.04.2019 00:10,126,11,Lvov
1776,1750,24,712,1047,17,1064,0,1064,38,482,544,22.04.2019 00:15,126,11,Lvov
1600,1597,35,630,937,33,970,0,970,34,463,473,22.04.2019 01:20,126,11,Lvov
1760,1730,42,713,1023,24,1047,0,1047,33,467,547,22.04.2019 00:05,126,11,Lvov
1440,1405,24,542,876,22,898,0,898,26,400,472,22.04.2019 00:20,126,11,Lvov
1760,1688,27,706,1036,18,1054,0,1054,34,527,493,22.04.2019 00:35,126,11,Lvov
1376,1374,12,571,797,8,805,0,805,27,452,326,22.04.2019 02:08,126,11,Lvov
1376,1357,7,570,800,6,806,0,806,23,398,385,22.04.2019 00:07,126,11,Lvov
1152,1141,25,505,625,22,647,0,647,23,254,370,22.04.2019 00:05,126,11,Lvov
1264,1262,38,459,774,31,805,0,805,28,258,519,22.04.2019 00:07,126,11,Lvov
1856,1836,22,695,1140,21,1161,0,1161,46,440,675,22.04.2019 01:05,126,11,Lvov
288,128,37,176,78,34,112,0,112,6,42,64,22.04.2019 00:07,126,11,Lvov
160,45,0,118,42,0,42,0,42,1,16,25,22.04.2019 00:30,126,11,Lvov
224,11,7,214,4,6,10,0,10,0,6,4,22.04.2019 00:10,126,11,Lvov
400,383,5,182,214,4,218,0,218,4,175,39,21.04.2019 20:41,127,12,Nikolaev
1024,1016,46,442,541,41,582,0,582,11,483,88,21.04.2019 21:10,127,12,Nikolaev
192,174,0,113,79,0,79,0,79,0,68,11,21.04.2019 20:32,127,12,Nikolaev
176,165,0,92,84,0,84,0,84,1,74,9,21.04.2019 20:35,127,12,Nikolaev
1520,1501,42,606,879,35,914,0,914,13,730,171,21.04.2019 21:50,127,12,Nikolaev
688,677,27,249,413,26,439,0,439,9,367,63,21.04.2019 22:30,127,12,Nikolaev
1440,1423,41,524,879,37,916,0,916,10,836,70,21.04.2019 21:15,127,12,Nikolaev
400,389,20,182,202,16,218,0,218,2,195,21,21.04.2019 21:25,127,12,Nikolaev
384,371,23,164,199,21,220,0,220,3,189,28,21.04.2019 21:30,127,12,Nikolaev
1584,1552,32,631,928,25,953,0,953,10,877,66,21.04.2019 21:06,127,12,Nikolaev
1808,1786,33,638,1149,21,1170,0,1170,29,1011,130,21.04.2019 22:50,127,12,Nikolaev
2224,2182,24,806,1399,19,1418,0,1418,44,1194,180,21.04.2019 21:23,127,12,Nikolaev
2400,2369,35,898,1480,22,1502,0,1502,14,1322,166,21.04.2019 21:00,127,12,Nikolaev
2233,2214,31,838,1374,21,1395,0,1395,25,1177,193,21.04.2019 22:14,127,12,Nikolaev
1072,1055,23,460,589,23,612,0,612,8,544,60,21.04.2019 21:05,127,12,Nikolaev
528,123,55,416,61,51,112,0,112,0,96,16,21.04.2019 23:30,127,12,Nikolaev
1712,1685,15,603,1095,14,1109,0,1109,13,982,114,21.04.2019 21:15,128,12,Nikolaev
1760,1753,10,710,1042,8,1050,0,1050,27,920,103,21.04.2019 21:22,128,12,Nikolaev
2480,2441,12,887,1582,11,1593,0,1593,27,1414,152,22.04.2019 00:15,128,12,Nikolaev
1968,1941,16,893,1064,11,1075,0,1075,21,943,111,22.04.2019 00:10,128,12,Nikolaev
2304,2282,19,916,1377,11,1388,0,1388,27,1187,174,22.04.2019 00:01,128,12,Nikolaev
2224,2192,13,807,1406,11,1417,0,1417,39,1212,166,22.04.2019 00:10,128,12,Nikolaev
2160,2129,2,739,1420,1,1421,0,1421,33,1223,165,21.04.2019 22:00,128,12,Nikolaev
2352,2289,15,1013,1328,11,1339,0,1339,26,1163,150,22.04.2019 00:01,128,12,Nikolaev
416,190,67,230,123,63,186,0,186,2,175,9,22.04.2019 00:05,128,12,Nikolaev
1936,1907,52,879,1010,47,1057,0,1057,20,963,74,22.04.2019 00:32,129,12,Nikolaev
1248,1235,50,525,681,42,723,0,723,15,652,56,22.04.2019 00:29,129,12,Nikolaev
384,377,5,167,212,5,217,0,217,4,187,26,22.04.2019 00:22,129,12,Nikolaev
1168,1153,31,476,667,25,692,0,692,10,618,64,22.04.2019 00:40,129,12,Nikolaev
1376,1357,23,568,787,21,808,0,808,8,744,56,22.04.2019 00:40,129,12,Nikolaev
1616,1589,2,765,849,2,851,0,851,4,794,53,22.04.2019 00:17,129,12,Nikolaev
1488,1474,16,595,882,11,893,0,893,18,742,133,22.04.2019 00:48,129,12,Nikolaev
1760,1767,14,600,1150,10,1160,0,1160,22,922,216,22.04.2019 00:28,129,12,Nikolaev
880,863,4,338,541,1,542,0,542,9,473,60,22.04.2019 00:03,129,12,Nikolaev
2240,2219,4,916,1320,4,1324,0,1324,28,1170,126,22.04.2019 00:37,129,12,Nikolaev
144,42,20,113,22,9,31,0,31,0,24,7,22.04.2019 00:13,129,12,Nikolaev
80,13,3,67,10,3,13,0,13,0,12,1,22.04.2019 00:06,129,12,Nikolaev
512,38,0,479,33,0,33,0,33,1,24,8,22.04.2019 00:14,129,12,Nikolaev
64,46,0,23,41,0,41,0,41,0,36,5,22.04.2019 00:08,129,12,Nikolaev
1984,1945,20,888,1079,17,1096,0,1096,20,905,171,22.04.2019 00:20,130,12,Nikolaev
1488,1468,13,677,801,10,811,0,811,15,718,78,21.04.2019 23:55,130,12,Nikolaev
1744,1710,16,699,1030,15,1045,0,1045,24,847,174,21.04.2019 23:54,130,12,Nikolaev
128,115,5,67,56,5,61,0,61,0,55,6,22.04.2019 00:05,130,12,Nikolaev
1104,1092,18,522,568,14,582,0,582,11,515,56,22.04.2019 00:10,130,12,Nikolaev
560,545,37,305,221,34,255,0,255,4,205,46,21.04.2019 20:46,130,12,Nikolaev
1264,1248,132,572,595,97,692,0,692,22,611,59,21.04.2019 23:30,130,12,Nikolaev
624,609,31,319,275,30,305,0,305,7,278,20,21.04.2019 21:10,130,12,Nikolaev
544,532,7,279,258,7,265,0,265,4,187,74,21.04.2019 20:50,130,12,Nikolaev
256,244,10,97,149,10,159,0,159,1,149,9,21.04.2019 23:00,130,12,Nikolaev
592,565,28,273,291,28,319,0,319,3,253,63,21.04.2019 20:15,130,12,Nikolaev
272,253,10,98,164,10,174,0,174,4,143,27,21.04.2019 21:30,130,12,Nikolaev
1536,1513,81,610,845,81,926,0,926,16,865,45,21.04.2019 20:58,130,12,Nikolaev
112,110,2,39,72,1,73,0,73,0,67,6,21.04.2019 20:25,130,12,Nikolaev
688,675,56,366,267,55,322,0,322,7,284,31,21.04.2019 23:30,130,12,Nikolaev
672,654,5,341,328,3,331,0,331,7,258,66,21.04.2019 21:05,130,12,Nikolaev
816,795,7,456,355,5,360,0,360,3,331,26,21.04.2019 20:27,130,12,Nikolaev
176,34,10,151,15,10,25,0,25,0,22,3,21.04.2019 21:43,130,12,Nikolaev
912,885,12,398,503,11,514,0,514,9,436,69,22.04.2019 00:05,130,12,Nikolaev
800,773,49,300,454,46,500,0,500,8,454,38,21.04.2019 23:40,130,12,Nikolaev
672,681,45,310,326,36,362,0,362,9,332,21,21.04.2019 20:30,130,12,Nikolaev
560,548,34,259,277,24,301,0,301,0,255,46,22.04.2019 00:13,130,12,Nikolaev
304,289,23,150,132,22,154,0,154,1,132,21,22.04.2019 00:05,130,12,Nikolaev
544,533,16,240,296,8,304,0,304,4,272,28,21.04.2019 22:30,130,12,Nikolaev
288,283,10,122,156,10,166,0,166,2,159,5,21.04.2019 20:40,130,12,Nikolaev
224,221,11,90,125,9,134,0,134,0,119,15,21.04.2019 21:20,130,12,Nikolaev
208,189,5,77,126,5,131,0,131,0,118,13,21.04.2019 20:57,130,12,Nikolaev
128,26,1,110,18,0,18,0,18,0,14,4,21.04.2019 20:20,130,12,Nikolaev
256,242,4,108,144,4,148,0,148,0,136,12,21.04.2019 21:30,130,12,Nikolaev
80,10,6,71,4,5,9,0,9,0,5,4,21.04.2019 21:00,130,12,Nikolaev
560,550,33,259,273,28,301,0,301,2,283,16,21.04.2019 23:56,130,12,Nikolaev
512,490,19,243,253,16,269,0,269,2,254,13,21.04.2019 21:05,130,12,Nikolaev
544,528,9,233,305,6,311,0,311,2,273,36,22.04.2019 00:20,130,12,Nikolaev
1200,1186,10,542,648,10,658,0,658,12,605,41,22.04.2019 00:09,130,12,Nikolaev
752,732,11,332,410,10,420,0,420,14,356,50,22.04.2019 00:02,130,12,Nikolaev
768,764,6,291,474,3,477,0,477,2,404,71,22.04.2019 00:10,130,12,Nikolaev
1424,1388,11,548,870,6,876,0,876,27,775,74,22.04.2019 00:24,130,12,Nikolaev
176,176,0,76,100,0,100,0,100,0,91,9,21.04.2019 21:20,130,12,Nikolaev
352,337,9,163,180,9,189,0,189,3,147,39,21.04.2019 21:00,130,12,Nikolaev
384,369,12,168,204,12,216,0,216,0,197,19,21.04.2019 20:56,130,12,Nikolaev
1200,1164,46,628,535,37,572,0,572,12,524,36,22.04.2019 00:05,130,12,Nikolaev
560,536,20,230,311,19,330,0,330,2,292,36,21.04.2019 21:02,130,12,Nikolaev
112,113,6,39,67,6,73,0,73,0,66,7,21.04.2019 22:55,130,12,Nikolaev
880,859,57,454,383,43,426,0,426,4,383,39,22.04.2019 00:01,130,12,Nikolaev
1008,981,56,470,489,49,538,0,538,32,436,70,21.04.2019 21:23,130,12,Nikolaev
224,213,0,94,130,0,130,0,130,2,115,13,22.04.2019 00:10,130,12,Nikolaev
80,75,1,30,49,1,50,0,50,1,42,7,22.04.2019 00:35,130,12,Nikolaev
320,313,11,112,198,10,208,0,208,1,195,12,22.04.2019 00:05,130,12,Nikolaev
128,121,4,62,63,3,66,0,66,0,61,5,21.04.2019 21:20,130,12,Nikolaev
144,56,24,93,30,21,51,0,51,0,41,10,22.04.2019 00:10,130,12,Nikolaev
944,924,34,356,558,30,588,0,588,9,506,73,21.04.2019 21:15,131,12,Nikolaev
1504,1466,33,643,844,17,861,0,861,11,720,130,22.04.2019 00:12,131,12,Nikolaev
1248,1230,48,525,684,39,723,0,723,16,620,87,21.04.2019 21:40,131,12,Nikolaev
144,129,3,70,73,1,74,0,74,0,69,5,21.04.2019 20:33,131,12,Nikolaev
144,127,9,52,86,6,92,0,92,3,79,10,21.04.2019 21:17,131,12,Nikolaev
384,375,4,178,205,1,206,0,206,2,187,17,21.04.2019 22:36,131,12,Nikolaev
320,310,2,155,163,2,165,0,165,12,136,17,21.04.2019 20:50,131,12,Nikolaev
432,424,18,227,189,16,205,0,205,2,175,28,22.04.2019 00:25,131,12,Nikolaev
288,264,20,127,143,18,161,0,161,1,129,31,21.04.2019 20:40,131,12,Nikolaev
544,537,29,178,338,28,366,0,366,13,318,35,21.04.2019 21:20,131,12,Nikolaev
96,95,3,33,60,3,63,0,63,1,45,17,21.04.2019 21:44,131,12,Nikolaev
960,944,207,361,419,180,599,0,599,14,428,157,22.04.2019 00:15,131,12,Nikolaev
800,784,36,364,403,33,436,0,436,6,373,57,22.04.2019 00:15,131,12,Nikolaev
464,444,28,227,213,24,237,0,237,0,213,24,21.04.2019 21:00,131,12,Nikolaev
304,300,16,151,140,13,153,0,153,3,137,13,21.04.2019 21:33,131,12,Nikolaev
352,337,22,86,246,20,266,0,266,2,239,25,21.04.2019 21:16,131,12,Nikolaev
336,320,17,122,197,17,214,0,214,3,179,32,21.04.2019 20:23,131,12,Nikolaev
1264,1235,26,543,697,24,721,0,721,9,643,69,22.04.2019 00:30,131,12,Nikolaev
1264,1234,40,539,689,36,725,0,725,8,656,61,21.04.2019 20:55,131,12,Nikolaev
800,788,27,374,401,25,426,0,426,7,390,29,21.04.2019 21:02,131,12,Nikolaev
1072,1045,16,505,554,13,567,0,567,8,528,31,22.04.2019 00:05,131,12,Nikolaev
640,620,15,273,356,11,367,0,367,2,333,32,21.04.2019 21:01,131,12,Nikolaev
720,712,40,314,370,36,406,0,406,5,368,33,22.04.2019 00:10,131,12,Nikolaev
1488,1467,33,629,827,32,859,0,859,5,782,72,22.04.2019 00:02,131,12,Nikolaev
928,916,43,421,464,43,507,0,507,2,455,50,22.04.2019 00:15,131,12,Nikolaev
272,258,15,125,133,14,147,0,147,2,127,18,22.04.2019 00:30,131,12,Nikolaev
1440,1420,65,607,771,62,833,0,833,13,743,77,22.04.2019 00:05,131,12,Nikolaev
304,290,9,130,169,5,174,0,174,3,148,23,21.04.2019 22:20,131,12,Nikolaev
80,75,3,28,49,3,52,0,52,0,37,15,21.04.2019 22:00,131,12,Nikolaev
512,493,7,127,378,7,385,0,385,2,330,53,21.04.2019 21:40,131,12,Nikolaev
1248,1219,32,523,707,18,725,0,725,14,603,108,21.04.2019 21:10,131,12,Nikolaev
144,159,7,32,106,6,112,0,112,0,103,9,21.04.2019 22:25,131,12,Nikolaev
1376,1375,57,563,756,57,813,0,813,5,736,72,22.04.2019 00:15,131,12,Nikolaev
576,552,21,259,296,21,317,0,317,6,257,54,22.04.2019 00:20,131,12,Nikolaev
64,59,0,16,48,0,48,0,48,2,34,12,21.04.2019 21:30,131,12,Nikolaev
1360,1344,63,643,659,58,717,0,717,5,668,44,21.04.2019 21:00,131,12,Nikolaev
368,348,5,170,193,5,198,0,198,1,169,28,21.04.2019 21:10,131,12,Nikolaev
1232,1203,0,607,625,0,625,0,625,12,557,56,22.04.2019 00:10,131,12,Nikolaev
224,208,5,122,100,2,102,0,102,3,86,13,21.04.2019 21:35,131,12,Nikolaev
192,182,0,84,108,0,108,0,108,1,98,9,22.04.2019 00:08,131,12,Nikolaev
80,62,0,40,40,0,40,0,40,0,30,10,21.04.2019 20:15,131,12,Nikolaev
768,771,38,307,424,37,461,0,461,6,374,81,22.04.2019 00:22,131,12,Nikolaev
64,70,10,17,38,9,47,0,47,0,36,11,22.04.2019 00:05,131,12,Nikolaev
1152,1125,24,569,562,21,583,0,583,13,525,45,22.04.2019 00:15,131,12,Nikolaev
1584,1550,19,678,890,16,906,0,906,18,804,84,22.04.2019 00:22,131,12,Nikolaev
1392,1361,47,576,779,37,816,0,816,22,719,75,21.04.2019 23:40,131,12,Nikolaev
192,191,10,43,140,9,149,0,149,0,122,27,21.04.2019 21:15,131,12,Nikolaev
144,136,4,66,74,4,78,0,78,0,71,7,22.04.2019 00:05,131,12,Nikolaev
304,291,5,141,159,4,163,0,163,1,131,31,21.04.2019 20:45,131,12,Nikolaev
528,516,31,212,289,27,316,0,316,2,278,36,21.04.2019 22:00,131,12,Nikolaev
1184,1157,27,589,571,24,595,0,595,11,496,88,21.04.2019 21:04,131,12,Nikolaev
240,228,7,119,114,7,121,0,121,0,99,22,21.04.2019 21:05,131,12,Nikolaev
128,128,0,51,77,0,77,0,77,2,56,19,21.04.2019 20:30,131,12,Nikolaev
448,433,5,215,229,4,233,0,233,3,199,31,22.04.2019 00:05,131,12,Nikolaev
320,317,3,119,198,3,201,0,201,3,112,86,21.04.2019 20:39,131,12,Nikolaev
304,281,19,142,144,18,162,0,162,1,145,16,21.04.2019 20:30,131,12,Nikolaev
144,140,12,69,64,11,75,0,75,1,62,12,21.04.2019 20:45,131,12,Nikolaev
160,161,15,68,79,13,92,0,92,2,77,13,21.04.2019 20:30,131,12,Nikolaev
576,559,21,235,321,20,341,0,341,4,290,47,21.04.2019 21:30,131,12,Nikolaev
1184,1166,28,603,553,28,581,0,581,6,513,62,21.04.2019 21:20,131,12,Nikolaev
736,717,27,355,358,23,381,0,381,10,303,68,21.04.2019 20:55,131,12,Nikolaev
736,714,26,345,366,25,391,0,391,4,324,63,22.04.2019 00:03,131,12,Nikolaev
368,348,3,155,210,3,213,0,213,4,178,31,21.04.2019 21:30,131,12,Nikolaev
256,246,16,113,130,13,143,0,143,0,115,28,22.04.2019 00:25,131,12,Nikolaev
352,337,26,160,166,26,192,0,192,4,155,33,22.04.2019 00:05,131,12,Nikolaev
512,490,9,263,240,9,249,0,249,9,217,23,22.04.2019 00:08,131,12,Nikolaev
272,264,4,109,160,3,163,0,163,2,140,21,21.04.2019 21:10,131,12,Nikolaev
480,465,26,226,233,21,254,0,254,1,223,30,21.04.2019 21:00,131,12,Nikolaev
96,80,5,43,50,3,53,0,53,0,44,9,21.04.2019 20:40,131,12,Nikolaev
704,672,39,280,389,35,424,0,424,9,371,44,22.04.2019 00:12,131,12,Nikolaev
656,633,47,269,341,46,387,0,387,2,365,20,21.04.2019 20:50,131,12,Nikolaev
272,269,12,112,150,10,160,0,160,3,147,10,21.04.2019 22:40,131,12,Nikolaev
336,317,7,156,176,4,180,0,180,3,163,14,21.04.2019 21:00,131,12,Nikolaev
432,418,29,154,252,26,278,0,278,4,240,34,21.04.2019 21:40,131,12,Nikolaev
144,136,5,57,83,4,87,0,87,0,67,20,21.04.2019 21:57,131,12,Nikolaev
384,370,12,146,231,7,238,0,238,3,206,29,21.04.2019 20:40,131,12,Nikolaev
80,73,2,23,55,2,57,0,57,0,43,14,21.04.2019 20:41,131,12,Nikolaev
144,143,6,62,77,5,82,0,82,2,77,3,21.04.2019 20:30,131,12,Nikolaev
64,15,0,52,12,0,12,0,12,1,9,2,21.04.2019 21:15,131,12,Nikolaev
1536,1513,17,656,868,12,880,0,880,13,775,92,22.04.2019 00:06,131,12,Nikolaev
1472,1453,16,613,845,14,859,0,859,13,784,62,22.04.2019 00:10,131,12,Nikolaev
1792,1750,23,759,1015,18,1033,0,1033,15,949,69,22.04.2019 00:10,131,12,Nikolaev
1776,1768,21,667,1092,17,1109,0,1109,9,964,136,21.04.2019 22:00,131,12,Nikolaev
2208,2189,35,804,1374,30,1404,0,1404,16,1235,153,21.04.2019 21:40,131,12,Nikolaev
1392,1367,14,534,845,13,858,0,858,14,756,88,22.04.2019 00:15,131,12,Nikolaev
1664,1632,139,581,948,135,1083,0,1083,15,932,136,22.04.2019 00:13,131,12,Nikolaev
2128,2114,24,896,1211,21,1232,0,1232,19,1081,132,22.04.2019 00:32,131,12,Nikolaev
1728,1694,26,694,1014,20,1034,0,1034,20,903,111,22.04.2019 00:22,131,12,Nikolaev
1376,1349,18,543,817,16,833,0,833,14,726,93,22.04.2019 00:04,131,12,Nikolaev
1760,1747,15,637,1110,13,1123,0,1123,14,994,115,22.04.2019 00:10,131,12,Nikolaev
1920,1882,17,849,1056,15,1071,0,1071,18,972,81,21.04.2019 22:00,131,12,Nikolaev
704,633,7,304,393,7,400,0,400,9,359,32,22.04.2019 00:07,131,12,Nikolaev
1776,1756,9,659,1111,6,1117,0,1117,23,912,182,22.04.2019 00:35,131,12,Nikolaev
1904,1866,7,667,1233,4,1237,0,1237,22,982,233,22.04.2019 00:10,131,12,Nikolaev
400,380,18,208,177,15,192,0,192,3,174,15,21.04.2019 21:30,131,12,Nikolaev
848,832,32,383,442,23,465,0,465,10,400,55,22.04.2019 00:05,132,12,Nikolaev
656,642,23,307,330,19,349,0,349,9,297,43,22.04.2019 00:05,132,12,Nikolaev
624,602,23,239,366,19,385,0,385,5,333,47,22.04.2019 00:05,132,12,Nikolaev
240,229,12,99,129,12,141,0,141,2,110,29,21.04.2019 21:02,132,12,Nikolaev
1040,1019,21,464,558,18,576,0,576,11,486,79,22.04.2019 00:05,132,12,Nikolaev
1056,1046,19,487,554,15,569,0,569,10,512,47,22.04.2019 00:02,132,12,Nikolaev
192,184,7,80,107,5,112,0,112,1,94,17,21.04.2019 21:00,132,12,Nikolaev
848,827,36,397,417,34,451,0,451,4,410,37,22.04.2019 00:30,132,12,Nikolaev
1072,1055,64,364,644,64,708,0,708,12,620,76,22.04.2019 00:05,132,12,Nikolaev
224,224,20,82,126,16,142,0,142,2,117,23,21.04.2019 20:29,132,12,Nikolaev
128,121,4,56,69,3,72,0,72,0,56,16,22.04.2019 00:05,132,12,Nikolaev
1104,1081,81,412,624,68,692,0,692,7,468,217,22.04.2019 00:05,132,12,Nikolaev
1168,371,0,797,371,0,371,0,371,26,332,13,22.04.2019 00:18,132,12,Nikolaev
448,445,21,197,234,17,251,0,251,2,208,41,22.04.2019 00:05,132,12,Nikolaev
336,344,7,97,232,7,239,0,239,4,202,33,21.04.2019 21:30,132,12,Nikolaev
112,106,0,66,46,0,46,0,46,0,36,10,21.04.2019 20:40,132,12,Nikolaev
336,332,7,168,162,6,168,0,168,1,148,19,21.04.2019 21:30,132,12,Nikolaev
208,195,15,88,106,14,120,0,120,1,102,17,21.04.2019 21:20,132,12,Nikolaev
320,309,23,145,155,20,175,0,175,3,149,23,21.04.2019 21:40,132,12,Nikolaev
784,755,18,362,407,15,422,0,422,3,345,74,21.04.2019 22:01,132,12,Nikolaev
928,892,8,411,510,7,517,0,517,6,452,59,22.04.2019 00:15,132,12,Nikolaev
384,377,23,135,229,20,249,0,249,0,191,58,21.04.2019 22:00,132,12,Nikolaev
1664,1636,34,777,862,25,887,0,887,17,744,126,22.04.2019 00:30,132,12,Nikolaev
320,312,29,100,194,26,220,0,220,1,186,33,22.04.2019 00:05,132,12,Nikolaev
352,336,28,121,205,26,231,0,231,5,194,32,21.04.2019 21:05,132,12,Nikolaev
1328,1308,22,612,696,20,716,0,716,18,604,94,21.04.2019 22:05,132,12,Nikolaev
816,793,47,352,418,46,464,0,464,13,371,80,22.04.2019 00:15,132,12,Nikolaev
800,783,79,353,375,72,447,0,447,7,365,75,21.04.2019 21:00,132,12,Nikolaev
400,385,25,223,160,17,177,0,177,4,110,63,22.04.2019 00:49,132,12,Nikolaev
1568,1537,44,689,841,38,879,0,879,15,684,180,22.04.2019 01:05,132,12,Nikolaev
80,75,0,38,42,0,42,0,42,0,27,15,22.04.2019 00:20,132,12,Nikolaev
160,159,4,68,88,4,92,0,92,1,62,29,22.04.2019 01:15,132,12,Nikolaev
208,201,10,75,123,10,133,0,133,2,83,48,22.04.2019 00:20,132,12,Nikolaev
112,101,4,52,59,1,60,0,60,0,47,13,22.04.2019 00:01,132,12,Nikolaev
736,715,44,303,390,43,433,0,433,12,349,72,22.04.2019 00:10,132,12,Nikolaev
496,485,29,194,279,23,302,0,302,12,242,48,22.04.2019 00:03,132,12,Nikolaev
640,626,60,265,331,44,375,0,375,8,320,47,21.04.2019 20:50,132,12,Nikolaev
192,179,21,82,90,20,110,0,110,2,84,24,22.04.2019 00:10,132,12,Nikolaev
144,137,7,53,85,6,91,0,91,2,69,20,22.04.2019 00:05,132,12,Nikolaev
1904,1866,29,781,1098,25,1123,0,1123,26,893,204,22.04.2019 00:04,132,12,Nikolaev
1632,1621,22,621,992,19,1011,621,1011,26,795,190,22.04.2019 00:45,132,12,Nikolaev
736,756,9,264,465,7,472,0,472,11,392,69,22.04.2019 00:10,132,12,Nikolaev
976,952,13,430,535,11,546,0,546,9,457,80,22.04.2019 00:33,132,12,Nikolaev
2096,2046,17,944,1139,13,1152,0,1152,25,930,197,22.04.2019 00:20,132,12,Nikolaev
1344,1313,13,573,759,12,771,0,771,17,658,96,22.04.2019 00:05,132,12,Nikolaev
1600,1564,41,738,829,33,862,13,849,0,716,133,22.04.2019 00:10,132,12,Nikolaev
1200,1182,36,555,613,32,645,0,645,6,553,86,22.04.2019 00:05,132,12,Nikolaev
1904,1869,49,819,1049,36,1085,0,1085,26,882,177,22.04.2019 00:10,132,12,Nikolaev
1376,1354,27,590,766,20,786,0,786,13,652,121,22.04.2019 00:20,132,12,Nikolaev
1280,1260,12,584,688,8,696,0,696,16,569,111,21.04.2019 22:12,132,12,Nikolaev
1888,1845,17,837,1037,14,1051,0,1051,22,873,156,22.04.2019 00:19,132,12,Nikolaev
1360,1332,15,637,710,13,723,0,723,14,597,112,22.04.2019 00:02,132,12,Nikolaev
1264,1240,12,629,628,7,635,0,635,8,522,105,22.04.2019 00:05,132,12,Nikolaev
1424,1397,16,620,789,15,804,0,804,9,693,102,22.04.2019 00:05,132,12,Nikolaev
1936,1884,5,883,1050,3,1053,0,1053,15,902,136,22.04.2019 00:04,132,12,Nikolaev
2032,1973,18,959,1059,14,1073,0,1073,22,895,156,22.04.2019 00:15,132,12,Nikolaev
2208,2169,27,860,1330,18,1348,0,1348,36,1115,197,21.04.2019 23:10,132,12,Nikolaev
224,29,13,200,12,12,24,0,24,0,20,4,22.04.2019 00:10,132,12,Nikolaev
80,21,2,59,19,2,21,0,21,1,13,7,21.04.2019 23:50,132,12,Nikolaev
144,17,2,127,15,2,17,0,17,0,11,6,22.04.2019 00:10,132,12,Nikolaev
2112,2160,8,686,1421,5,1426,0,1426,33,1259,134,21.04.2019 22:51,133,13,Odessa
2272,2259,2,718,1552,2,1554,0,1554,47,1330,177,22.04.2019 02:00,133,13,Odessa
2080,2069,13,772,1297,11,1308,0,1308,24,1156,128,22.04.2019 00:05,133,13,Odessa
2256,2272,10,844,1403,9,1412,0,1412,35,1204,173,21.04.2019 22:53,133,13,Odessa
1808,1777,23,724,1070,14,1084,0,1084,30,934,120,21.04.2019 22:55,133,13,Odessa
1904,1897,11,725,1171,8,1179,0,1179,28,1019,132,22.04.2019 00:15,133,13,Odessa
2080,2072,7,820,1253,7,1260,0,1260,35,1059,166,22.04.2019 00:05,133,13,Odessa
2032,2013,5,813,1215,4,1219,0,1219,29,1004,186,21.04.2019 22:53,133,13,Odessa
2400,2404,8,863,1530,7,1537,0,1537,32,1290,215,22.04.2019 00:30,133,13,Odessa
2288,2312,9,887,1394,7,1401,0,1401,33,1218,150,22.04.2019 00:40,133,13,Odessa
2480,2508,6,1038,1439,3,1442,0,1442,26,1219,197,22.04.2019 00:05,133,13,Odessa
2336,2343,14,853,1474,9,1483,0,1483,36,1256,191,22.04.2019 00:10,133,13,Odessa
2096,2121,8,762,1331,3,1334,0,1334,17,1144,173,21.04.2019 22:26,133,13,Odessa
2224,2219,4,727,1496,1,1497,0,1497,52,1233,212,21.04.2019 23:48,133,13,Odessa
1568,1628,10,553,1009,6,1015,0,1015,37,854,124,22.04.2019 00:20,133,13,Odessa
1824,1826,10,846,970,8,978,0,978,18,855,105,22.04.2019 00:10,133,13,Odessa
2064,2063,12,697,1360,7,1367,0,1367,38,1159,170,22.04.2019 00:10,133,13,Odessa
2224,2256,7,852,1369,3,1372,0,1372,41,1174,157,21.04.2019 22:34,133,13,Odessa
1952,1932,14,725,1217,10,1227,0,1227,41,1033,153,22.04.2019 00:26,133,13,Odessa
1968,1980,7,729,1235,4,1239,0,1239,18,1070,151,21.04.2019 21:40,133,13,Odessa
2192,2207,1418,774,1411,7,1418,0,1417,44,1183,190,22.04.2019 00:20,133,13,Odessa
2256,2255,4,878,1374,4,1378,0,1378,30,1199,149,21.04.2019 21:50,133,13,Odessa
2144,2135,4,738,1404,2,1406,0,1406,43,1192,171,22.04.2019 00:15,133,13,Odessa
1760,1759,3,637,1122,1,1123,0,1123,33,977,113,21.04.2019 21:25,133,13,Odessa
2224,2214,8,798,1418,8,1426,0,1426,42,1218,166,21.04.2019 22:47,133,13,Odessa
2112,2180,14,673,1428,11,1439,0,1439,42,1235,162,21.04.2019 21:52,133,13,Odessa
1952,1958,12,766,1177,9,1186,0,1186,35,1028,123,21.04.2019 23:30,133,13,Odessa
2352,2351,9,908,1439,5,1444,0,1444,31,1242,171,21.04.2019 22:50,133,13,Odessa
320,54,0,299,21,0,21,0,21,1,18,2,21.04.2019 23:00,133,13,Odessa
208,60,1,150,57,1,58,0,58,1,51,6,22.04.2019 00:16,133,13,Odessa
144,52,0,103,41,0,41,0,41,5,31,5,21.04.2019 23:30,133,13,Odessa
176,53,0,124,52,0,52,0,52,0,28,24,21.04.2019 21:16,133,13,Odessa
112,109,12,26,80,6,86,0,86,1,79,6,21.04.2019 21:35,133,13,Odessa
2432,2460,17,910,1515,7,1522,0,1522,41,1271,210,22.04.2019 00:10,134,13,Odessa
1808,1862,19,587,1208,13,1221,0,1221,32,1055,134,22.04.2019 00:01,134,13,Odessa
2160,2174,23,784,1357,19,1376,0,1376,28,1201,147,22.04.2019 00:15,134,13,Odessa
2192,2192,17,763,1415,14,1429,0,1429,27,1259,143,21.04.2019 22:10,134,13,Odessa
1968,1981,16,629,1327,12,1339,0,1339,18,1164,157,21.04.2019 23:00,134,13,Odessa
1744,1794,20,559,1169,16,1185,0,1185,28,983,174,21.04.2019 22:28,134,13,Odessa
928,937,3,400,527,1,528,0,528,24,451,53,21.04.2019 23:10,134,13,Odessa
2256,2249,3,1465,791,0,791,0,791,13,697,81,22.04.2019 00:05,134,13,Odessa
1296,1277,17,450,831,15,846,0,846,24,713,109,22.04.2019 00:05,134,13,Odessa
2352,2351,19,997,1342,13,1355,0,1355,34,1162,159,22.04.2019 00:03,134,13,Odessa
2192,2172,21,935,1243,14,1257,0,1257,36,1079,142,21.04.2019 22:15,134,13,Odessa
2416,2392,29,925,1469,22,1491,0,1491,29,1331,131,22.04.2019 00:20,134,13,Odessa
2288,2297,14,817,1462,9,1471,0,1471,25,1280,166,21.04.2019 22:30,134,13,Odessa
2224,2225,17,862,1350,12,1362,0,1362,22,1202,138,21.04.2019 21:48,134,13,Odessa
2208,2203,16,850,1344,14,1358,0,1358,32,1180,146,22.04.2019 00:01,134,13,Odessa
2304,2301,20,925,1364,15,1379,0,1379,15,1216,148,22.04.2019 00:01,134,13,Odessa
2240,2237,16,1014,1215,11,1226,0,1226,24,1087,115,21.04.2019 22:00,134,13,Odessa
2544,2535,16,962,1571,11,1582,0,1582,39,1339,204,21.04.2019 21:31,134,13,Odessa
496,123,71,395,44,57,101,0,101,0,94,7,21.04.2019 21:26,134,13,Odessa
448,188,74,264,115,69,184,0,184,7,164,13,22.04.2019 00:11,134,13,Odessa
1056,1040,3,485,569,2,571,0,571,10,520,41,22.04.2019 00:03,134,13,Odessa
2464,2394,1,2065,399,0,399,0,399,5,338,56,21.04.2019 21:59,134,13,Odessa
2080,2115,6,916,1162,2,1164,0,1164,19,982,163,21.04.2019 22:31,135,13,Odessa
2400,2377,11,1018,1378,4,1382,0,1382,29,1182,171,21.04.2019 22:18,135,13,Odessa
2256,2261,17,1158,1084,14,1098,0,1098,46,904,148,21.04.2019 21:50,135,13,Odessa
2272,2203,4,1063,1205,4,1209,0,1209,16,933,260,21.04.2019 22:40,135,13,Odessa
2192,2177,16,913,1267,12,1279,0,1279,42,1068,169,21.04.2019 21:47,135,13,Odessa
2176,2177,0,1035,1141,0,1141,0,1141,17,981,143,21.04.2019 22:50,135,13,Odessa
2240,2312,5,823,1413,4,1417,0,1417,43,1104,270,21.04.2019 23:40,135,13,Odessa
2128,2281,12,635,1483,10,1493,0,1493,36,1196,261,21.04.2019 23:10,135,13,Odessa
144,34,0,111,33,0,33,0,33,0,33,0,21.04.2019 20:40,135,13,Odessa
368,79,70,291,11,66,77,0,77,1,70,6,21.04.2019 20:51,135,13,Odessa
208,21,2,187,19,2,21,0,21,0,21,0,21.04.2019 22:11,135,13,Odessa
128,40,0,89,39,0,39,0,39,0,38,1,21.04.2019 20:30,135,13,Odessa
224,110,36,134,67,23,90,0,90,2,81,7,21.04.2019 20:40,135,13,Odessa
240,86,10,155,77,8,85,0,85,5,74,6,21.04.2019 21:10,135,13,Odessa
176,81,0,122,54,0,54,0,54,3,47,4,21.04.2019 21:15,135,13,Odessa
192,105,46,89,58,45,103,0,103,4,87,12,21.04.2019 20:40,135,13,Odessa
2160,2162,14,794,1355,11,1366,0,1366,29,1150,187,22.04.2019 00:30,136,13,Odessa
2352,2348,8,1010,1337,5,1342,0,1342,16,1203,123,22.04.2019 00:02,136,13,Odessa
2352,2347,16,989,1358,5,1363,0,1363,36,1210,117,22.04.2019 00:10,136,13,Odessa
2208,2183,14,941,1257,10,1267,0,1267,32,1134,101,22.04.2019 00:06,136,13,Odessa
2208,2200,19,847,1350,11,1361,0,1361,30,1231,100,21.04.2019 21:30,136,13,Odessa
2384,2368,18,986,1383,15,1398,0,1398,28,1254,116,21.04.2019 22:25,136,13,Odessa
2303,2301,14,941,1352,10,1362,0,1362,13,1236,113,22.04.2019 00:10,136,13,Odessa
1536,1544,14,719,807,10,817,0,817,16,747,54,22.04.2019 00:20,136,13,Odessa
2288,2284,20,946,1330,12,1342,0,1342,37,1199,106,22.04.2019 00:15,136,13,Odessa
1216,1239,17,474,729,13,742,0,742,17,678,47,22.04.2019 00:12,136,13,Odessa
2208,2220,20,827,1363,18,1381,0,1381,19,1224,138,22.04.2019 00:08,136,13,Odessa
1872,1186,20,710,1148,14,1162,0,1162,28,1035,99,22.04.2019 00:40,136,13,Odessa
1952,1994,24,653,1280,19,1299,0,1299,25,1153,121,21.04.2019 21:33,136,13,Odessa
2128,2165,23,730,1379,19,1398,0,1398,26,1248,124,21.04.2019 23:05,136,13,Odessa
2096,2080,22,686,1394,16,1410,0,1410,43,1244,123,22.04.2019 00:02,136,13,Odessa
2000,2014,20,714,1268,18,1286,0,1286,17,1142,127,22.04.2019 00:03,136,13,Odessa
1984,1986,19,649,1320,15,1335,0,1335,22,1174,139,22.04.2019 00:16,136,13,Odessa
1952,1946,17,811,1129,12,1141,0,1141,16,1038,87,22.04.2019 00:20,136,13,Odessa
2352,2242,110,814,1455,83,1538,0,1538,55,1356,127,22.04.2019 00:40,136,13,Odessa
2192,2195,15,691,1491,10,1501,0,1501,33,1332,136,22.04.2019 00:05,136,13,Odessa
2128,2139,24,718,1397,13,1410,0,1410,41,1214,155,22.04.2019 00:05,136,13,Odessa
2048,2057,18,669,1364,15,1379,0,1379,30,1198,151,22.04.2019 00:07,136,13,Odessa
2272,2288,19,721,1536,15,1551,0,1551,35,1373,143,22.04.2019 00:05,136,13,Odessa
2256,2253,14,757,1487,12,1499,0,1499,25,1309,165,22.04.2019 00:06,136,13,Odessa
2160,2147,16,773,1377,10,1387,0,1387,27,1209,151,22.04.2019 00:22,136,13,Odessa
2160,2160,19,765,1386,9,1395,0,1395,37,1211,147,22.04.2019 00:14,136,13,Odessa
2080,2071,20,711,1363,6,1369,0,1369,28,1185,156,22.04.2019 00:15,136,13,Odessa
2000,2009,22,654,1329,17,1346,0,1346,29,1197,120,21.04.2019 22:30,136,13,Odessa
2224,2205,15,783,1427,14,1441,0,1441,30,1230,181,22.04.2019 00:04,136,13,Odessa
2320,2335,11,741,1571,8,1579,0,1579,32,1355,192,21.04.2019 22:10,136,13,Odessa
2112,2111,16,694,1407,11,1418,0,1418,39,1239,140,22.04.2019 00:15,136,13,Odessa
2128,2132,29,666,1442,20,1462,0,1462,47,1275,140,22.04.2019 00:05,136,13,Odessa
2128,2116,34,739,1362,27,1389,0,1389,33,1219,137,22.04.2019 00:05,136,13,Odessa
1952,1956,20,666,1268,18,1286,0,1286,35,1139,112,22.04.2019 00:22,136,13,Odessa
2288,2296,13,830,1448,10,1458,0,1458,32,1291,135,22.04.2019 00:15,136,13,Odessa
2400,2470,14,769,1623,8,1631,0,1631,19,1412,200,22.04.2019 00:15,136,13,Odessa
1936,1944,20,602,1325,9,1334,0,1334,33,1188,113,22.04.2019 00:50,136,13,Odessa
1808,1810,17,647,1151,10,1161,0,1161,26,1032,103,22.04.2019 00:11,136,13,Odessa
2064,2057,14,768,1285,11,1296,0,1296,25,1135,136,22.04.2019 00:16,136,13,Odessa
1952,1971,18,663,1275,14,1289,0,1289,32,1126,131,22.04.2019 00:20,136,13,Odessa
2048,2051,17,672,1363,13,1376,0,1376,33,1213,130,22.04.2019 00:23,136,13,Odessa
2128,2122,13,744,1371,13,1384,0,1384,43,1182,159,21.04.2019 23:02,136,13,Odessa
2192,2259,8,623,1564,5,1569,0,1569,30,1352,187,22.04.2019 00:12,136,13,Odessa
2480,2469,10,867,1603,10,1613,0,1613,13,1388,212,22.04.2019 00:27,136,13,Odessa
2464,2471,19,881,1573,10,1583,0,1583,40,1379,164,22.04.2019 00:01,136,13,Odessa
2336,2370,14,779,1548,9,1557,0,1557,36,1338,183,22.04.2019 00:15,136,13,Odessa
2048,2066,15,647,1389,12,1401,0,1401,36,1237,128,22.04.2019 00:33,136,13,Odessa
512,189,79,327,110,75,185,0,185,8,165,12,22.04.2019 00:05,136,13,Odessa
1040,129,0,915,125,0,125,0,125,14,97,14,22.04.2019 00:18,136,13,Odessa
128,16,0,112,16,0,16,0,16,0,16,0,22.04.2019 00:12,136,13,Odessa
96,73,3,23,70,3,73,0,73,1,67,5,21.04.2019 22:35,136,13,Odessa
1008,463,191,610,230,168,398,0,398,12,360,26,21.04.2019 20:40,136,13,Odessa
512,503,56,209,253,50,303,0,303,1,244,58,21.04.2019 23:30,137,13,Odessa
272,265,20,100,152,20,172,0,172,0,115,57,21.04.2019 20:50,137,13,Odessa
384,385,26,150,209,25,234,0,234,5,168,61,21.04.2019 21:30,137,13,Odessa
48,37,1,20,28,0,28,0,28,0,21,7,21.04.2019 21:14,137,13,Odessa
272,261,12,96,164,12,176,0,176,2,133,41,21.04.2019 23:00,137,13,Odessa
368,362,6,187,177,4,181,0,181,3,151,27,22.04.2019 00:10,137,13,Odessa
384,381,37,139,213,32,245,0,245,4,195,46,22.04.2019 00:20,137,13,Odessa
32,30,5,6,22,4,26,0,26,0,23,3,22.04.2019 00:00,137,13,Odessa
32,18,2,16,15,1,16,0,16,0,9,7,22.04.2019 00:20,137,13,Odessa
768,750,26,332,412,24,436,0,436,11,360,65,22.04.2019 00:34,137,13,Odessa
624,608,44,263,317,44,361,0,361,3,323,35,22.04.2019 00:08,137,13,Odessa
272,257,1,164,107,1,108,0,108,1,96,11,22.04.2019 00:04,137,13,Odessa
432,402,20,202,211,19,230,0,230,2,213,15,22.04.2019 00:09,137,13,Odessa
48,40,1,16,32,0,32,0,32,0,14,18,21.04.2019 20:35,137,13,Odessa
1040,1015,26,542,479,19,498,0,498,14,403,81,21.04.2019 23:00,137,13,Odessa
928,911,43,482,410,36,446,0,446,4,390,52,21.04.2019 21:35,137,13,Odessa
64,54,6,37,22,5,27,0,27,0,19,8,22.04.2019 00:15,137,13,Odessa
1136,1114,32,550,564,22,586,0,586,8,502,76,22.04.2019 00:05,137,13,Odessa
496,485,7,229,260,7,267,0,267,3,238,26,22.04.2019 00:05,137,13,Odessa
288,281,8,156,126,6,132,0,132,0,105,27,22.04.2019 00:15,137,13,Odessa
416,399,10,197,211,8,219,0,219,1,192,26,22.04.2019 00:17,137,13,Odessa
224,212,8,89,129,6,135,0,135,3,114,18,21.04.2019 21:30,137,13,Odessa
1344,1334,8,529,808,7,815,0,815,16,705,94,22.04.2019 00:10,137,13,Odessa
2000,1950,9,798,1193,9,1202,0,1202,19,1067,116,22.04.2019 00:05,137,13,Odessa
368,26,12,346,11,11,22,0,22,0,20,2,22.04.2019 00:02,137,13,Odessa
144,28,16,119,11,14,25,0,25,0,20,5,22.04.2019 00:05,137,13,Odessa
144,129,0,54,90,0,90,0,90,0,86,4,21.04.2019 20:15,138,13,Odessa
336,322,15,176,147,13,160,0,160,10,138,12,21.04.2019 21:20,138,13,Odessa
112,107,4,36,72,4,76,0,76,1,60,15,21.04.2019 20:35,138,13,Odessa
592,583,26,334,236,22,258,0,258,1,228,29,21.04.2019 21:23,138,13,Odessa
528,520,40,194,300,34,334,0,334,5,293,36,21.04.2019 20:40,138,13,Odessa
320,309,19,66,235,19,254,0,254,1,241,12,21.04.2019 21:20,138,13,Odessa
176,160,16,49,111,16,127,0,127,0,91,36,21.04.2019 20:30,138,13,Odessa
288,274,6,161,124,3,127,0,127,0,117,10,21.04.2019 20:43,138,13,Odessa
272,269,18,142,115,15,130,0,130,1,98,31,21.04.2019 20:35,138,13,Odessa
304,288,19,148,141,15,156,0,156,0,137,19,21.04.2019 20:45,138,13,Odessa
1920,1890,82,974,889,57,946,0,946,19,818,109,21.04.2019 22:00,138,13,Odessa
624,613,43,333,252,39,291,0,291,1,260,30,21.04.2019 20:31,138,13,Odessa
496,488,17,216,264,16,280,0,280,6,255,19,21.04.2019 21:40,138,13,Odessa
160,155,5,63,94,3,97,0,97,3,86,8,21.04.2019 20:15,138,13,Odessa
368,366,18,193,159,16,175,0,175,3,151,21,21.04.2019 21:05,138,13,Odessa
592,580,62,276,259,57,316,0,316,1,293,22,21.04.2019 21:35,138,13,Odessa
416,405,31,200,189,27,216,0,216,3,195,18,21.04.2019 20:50,138,13,Odessa
528,521,27,256,249,23,272,0,272,3,238,31,21.04.2019 21:00,138,13,Odessa
224,210,7,101,118,5,123,0,123,2,110,11,21.04.2019 21:15,138,13,Odessa
480,472,40,270,173,37,210,0,210,5,147,58,21.04.2019 20:37,138,13,Odessa
1680,1644,13,743,925,12,937,0,937,6,808,123,21.04.2019 20:51,138,13,Odessa
80,54,0,37,43,0,43,0,43,2,40,1,21.04.2019 20:35,138,13,Odessa
144,14,4,130,10,4,14,0,14,0,10,4,21.04.2019 20:39,138,13,Odessa
160,146,1,65,94,1,95,0,95,2,89,4,21.04.2019 20:28,139,13,Odessa
464,446,3,179,282,3,285,0,285,3,269,13,21.04.2019 20:35,139,13,Odessa
320,311,10,147,163,10,173,0,173,3,164,6,21.04.2019 20:40,139,13,Odessa
1392,1366,22,608,775,9,784,0,784,17,686,81,21.04.2019 20:50,139,13,Odessa
896,865,77,489,352,55,407,0,407,3,372,32,21.04.2019 20:35,139,13,Odessa
1520,1504,26,743,752,25,777,0,777,11,709,57,21.04.2019 21:20,139,13,Odessa
320,320,31,99,194,27,221,0,221,0,190,31,21.04.2019 20:43,139,13,Odessa
608,591,31,325,259,24,283,0,283,6,252,25,21.04.2019 21:35,139,13,Odessa
592,583,49,302,262,28,290,0,290,4,262,24,21.04.2019 21:00,139,13,Odessa
496,479,39,202,261,33,294,0,294,8,248,38,21.04.2019 21:15,139,13,Odessa
560,546,26,300,245,15,260,0,260,8,240,12,21.04.2019 20:39,139,13,Odessa
432,430,41,190,207,35,242,0,242,3,207,32,21.04.2019 20:25,139,13,Odessa
1088,1080,4,355,730,3,733,0,733,7,654,72,21.04.2019 21:20,139,13,Odessa
2352,2337,14,1168,1174,10,1184,0,1184,28,1079,77,22.04.2019 00:10,139,13,Odessa
2416,2391,29,1039,1352,25,1377,0,1377,27,1215,135,22.04.2019 00:03,139,13,Odessa
336,331,29,114,198,24,222,0,222,10,172,40,22.04.2019 00:00,139,13,Odessa
512,503,30,229,255,28,283,0,283,4,269,10,21.04.2019 20:30,139,13,Odessa
464,463,20,194,250,20,270,0,270,5,240,25,21.04.2019 21:30,139,13,Odessa
896,892,29,397,470,29,499,0,499,5,456,38,21.04.2019 20:35,139,13,Odessa
1072,1050,30,418,624,30,654,0,654,9,606,39,21.04.2019 21:00,139,13,Odessa
768,755,42,290,437,41,478,0,478,5,328,145,21.04.2019 20:45,139,13,Odessa
624,617,8,280,337,7,344,0,344,5,280,59,21.04.2019 20:45,139,13,Odessa
1472,1453,16,836,623,13,636,0,636,13,593,30,21.04.2019 20:55,139,13,Odessa
912,904,38,378,504,30,534,0,534,16,479,39,21.04.2019 20:30,139,13,Odessa
624,607,14,269,342,13,355,0,355,10,320,25,21.04.2019 20:48,139,13,Odessa
512,506,8,231,276,5,281,0,281,5,259,17,21.04.2019 20:40,139,13,Odessa
816,809,56,386,387,43,430,0,430,11,354,65,21.04.2019 20:26,139,13,Odessa
800,791,36,429,339,32,371,0,371,4,345,22,21.04.2019 21:40,139,13,Odessa
928,904,13,503,413,12,425,0,425,16,377,32,22.04.2019 00:20,139,13,Odessa
400,391,16,173,218,9,227,0,227,0,215,12,21.04.2019 20:50,139,13,Odessa
1440,1433,59,753,634,53,687,0,687,12,608,67,21.04.2019 23:30,139,13,Odessa
1120,1118,8,477,639,4,643,0,643,16,566,61,21.04.2019 23:00,140,13,Odessa
464,460,7,206,253,5,258,0,258,2,220,36,21.04.2019 20:10,140,13,Odessa
1648,1560,0,748,900,0,900,0,900,17,774,109,21.04.2019 20:50,140,13,Odessa
272,267,2,116,154,2,156,0,156,3,142,11,21.04.2019 20:40,140,13,Odessa
1536,1524,19,701,822,13,835,0,835,14,740,81,21.04.2019 23:10,140,13,Odessa
1520,1514,12,639,873,8,881,0,881,16,778,87,21.04.2019 21:30,140,13,Odessa
1200,1191,13,480,709,11,720,0,720,7,655,58,21.04.2019 21:30,140,13,Odessa
768,750,4,307,458,3,461,0,461,7,435,19,21.04.2019 20:30,140,13,Odessa
288,289,9,109,170,9,179,0,179,4,167,8,21.04.2019 21:00,140,13,Odessa
2176,2139,9,1134,1034,8,1042,0,1042,27,981,34,21.04.2019 21:08,140,13,Odessa
1616,1596,10,838,768,10,778,0,778,7,748,23,21.04.2019 20:30,140,13,Odessa
624,604,25,249,353,22,375,0,375,8,337,30,21.04.2019 20:55,140,13,Odessa
1552,1530,14,722,818,12,830,0,830,21,775,34,21.04.2019 21:10,140,13,Odessa
1616,1604,29,835,755,26,781,0,781,13,714,54,21.04.2019 20:45,140,13,Odessa
1232,1217,49,480,721,31,752,0,752,14,675,63,21.04.2019 21:00,140,13,Odessa
368,365,7,113,249,6,255,0,255,3,232,20,21.04.2019 20:35,140,13,Odessa
672,667,4,246,422,4,426,0,426,7,384,35,21.04.2019 22:48,140,13,Odessa
1472,1463,33,580,867,25,892,0,892,17,816,59,21.04.2019 21:00,140,13,Odessa
1200,1205,11,512,677,11,688,0,688,17,622,49,21.04.2019 21:20,140,13,Odessa
1184,1179,13,516,656,12,668,0,668,6,618,44,21.04.2019 21:50,140,13,Odessa
1504,1518,9,492,1004,8,1012,0,1012,25,907,80,21.04.2019 20:56,140,13,Odessa
1696,1722,9,598,1091,7,1098,0,1098,23,969,106,21.04.2019 21:05,140,13,Odessa
1456,1449,39,534,890,32,922,0,922,9,799,114,21.04.2019 21:20,140,13,Odessa
1504,1501,11,535,961,8,969,0,969,26,848,95,21.04.2019 21:15,140,13,Odessa
1392,1376,7,566,821,5,826,0,826,21,744,61,21.04.2019 21:15,140,13,Odessa
64,13,9,53,4,7,11,0,11,0,10,1,21.04.2019 20:30,140,13,Odessa
400,110,0,324,76,0,76,0,76,0,69,7,21.04.2019 20:57,140,13,Odessa
144,139,2,55,87,2,89,0,89,2,63,24,21.04.2019 20:20,141,13,Odessa
112,108,3,18,91,3,94,0,94,0,86,8,21.04.2019 21:40,141,13,Odessa
464,450,28,103,335,26,361,0,361,6,341,14,22.04.2019 00:35,141,13,Odessa
2384,2360,11,1060,1317,7,1324,0,1324,28,1224,72,22.04.2019 00:10,141,13,Odessa
2272,2252,15,1000,1262,10,1272,0,1272,33,1165,74,22.04.2019 00:30,141,13,Odessa
576,563,17,272,289,15,304,0,304,12,266,26,22.04.2019 00:15,141,13,Odessa
784,776,19,332,437,15,452,0,452,10,420,22,21.04.2019 20:30,141,13,Odessa
544,526,45,137,366,41,407,0,407,2,389,16,21.04.2019 20:48,141,13,Odessa
560,547,35,286,246,28,274,0,274,5,240,29,21.04.2019 21:30,141,13,Odessa
528,512,24,251,258,19,277,0,277,6,231,40,21.04.2019 20:45,141,13,Odessa
208,194,0,28,180,0,180,0,180,2,162,16,21.04.2019 21:55,141,13,Odessa
112,111,1,29,82,1,83,0,83,0,78,5,21.04.2019 20:35,141,13,Odessa
672,653,17,288,370,14,384,0,384,5,348,31,21.04.2019 22:55,141,13,Odessa
1312,1278,69,591,662,59,721,0,721,11,607,103,21.04.2019 20:55,141,13,Odessa
816,801,29,247,547,22,569,0,569,14,529,26,21.04.2019 20:30,141,13,Odessa
1152,1151,56,599,505,48,553,0,553,16,488,49,21.04.2019 22:00,141,13,Odessa
432,420,7,244,183,5,188,0,188,3,155,30,21.04.2019 20:50,141,13,Odessa
256,33,4,224,29,3,32,0,32,0,30,2,21.04.2019 21:00,141,13,Odessa
64,18,5,46,13,5,18,0,18,0,16,2,22.04.2019 00:13,141,13,Odessa
1712,1678,10,709,993,10,1003,0,1003,34,840,129,22.04.2019 00:15,141,13,Odessa
2000,1973,16,852,1140,8,1148,0,1148,21,1001,126,22.04.2019 00:40,141,13,Odessa
2096,2065,14,1012,1073,11,1084,0,1084,21,945,118,22.04.2019 00:12,141,13,Odessa
1552,1517,12,708,833,11,844,0,844,31,735,78,22.04.2019 00:10,141,13,Odessa
656,644,19,299,344,13,357,0,357,8,307,42,21.04.2019 21:10,141,13,Odessa
1472,1452,25,750,705,17,722,0,722,12,647,63,22.04.2019 00:15,141,13,Odessa
1312,1301,30,583,701,28,729,0,729,11,687,31,21.04.2019 22:10,141,13,Odessa
624,597,31,311,286,27,313,0,313,7,276,30,21.04.2019 20:46,141,13,Odessa
1696,1672,46,741,915,40,955,0,955,28,872,55,22.04.2019 00:35,141,13,Odessa
1424,1395,61,623,744,57,801,0,801,30,721,50,21.04.2019 21:25,141,13,Odessa
608,593,38,291,282,35,317,0,317,8,268,41,22.04.2019 00:30,141,13,Odessa
480,458,29,197,261,22,283,0,283,7,162,114,22.04.2019 00:50,141,13,Odessa
1280,1253,75,619,594,67,661,0,661,12,609,40,22.04.2019 00:53,141,13,Odessa
688,671,11,364,315,9,324,0,324,8,270,46,21.04.2019 21:16,141,13,Odessa
416,400,8,196,214,6,220,0,220,2,190,28,21.04.2019 21:00,141,13,Odessa
176,33,4,143,29,4,33,0,33,0,31,2,22.04.2019 00:08,141,13,Odessa
48,15,0,33,15,0,15,0,15,0,12,3,22.04.2019 00:30,141,13,Odessa
304,11,0,295,9,0,9,0,9,0,9,0,22.04.2019 00:05,141,13,Odessa
2128,2079,29,1031,1080,17,1097,0,1097,35,1000,62,21.04.2019 21:25,142,13,Odessa
1776,1744,32,870,878,28,906,0,906,21,816,69,21.04.2019 20:43,142,13,Odessa
1840,1788,25,795,1026,19,1045,0,1045,10,933,102,22.04.2019 00:10,142,13,Odessa
656,651,18,281,360,15,375,0,375,9,332,34,21.04.2019 20:34,142,13,Odessa
656,647,9,277,372,7,379,0,379,2,360,17,22.04.2019 00:15,142,13,Odessa
2496,2436,20,1224,1255,17,1272,0,1272,19,1145,108,21.04.2019 21:25,142,13,Odessa
1376,1347,14,631,737,8,745,0,745,14,668,63,21.04.2019 21:09,142,13,Odessa
896,884,71,420,414,62,476,0,476,7,436,33,22.04.2019 00:10,142,13,Odessa
192,176,3,96,93,3,96,0,96,2,87,7,21.04.2019 20:39,142,13,Odessa
1152,1126,72,225,859,68,927,0,927,19,624,284,22.04.2019 00:10,142,13,Odessa
656,632,26,263,370,23,393,0,393,7,348,38,21.04.2019 20:37,142,13,Odessa
400,390,10,189,204,7,211,0,211,2,196,13,21.04.2019 20:35,142,13,Odessa
352,338,31,133,194,25,219,0,219,3,170,46,21.04.2019 20:40,142,13,Odessa
528,518,10,213,305,10,315,0,315,4,292,19,21.04.2019 20:55,142,13,Odessa
1136,1100,77,468,605,63,668,0,668,17,561,90,21.04.2019 23:00,142,13,Odessa
976,953,67,77,836,63,899,0,899,9,556,334,21.04.2019 21:14,142,13,Odessa
784,773,59,110,618,56,674,0,674,7,400,267,21.04.2019 21:30,142,13,Odessa
528,513,17,218,294,16,310,0,310,5,278,27,21.04.2019 20:45,142,13,Odessa
432,418,22,203,207,22,229,0,229,3,206,20,21.04.2019 20:45,142,13,Odessa
320,318,14,155,154,11,165,0,165,0,151,14,21.04.2019 20:33,142,13,Odessa
736,723,63,332,353,51,404,0,404,3,358,43,22.04.2019 00:15,142,13,Odessa
768,754,18,321,433,14,447,0,447,6,407,34,21.04.2019 20:30,142,13,Odessa
784,762,31,352,401,31,432,0,432,15,406,11,21.04.2019 20:44,142,13,Odessa
80,75,3,37,40,3,43,0,43,0,31,12,21.04.2019 20:47,142,13,Odessa
144,134,3,70,72,2,74,0,74,2,70,2,21.04.2019 20:40,142,13,Odessa
1008,988,51,565,404,39,443,0,443,11,389,43,21.04.2019 21:30,142,13,Odessa
448,446,22,201,226,21,247,0,247,5,208,34,21.04.2019 20:35,142,13,Odessa
816,794,36,359,426,31,457,0,457,15,423,19,21.04.2019 20:30,142,13,Odessa
240,229,4,110,126,4,130,0,130,1,117,12,21.04.2019 22:00,142,13,Odessa
576,571,29,286,269,21,290,0,290,3,264,23,21.04.2019 20:45,142,13,Odessa
656,644,20,306,331,19,350,0,350,5,313,32,21.04.2019 20:50,142,13,Odessa
768,741,15,346,410,12,422,0,422,12,358,52,21.04.2019 20:42,142,13,Odessa
640,627,13,294,338,8,346,0,346,3,308,35,21.04.2019 20:40,142,13,Odessa
736,727,16,302,423,11,434,0,434,6,352,76,21.04.2019 20:45,142,13,Odessa
1184,1155,47,674,467,43,510,0,510,9,475,26,21.04.2019 20:50,142,13,Odessa
2032,1975,29,930,1078,24,1102,0,1102,25,932,145,21.04.2019 23:10,142,13,Odessa
2208,2203,29,919,1267,22,1289,0,1289,25,1052,212,22.04.2019 00:02,142,13,Odessa
656,638,27,371,259,26,285,0,285,8,258,19,21.04.2019 21:00,142,13,Odessa
1152,1114,59,591,510,51,561,0,561,6,548,7,21.04.2019 20:50,142,13,Odessa
400,379,17,196,190,14,204,0,204,6,186,12,21.04.2019 20:46,142,13,Odessa
416,399,31,208,178,30,208,0,208,3,193,12,21.04.2019 20:38,142,13,Odessa
528,508,9,222,299,7,306,0,306,4,284,18,21.04.2019 20:30,142,13,Odessa
176,170,0,88,88,0,88,0,88,1,81,6,21.04.2019 20:20,142,13,Odessa
1024,980,2,557,467,0,467,0,467,7,446,14,21.04.2019 20:55,142,13,Odessa
256,239,2,99,155,2,157,0,157,1,146,10,21.04.2019 20:35,142,13,Odessa
48,30,0,19,29,0,29,0,29,0,13,16,21.04.2019 22:00,143,13,Odessa
320,288,1,32,287,1,288,0,288,25,251,12,21.04.2019 20:50,143,13,Odessa
0,12,0,0,12,0,12,0,12,0,12,0,21.04.2019 10:30,143,13,Odessa
0,12,0,0,12,0,12,0,12,0,11,1,21.04.2019 08:20,143,13,Odessa
0,12,0,0,12,0,12,0,12,0,11,1,21.04.2019 12:00,143,13,Odessa
0,11,0,0,11,0,11,0,11,0,6,5,21.04.2019 10:30,143,13,Odessa
0,13,0,0,13,0,13,0,13,0,13,0,21.04.2019 08:28,143,13,Odessa
0,12,0,0,12,0,12,0,12,0,12,0,21.04.2019 09:00,143,13,Odessa
0,9,0,0,9,0,9,0,9,0,9,0,21.04.2019 09:00,143,13,Odessa
0,9,0,0,9,0,9,0,9,0,9,0,21.04.2019 09:00,143,13,Odessa
0,8,0,0,8,0,8,0,8,1,7,0,21.04.2019 09:30,143,13,Odessa
0,8,0,0,8,0,8,0,8,0,8,0,21.04.2019 12:05,143,13,Odessa
0,12,0,0,12,0,12,0,12,0,11,1,21.04.2019 11:00,143,13,Odessa
0,6,0,0,6,0,6,0,6,0,5,1,21.04.2019 10:15,143,13,Odessa
0,12,0,0,12,0,12,0,12,0,11,1,21.04.2019 10:00,143,13,Odessa
0,11,0,0,11,0,11,0,11,0,11,0,21.04.2019 20:30,143,13,Odessa
0,8,0,0,8,0,8,0,8,1,7,0,21.04.2019 10:00,143,13,Odessa
896,876,21,410,466,20,486,0,486,4,468,14,21.04.2019 21:07,143,13,Odessa
1488,1461,42,612,839,37,876,0,876,8,836,32,21.04.2019 21:18,143,13,Odessa
1344,1306,47,555,751,38,789,0,789,14,751,24,21.04.2019 20:33,143,13,Odessa
1344,1321,23,549,775,20,795,0,795,19,700,76,21.04.2019 21:30,143,13,Odessa
1024,1012,56,474,501,49,550,0,550,15,519,16,21.04.2019 21:15,143,13,Odessa
1264,1236,56,327,883,54,937,0,937,18,897,22,21.04.2019 21:25,143,13,Odessa
1440,1405,63,490,897,53,950,0,950,33,883,34,21.04.2019 21:45,143,13,Odessa
2032,1989,26,1078,938,16,954,0,954,18,822,114,21.04.2019 21:20,143,13,Odessa
1664,1639,31,716,922,26,948,0,948,24,855,69,22.04.2019 00:08,143,13,Odessa
1664,1624,46,666,959,39,998,0,998,19,882,97,21.04.2019 22:15,143,13,Odessa
736,710,43,323,375,38,413,0,413,2,344,67,21.04.2019 21:05,143,13,Odessa
1440,1401,32,596,813,31,844,0,844,8,798,38,21.04.2019 21:18,143,13,Odessa
656,632,48,306,309,41,350,0,350,6,316,28,21.04.2019 21:01,143,13,Odessa
1280,1263,41,653,594,33,627,0,627,8,542,77,21.04.2019 21:32,143,13,Odessa
2192,2151,53,1000,1150,42,1192,0,1192,15,1068,109,21.04.2019 22:15,143,13,Odessa
416,406,18,144,254,18,272,0,272,7,254,11,21.04.2019 21:44,143,13,Odessa
1776,1737,33,865,889,22,911,0,911,13,857,41,21.04.2019 20:43,143,13,Odessa
1472,1423,22,727,730,15,745,0,745,17,693,35,21.04.2019 20:48,143,13,Odessa
1280,1239,69,527,691,62,753,0,753,6,726,21,21.04.2019 20:47,143,13,Odessa
1744,1715,89,657,1002,85,1087,0,1087,15,1016,56,21.04.2019 21:12,143,13,Odessa
64,41,4,27,33,4,37,0,37,0,28,9,21.04.2019 21:30,143,13,Odessa
1408,1374,24,703,684,21,705,0,705,22,657,26,21.04.2019 23:50,143,13,Odessa
1872,1836,20,956,897,19,916,0,916,35,828,53,21.04.2019 21:00,143,13,Odessa
1520,1471,28,841,656,23,679,0,679,21,628,30,21.04.2019 23:30,143,13,Odessa
1920,1869,100,977,855,88,943,0,943,18,895,30,21.04.2019 21:30,143,13,Odessa
1984,1945,118,948,927,109,1036,0,1036,16,986,34,21.04.2019 20:15,143,13,Odessa
2400,2312,31,955,1416,29,1445,0,1445,42,1244,159,21.04.2019 21:50,143,13,Odessa
2288,2231,25,992,1278,18,1296,0,1296,38,1141,117,21.04.2019 21:38,143,13,Odessa
2272,2232,28,964,1286,22,1308,0,1308,33,1173,102,21.04.2019 22:05,143,13,Odessa
2256,2204,19,971,1270,15,1285,0,1285,31,1161,93,21.04.2019 21:30,143,13,Odessa
2208,2181,33,880,1309,19,1328,0,1328,38,1173,117,21.04.2019 22:05,143,13,Odessa
2224,2204,33,925,1279,20,1299,0,1298,33,1167,98,21.04.2019 22:32,143,13,Odessa
1872,1839,57,750,1076,46,1122,0,1122,29,1001,92,21.04.2019 21:30,143,13,Odessa
1856,1826,35,789,1045,22,1067,0,1067,28,957,82,21.04.2019 21:30,143,13,Odessa
2064,2050,45,848,1192,24,1216,0,1216,24,1104,88,21.04.2019 20:20,143,13,Odessa
2208,2169,76,881,1269,58,1327,0,1327,34,1170,123,21.04.2019 22:20,143,13,Odessa
1488,1491,23,562,908,18,926,0,926,25,833,68,21.04.2019 22:30,143,13,Odessa
2432,2413,28,972,1440,20,1460,0,1460,41,1278,141,21.04.2019 21:50,143,13,Odessa
2000,1999,62,773,1171,56,1227,0,1227,27,1086,114,21.04.2019 21:35,143,13,Odessa
1904,1871,26,708,1177,19,1196,0,1196,25,1056,115,21.04.2019 21:50,143,13,Odessa
2272,2248,26,902,1353,17,1370,0,1370,40,1221,109,21.04.2019 22:00,143,13,Odessa
2128,2110,48,800,1290,38,1328,0,1328,31,1169,128,21.04.2019 22:00,143,13,Odessa
1952,1941,26,734,1204,14,1218,0,1218,34,1080,104,21.04.2019 22:00,143,13,Odessa
2112,2077,15,837,1262,13,1275,0,1275,26,1131,118,21.04.2019 21:48,143,13,Odessa
2128,2094,50,876,1215,37,1252,0,1252,11,1127,114,21.04.2019 21:30,143,13,Odessa
1344,1323,13,492,841,11,852,0,852,14,731,107,21.04.2019 21:30,143,13,Odessa
208,22,6,187,16,5,21,0,21,0,18,3,21.04.2019 20:15,143,13,Odessa
176,22,8,156,14,6,20,0,20,0,17,3,21.04.2019 21:40,143,13,Odessa
80,16,0,65,15,0,15,0,15,0,10,5,22.04.2019 00:25,143,13,Odessa
176,82,41,100,39,37,76,0,76,0,69,7,21.04.2019 20:40,143,13,Odessa
128,18,0,111,17,0,17,0,17,0,14,3,21.04.2019 22:15,143,13,Odessa
96,13,0,83,13,0,13,0,13,0,11,2,21.04.2019 20:08,143,13,Odessa
80,29,4,51,25,4,29,0,29,0,24,5,21.04.2019 20:45,143,13,Odessa
2016,1960,3,1519,495,2,497,0,497,9,451,37,21.04.2019 23:50,143,13,Odessa
2128,2133,20,644,1471,13,1484,0,1484,39,1182,263,21.04.2019 22:45,144,14,Poltava
1376,1367,27,510,845,21,866,0,866,28,702,136,21.04.2019 22:30,144,14,Poltava
1312,1300,15,460,837,15,852,0,852,16,708,128,21.04.2019 21:49,144,14,Poltava
1696,1684,20,493,1187,16,1203,0,1203,26,964,213,21.04.2019 21:30,144,14,Poltava
320,11,0,309,11,0,11,0,11,0,11,0,21.04.2019 21:09,144,14,Poltava
1120,505,0,615,505,0,505,0,505,25,452,28,21.04.2019 20:55,144,14,Poltava
1312,1307,13,435,865,12,877,0,877,29,667,181,21.04.2019 21:45,144,14,Poltava
2256,2244,17,812,1434,10,1444,0,1444,28,1209,207,21.04.2019 23:13,144,14,Poltava
2112,2113,32,705,1381,26,1407,0,1407,38,1161,208,21.04.2019 21:30,144,14,Poltava
2160,2171,5,668,1487,5,1492,0,1492,39,1260,193,21.04.2019 21:36,144,14,Poltava
672,671,5,243,425,4,429,0,429,5,357,67,21.04.2019 21:45,144,14,Poltava
1920,1916,16,605,1304,11,1315,0,1315,35,1072,208,21.04.2019 21:40,144,14,Poltava
1984,1985,21,600,1366,18,1384,0,1384,29,1119,236,21.04.2019 22:08,144,14,Poltava
2144,2135,17,644,1486,14,1500,0,1500,41,1229,230,21.04.2019 21:50,144,14,Poltava
2224,2194,26,692,1515,17,1532,0,1532,45,1244,243,21.04.2019 21:45,144,14,Poltava
176,29,17,150,10,16,26,0,26,1,23,2,21.04.2019 21:26,144,14,Poltava
224,32,2,192,30,2,32,0,32,0,28,4,21.04.2019 20:40,144,14,Poltava
256,29,14,228,14,14,28,0,28,2,20,6,21.04.2019 20:45,144,14,Poltava
96,16,0,81,15,0,15,0,15,0,14,1,21.04.2019 20:20,144,14,Poltava
1440,1407,16,536,888,16,904,0,904,10,803,91,22.04.2019 00:10,145,14,Poltava
1792,1766,38,728,1028,36,1064,0,1064,24,875,165,21.04.2019 21:07,145,14,Poltava
1504,1471,38,578,896,30,926,0,926,23,763,140,21.04.2019 22:11,145,14,Poltava
688,677,62,175,453,60,513,0,513,15,426,72,21.04.2019 21:40,145,14,Poltava
960,968,61,294,610,56,666,0,666,9,583,74,22.04.2019 00:50,145,14,Poltava
112,101,4,44,65,3,68,1,68,1,60,7,22.04.2019 00:20,145,14,Poltava
416,398,22,142,258,16,274,0,274,1,224,48,22.04.2019 00:02,145,14,Poltava
272,270,18,87,171,14,185,0,185,3,164,18,21.04.2019 20:15,145,14,Poltava
112,120,11,16,85,11,96,0,96,0,86,10,21.04.2019 21:30,145,14,Poltava
64,60,5,23,38,3,41,0,41,0,35,6,21.04.2019 20:45,145,14,Poltava
720,727,59,173,492,55,547,0,547,5,488,54,22.04.2019 00:15,145,14,Poltava
160,146,16,68,76,16,92,0,92,0,78,14,22.04.2019 00:10,145,14,Poltava
272,269,17,94,161,17,178,0,178,1,152,25,22.04.2019 00:30,145,14,Poltava
160,153,9,70,82,8,90,0,90,1,74,15,21.04.2019 20:45,145,14,Poltava
496,489,32,139,328,29,357,0,357,7,304,46,21.04.2019 20:55,145,14,Poltava
352,346,21,118,216,18,234,0,234,5,177,52,21.04.2019 20:50,145,14,Poltava
752,749,18,325,409,18,427,0,427,13,360,54,21.04.2019 20:16,145,14,Poltava
512,495,12,191,309,12,321,0,321,3,269,49,21.04.2019 21:10,145,14,Poltava
736,728,24,308,408,20,428,0,428,12,342,74,21.04.2019 21:20,145,14,Poltava
384,377,37,137,213,34,247,0,247,3,208,36,21.04.2019 22:33,145,14,Poltava
864,853,33,276,556,32,588,0,588,11,515,62,21.04.2019 21:35,145,14,Poltava
864,844,7,389,468,7,475,0,475,8,376,91,22.04.2019 00:10,145,14,Poltava
1104,1082,25,447,634,23,657,0,657,22,519,116,21.04.2019 21:00,145,14,Poltava
1440,1417,6,542,892,6,898,0,898,23,762,113,22.04.2019 00:15,145,14,Poltava
336,327,36,122,179,35,214,0,214,3,183,28,22.04.2019 00:35,145,14,Poltava
928,915,13,311,604,13,617,0,617,16,505,96,21.04.2019 22:10,145,14,Poltava
1392,1377,63,505,831,56,887,0,887,28,722,137,21.04.2019 22:35,145,14,Poltava
1984,1960,3,689,1292,3,1295,0,1295,22,1023,250,21.04.2019 22:00,145,14,Poltava
672,657,7,235,430,7,437,0,437,5,375,57,21.04.2019 21:08,145,14,Poltava
560,546,8,196,356,8,364,0,364,4,316,44,21.04.2019 20:45,145,14,Poltava
320,307,3,127,191,2,193,0,193,1,172,20,21.04.2019 21:05,145,14,Poltava
512,505,24,175,313,24,337,0,337,1,269,67,21.04.2019 21:05,145,14,Poltava
960,965,3,289,670,1,671,0,671,15,554,102,21.04.2019 22:50,145,14,Poltava
1856,1826,7,633,1217,6,1223,0,1223,16,1020,187,22.04.2019 00:05,145,14,Poltava
560,557,0,197,363,0,363,0,363,12,290,61,21.04.2019 21:40,145,14,Poltava
992,239,0,753,239,0,239,0,239,5,215,19,21.04.2019 21:30,145,14,Poltava
336,99,0,239,97,0,97,0,97,3,87,7,22.04.2019 00:15,145,14,Poltava
2016,2015,12,770,1236,10,1246,0,1246,37,969,240,21.04.2019 22:30,145,14,Poltava
1264,1256,2,639,623,2,625,0,625,9,494,122,21.04.2019 21:34,145,14,Poltava
1392,1432,5,640,747,5,752,0,752,16,628,108,21.04.2019 21:05,145,14,Poltava
1952,1949,31,636,1293,23,1316,34,1316,34,1062,220,21.04.2019 23:05,145,14,Poltava
2320,2324,16,766,1542,12,1554,0,1554,46,1244,264,22.04.2019 00:05,145,14,Poltava
2416,2371,47,902,1471,43,1514,0,1514,27,1253,234,21.04.2019 21:35,145,14,Poltava
1248,1219,15,465,772,11,783,0,783,17,674,92,21.04.2019 20:51,145,14,Poltava
1952,1948,24,701,1227,24,1251,0,1251,30,1046,175,21.04.2019 21:45,145,14,Poltava
2000,1972,31,679,1294,27,1321,0,1321,32,1072,217,21.04.2019 22:10,145,14,Poltava
2096,2092,16,823,1262,11,1273,823,1273,42,1010,221,22.04.2019 00:01,145,14,Poltava
2352,2328,10,782,1562,8,1570,0,1570,28,1304,238,22.04.2019 00:03,145,14,Poltava
2144,2142,24,655,1466,23,1489,0,1489,33,1187,269,21.04.2019 21:31,145,14,Poltava
2256,2272,28,752,1481,23,1504,0,1504,51,1221,232,21.04.2019 22:08,145,14,Poltava
2128,2125,18,651,1459,18,1477,0,1477,38,1197,242,22.04.2019 00:10,145,14,Poltava
176,23,11,153,12,11,23,0,23,0,19,4,22.04.2019 00:15,145,14,Poltava
864,231,70,656,139,69,208,0,208,14,153,41,21.04.2019 21:00,145,14,Poltava
112,41,0,86,26,0,26,0,26,1,21,4,22.04.2019 01:30,145,14,Poltava
320,11,11,309,0,11,11,0,11,0,9,2,21.04.2019 20:35,145,14,Poltava
208,16,0,193,15,0,15,0,15,0,13,2,21.04.2019 21:59,145,14,Poltava
80,19,0,61,19,0,19,0,19,1,12,6,21.04.2019 20:30,145,14,Poltava
64,18,0,47,17,0,17,0,17,0,14,3,21.04.2019 22:03,145,14,Poltava
208,48,0,164,44,0,44,0,44,1,37,6,22.04.2019 01:00,145,14,Poltava
1696,1724,7,687,1003,6,1009,0,1009,20,795,194,22.04.2019 00:05,146,14,Poltava
1664,1663,16,582,1070,12,1082,0,1082,27,824,231,22.04.2019 00:28,146,14,Poltava
1712,1712,6,602,1104,6,1110,0,1110,23,821,266,22.04.2019 00:15,146,14,Poltava
1696,1679,12,595,1093,8,1101,0,1101,18,826,257,22.04.2019 00:04,146,14,Poltava
1888,1883,17,636,1241,11,1252,0,1252,37,940,275,22.04.2019 00:03,146,14,Poltava
1776,1786,11,553,1214,9,1223,0,1223,32,914,277,22.04.2019 01:45,146,14,Poltava
1280,1281,16,426,841,13,854,0,854,22,664,168,22.04.2019 00:07,146,14,Poltava
736,740,5,246,485,5,490,0,490,22,389,79,22.04.2019 00:30,146,14,Poltava
1536,1516,9,505,1024,7,1031,0,1031,27,791,213,22.04.2019 00:01,146,14,Poltava
800,804,11,299,491,10,501,0,501,11,403,87,22.04.2019 00:05,146,14,Poltava
1984,1952,33,786,1174,24,1198,0,1198,29,947,222,22.04.2019 00:22,146,14,Poltava
960,956,11,357,597,6,603,0,603,20,462,121,21.04.2019 23:30,146,14,Poltava
624,614,8,222,396,6,402,0,402,14,332,56,22.04.2019 00:24,146,14,Poltava
1680,1671,14,606,1061,13,1074,0,1074,26,840,208,22.04.2019 00:35,146,14,Poltava
1648,1637,11,554,1085,9,1094,0,1094,32,862,200,21.04.2019 21:15,146,14,Poltava
2000,1987,5,673,1323,4,1327,0,1327,27,1079,221,22.04.2019 00:05,146,14,Poltava
2368,2346,18,730,1629,9,1638,0,1638,24,1304,310,22.04.2019 00:09,146,14,Poltava
2144,2159,6,658,1480,6,1486,0,1486,37,1143,306,22.04.2019 00:25,146,14,Poltava
2176,2155,7,682,1492,2,1494,0,1494,31,1183,280,22.04.2019 00:15,146,14,Poltava
1728,1738,21,572,1143,13,1156,0,1156,23,902,231,22.04.2019 00:40,146,14,Poltava
2304,2288,24,705,1581,18,1599,0,1599,35,1275,289,22.04.2019 00:15,146,14,Poltava
2176,2154,6,733,1440,3,1443,0,1443,30,1151,262,22.04.2019 01:40,146,14,Poltava
2320,2299,13,792,1516,12,1528,0,1528,19,1249,260,22.04.2019 00:30,146,14,Poltava
2208,2173,18,710,1483,15,1498,0,1498,35,1184,279,22.04.2019 00:59,146,14,Poltava
2000,2004,15,612,1377,11,1388,0,1388,35,1076,277,22.04.2019 00:26,146,14,Poltava
1984,1924,13,747,1228,9,1237,0,1237,34,964,239,22.04.2019 00:20,146,14,Poltava
2000,1965,20,729,1258,13,1271,0,1271,32,998,241,22.04.2019 00:05,146,14,Poltava
1968,1935,31,654,1290,24,1314,0,1314,33,1026,255,22.04.2019 00:02,146,14,Poltava
1840,1835,18,564,1259,17,1276,0,1276,25,960,291,22.04.2019 00:30,146,14,Poltava
2064,2046,18,829,1227,8,1235,0,1235,26,1029,180,22.04.2019 00:17,146,14,Poltava
2416,2396,24,848,1549,19,1568,0,1568,51,1268,249,22.04.2019 00:05,146,14,Poltava
1920,1914,8,715,1199,6,1205,0,1205,25,979,201,22.04.2019 00:42,146,14,Poltava
1888,1862,9,739,1143,6,1149,0,1149,25,936,188,22.04.2019 00:30,146,14,Poltava
1808,1793,18,626,1168,14,1182,0,1182,35,930,217,22.04.2019 00:30,146,14,Poltava
1120,1109,4,435,681,4,685,0,685,18,559,108,21.04.2019 23:06,146,14,Poltava
1840,1826,12,617,1216,7,1223,0,1223,30,988,205,22.04.2019 00:22,146,14,Poltava
1456,1458,10,503,947,6,953,0,953,21,721,211,22.04.2019 00:30,146,14,Poltava
2048,2020,14,874,1164,10,1174,0,1174,19,978,177,21.04.2019 23:01,146,14,Poltava
1744,1716,10,636,1100,8,1108,0,1108,27,870,211,22.04.2019 00:05,146,14,Poltava
1360,1349,11,458,892,10,902,0,902,27,725,150,22.04.2019 00:09,146,14,Poltava
2256,2245,11,820,1427,9,1436,0,1436,36,1179,221,22.04.2019 00:05,146,14,Poltava
1984,1959,11,717,1259,8,1267,0,1267,28,1031,208,22.04.2019 00:30,146,14,Poltava
2144,2119,7,655,1483,6,1489,0,1489,39,1202,248,22.04.2019 00:05,146,14,Poltava
2288,2257,7,785,1499,4,1503,0,1503,31,1205,267,22.04.2019 00:45,146,14,Poltava
2176,2139,13,680,1486,10,1496,0,1496,40,1177,279,22.04.2019 00:20,146,14,Poltava
2144,2128,12,715,1418,11,1429,0,1429,27,1134,268,22.04.2019 00:40,146,14,Poltava
240,66,0,187,53,0,53,0,53,0,47,6,21.04.2019 22:25,146,14,Poltava
48,31,0,17,31,0,31,0,31,2,24,5,21.04.2019 20:21,146,14,Poltava
1088,1067,11,357,722,9,731,0,731,17,558,156,22.04.2019 00:07,146,14,Poltava
1088,1063,13,397,684,7,691,0,691,13,543,135,21.04.2019 22:05,146,14,Poltava
1872,1855,21,664,1189,19,1208,0,1208,23,955,230,22.04.2019 00:10,146,14,Poltava
1152,1123,12,460,684,8,692,0,692,23,534,135,22.04.2019 00:10,146,14,Poltava
992,992,12,337,643,12,655,0,655,17,506,132,22.04.2019 00:12,146,14,Poltava
1136,1122,14,399,728,9,737,0,737,25,549,163,22.04.2019 00:26,146,14,Poltava
1648,1646,6,531,1112,5,1117,0,1117,36,852,229,21.04.2019 22:12,146,14,Poltava
1536,1510,22,538,978,20,998,0,998,34,738,226,22.04.2019 00:30,146,14,Poltava
1472,1441,11,540,922,10,932,0,932,13,759,160,22.04.2019 00:35,146,14,Poltava
1952,1928,12,647,1295,10,1305,0,1305,30,1053,222,22.04.2019 00:10,146,14,Poltava
1568,1540,4,553,1013,2,1015,0,1015,27,824,164,21.04.2019 22:00,146,14,Poltava
2048,2010,11,667,1373,8,1381,0,1381,38,1083,260,22.04.2019 00:05,146,14,Poltava
2032,2004,9,662,1363,7,1370,0,1370,25,1133,212,22.04.2019 00:50,146,14,Poltava
672,662,6,264,402,6,408,0,408,9,335,64,21.04.2019 23:47,146,14,Poltava
1024,989,6,473,547,4,551,0,551,4,481,66,22.04.2019 00:05,146,14,Poltava
1984,1958,21,719,1251,14,1265,0,1265,27,1051,187,22.04.2019 00:05,146,14,Poltava
1776,1730,20,661,1105,10,1115,0,1115,27,927,161,21.04.2019 23:45,146,14,Poltava
1392,1364,7,547,840,5,845,0,845,26,682,137,22.04.2019 00:05,146,14,Poltava
1536,1523,13,595,928,13,941,0,941,28,780,133,22.04.2019 00:10,146,14,Poltava
1456,1445,10,634,815,7,822,0,822,25,692,105,22.04.2019 00:30,146,14,Poltava
1440,1418,15,650,777,13,790,0,790,21,658,111,22.04.2019 00:10,146,14,Poltava
1392,1382,13,550,833,9,842,0,842,15,702,125,22.04.2019 00:11,146,14,Poltava
1488,1462,13,610,869,9,878,0,878,18,706,154,22.04.2019 00:22,146,14,Poltava
1600,1572,16,626,961,13,974,0,974,25,810,139,22.04.2019 00:09,146,14,Poltava
1392,1365,15,594,788,10,798,0,798,18,673,107,22.04.2019 00:16,146,14,Poltava
1440,1419,13,591,842,7,849,0,849,25,678,146,22.04.2019 00:10,146,14,Poltava
1600,1571,14,526,1060,14,1074,0,1074,31,859,184,22.04.2019 00:15,146,14,Poltava
2144,2116,15,736,1396,12,1408,0,1408,38,1133,237,22.04.2019 00:35,146,14,Poltava
2256,2207,12,750,1501,5,1506,0,1506,44,1190,272,22.04.2019 00:10,146,14,Poltava
1472,1443,6,482,986,4,990,0,990,18,795,177,22.04.2019 00:49,146,14,Poltava
1312,1284,13,476,823,13,836,0,836,29,669,138,22.04.2019 00:20,146,14,Poltava
1472,1439,19,575,881,16,897,0,897,28,745,124,22.04.2019 00:03,146,14,Poltava
1472,1450,14,547,915,10,925,0,925,24,758,143,21.04.2019 21:30,146,14,Poltava
1536,1518,11,501,1029,6,1035,0,1035,26,864,145,22.04.2019 00:30,146,14,Poltava
1824,1800,14,655,1157,12,1169,0,1169,33,936,200,22.04.2019 01:20,146,14,Poltava
1232,113,0,1119,113,0,113,0,113,7,102,4,21.04.2019 22:30,146,14,Poltava
176,163,14,74,90,12,102,0,102,6,83,13,22.04.2019 00:20,147,14,Poltava
304,294,18,106,183,15,198,0,198,4,160,34,21.04.2019 20:35,147,14,Poltava
320,315,32,110,183,27,210,0,210,0,186,24,22.04.2019 00:40,147,14,Poltava
864,845,74,243,559,62,621,0,621,14,533,74,22.04.2019 00:20,147,14,Poltava
208,204,9,82,118,8,126,0,126,7,106,13,22.04.2019 00:15,147,14,Poltava
288,282,33,113,145,30,175,0,175,2,147,26,21.04.2019 20:40,147,14,Poltava
256,258,11,78,167,11,178,0,178,3,148,27,21.04.2019 21:45,147,14,Poltava
736,716,77,275,394,67,461,0,461,10,425,26,22.04.2019 00:05,147,14,Poltava
432,425,47,143,248,41,289,0,289,2,257,30,22.04.2019 00:30,147,14,Poltava
544,539,41,164,343,37,380,0,380,6,334,40,21.04.2019 21:55,147,14,Poltava
1104,1089,54,361,692,51,743,0,743,14,641,88,22.04.2019 00:50,147,14,Poltava
1184,1160,72,386,728,70,798,0,798,20,692,86,22.04.2019 00:15,147,14,Poltava
1120,1097,83,408,645,67,712,0,712,25,621,66,22.04.2019 00:15,147,14,Poltava
928,921,28,327,575,26,601,0,601,13,517,71,22.04.2019 00:30,147,14,Poltava
272,266,44,111,121,40,161,0,161,1,140,20,22.04.2019 00:10,147,14,Poltava
736,715,42,245,452,39,491,0,491,13,426,52,21.04.2019 23:45,147,14,Poltava
464,452,21,165,279,20,299,0,299,2,264,33,21.04.2019 20:32,147,14,Poltava
192,181,25,61,108,23,131,0,131,1,109,21,21.04.2019 20:30,147,14,Poltava
144,136,22,64,63,17,80,0,80,0,68,12,22.04.2019 00:20,147,14,Poltava
400,393,68,140,195,65,260,0,260,9,229,22,21.04.2019 21:00,147,14,Poltava
448,436,50,154,247,47,294,0,294,2,267,25,22.04.2019 00:10,147,14,Poltava
384,379,28,150,216,18,234,0,234,4,204,26,22.04.2019 00:42,147,14,Poltava
144,135,20,65,60,19,79,0,79,0,75,4,22.04.2019 00:25,147,14,Poltava
384,371,46,110,237,37,274,0,274,3,232,39,21.04.2019 23:00,147,14,Poltava
336,323,46,105,189,42,231,0,231,2,208,21,22.04.2019 00:30,147,14,Poltava
256,237,27,83,149,24,173,0,173,11,150,12,22.04.2019 00:20,147,14,Poltava
384,367,27,180,184,20,204,0,204,2,178,24,22.04.2019 00:15,147,14,Poltava
96,89,14,34,50,12,62,0,62,0,51,11,22.04.2019 00:51,147,14,Poltava
128,125,30,36,70,22,92,0,92,1,82,9,21.04.2019 22:00,147,14,Poltava
640,625,53,226,367,47,414,0,414,6,364,44,22.04.2019 00:05,147,14,Poltava
224,219,26,71,128,25,153,0,153,3,140,10,22.04.2019 00:35,147,14,Poltava
624,621,76,231,324,69,393,0,393,4,346,43,22.04.2019 00:01,147,14,Poltava
560,549,53,215,303,42,345,0,345,4,290,51,22.04.2019 00:55,147,14,Poltava
224,218,38,58,130,36,166,0,166,4,148,14,22.04.2019 00:15,147,14,Poltava
720,702,30,261,429,30,459,0,459,8,402,49,21.04.2019 20:23,147,14,Poltava
432,435,56,133,254,45,299,0,299,3,244,52,22.04.2019 00:05,147,14,Poltava
704,685,65,239,404,61,465,0,465,7,386,72,21.04.2019 20:40,147,14,Poltava
1280,1255,54,496,730,54,784,0,784,8,665,111,21.04.2019 21:00,147,14,Poltava
1408,1390,49,604,760,44,804,0,804,11,674,119,21.04.2019 21:50,147,14,Poltava
320,307,18,118,186,16,202,0,202,0,177,25,21.04.2019 20:51,147,14,Poltava
1200,1173,28,482,696,22,718,0,718,13,604,101,21.04.2019 22:00,147,14,Poltava
1008,985,53,414,542,52,594,0,594,10,512,72,21.04.2019 21:15,147,14,Poltava
704,702,58,300,352,52,404,0,404,14,314,76,21.04.2019 21:00,147,14,Poltava
128,116,8,51,71,6,77,0,77,1,66,10,21.04.2019 20:28,147,14,Poltava
624,611,54,188,384,52,436,0,436,10,345,81,22.04.2019 00:03,147,14,Poltava
832,825,74,332,430,70,500,0,500,6,435,59,21.04.2019 20:45,147,14,Poltava
528,509,53,203,282,43,325,0,325,10,260,55,21.04.2019 20:50,147,14,Poltava
240,220,30,100,115,25,140,0,140,3,121,16,21.04.2019 21:15,147,14,Poltava
832,813,33,333,467,32,499,0,499,9,432,58,21.04.2019 23:21,147,14,Poltava
816,802,43,333,442,41,483,0,483,6,430,47,22.04.2019 00:20,147,14,Poltava
144,144,18,56,72,16,88,0,88,0,79,9,21.04.2019 20:55,147,14,Poltava
464,445,42,166,256,42,298,0,298,3,249,46,21.04.2019 20:52,147,14,Poltava
144,139,19,28,97,19,116,0,116,2,83,31,21.04.2019 21:05,147,14,Poltava
1200,1199,54,419,728,53,781,0,781,9,673,99,21.04.2019 21:10,147,14,Poltava
464,459,54,151,263,50,313,0,313,3,280,30,21.04.2019 20:45,147,14,Poltava
320,308,9,112,202,6,208,0,208,3,151,54,22.04.2019 00:20,147,14,Poltava
176,163,17,40,121,15,136,0,136,5,102,29,21.04.2019 20:40,147,14,Poltava
80,66,3,19,58,3,61,0,61,0,40,21,21.04.2019 20:52,147,14,Poltava
96,80,6,21,69,6,75,0,75,3,48,24,21.04.2019 20:50,147,14,Poltava
320,312,23,111,189,20,209,0,209,7,178,24,21.04.2019 23:45,147,14,Poltava
160,152,27,51,82,27,109,0,109,1,94,14,21.04.2019 21:05,147,14,Poltava
288,283,23,112,153,23,176,0,176,3,154,19,21.04.2019 20:40,147,14,Poltava
112,106,5,37,71,4,75,0,75,1,58,16,21.04.2019 20:40,147,14,Poltava
1376,1358,56,650,673,53,726,0,726,15,580,131,21.04.2019 22:00,147,14,Poltava
160,163,20,47,93,20,113,0,113,2,91,20,21.04.2019 21:15,147,14,Poltava
320,318,26,110,184,26,210,0,210,2,161,47,21.04.2019 21:04,147,14,Poltava
272,274,42,68,167,37,204,0,204,1,151,52,21.04.2019 22:05,147,14,Poltava
448,439,32,206,215,27,242,0,242,2,213,27,22.04.2019 00:01,147,14,Poltava
112,111,8,37,68,7,75,0,75,0,62,13,21.04.2019 20:40,147,14,Poltava
560,556,56,254,251,55,306,0,306,8,260,38,21.04.2019 21:00,147,14,Poltava
816,795,20,365,432,19,451,0,451,7,384,60,22.04.2019 00:10,147,14,Poltava
272,257,22,92,163,17,180,0,180,3,152,25,21.04.2019 22:35,147,14,Poltava
288,286,25,87,176,25,201,0,201,2,179,20,21.04.2019 20:40,147,14,Poltava
1664,1649,26,598,1043,23,1066,0,1066,28,878,160,22.04.2019 00:06,147,14,Poltava
320,311,11,120,189,11,200,0,200,4,181,15,21.04.2019 21:30,147,14,Poltava
848,821,32,294,522,32,554,0,554,15,453,86,21.04.2019 21:30,147,14,Poltava
320,309,10,90,220,10,230,0,230,5,201,24,21.04.2019 23:20,147,14,Poltava
624,610,28,250,350,24,374,0,374,4,337,33,22.04.2019 00:15,147,14,Poltava
288,287,10,140,138,10,148,0,148,1,126,21,21.04.2019 20:42,147,14,Poltava
992,975,52,358,585,49,634,0,634,14,553,67,21.04.2019 21:30,147,14,Poltava
832,829,59,255,526,51,577,0,577,7,525,45,21.04.2019 20:30,147,14,Poltava
240,222,21,94,127,19,146,0,146,1,131,14,22.04.2019 00:05,147,14,Poltava
384,370,41,121,227,36,263,0,263,3,221,39,22.04.2019 00:09,147,14,Poltava
160,147,15,54,93,13,106,0,106,6,78,22,22.04.2019 00:03,147,14,Poltava
496,486,35,208,259,29,288,0,288,1,244,43,21.04.2019 21:15,147,14,Poltava
384,387,40,138,217,29,246,0,246,1,209,36,21.04.2019 22:20,147,14,Poltava
368,365,31,106,233,29,262,0,262,7,232,23,22.04.2019 00:10,147,14,Poltava
400,380,44,134,225,41,266,0,266,6,226,34,22.04.2019 00:25,147,14,Poltava
208,195,30,73,108,27,135,0,135,2,101,32,22.04.2019 00:05,147,14,Poltava
320,313,44,83,197,40,237,0,237,6,206,25,22.04.2019 00:12,147,14,Poltava
192,188,15,47,131,14,145,0,145,2,136,7,22.04.2019 00:25,147,14,Poltava
272,262,19,78,175,19,194,0,194,5,159,30,22.04.2019 00:05,147,14,Poltava
704,696,64,259,386,59,445,0,445,1,366,78,22.04.2019 00:45,147,14,Poltava
496,483,34,195,267,34,301,0,301,3,273,25,22.04.2019 01:55,147,14,Poltava
320,307,33,91,199,30,229,0,229,4,208,17,22.04.2019 00:05,147,14,Poltava
256,242,34,82,141,33,174,0,174,7,143,24,22.04.2019 00:05,147,14,Poltava
1968,1935,87,666,1230,72,1302,0,1302,19,1080,203,22.04.2019 00:20,147,14,Poltava
272,261,19,78,179,15,194,0,194,2,170,22,21.04.2019 20:23,147,14,Poltava
288,276,40,73,177,38,215,0,215,6,180,29,21.04.2019 20:50,147,14,Poltava
416,404,41,135,243,38,281,0,281,1,263,17,22.04.2019 00:05,147,14,Poltava
368,356,43,124,203,41,244,0,244,3,222,19,21.04.2019 21:00,147,14,Poltava
464,456,45,153,271,40,311,0,311,3,285,23,22.04.2019 00:08,147,14,Poltava
624,607,37,208,388,28,416,0,416,3,364,49,21.04.2019 22:00,147,14,Poltava
272,258,18,103,152,17,169,0,169,1,149,19,21.04.2019 21:00,147,14,Poltava
496,476,53,171,275,50,325,0,325,6,284,35,21.04.2019 20:45,147,14,Poltava
544,530,34,162,349,33,382,0,382,1,336,45,21.04.2019 20:50,147,14,Poltava
384,385,38,125,222,37,259,0,259,4,217,38,22.04.2019 00:02,147,14,Poltava
784,778,50,282,458,44,502,0,502,8,432,62,22.04.2019 00:12,147,14,Poltava
560,549,59,219,291,50,341,0,341,6,302,33,21.04.2019 20:50,147,14,Poltava
432,427,52,148,236,48,284,0,284,10,240,34,21.04.2019 23:20,147,14,Poltava
1824,1795,99,676,1062,86,1148,0,1148,28,988,132,21.04.2019 20:40,147,14,Poltava
1504,1489,53,516,938,50,988,0,988,14,853,121,21.04.2019 21:50,147,14,Poltava
2000,1967,17,697,1286,17,1303,0,1303,20,1104,179,21.04.2019 21:25,147,14,Poltava
1424,1404,16,510,903,11,914,0,914,22,766,126,22.04.2019 00:01,147,14,Poltava
1840,1809,65,636,1148,56,1204,0,1204,39,1053,112,22.04.2019 00:10,147,14,Poltava
1824,1810,19,712,1098,14,1112,0,1112,26,928,158,21.04.2019 20:40,147,14,Poltava
1760,1847,24,525,1214,21,1235,0,1235,42,993,200,21.04.2019 20:23,147,14,Poltava
1632,1678,25,548,1063,21,1084,0,1084,30,854,200,22.04.2019 00:05,147,14,Poltava
1776,1759,22,629,1129,18,1147,0,1147,35,940,172,22.04.2019 00:05,147,14,Poltava
1840,1805,10,728,1104,8,1112,0,1112,25,941,146,22.04.2019 00:03,147,14,Poltava
1840,1832,7,700,1135,5,1140,0,1140,26,934,180,21.04.2019 20:45,147,14,Poltava
1920,1953,21,639,1262,19,1281,0,1281,34,1064,183,21.04.2019 22:30,147,14,Poltava
1712,1685,33,696,983,33,1016,0,1016,28,896,92,22.04.2019 00:01,147,14,Poltava
1872,1891,25,574,1276,22,1298,0,1298,28,1055,215,22.04.2019 00:05,147,14,Poltava
1680,1677,8,615,1057,8,1065,0,1065,16,893,156,22.04.2019 00:03,147,14,Poltava
1840,1825,22,709,1112,19,1131,0,1131,24,954,153,22.04.2019 00:05,147,14,Poltava
1424,1418,11,557,859,8,867,0,867,21,724,122,21.04.2019 20:47,147,14,Poltava
1920,1877,11,722,1189,9,1198,0,1198,43,962,193,22.04.2019 00:06,147,14,Poltava
2016,1975,15,793,1208,15,1223,0,1223,35,994,194,22.04.2019 00:20,147,14,Poltava
352,333,27,139,186,27,213,0,213,3,181,29,21.04.2019 21:18,148,14,Poltava
304,288,41,115,150,39,189,0,189,1,143,45,22.04.2019 00:25,148,14,Poltava
135,133,16,43,77,15,92,0,92,4,73,15,22.04.2019 01:00,148,14,Poltava
432,425,36,142,257,33,290,0,290,6,238,46,21.04.2019 20:45,148,14,Poltava
208,195,25,55,131,22,153,0,153,2,126,25,22.04.2019 00:07,148,14,Poltava
544,538,41,185,318,41,359,0,359,4,305,50,21.04.2019 22:15,148,14,Poltava
960,932,77,354,533,73,606,0,606,8,514,84,22.04.2019 00:10,148,14,Poltava
1136,1122,16,439,681,16,697,0,697,17,589,91,22.04.2019 00:25,148,14,Poltava
880,861,44,297,539,44,583,0,583,15,480,88,22.04.2019 00:25,148,14,Poltava
592,575,38,210,348,34,382,0,382,9,297,76,22.04.2019 00:25,148,14,Poltava
432,418,37,169,227,36,263,0,263,4,204,55,21.04.2019 21:25,148,14,Poltava
704,686,36,296,372,36,408,0,408,13,308,87,22.04.2019 00:15,148,14,Poltava
432,415,25,176,232,24,256,0,256,8,197,51,22.04.2019 00:30,148,14,Poltava
320,319,19,107,196,17,213,0,213,4,180,29,22.04.2019 00:20,148,14,Poltava
608,590,36,241,333,34,367,0,367,9,298,60,22.04.2019 01:30,148,14,Poltava
608,586,43,197,371,40,411,0,411,17,314,80,22.04.2019 00:02,148,14,Poltava
384,366,34,76,281,27,308,0,308,5,263,40,22.04.2019 00:02,148,14,Poltava
368,353,17,132,219,17,236,0,236,6,189,41,22.04.2019 00:45,148,14,Poltava
1904,1872,31,740,1137,27,1164,0,1164,31,951,182,22.04.2019 00:42,148,14,Poltava
1168,1159,16,475,680,13,693,0,693,26,522,145,22.04.2019 00:05,148,14,Poltava
800,779,108,281,424,95,519,0,519,9,402,108,21.04.2019 21:50,148,14,Poltava
448,439,11,183,255,10,265,0,265,4,219,42,22.04.2019 00:10,148,14,Poltava
976,963,55,384,539,53,592,0,592,8,448,136,22.04.2019 00:30,148,14,Poltava
240,221,18,107,119,14,133,0,133,2,98,33,22.04.2019 00:25,148,14,Poltava
240,229,10,87,145,8,153,0,153,3,137,13,22.04.2019 00:01,148,14,Poltava
256,234,5,98,153,5,158,0,158,5,122,31,21.04.2019 20:40,148,14,Poltava
448,431,31,190,231,27,258,0,258,5,197,56,22.04.2019 01:10,148,14,Poltava
192,178,3,79,111,2,113,0,113,0,84,29,21.04.2019 23:15,148,14,Poltava
128,25,7,106,15,7,22,0,22,0,18,4,21.04.2019 21:20,148,14,Poltava
1248,1217,16,479,755,14,769,0,769,14,639,116,22.04.2019 00:15,148,14,Poltava
1600,1567,169,559,891,150,1041,0,1041,33,841,167,22.04.2019 00:45,148,14,Poltava
96,79,4,22,70,4,74,0,74,1,60,13,22.04.2019 00:10,148,14,Poltava
128,127,10,27,92,9,101,0,101,0,81,20,22.04.2019 00:05,148,14,Poltava
704,682,60,267,380,57,437,0,437,4,371,62,21.04.2019 21:10,148,14,Poltava
432,430,48,155,235,42,277,0,277,4,232,41,21.04.2019 22:50,148,14,Poltava
160,158,12,38,110,12,122,0,122,1,106,15,22.04.2019 01:20,148,14,Poltava
368,355,18,115,239,14,253,0,253,4,210,39,22.04.2019 00:05,148,14,Poltava
80,74,7,15,58,7,65,0,65,1,45,19,22.04.2019 00:05,148,14,Poltava
208,193,11,52,145,11,156,0,156,0,123,33,22.04.2019 00:20,148,14,Poltava
496,481,64,169,271,56,327,0,327,3,252,72,21.04.2019 22:45,148,14,Poltava
160,157,5,73,82,5,87,0,87,0,69,18,22.04.2019 00:40,148,14,Poltava
960,947,42,406,512,42,554,0,554,9,472,73,22.04.2019 00:35,148,14,Poltava
1968,1931,12,647,1313,8,1321,0,1321,44,1048,228,22.04.2019 00:05,148,14,Poltava
1984,1978,23,657,1308,19,1327,0,1327,51,1067,209,22.04.2019 00:07,148,14,Poltava
1808,1801,33,661,1122,25,1147,0,1147,28,919,200,22.04.2019 01:20,148,14,Poltava
1904,1901,21,741,1143,20,1163,0,1163,36,925,202,22.04.2019 00:20,148,14,Poltava
1904,1873,15,701,1190,13,1203,0,1203,32,946,225,22.04.2019 00:30,148,14,Poltava
1808,1784,13,700,1099,9,1108,0,1108,37,872,199,22.04.2019 00:30,148,14,Poltava
2000,1962,28,750,1226,24,1250,0,1250,36,993,221,22.04.2019 00:40,148,14,Poltava
2112,2070,23,760,1333,19,1352,0,1352,32,1101,219,22.04.2019 00:12,148,14,Poltava
1872,1863,12,682,1180,10,1190,0,1190,37,949,204,22.04.2019 00:30,148,14,Poltava
1808,1789,12,720,1077,11,1088,0,1088,18,909,161,22.04.2019 01:30,148,14,Poltava
1984,1958,15,785,1187,12,1199,0,1199,28,1001,170,22.04.2019 00:45,148,14,Poltava
1968,1946,13,735,1222,11,1233,0,1233,29,1017,187,22.04.2019 00:50,148,14,Poltava
1968,1967,25,774,1172,22,1194,0,1194,27,964,203,22.04.2019 00:50,148,14,Poltava
2096,2083,20,813,1265,18,1283,0,1283,29,1063,191,22.04.2019 00:15,149,14,Poltava
1824,1790,28,726,1073,25,1098,0,1098,20,929,149,22.04.2019 00:38,149,14,Poltava
2048,2022,18,863,1169,16,1185,0,1185,29,992,164,22.04.2019 00:10,149,14,Poltava
1936,1900,13,908,1018,10,1028,0,1028,28,863,137,22.04.2019 00:10,149,14,Poltava
2400,2365,17,1063,1321,16,1337,0,1337,30,1163,144,22.04.2019 00:15,149,14,Poltava
1584,1558,11,765,809,10,819,0,819,11,722,86,22.04.2019 00:30,149,14,Poltava
1968,1938,13,833,1122,13,1135,0,1135,24,996,115,21.04.2019 21:30,149,14,Poltava
944,921,82,371,497,76,573,0,573,7,501,65,22.04.2019 00:20,149,14,Poltava
928,922,32,461,439,28,467,0,467,11,405,51,21.04.2019 21:55,149,14,Poltava
1136,1126,46,482,608,46,654,0,654,5,593,56,21.04.2019 22:10,149,14,Poltava
608,592,45,210,357,41,398,0,398,2,332,64,22.04.2019 00:35,149,14,Poltava
368,355,15,126,227,15,242,0,242,1,182,59,22.04.2019 00:30,149,14,Poltava
592,577,30,218,345,29,374,0,374,5,333,36,22.04.2019 00:30,149,14,Poltava
1472,1455,51,624,806,42,848,0,848,11,738,99,22.04.2019 00:50,149,14,Poltava
864,849,31,346,491,27,518,0,518,7,457,54,22.04.2019 00:15,149,14,Poltava
864,843,68,349,455,60,515,0,515,10,451,54,22.04.2019 00:04,149,14,Poltava
1056,1024,33,496,528,32,560,0,560,10,483,67,22.04.2019 00:28,149,14,Poltava
688,658,53,271,366,51,417,0,417,6,365,46,22.04.2019 00:10,149,14,Poltava
912,889,49,405,460,47,507,0,507,3,460,44,22.04.2019 00:05,149,14,Poltava
400,381,10,133,257,10,267,0,267,5,222,40,22.04.2019 02:10,149,14,Poltava
1152,1122,61,495,600,57,657,0,657,7,617,33,22.04.2019 00:15,149,14,Poltava
448,426,1,242,205,1,206,0,206,5,187,14,22.04.2019 01:10,149,14,Poltava
784,777,53,330,411,43,454,0,454,5,402,47,22.04.2019 00:05,149,14,Poltava
736,727,75,276,385,75,460,0,460,4,391,65,21.04.2019 20:42,149,14,Poltava
224,218,28,73,123,28,151,0,151,3,131,17,21.04.2019 20:40,149,14,Poltava
208,195,19,90,101,17,118,0,118,2,97,19,22.04.2019 00:05,149,14,Poltava
352,341,32,150,172,30,202,0,202,0,179,23,21.04.2019 21:05,149,14,Poltava
512,497,43,200,270,42,312,0,312,1,270,41,21.04.2019 20:40,149,14,Poltava
304,302,20,96,191,17,208,0,208,5,178,25,22.04.2019 00:05,149,14,Poltava
448,441,57,128,266,54,320,0,320,12,274,34,21.04.2019 20:40,149,14,Poltava
240,222,17,67,157,16,173,0,173,11,143,19,21.04.2019 20:52,149,14,Poltava
192,178,10,59,123,10,133,0,133,2,109,22,21.04.2019 20:30,149,14,Poltava
1456,1445,32,472,956,28,984,0,984,15,815,154,21.04.2019 21:50,149,14,Poltava
208,200,20,22,166,20,186,0,186,0,134,52,21.04.2019 20:45,149,14,Poltava
432,425,27,171,237,24,261,0,261,4,214,43,22.04.2019 00:05,149,14,Poltava
224,217,34,82,111,31,142,0,142,2,107,33,22.04.2019 00:45,149,14,Poltava
256,47,28,226,15,15,30,0,30,1,26,3,22.04.2019 00:10,149,14,Poltava
368,360,22,134,212,22,234,0,234,3,192,39,21.04.2019 22:04,149,14,Poltava
224,213,15,77,132,15,147,0,147,3,126,18,22.04.2019 00:25,149,14,Poltava
128,110,5,58,65,5,70,0,70,2,55,13,21.04.2019 21:00,149,14,Poltava
176,161,18,78,81,17,98,0,98,3,85,10,21.04.2019 23:15,149,14,Poltava
560,552,43,224,295,41,336,0,336,9,278,49,22.04.2019 01:10,149,14,Poltava
480,465,25,163,292,25,317,0,317,4,276,37,22.04.2019 00:50,149,14,Poltava
304,295,24,140,147,17,164,0,164,2,142,20,22.04.2019 00:35,149,14,Poltava
704,701,28,318,360,26,386,0,386,2,318,66,22.04.2019 00:05,149,14,Poltava
96,93,9,36,51,9,60,0,60,4,38,18,21.04.2019 21:00,149,14,Poltava
1392,1369,27,526,845,21,866,0,866,13,698,155,22.04.2019 00:25,149,14,Poltava
1680,1659,24,574,1083,23,1106,0,1106,28,881,197,22.04.2019 00:20,149,14,Poltava
288,281,4,112,172,4,176,0,176,3,148,25,21.04.2019 20:52,149,14,Poltava
400,382,17,172,211,17,228,0,228,4,166,58,22.04.2019 00:10,149,14,Poltava
128,123,2,57,69,2,71,0,71,0,52,19,22.04.2019 00:15,149,14,Poltava
656,649,21,214,421,21,442,0,442,8,373,61,22.04.2019 00:30,149,14,Poltava
448,435,34,178,236,34,270,0,270,3,208,59,22.04.2019 00:05,149,14,Poltava
224,212,11,97,116,11,127,0,127,0,104,23,22.04.2019 00:15,149,14,Poltava
448,429,24,178,246,24,270,0,270,5,236,29,21.04.2019 22:10,149,14,Poltava
1504,1480,67,514,928,62,990,0,990,14,891,85,22.04.2019 00:10,149,14,Poltava
192,188,18,69,107,16,123,0,123,3,103,17,21.04.2019 20:50,149,14,Poltava
1008,988,31,438,542,28,570,0,570,3,516,51,22.04.2019 00:10,149,14,Poltava
384,369,21,109,254,21,275,0,275,3,249,23,21.04.2019 23:05,149,14,Poltava
864,849,21,290,554,20,574,0,574,6,501,67,22.04.2019 00:15,149,14,Poltava
128,118,6,42,80,6,86,0,86,0,75,11,22.04.2019 00:12,149,14,Poltava
144,132,11,45,88,11,99,0,99,2,78,19,22.04.2019 00:30,149,14,Poltava
144,139,11,33,100,11,111,0,111,0,90,21,22.04.2019 00:04,149,14,Poltava
400,385,30,144,227,29,256,0,256,2,228,26,22.04.2019 00:15,149,14,Poltava
208,194,25,94,93,21,114,0,114,2,102,10,22.04.2019 00:15,149,14,Poltava
352,340,39,100,213,39,252,0,252,2,222,28,22.04.2019 00:25,149,14,Poltava
496,488,37,245,218,33,251,0,251,10,189,52,22.04.2019 00:05,149,14,Poltava
1728,1709,50,657,1025,46,1071,0,1071,22,919,130,22.04.2019 00:18,149,14,Poltava
800,795,18,288,495,17,512,0,512,6,451,55,22.04.2019 00:03,149,14,Poltava
208,199,5,83,120,5,125,0,125,1,112,12,22.04.2019 00:10,149,14,Poltava
224,210,11,103,110,11,121,0,121,3,94,24,22.04.2019 00:30,149,14,Poltava
240,224,19,102,123,15,138,0,138,0,117,21,22.04.2019 00:05,149,14,Poltava
144,121,0,27,117,0,117,0,117,5,107,5,22.04.2019 00:05,149,14,Poltava
800,798,26,286,491,23,514,0,514,7,420,87,22.04.2019 00:19,149,14,Poltava
144,129,15,58,74,12,86,0,86,0,82,4,22.04.2019 01:20,149,14,Poltava
288,284,48,105,145,38,183,0,183,2,138,43,22.04.2019 00:50,149,14,Poltava
352,333,23,146,185,21,206,0,206,3,190,13,21.04.2019 23:50,149,14,Poltava
176,171,19,44,115,17,132,0,132,1,117,14,22.04.2019 00:02,149,14,Poltava
848,832,86,214,554,80,634,0,634,11,562,61,22.04.2019 01:15,149,14,Poltava
96,87,8,28,60,8,68,0,68,2,60,6,22.04.2019 00:05,149,14,Poltava
48,39,3,14,32,2,34,0,34,4,28,2,22.04.2019 00:05,149,14,Poltava
384,376,34,149,205,30,235,0,235,3,186,46,22.04.2019 00:03,149,14,Poltava
560,552,86,198,283,79,362,0,362,8,310,44,22.04.2019 00:51,149,14,Poltava
576,560,39,214,331,31,362,0,362,1,322,39,22.04.2019 00:30,149,14,Poltava
96,94,7,24,66,6,72,0,72,3,67,2,22.04.2019 00:23,149,14,Poltava
128,121,22,23,85,20,105,0,105,0,102,3,22.04.2019 00:15,149,14,Poltava
224,214,14,74,137,13,150,0,150,1,131,18,22.04.2019 00:05,149,14,Poltava
128,112,16,51,62,15,77,0,77,0,68,9,22.04.2019 00:45,149,14,Poltava
368,370,51,132,190,46,236,0,236,3,199,34,22.04.2019 01:15,149,14,Poltava
576,560,32,208,340,28,368,0,368,5,320,43,22.04.2019 00:07,149,14,Poltava
432,427,38,151,246,35,281,0,281,7,222,52,21.04.2019 21:00,149,14,Poltava
384,370,25,159,201,24,225,0,225,2,198,25,22.04.2019 00:15,149,14,Poltava
496,485,46,177,276,43,319,0,319,3,259,57,21.04.2019 22:00,149,14,Poltava
432,415,31,173,233,26,259,0,259,8,207,44,22.04.2019 00:02,149,14,Poltava
192,181,15,89,90,13,103,0,103,2,81,20,22.04.2019 00:30,149,14,Poltava
352,352,25,116,211,25,236,0,236,5,195,36,22.04.2019 00:35,149,14,Poltava
192,189,16,71,106,15,121,0,121,3,101,17,21.04.2019 23:30,149,14,Poltava
544,540,60,165,323,56,379,0,379,2,333,44,22.04.2019 00:10,149,14,Poltava
352,342,37,123,194,35,229,0,229,10,193,26,22.04.2019 00:18,149,14,Poltava
448,434,57,162,232,54,286,0,286,4,245,37,22.04.2019 01:00,149,14,Poltava
880,861,48,324,516,40,556,0,556,12,491,53,22.04.2019 00:05,149,14,Poltava
1536,1521,65,576,903,57,960,0,960,15,831,114,22.04.2019 00:10,149,14,Poltava
304,285,21,110,173,21,194,0,194,0,161,33,22.04.2019 00:10,149,14,Poltava
336,320,35,152,150,34,184,0,184,1,161,22,22.04.2019 00:05,149,14,Poltava
752,735,72,265,423,64,487,0,487,10,397,80,21.04.2019 21:30,149,14,Poltava
176,167,5,76,96,4,100,0,100,4,86,10,21.04.2019 20:30,149,14,Poltava
448,436,60,134,256,58,314,0,314,4,267,43,22.04.2019 00:20,149,14,Poltava
496,487,57,175,267,54,321,0,321,1,271,49,22.04.2019 00:01,149,14,Poltava
384,364,26,104,257,23,280,0,280,4,250,26,22.04.2019 00:15,149,14,Poltava
288,280,37,83,169,36,205,0,205,3,178,24,22.04.2019 00:15,149,14,Poltava
512,497,49,189,282,41,323,0,323,2,278,43,22.04.2019 00:15,149,14,Poltava
336,322,38,111,193,32,225,0,225,4,194,27,22.04.2019 00:10,149,14,Poltava
304,301,38,99,169,36,205,0,205,2,168,35,22.04.2019 00:05,149,14,Poltava
336,321,41,82,215,39,254,0,254,5,221,28,21.04.2019 23:45,149,14,Poltava
192,176,25,68,102,22,124,0,124,3,110,11,22.04.2019 00:05,149,14,Poltava
624,614,65,234,329,61,390,0,390,4,334,52,22.04.2019 00:05,149,14,Poltava
640,627,56,233,355,52,407,0,407,5,363,39,22.04.2019 00:05,149,14,Poltava
624,612,41,235,348,41,389,0,389,9,343,37,22.04.2019 00:30,149,14,Poltava
96,96,5,43,48,5,53,0,53,0,46,7,21.04.2019 20:50,149,14,Poltava
480,470,26,228,226,26,252,0,252,2,200,50,21.04.2019 20:58,150,14,Poltava
1728,1711,36,852,845,31,876,0,876,18,731,127,21.04.2019 21:15,150,14,Poltava
2144,2115,60,1011,1083,50,1133,0,1133,23,946,164,21.04.2019 22:00,150,14,Poltava
2304,2280,49,929,1330,45,1375,0,1375,33,1117,225,21.04.2019 20:40,150,14,Poltava
592,586,24,219,349,24,373,0,373,8,289,76,21.04.2019 21:40,150,14,Poltava
528,506,43,210,275,43,318,0,318,6,248,64,21.04.2019 21:50,150,14,Poltava
368,362,32,136,205,27,232,0,232,11,177,44,21.04.2019 20:39,150,14,Poltava
1120,1098,72,424,625,71,696,0,696,18,531,147,21.04.2019 20:50,150,14,Poltava
224,217,21,61,142,21,163,0,163,0,128,35,21.04.2019 22:00,150,14,Poltava
224,203,17,109,101,14,115,0,115,3,78,34,21.04.2019 21:00,150,14,Poltava
576,566,62,209,305,62,367,0,367,6,305,56,21.04.2019 21:00,150,14,Poltava
688,672,53,278,358,52,410,0,410,6,321,83,21.04.2019 22:10,150,14,Poltava
416,393,47,106,263,47,310,0,310,2,285,23,21.04.2019 20:45,150,14,Poltava
368,367,24,112,232,24,256,0,256,2,208,46,21.04.2019 22:40,150,14,Poltava
160,143,13,59,89,12,101,0,101,2,80,19,21.04.2019 20:31,150,14,Poltava
352,354,22,111,220,21,241,0,241,4,157,80,21.04.2019 20:33,150,14,Poltava
256,236,33,80,147,29,176,0,176,5,144,27,21.04.2019 21:00,150,14,Poltava
288,276,4,133,151,4,155,0,155,4,134,17,21.04.2019 20:34,150,14,Poltava
176,164,15,61,100,15,115,0,115,0,99,16,21.04.2019 20:30,150,14,Poltava
432,415,31,193,211,28,239,0,239,3,201,35,21.04.2019 20:35,150,14,Poltava
112,102,9,49,56,7,63,0,63,1,55,7,21.04.2019 20:30,150,14,Poltava
736,718,42,283,421,32,453,0,453,15,375,63,21.04.2019 20:46,150,14,Poltava
192,174,14,68,112,12,124,0,124,1,114,9,21.04.2019 21:10,150,14,Poltava
112,108,9,39,64,9,73,0,73,0,59,14,21.04.2019 20:20,150,14,Poltava
624,615,28,283,315,26,341,0,341,8,279,54,22.04.2019 00:30,150,14,Poltava
304,290,10,89,206,9,215,0,215,2,188,25,22.04.2019 02:25,150,14,Poltava
528,518,40,203,288,37,325,0,325,7,283,35,22.04.2019 01:36,150,14,Poltava
528,514,17,215,296,17,313,0,313,6,258,49,21.04.2019 21:10,150,14,Poltava
112,105,11,36,65,11,76,0,76,0,71,5,22.04.2019 00:10,150,14,Poltava
576,565,50,155,373,48,421,0,421,7,362,52,21.04.2019 21:15,150,14,Poltava
256,30,12,227,17,12,29,0,29,1,21,7,21.04.2019 21:00,150,14,Poltava
1920,1899,21,810,1090,20,1110,0,1110,24,944,142,21.04.2019 22:15,150,14,Poltava
208,194,6,115,87,6,93,0,93,2,74,17,21.04.2019 21:10,150,14,Poltava
800,793,32,300,468,32,500,0,500,14,439,47,21.04.2019 21:40,150,14,Poltava
1552,1530,40,631,883,38,921,0,921,17,761,143,21.04.2019 22:00,150,14,Poltava
608,589,47,306,261,41,302,0,302,5,237,60,21.04.2019 21:25,150,14,Poltava
784,769,40,314,430,40,470,0,470,9,369,92,21.04.2019 20:54,150,14,Poltava
384,366,19,161,205,18,223,0,223,4,186,33,21.04.2019 20:49,150,14,Poltava
256,240,30,100,132,24,156,0,156,0,134,22,21.04.2019 21:00,150,14,Poltava
512,504,24,222,270,20,290,0,290,7,237,46,21.04.2019 20:50,150,14,Poltava
1680,1650,10,745,927,8,935,0,935,26,788,121,21.04.2019 21:40,150,14,Poltava
1712,1687,17,763,934,15,949,0,949,15,825,109,21.04.2019 22:30,150,14,Poltava
1008,990,6,484,518,6,524,0,524,6,423,95,21.04.2019 21:40,150,14,Poltava
304,294,2,142,160,2,162,0,162,4,124,34,21.04.2019 20:37,150,14,Poltava
336,318,30,116,192,28,220,0,220,6,184,30,21.04.2019 21:00,150,14,Poltava
480,465,38,156,289,35,324,0,324,2,272,50,22.04.2019 00:20,150,14,Poltava
672,651,28,295,349,28,377,0,377,9,325,43,21.04.2019 20:49,150,14,Poltava
160,149,19,54,87,19,106,0,106,2,82,22,21.04.2019 22:10,150,14,Poltava
1584,1559,47,702,835,47,882,0,882,21,717,144,21.04.2019 21:25,150,14,Poltava
1376,1351,43,565,771,40,811,0,811,15,640,156,22.04.2019 01:40,150,14,Poltava
144,145,10,33,101,10,111,0,111,0,85,26,21.04.2019 22:35,150,14,Poltava
1424,1405,65,503,857,64,921,0,921,28,707,186,21.04.2019 21:48,150,14,Poltava
256,253,17,119,122,15,137,0,137,1,101,35,21.04.2019 21:00,150,14,Poltava
2240,2213,48,819,1379,42,1421,0,1421,33,1097,291,21.04.2019 21:20,150,14,Poltava
1856,1828,29,678,1153,25,1178,0,1178,35,926,217,21.04.2019 21:21,150,14,Poltava
1536,1523,15,634,889,13,902,0,902,19,723,160,21.04.2019 21:35,150,14,Poltava
1408,1391,35,549,824,35,859,0,859,22,698,139,21.04.2019 21:06,150,14,Poltava
1056,1021,37,464,556,36,592,0,592,8,500,84,21.04.2019 21:15,150,14,Poltava
352,342,9,137,206,9,215,0,215,3,178,34,21.04.2019 21:20,150,14,Poltava
752,744,54,264,441,47,488,0,488,10,392,86,21.04.2019 22:30,150,14,Poltava
144,136,6,63,75,6,81,0,81,0,69,12,21.04.2019 20:33,150,14,Poltava
1184,1171,63,460,661,63,724,0,724,16,616,92,21.04.2019 21:10,150,14,Poltava
368,350,17,106,245,17,262,0,262,5,231,26,21.04.2019 20:49,150,14,Poltava
1952,1912,34,819,1102,31,1133,0,1133,24,910,199,21.04.2019 21:01,150,14,Poltava
928,909,58,296,580,52,632,0,632,9,549,74,21.04.2019 20:55,150,14,Poltava
704,689,35,236,438,30,468,0,468,10,367,91,21.04.2019 21:20,150,14,Poltava
256,254,13,114,133,9,142,0,142,1,115,26,21.04.2019 21:20,150,14,Poltava
2496,2478,111,790,1617,89,1706,0,1706,30,1459,217,22.04.2019 00:05,150,14,Poltava
1792,1750,32,692,1073,27,1100,0,1100,33,949,118,22.04.2019 00:07,150,14,Poltava
1936,1937,46,626,1278,32,1310,0,1310,32,1115,163,21.04.2019 22:40,150,14,Poltava
2064,2028,54,621,1398,45,1443,0,1443,25,1245,173,21.04.2019 21:59,150,14,Poltava
1824,1791,49,523,1272,29,1301,0,1301,25,1074,202,22.04.2019 00:02,150,14,Poltava
1904,1901,54,569,1295,40,1335,0,1335,22,1151,162,22.04.2019 00:01,150,14,Poltava
2160,2146,31,658,1482,20,1502,0,1502,35,1255,212,22.04.2019 00:11,150,14,Poltava
2192,2171,24,641,1536,15,1551,0,1551,21,1332,198,22.04.2019 00:05,150,14,Poltava
2048,2056,24,620,1413,15,1428,0,1428,21,1220,187,22.04.2019 00:20,150,14,Poltava
2032,2007,66,605,1374,53,1427,0,1427,38,1207,182,22.04.2019 00:30,150,14,Poltava
2080,2054,54,617,1420,43,1463,0,1463,21,1257,185,22.04.2019 00:15,150,14,Poltava
1824,1800,45,588,1205,31,1236,0,1236,19,1059,158,21.04.2019 23:50,150,14,Poltava
1904,1899,44,585,1284,35,1319,0,1319,29,1148,142,21.04.2019 22:05,150,14,Poltava
1968,1963,15,728,1227,13,1240,0,1240,24,1074,142,21.04.2019 21:10,150,14,Poltava
1984,1979,40,573,1384,27,1411,0,1411,30,1203,178,22.04.2019 00:10,150,14,Poltava
2112,2122,46,607,1465,40,1505,0,1505,31,1283,191,21.04.2019 22:00,150,14,Poltava
2144,2108,113,913,1130,101,1231,0,1231,27,1029,175,21.04.2019 21:40,150,14,Poltava
2128,2100,13,752,1366,10,1376,0,1376,28,1090,258,22.04.2019 02:10,150,14,Poltava
1840,1813,10,619,1213,8,1221,0,1221,37,972,212,22.04.2019 00:30,150,14,Poltava
2224,2220,19,723,1489,12,1501,0,1501,40,1231,230,22.04.2019 00:30,150,14,Poltava
208,204,12,70,126,12,138,0,138,1,106,31,22.04.2019 01:30,151,14,Poltava
1408,1377,80,551,793,64,857,0,857,25,687,145,22.04.2019 00:40,151,14,Poltava
1872,1848,43,705,1129,38,1167,0,1167,21,931,215,22.04.2019 00:25,151,14,Poltava
2352,2268,57,889,1414,49,1463,0,1463,41,1165,257,22.04.2019 00:40,151,14,Poltava
1328,1298,11,512,807,9,816,0,816,19,640,157,22.04.2019 01:10,151,14,Poltava
336,325,21,110,207,19,226,0,226,3,192,31,22.04.2019 00:10,151,14,Poltava
1920,1903,53,748,1119,53,1172,0,1172,20,954,198,22.04.2019 00:03,151,14,Poltava
2080,2053,53,848,1188,44,1232,0,1232,32,991,209,22.04.2019 00:50,151,14,Poltava
544,527,20,199,330,15,345,0,345,10,283,52,22.04.2019 00:20,151,14,Poltava
512,504,32,204,278,30,308,0,308,4,237,67,22.04.2019 00:15,151,14,Poltava
160,143,1,71,89,0,89,0,89,2,60,27,22.04.2019 00:10,151,14,Poltava
256,241,28,108,126,22,148,0,148,3,115,30,22.04.2019 01:20,151,14,Poltava
304,297,24,127,156,21,177,0,177,4,112,61,21.04.2019 21:50,151,14,Poltava
704,686,66,323,322,59,381,0,381,8,273,100,22.04.2019 00:15,151,14,Poltava
208,199,27,75,109,24,133,0,133,0,110,23,22.04.2019 00:05,151,14,Poltava
240,230,40,82,122,36,158,0,158,2,133,23,22.04.2019 00:02,151,14,Poltava
96,95,8,36,52,8,60,0,60,3,38,19,22.04.2019 00:30,151,14,Poltava
816,803,57,354,410,52,462,0,462,5,408,49,22.04.2019 00:30,151,14,Poltava
256,240,27,111,124,21,145,0,145,1,116,28,22.04.2019 01:20,151,14,Poltava
704,680,42,256,409,39,448,0,448,7,377,64,22.04.2019 00:15,151,14,Poltava
464,451,24,182,261,21,282,0,282,3,225,54,22.04.2019 00:16,151,14,Poltava
128,119,11,55,63,10,73,0,73,2,60,11,22.04.2019 00:05,151,14,Poltava
464,444,47,187,240,37,277,0,277,7,227,43,22.04.2019 00:30,151,14,Poltava
224,220,39,65,124,35,159,0,159,0,139,20,22.04.2019 00:05,151,14,Poltava
144,133,12,65,70,9,79,0,79,2,59,18,22.04.2019 00:40,151,14,Poltava
352,347,25,153,176,23,199,0,199,3,160,36,22.04.2019 00:15,151,14,Poltava
528,529,22,222,287,19,306,0,306,3,238,65,22.04.2019 00:15,151,14,Poltava
368,368,22,137,209,22,231,0,231,6,179,46,22.04.2019 00:15,151,14,Poltava
288,282,17,100,174,14,188,0,188,3,143,42,22.04.2019 00:15,151,14,Poltava
368,358,38,131,201,36,237,0,237,5,205,27,22.04.2019 00:15,151,14,Poltava
64,62,8,15,41,8,49,0,49,0,34,15,22.04.2019 00:05,151,14,Poltava
176,161,10,76,90,10,100,0,100,4,79,17,22.04.2019 00:05,151,14,Poltava
688,679,47,261,380,47,427,0,427,7,360,60,22.04.2019 00:05,151,14,Poltava
448,434,36,159,256,33,289,0,289,10,230,49,22.04.2019 00:10,151,14,Poltava
368,358,26,150,195,23,218,0,218,6,168,44,22.04.2019 00:22,151,14,Poltava
192,173,10,80,102,10,112,0,112,2,92,18,22.04.2019 00:15,151,14,Poltava
784,767,70,251,469,64,533,0,533,3,462,68,22.04.2019 00:07,151,14,Poltava
96,93,11,25,61,10,71,0,71,0,62,9,22.04.2019 00:05,151,14,Poltava
224,207,16,82,127,15,142,0,142,4,110,28,22.04.2019 00:30,151,14,Poltava
144,132,12,62,72,10,82,0,82,1,69,12,22.04.2019 00:10,151,14,Poltava
848,839,38,268,542,38,580,0,580,9,460,111,22.04.2019 00:30,151,14,Poltava
288,290,32,98,162,28,190,0,190,0,142,48,22.04.2019 00:01,151,14,Poltava
272,257,25,108,141,23,164,0,164,1,125,38,22.04.2019 00:55,151,14,Poltava
736,718,64,283,394,59,453,0,453,12,362,79,22.04.2019 00:30,151,14,Poltava
176,171,26,65,90,21,111,0,111,2,94,15,22.04.2019 00:05,151,14,Poltava
272,256,34,96,142,34,176,0,176,2,148,26,22.04.2019 00:05,151,14,Poltava
256,245,27,105,124,27,151,0,151,2,123,26,22.04.2019 00:05,151,14,Poltava
448,439,53,164,231,53,284,0,284,9,211,64,22.04.2019 00:05,151,14,Poltava
320,300,28,128,171,21,192,0,192,1,159,32,22.04.2019 00:30,151,14,Poltava
176,163,23,73,84,19,103,0,103,1,79,23,22.04.2019 00:40,151,14,Poltava
368,331,1,37,330,1,331,0,331,33,266,32,21.04.2019 20:20,152,15,Rovno
1712,1690,11,581,1122,9,1131,0,1131,31,699,401,21.04.2019 22:10,152,15,Rovno
1600,1592,12,538,1052,10,1062,0,1062,30,594,438,21.04.2019 22:15,152,15,Rovno
1888,1889,8,611,1271,6,1277,0,1277,38,768,471,21.04.2019 22:20,152,15,Rovno
1264,1241,3,549,712,3,715,0,715,21,437,257,21.04.2019 21:45,152,15,Rovno
1968,1940,12,766,1190,12,1202,0,1202,42,750,410,21.04.2019 21:20,152,15,Rovno
2064,2034,14,736,1321,7,1328,0,1328,34,809,485,21.04.2019 22:02,152,15,Rovno
1056,1036,6,350,702,4,706,0,706,38,410,258,21.04.2019 20:30,152,15,Rovno
1808,1806,19,581,1213,14,1227,0,1227,44,727,456,22.04.2019 00:10,152,15,Rovno
1664,1695,17,502,1149,13,1162,0,1162,35,666,461,21.04.2019 23:50,152,15,Rovno
704,695,7,234,463,7,470,0,470,13,292,165,21.04.2019 22:32,152,15,Rovno
1488,1478,11,545,933,10,943,0,943,28,512,403,21.04.2019 22:58,152,15,Rovno
1328,1331,5,387,936,5,941,0,941,34,532,375,21.04.2019 22:02,152,15,Rovno
672,651,6,240,426,6,432,0,432,17,259,156,21.04.2019 20:45,152,15,Rovno
1152,1132,6,418,729,5,734,0,734,16,438,280,21.04.2019 22:00,152,15,Rovno
1728,1699,16,521,1194,13,1207,0,1207,48,646,513,21.04.2019 22:10,152,15,Rovno
1088,1071,3,427,659,2,661,0,661,9,364,288,21.04.2019 21:15,152,15,Rovno
2352,2330,13,897,1443,12,1455,0,1455,53,792,610,21.04.2019 22:30,152,15,Rovno
1904,1886,1,1092,811,1,812,0,812,21,547,244,21.04.2019 21:40,152,15,Rovno
2064,2022,6,1015,1045,4,1049,0,1049,25,598,426,21.04.2019 21:40,152,15,Rovno
2000,1964,15,702,1285,13,1298,0,1298,41,767,490,21.04.2019 22:05,152,15,Rovno
832,832,7,332,494,6,500,0,500,16,312,172,21.04.2019 21:40,152,15,Rovno
1952,1915,15,650,1289,13,1302,0,1302,41,770,491,21.04.2019 22:00,152,15,Rovno
2336,2286,2,1231,1104,1,1105,0,1105,38,675,392,21.04.2019 21:05,152,15,Rovno
1952,1943,5,650,1297,5,1302,0,1302,31,755,516,21.04.2019 21:45,152,15,Rovno
1648,1621,6,728,914,6,920,0,920,25,570,325,21.04.2019 22:24,152,15,Rovno
1840,1815,5,695,1140,5,1145,0,1145,17,662,466,21.04.2019 21:25,152,15,Rovno
1968,1946,13,777,1182,9,1191,0,1191,34,696,461,21.04.2019 21:54,152,15,Rovno
992,976,5,321,666,5,671,0,671,20,409,242,21.04.2019 21:42,152,15,Rovno
2160,2147,8,741,1412,7,1419,0,1419,39,881,499,22.04.2019 00:05,152,15,Rovno
1824,1835,5,585,1235,4,1239,0,1239,34,698,507,21.04.2019 21:30,152,15,Rovno
2272,2230,7,801,1466,5,1471,0,1471,48,766,657,21.04.2019 21:30,152,15,Rovno
1552,1512,6,559,987,6,993,0,993,27,541,425,21.04.2019 21:35,152,15,Rovno
2112,2084,9,641,1462,9,1471,0,1471,36,832,603,21.04.2019 22:45,152,15,Rovno
2224,2195,13,798,1416,10,1426,0,1426,47,799,580,21.04.2019 23:00,152,15,Rovno
1376,1361,0,526,850,0,850,0,850,38,508,304,21.04.2019 20:50,152,15,Rovno
1888,1871,15,724,1151,13,1164,0,1164,41,687,436,22.04.2019 00:05,152,15,Rovno
1024,1003,8,367,650,7,657,0,657,11,378,268,21.04.2019 22:00,152,15,Rovno
128,19,3,110,15,3,18,0,18,0,9,9,21.04.2019 21:15,152,15,Rovno
256,74,29,190,39,27,66,0,66,4,38,24,21.04.2019 22:32,152,15,Rovno
144,56,5,89,50,5,55,0,55,3,34,18,21.04.2019 20:28,152,15,Rovno
208,18,0,191,17,0,17,0,17,1,12,4,21.04.2019 20:44,152,15,Rovno
768,164,120,619,41,108,149,0,149,6,82,61,21.04.2019 21:32,152,15,Rovno
384,41,0,344,40,0,40,0,40,1,27,12,21.04.2019 21:10,152,15,Rovno
704,167,93,539,73,92,165,0,165,9,103,53,21.04.2019 20:22,152,15,Rovno
1184,1169,5,481,700,3,703,0,703,16,439,248,21.04.2019 21:30,152,15,Rovno
1632,1597,8,546,1079,7,1086,0,1086,22,658,406,21.04.2019 22:00,152,15,Rovno
1088,1066,11,376,704,8,712,0,712,24,376,312,21.04.2019 21:26,152,15,Rovno
1568,1562,6,498,1065,5,1070,0,1070,35,540,495,21.04.2019 22:20,152,15,Rovno
2096,2075,34,811,1255,30,1285,0,1285,25,702,558,22.04.2019 00:15,153,15,Rovno
1824,1785,28,750,1046,28,1074,0,1074,33,607,434,21.04.2019 22:13,153,15,Rovno
224,210,16,100,110,14,124,0,124,0,89,35,21.04.2019 23:05,153,15,Rovno
752,739,27,378,354,20,374,0,374,8,234,132,21.04.2019 21:55,153,15,Rovno
304,298,28,97,180,27,207,0,207,3,97,107,21.04.2019 20:40,153,15,Rovno
336,320,21,162,157,17,174,0,174,2,123,49,21.04.2019 20:35,153,15,Rovno
528,522,35,215,280,33,313,0,313,5,118,190,21.04.2019 21:35,153,15,Rovno
512,503,30,167,319,26,345,0,345,11,174,160,21.04.2019 20:45,153,15,Rovno
1456,1447,38,654,774,28,802,0,802,15,542,245,21.04.2019 21:50,153,15,Rovno
496,485,29,198,275,23,298,0,298,5,171,122,21.04.2019 21:40,153,15,Rovno
400,386,20,109,272,19,291,0,291,10,118,163,22.04.2019 00:02,153,15,Rovno
400,382,35,124,243,33,276,0,276,12,141,123,21.04.2019 21:30,153,15,Rovno
128,121,15,38,76,14,90,0,90,7,36,47,21.04.2019 20:55,153,15,Rovno
368,373,14,136,219,13,232,0,232,6,112,114,21.04.2019 21:05,153,15,Rovno
304,293,14,79,211,14,225,0,225,4,139,82,21.04.2019 21:45,153,15,Rovno
240,236,21,71,148,21,169,0,169,3,83,83,21.04.2019 22:00,153,15,Rovno
160,161,17,35,110,15,125,0,125,0,66,59,21.04.2019 21:45,153,15,Rovno
176,166,20,53,104,19,123,0,123,4,65,54,21.04.2019 21:00,153,15,Rovno
480,469,13,142,327,11,338,0,338,12,191,135,21.04.2019 22:00,153,15,Rovno
256,242,10,106,140,10,150,0,150,6,76,68,21.04.2019 20:42,153,15,Rovno
384,368,11,151,222,11,233,0,233,1,132,100,22.04.2019 00:05,153,15,Rovno
432,424,22,159,259,14,273,0,273,5,172,96,21.04.2019 21:10,153,15,Rovno
160,154,16,48,96,16,112,0,112,2,73,37,21.04.2019 21:40,153,15,Rovno
368,357,30,142,198,28,226,0,226,1,154,71,21.04.2019 21:45,153,15,Rovno
240,236,23,85,135,20,155,0,155,3,56,96,21.04.2019 21:30,153,15,Rovno
304,291,28,139,141,24,165,0,165,1,79,85,21.04.2019 21:00,153,15,Rovno
400,385,39,165,200,35,235,0,235,6,105,124,21.04.2019 21:10,153,15,Rovno
448,433,18,185,247,16,263,0,263,4,86,173,21.04.2019 22:00,153,15,Rovno
128,116,19,42,71,15,86,0,86,4,49,33,21.04.2019 20:55,153,15,Rovno
128,119,24,41,64,23,87,0,87,0,50,37,22.04.2019 00:05,153,15,Rovno
256,255,33,75,149,32,181,0,181,3,71,107,22.04.2019 00:25,153,15,Rovno
224,216,20,82,122,20,142,0,142,0,75,67,21.04.2019 20:34,153,15,Rovno
336,323,9,149,181,6,187,0,187,3,108,76,21.04.2019 21:40,153,15,Rovno
224,209,17,95,114,15,129,0,129,0,68,61,21.04.2019 20:45,153,15,Rovno
464,451,38,192,235,37,272,0,272,9,143,120,21.04.2019 21:30,153,15,Rovno
144,129,13,62,69,13,82,0,82,1,47,34,21.04.2019 20:50,153,15,Rovno
528,515,32,198,301,29,330,0,330,11,188,131,21.04.2019 21:30,153,15,Rovno
288,273,17,103,174,11,185,0,185,0,98,87,21.04.2019 20:40,153,15,Rovno
928,918,72,325,543,60,603,0,603,13,363,227,21.04.2019 21:15,153,15,Rovno
624,609,17,284,325,15,340,0,340,13,177,150,21.04.2019 21:45,153,15,Rovno
288,275,21,107,162,19,181,0,181,3,85,93,21.04.2019 22:15,153,15,Rovno
192,196,16,54,123,15,138,0,138,1,73,64,21.04.2019 21:00,153,15,Rovno
304,299,19,126,161,17,178,0,178,2,137,39,21.04.2019 20:45,153,15,Rovno
448,429,22,154,273,21,294,0,294,5,185,104,21.04.2019 21:37,153,15,Rovno
112,110,10,25,77,10,87,0,87,1,50,36,21.04.2019 22:40,153,15,Rovno
368,353,21,141,207,20,227,0,227,10,138,79,21.04.2019 20:50,153,15,Rovno
320,304,33,137,154,29,183,0,183,4,111,68,21.04.2019 22:01,153,15,Rovno
176,172,18,50,109,17,126,0,126,2,84,40,21.04.2019 22:47,153,15,Rovno
384,380,38,180,172,32,204,0,204,2,108,94,21.04.2019 22:05,153,15,Rovno
496,487,31,199,270,27,297,0,297,8,188,101,21.04.2019 21:31,153,15,Rovno
640,626,16,275,351,14,365,0,365,9,253,103,21.04.2019 21:50,153,15,Rovno
336,320,20,143,173,20,193,0,193,2,88,103,21.04.2019 20:45,153,15,Rovno
944,924,38,462,448,34,482,0,482,4,369,109,22.04.2019 00:50,153,15,Rovno
656,643,73,292,303,61,364,0,364,2,211,151,21.04.2019 20:55,153,15,Rovno
128,123,24,43,61,24,85,0,85,0,34,51,21.04.2019 21:20,153,15,Rovno
608,588,43,263,308,37,345,0,345,13,178,154,22.04.2019 00:10,153,15,Rovno
448,431,44,178,226,44,270,0,270,3,147,120,22.04.2019 00:15,153,15,Rovno
256,245,19,129,111,16,127,0,127,4,97,26,21.04.2019 21:50,153,15,Rovno
432,418,34,116,282,34,316,0,316,5,194,117,21.04.2019 21:25,153,15,Rovno
528,519,36,223,272,33,305,0,305,10,215,80,21.04.2019 21:35,153,15,Rovno
128,115,17,54,57,17,74,0,74,0,53,21,21.04.2019 20:25,153,15,Rovno
400,397,33,182,188,30,218,0,218,4,134,80,21.04.2019 20:40,153,15,Rovno
128,120,3,73,52,3,55,0,55,3,30,22,22.04.2019 00:13,153,15,Rovno
496,476,23,236,240,20,260,0,260,4,154,102,22.04.2019 00:01,153,15,Rovno
208,199,3,82,123,3,126,0,126,0,78,48,22.04.2019 00:07,153,15,Rovno
288,283,28,105,155,28,183,0,183,3,95,85,21.04.2019 21:30,153,15,Rovno
368,354,24,141,204,23,227,0,227,6,112,109,22.04.2019 00:20,153,15,Rovno
128,126,10,44,74,10,84,0,84,1,40,43,22.04.2019 00:15,153,15,Rovno
432,417,42,165,230,37,267,0,267,7,152,108,22.04.2019 00:10,153,15,Rovno
800,782,34,333,433,34,467,0,467,8,230,229,22.04.2019 00:25,153,15,Rovno
304,294,9,128,167,9,176,0,176,1,137,38,21.04.2019 22:05,153,15,Rovno
208,194,16,80,114,14,128,0,128,1,88,39,21.04.2019 22:00,153,15,Rovno
256,244,13,110,133,13,146,0,146,5,85,56,21.04.2019 22:00,153,15,Rovno
848,833,17,318,513,17,530,0,530,9,304,217,21.04.2019 20:40,153,15,Rovno
432,414,32,145,258,29,287,0,287,7,166,114,22.04.2019 00:05,153,15,Rovno
272,256,23,124,128,20,148,0,148,5,70,73,21.04.2019 21:30,153,15,Rovno
112,111,5,25,83,4,87,0,87,2,51,34,21.04.2019 21:40,153,15,Rovno
672,654,13,312,351,9,360,0,360,6,211,143,22.04.2019 00:10,153,15,Rovno
272,267,3,109,160,3,163,0,163,4,95,64,21.04.2019 23:45,153,15,Rovno
432,428,13,158,261,13,274,0,274,7,156,111,21.04.2019 20:41,153,15,Rovno
1024,992,13,300,711,13,724,0,724,15,354,355,21.04.2019 21:00,153,15,Rovno
176,170,23,65,88,23,111,0,111,0,42,69,22.04.2019 00:37,153,15,Rovno
64,60,3,21,40,3,43,0,43,0,24,19,21.04.2019 21:10,153,15,Rovno
176,175,8,52,116,8,124,0,124,4,82,38,22.04.2019 00:23,153,15,Rovno
752,738,31,305,420,27,447,0,447,9,266,172,21.04.2019 20:45,153,15,Rovno
192,189,15,68,110,14,124,0,124,6,64,54,21.04.2019 20:30,153,15,Rovno
176,167,28,96,63,17,80,0,80,1,49,30,21.04.2019 22:00,153,15,Rovno
272,256,21,90,163,19,182,0,182,4,130,48,22.04.2019 00:10,153,15,Rovno
448,430,20,186,245,17,262,0,262,5,171,86,22.04.2019 00:10,153,15,Rovno
1024,993,25,428,573,23,596,0,596,13,379,204,21.04.2019 21:39,153,15,Rovno
944,915,32,359,556,29,585,0,585,15,323,247,22.04.2019 00:15,153,15,Rovno
576,562,39,230,307,39,346,0,346,9,197,140,22.04.2019 00:32,153,15,Rovno
2304,2267,22,894,1393,17,1410,0,1410,38,891,481,21.04.2019 22:22,153,15,Rovno
288,275,21,107,160,21,181,0,181,6,93,82,21.04.2019 22:00,153,15,Rovno
2112,2085,30,846,1237,29,1266,0,1266,36,691,539,22.04.2019 00:40,153,15,Rovno
1776,1758,27,704,1047,25,1072,0,1072,41,502,529,21.04.2019 22:30,153,15,Rovno
1328,1313,7,441,880,7,887,0,887,20,450,417,22.04.2019 00:05,153,15,Rovno
1152,1124,23,521,609,22,631,0,631,16,359,256,22.04.2019 00:40,153,15,Rovno
864,842,17,394,456,14,470,0,470,6,264,200,22.04.2019 00:16,153,15,Rovno
448,441,49,165,241,42,283,0,283,8,178,97,21.04.2019 22:10,153,15,Rovno
768,759,19,255,494,19,513,0,513,9,300,204,21.04.2019 22:40,153,15,Rovno
192,183,11,61,120,11,131,0,131,2,89,40,21.04.2019 22:30,153,15,Rovno
272,266,15,82,175,15,190,0,190,3,102,85,22.04.2019 00:10,153,15,Rovno
272,269,9,90,174,8,182,0,182,1,115,66,22.04.2019 00:08,153,15,Rovno
432,413,8,201,223,8,231,0,231,3,125,103,22.04.2019 00:20,153,15,Rovno
96,95,2,16,78,2,80,0,80,1,47,32,21.04.2019 22:23,153,15,Rovno
1440,1409,22,594,827,19,846,0,846,25,463,358,22.04.2019 02:20,153,15,Rovno
352,347,44,109,199,44,243,0,243,8,153,82,21.04.2019 20:50,153,15,Rovno
208,208,12,69,127,12,139,0,139,1,83,55,21.04.2019 21:45,153,15,Rovno
192,175,9,81,102,9,111,0,111,1,73,37,21.04.2019 21:00,153,15,Rovno
528,512,3,213,313,2,315,0,315,8,195,112,21.04.2019 21:30,153,15,Rovno
736,728,46,309,386,41,427,0,427,8,232,187,21.04.2019 21:00,153,15,Rovno
2256,2222,12,928,1319,9,1328,0,1328,28,867,433,22.04.2019 00:08,153,15,Rovno
1648,1621,11,738,900,10,910,0,910,20,572,318,22.04.2019 00:05,153,15,Rovno
1888,1855,13,786,1090,12,1102,0,1102,16,596,490,21.04.2019 22:40,153,15,Rovno
304,22,13,282,9,13,22,0,22,0,13,9,21.04.2019 20:40,153,15,Rovno
704,408,29,297,378,29,407,0,407,34,333,40,22.04.2019 00:25,153,15,Rovno
480,272,0,208,272,0,272,0,272,12,234,26,22.04.2019 01:20,153,15,Rovno
1312,1282,9,585,722,5,727,0,727,19,465,243,22.04.2019 00:10,153,15,Rovno
496,479,0,168,328,0,328,0,328,7,198,123,22.04.2019 00:02,153,15,Rovno
704,680,37,262,410,32,442,0,442,7,248,187,22.04.2019 00:30,154,15,Rovno
1312,1292,74,471,773,68,841,0,841,32,466,343,22.04.2019 02:10,154,15,Rovno
416,403,40,146,235,35,270,0,270,5,135,130,22.04.2019 00:15,154,15,Rovno
944,934,82,358,507,79,586,0,586,9,374,203,22.04.2019 01:30,154,15,Rovno
544,524,56,156,334,54,388,0,388,7,177,204,22.04.2019 01:00,154,15,Rovno
224,213,37,69,119,36,155,0,155,1,71,83,22.04.2019 00:10,154,15,Rovno
128,124,21,43,66,19,85,0,85,2,40,43,22.04.2019 00:05,154,15,Rovno
320,318,37,128,158,34,192,0,192,3,81,108,21.04.2019 21:20,154,15,Rovno
768,746,48,285,444,39,483,0,483,10,276,197,22.04.2019 00:30,154,15,Rovno
336,330,20,110,209,17,226,0,226,2,142,82,22.04.2019 00:40,154,15,Rovno
736,726,67,256,428,52,480,0,480,9,271,200,22.04.2019 00:42,154,15,Rovno
608,587,44,300,271,37,308,0,308,17,189,102,22.04.2019 00:00,154,15,Rovno
288,280,23,106,164,18,182,0,182,7,100,75,22.04.2019 00:05,154,15,Rovno
656,644,31,188,437,31,468,0,468,9,262,197,22.04.2019 00:20,154,15,Rovno
1680,1650,53,654,976,50,1026,0,1026,22,634,370,21.04.2019 22:50,154,15,Rovno
1280,1250,67,470,750,60,810,0,810,19,560,231,22.04.2019 00:30,154,15,Rovno
832,821,29,304,499,29,528,0,528,9,367,152,22.04.2019 00:20,154,15,Rovno
528,513,32,178,318,32,350,0,350,11,226,113,22.04.2019 00:10,154,15,Rovno
128,125,9,26,93,9,102,0,102,2,59,41,22.04.2019 00:10,154,15,Rovno
240,231,11,90,140,10,150,0,150,4,99,47,22.04.2019 00:02,154,15,Rovno
304,292,21,109,179,16,195,0,195,4,85,106,21.04.2019 21:15,154,15,Rovno
784,760,30,390,364,30,394,0,394,4,244,146,22.04.2019 00:15,154,15,Rovno
352,340,23,149,180,23,203,0,203,1,135,67,22.04.2019 00:05,154,15,Rovno
256,251,25,66,165,25,190,0,190,11,71,108,22.04.2019 00:05,154,15,Rovno
464,457,23,149,294,21,315,0,315,7,195,113,22.04.2019 00:10,154,15,Rovno
288,273,18,105,169,14,183,0,183,4,127,52,22.04.2019 00:10,154,15,Rovno
368,351,15,107,246,15,261,0,261,8,123,130,22.04.2019 00:10,154,15,Rovno
224,212,4,63,157,4,161,0,161,2,105,54,22.04.2019 00:40,154,15,Rovno
448,432,22,162,264,22,286,0,286,12,141,133,22.04.2019 00:17,154,15,Rovno
288,273,31,105,152,31,183,0,183,2,93,88,22.04.2019 00:18,154,15,Rovno
480,458,34,179,268,33,301,0,301,4,163,134,22.04.2019 00:15,154,15,Rovno
320,311,20,85,215,20,235,0,235,3,114,118,22.04.2019 00:10,154,15,Rovno
688,676,34,225,429,34,463,0,463,8,288,167,22.04.2019 00:05,154,15,Rovno
1216,1182,23,496,699,21,720,0,720,10,419,291,22.04.2019 00:40,154,15,Rovno
112,103,9,48,55,9,64,0,64,3,22,39,21.04.2019 21:12,154,15,Rovno
128,114,8,63,57,8,65,0,65,0,47,18,22.04.2019 01:08,154,15,Rovno
336,330,27,141,170,25,195,0,195,0,110,85,22.04.2019 00:10,154,15,Rovno
256,247,16,67,175,14,189,0,189,3,123,63,22.04.2019 00:10,154,15,Rovno
288,270,15,109,164,15,179,0,179,3,115,61,22.04.2019 00:01,154,15,Rovno
576,557,23,225,328,23,351,0,351,9,165,177,22.04.2019 00:18,154,15,Rovno
240,252,23,85,136,19,155,0,155,8,77,70,22.04.2019 00:17,154,15,Rovno
2224,2184,73,894,1266,64,1330,0,1330,39,692,599,22.04.2019 00:45,154,15,Rovno
160,152,19,62,85,13,98,0,98,3,43,52,22.04.2019 00:05,154,15,Rovno
400,389,41,133,230,37,267,0,267,5,135,127,22.04.2019 00:10,154,15,Rovno
128,124,4,51,73,4,77,0,77,3,45,29,21.04.2019 21:11,154,15,Rovno
704,683,43,244,417,43,460,0,460,13,310,137,22.04.2019 00:15,154,15,Rovno
176,172,14,57,105,14,119,0,119,2,80,37,22.04.2019 00:30,154,15,Rovno
448,444,33,176,239,33,272,0,272,7,162,103,22.04.2019 00:30,154,15,Rovno
832,816,29,340,463,29,492,0,492,46,234,212,22.04.2019 00:30,154,15,Rovno
544,527,34,240,271,33,304,0,304,6,150,148,22.04.2019 01:00,154,15,Rovno
272,34,18,241,13,18,31,0,31,1,16,14,22.04.2019 00:13,154,15,Rovno
1984,1967,7,722,1255,7,1262,0,1262,39,759,464,22.04.2019 00:40,154,15,Rovno
2272,2246,16,903,1354,15,1369,0,1369,40,781,548,22.04.2019 00:10,154,15,Rovno
864,845,14,453,398,13,411,0,411,17,266,128,22.04.2019 00:05,154,15,Rovno
1184,1162,6,490,688,6,694,0,694,20,428,246,21.04.2019 23:30,154,15,Rovno
1280,1258,25,521,737,22,759,0,759,16,444,299,22.04.2019 00:30,154,15,Rovno
1312,1299,24,543,745,24,769,0,769,14,419,336,22.04.2019 00:35,154,15,Rovno
1504,1490,20,665,820,19,839,0,839,11,487,341,22.04.2019 00:30,154,15,Rovno
720,713,28,276,417,27,444,0,444,10,284,150,22.04.2019 00:10,154,15,Rovno
80,75,0,10,70,0,70,0,70,0,26,44,22.04.2019 00:15,154,15,Rovno
464,453,6,148,311,5,316,0,316,9,171,136,22.04.2019 00:48,154,15,Rovno
528,510,24,242,263,23,286,0,286,0,168,118,21.04.2019 22:20,154,15,Rovno
288,269,20,133,135,20,155,0,155,2,84,69,22.04.2019 00:05,154,15,Rovno
640,625,10,291,340,9,349,0,349,4,179,166,21.04.2019 21:00,154,15,Rovno
352,341,25,145,182,25,207,0,207,3,125,79,22.04.2019 00:20,154,15,Rovno
2288,2262,46,867,1379,42,1421,0,1421,41,818,562,22.04.2019 00:15,154,15,Rovno
1136,1120,58,442,644,50,694,0,694,12,409,273,22.04.2019 00:34,154,15,Rovno
400,396,33,166,202,32,234,0,234,5,139,90,21.04.2019 20:40,154,15,Rovno
640,624,32,246,364,30,394,0,394,9,222,163,21.04.2019 20:30,154,15,Rovno
432,420,29,155,254,23,277,0,277,7,185,85,21.04.2019 21:00,154,15,Rovno
480,471,25,169,289,22,311,0,311,4,191,116,22.04.2019 00:05,154,15,Rovno
128,119,13,53,64,11,75,0,75,0,37,38,22.04.2019 00:15,154,15,Rovno
144,141,7,52,85,7,92,0,92,3,47,42,22.04.2019 00:15,154,15,Rovno
1232,1211,34,493,705,34,739,0,739,16,412,311,21.04.2019 22:00,154,15,Rovno
416,409,25,179,212,25,237,0,237,1,143,93,22.04.2019 00:05,154,15,Rovno
816,802,50,321,456,39,495,0,495,12,281,202,22.04.2019 00:05,154,15,Rovno
320,309,19,110,191,19,210,0,210,4,131,75,21.04.2019 22:15,154,15,Rovno
1120,1104,88,493,546,81,627,0,627,19,359,249,22.04.2019 00:15,154,15,Rovno
528,508,57,181,291,56,347,0,347,14,158,175,21.04.2019 21:30,154,15,Rovno
400,399,55,150,203,47,250,0,250,9,93,148,21.04.2019 21:30,154,15,Rovno
784,756,37,299,450,35,485,0,485,12,298,175,22.04.2019 00:02,154,15,Rovno
176,171,13,78,87,11,98,0,98,2,61,35,22.04.2019 00:15,154,15,Rovno
480,467,32,195,258,27,285,0,285,5,128,152,22.04.2019 01:10,154,15,Rovno
560,555,38,175,350,35,385,0,385,4,197,184,21.04.2019 21:20,154,15,Rovno
272,262,23,116,136,20,156,0,156,2,78,76,22.04.2019 00:30,154,15,Rovno
528,522,28,244,257,27,284,0,284,6,122,156,22.04.2019 00:10,154,15,Rovno
416,397,12,178,226,12,238,0,238,6,136,96,22.04.2019 00:10,154,15,Rovno
272,259,21,85,166,21,187,0,187,5,80,102,22.04.2019 00:25,154,15,Rovno
176,159,3,72,102,2,104,0,104,0,65,39,22.04.2019 00:20,154,15,Rovno
1088,1082,14,466,609,13,622,0,622,12,387,223,21.04.2019 22:00,154,15,Rovno
1056,1045,18,443,596,17,613,0,613,11,383,219,22.04.2019 00:20,154,15,Rovno
192,184,14,62,116,14,130,0,130,3,53,74,22.04.2019 00:15,154,15,Rovno
192,185,15,62,115,15,130,0,130,2,78,50,22.04.2019 00:10,154,15,Rovno
288,275,10,103,177,8,185,0,185,4,68,113,22.04.2019 00:05,154,15,Rovno
560,545,50,202,310,48,358,0,358,1,155,202,22.04.2019 00:17,154,15,Rovno
352,348,9,149,194,9,203,0,203,3,110,90,22.04.2019 00:10,154,15,Rovno
256,251,4,115,137,4,141,0,141,8,72,61,22.04.2019 00:10,154,15,Rovno
288,287,15,98,175,15,190,0,190,8,82,100,22.04.2019 00:20,154,15,Rovno
800,789,41,289,472,39,511,0,511,7,299,205,22.04.2019 00:05,154,15,Rovno
512,506,16,184,312,16,328,0,328,7,168,153,22.04.2019 00:20,154,15,Rovno
432,412,24,150,258,24,282,0,282,8,168,106,22.04.2019 00:38,154,15,Rovno
336,326,13,88,235,13,248,0,248,10,135,103,22.04.2019 00:15,154,15,Rovno
272,260,14,96,162,14,176,0,176,5,90,81,22.04.2019 00:20,154,15,Rovno
704,694,40,181,483,40,523,0,523,11,298,214,22.04.2019 00:15,154,15,Rovno
1472,1431,15,651,810,11,821,0,821,20,504,297,22.04.2019 00:30,154,15,Rovno
1472,1458,15,611,849,12,861,0,861,22,522,317,22.04.2019 00:05,154,15,Rovno
1472,1461,6,560,907,5,912,0,912,42,541,329,22.04.2019 00:03,154,15,Rovno
1568,1538,10,589,969,10,979,0,979,35,553,391,22.04.2019 00:15,154,15,Rovno
1840,1790,9,769,1064,7,1071,0,1071,28,626,417,22.04.2019 00:20,154,15,Rovno
1584,1561,17,592,977,15,992,0,992,29,599,364,22.04.2019 00:15,154,15,Rovno
1744,1726,14,731,1000,13,1013,0,1013,26,656,331,22.04.2019 00:05,154,15,Rovno
1920,1872,12,779,1132,9,1141,0,1141,56,699,386,22.04.2019 00:25,154,15,Rovno
1504,1483,19,532,961,11,972,0,972,39,553,380,22.04.2019 00:15,154,15,Rovno
1152,1141,13,481,660,11,671,0,671,18,403,250,22.04.2019 00:10,154,15,Rovno
1584,1575,14,647,926,11,937,0,937,30,543,364,22.04.2019 00:20,154,15,Rovno
1888,1863,11,690,1187,11,1198,0,1198,38,716,444,22.04.2019 00:10,154,15,Rovno
1376,1359,13,602,763,11,774,0,774,20,450,304,22.04.2019 00:25,154,15,Rovno
1600,1577,9,676,915,9,924,0,924,27,548,349,22.04.2019 00:05,154,15,Rovno
1392,1368,96,540,773,79,852,0,852,30,524,298,22.04.2019 00:20,154,15,Rovno
1199,1184,10,429,762,8,770,0,770,16,431,323,22.04.2019 00:10,154,15,Rovno
96,15,0,81,15,0,15,0,15,0,9,6,22.04.2019 00:10,154,15,Rovno
48,42,29,9,13,26,39,0,39,2,22,15,21.04.2019 20:30,154,15,Rovno
2320,2288,8,967,1345,8,1353,0,1353,27,790,536,22.04.2019 00:30,155,15,Rovno
640,634,17,331,293,16,309,0,309,6,145,158,22.04.2019 00:40,155,15,Rovno
480,461,7,210,263,7,270,0,270,16,129,125,22.04.2019 00:08,155,15,Rovno
880,865,51,265,565,50,615,0,615,13,362,240,22.04.2019 00:10,155,15,Rovno
544,532,24,218,304,22,326,0,326,6,203,117,22.04.2019 00:15,155,15,Rovno
448,442,19,157,273,18,291,0,291,8,135,148,22.04.2019 00:10,155,15,Rovno
800,776,19,308,475,17,492,0,492,3,293,196,22.04.2019 00:10,155,15,Rovno
1984,1940,7,785,1192,7,1199,0,1199,30,709,460,22.04.2019 00:20,155,15,Rovno
1760,1728,4,719,1037,4,1041,0,1041,23,623,395,22.04.2019 01:46,155,15,Rovno
1840,1780,4,811,1026,3,1029,0,1029,18,645,366,22.04.2019 00:14,155,15,Rovno
464,425,0,224,240,0,240,0,240,2,144,94,22.04.2019 00:15,155,15,Rovno
1248,1222,4,507,737,4,741,0,741,18,481,242,22.04.2019 00:01,155,15,Rovno
224,216,0,80,144,0,144,0,144,2,108,34,22.04.2019 00:21,155,15,Rovno
320,317,18,103,199,18,217,0,217,3,132,82,22.04.2019 00:08,155,15,Rovno
2016,1974,6,778,1232,6,1238,0,1238,23,683,532,22.04.2019 01:30,155,15,Rovno
656,643,2,311,343,2,345,0,345,3,264,78,22.04.2019 00:25,155,15,Rovno
112,101,0,42,70,0,70,0,70,10,26,34,22.04.2019 00:40,155,15,Rovno
560,548,32,203,326,31,357,0,357,6,168,183,22.04.2019 00:40,155,15,Rovno
720,700,25,310,385,25,410,0,410,6,233,171,22.04.2019 00:20,155,15,Rovno
1280,1257,10,652,619,9,628,0,628,15,408,205,22.04.2019 00:20,155,15,Rovno
1632,1603,32,701,899,32,931,0,931,12,587,332,22.04.2019 00:15,155,15,Rovno
336,318,16,94,226,16,242,0,242,5,170,67,22.04.2019 00:10,155,15,Rovno
416,391,7,174,235,7,242,0,242,1,145,96,22.04.2019 00:03,155,15,Rovno
512,491,7,203,303,6,309,0,309,9,152,148,22.04.2019 00:15,155,15,Rovno
384,374,12,158,214,12,226,0,226,6,147,73,22.04.2019 00:05,155,15,Rovno
160,147,6,35,119,6,125,0,125,3,52,70,22.04.2019 00:10,155,15,Rovno
464,457,27,142,297,25,322,0,322,6,211,105,22.04.2019 00:10,155,15,Rovno
784,757,5,244,537,3,540,0,540,7,276,257,22.04.2019 00:10,155,15,Rovno
384,380,6,184,194,6,200,0,200,3,104,93,22.04.2019 00:10,155,15,Rovno
208,197,3,82,124,2,126,0,126,3,56,67,22.04.2019 00:04,155,15,Rovno
608,598,12,222,375,11,386,0,386,6,240,140,22.04.2019 00:03,155,15,Rovno
576,558,20,161,396,19,415,0,415,6,263,146,22.04.2019 00:05,155,15,Rovno
416,405,2,216,198,2,200,0,200,3,116,81,22.04.2019 00:05,155,15,Rovno
736,732,26,275,435,26,461,0,461,6,219,236,22.04.2019 00:20,155,15,Rovno
1088,1074,1,583,504,1,505,0,505,9,321,175,22.04.2019 00:50,155,15,Rovno
1440,1407,33,642,765,33,798,0,798,16,428,354,22.04.2019 00:55,155,15,Rovno
384,375,8,168,208,8,216,0,216,6,137,73,22.04.2019 00:15,155,15,Rovno
400,385,17,145,238,17,255,0,255,3,112,140,22.04.2019 00:05,155,15,Rovno
208,200,20,54,134,20,154,0,154,7,58,89,22.04.2019 00:04,155,15,Rovno
1472,1431,30,617,825,30,855,0,855,15,479,361,22.04.2019 00:30,155,15,Rovno
528,518,32,166,330,32,362,0,362,6,250,106,22.04.2019 00:25,155,15,Rovno
240,233,14,73,153,14,167,0,167,6,100,61,22.04.2019 01:55,155,15,Rovno
224,203,17,84,124,16,140,0,140,4,57,79,22.04.2019 00:45,155,15,Rovno
320,315,4,133,185,2,187,0,187,3,107,77,22.04.2019 00:35,155,15,Rovno
416,400,6,145,266,5,271,0,271,2,189,80,22.04.2019 00:10,155,15,Rovno
176,160,12,58,106,12,118,0,118,1,84,33,22.04.2019 00:35,155,15,Rovno
240,29,11,212,18,10,28,0,28,1,16,11,22.04.2019 00:35,155,15,Rovno
560,547,10,198,353,9,362,0,362,2,288,72,21.04.2019 22:05,155,15,Rovno
160,164,3,51,106,3,109,0,109,0,76,33,22.04.2019 00:05,155,15,Rovno
352,341,29,126,197,29,226,0,226,0,118,108,22.04.2019 00:10,155,15,Rovno
464,454,52,171,245,48,293,0,293,2,178,113,22.04.2019 00:30,155,15,Rovno
224,208,14,63,147,14,161,0,161,6,97,58,22.04.2019 00:07,155,15,Rovno
240,233,12,75,155,10,165,0,165,2,90,73,22.04.2019 01:30,155,15,Rovno
736,726,56,255,431,50,481,0,481,3,332,146,22.04.2019 00:25,155,15,Rovno
288,273,15,79,195,14,209,0,209,0,141,68,22.04.2019 00:40,155,15,Rovno
448,437,27,151,271,26,297,0,297,4,191,102,22.04.2019 00:40,155,15,Rovno
384,377,24,179,181,24,205,0,205,0,156,49,22.04.2019 00:25,155,15,Rovno
416,405,8,132,276,8,284,0,284,4,162,118,22.04.2019 00:20,155,15,Rovno
592,586,48,242,307,43,350,0,350,8,252,90,22.04.2019 00:50,155,15,Rovno
288,285,9,120,161,7,168,0,168,2,139,27,22.04.2019 00:37,155,15,Rovno
64,56,8,28,31,5,36,0,36,1,19,16,22.04.2019 00:05,155,15,Rovno
448,435,6,177,266,5,271,0,271,3,96,172,21.04.2019 23:30,156,15,Rovno
320,309,20,118,182,20,202,0,202,4,131,67,22.04.2019 00:40,156,15,Rovno
2144,2119,41,864,1239,41,1280,0,1280,32,898,350,22.04.2019 00:35,156,15,Rovno
1232,1218,22,579,632,21,653,0,653,14,414,225,22.04.2019 00:10,156,15,Rovno
496,478,15,256,226,14,240,0,240,13,141,86,21.04.2019 21:30,156,15,Rovno
1024,1018,9,511,504,9,513,0,513,4,346,163,22.04.2019 00:20,156,15,Rovno
832,818,9,479,344,9,353,0,353,6,249,98,21.04.2019 23:05,156,15,Rovno
384,367,22,118,245,21,266,0,266,4,136,126,21.04.2019 20:35,156,15,Rovno
560,544,20,192,349,19,368,0,368,6,231,131,21.04.2019 21:45,156,15,Rovno
192,183,10,70,113,9,122,0,122,1,80,41,21.04.2019 20:40,156,15,Rovno
288,277,4,130,154,4,158,0,158,0,73,85,21.04.2019 22:30,156,15,Rovno
256,254,0,75,181,0,181,0,181,3,65,113,21.04.2019 22:45,156,15,Rovno
624,615,15,280,329,15,344,0,344,2,222,120,21.04.2019 23:55,156,15,Rovno
416,409,11,186,219,11,230,0,230,4,161,65,22.04.2019 00:05,156,15,Rovno
144,132,3,41,100,3,103,0,103,0,59,44,22.04.2019 00:20,156,15,Rovno
192,185,9,82,101,9,110,0,110,4,82,24,22.04.2019 00:20,156,15,Rovno
112,106,5,44,64,4,68,0,68,1,46,21,21.04.2019 21:00,156,15,Rovno
336,311,22,181,134,21,155,0,155,2,83,70,21.04.2019 21:50,156,15,Rovno
176,161,3,92,81,3,84,0,84,1,58,25,21.04.2019 21:40,156,15,Rovno
240,235,16,100,125,15,140,0,140,3,91,46,21.04.2019 20:48,156,15,Rovno
480,462,23,214,244,22,266,0,266,7,151,108,21.04.2019 23:10,156,15,Rovno
96,88,2,41,53,2,55,0,55,0,26,29,21.04.2019 22:00,156,15,Rovno
160,144,8,39,113,8,121,0,121,0,58,63,22.04.2019 00:50,156,15,Rovno
320,316,6,138,176,6,182,0,182,3,100,79,21.04.2019 20:28,156,15,Rovno
1632,1611,7,697,931,4,935,0,935,23,608,304,22.04.2019 00:31,156,15,Rovno
2016,1957,28,880,1115,21,1136,0,1136,24,755,357,21.04.2019 21:25,156,15,Rovno
1904,1873,18,806,1086,12,1098,0,1098,30,685,383,22.04.2019 00:30,156,15,Rovno
144,34,22,115,12,17,29,0,29,0,16,13,21.04.2019 20:30,156,15,Rovno
464,446,2,219,243,2,245,0,245,5,165,75,22.04.2019 00:15,156,15,Rovno
1136,1133,9,459,669,8,677,0,677,22,475,180,21.04.2019 21:10,156,15,Rovno
1152,1129,16,477,660,15,675,0,675,16,454,205,22.04.2019 00:35,156,15,Rovno
1104,1076,16,456,638,10,648,0,648,13,475,160,22.04.2019 00:30,156,15,Rovno
1040,1005,9,446,586,8,594,0,594,16,398,180,21.04.2019 21:02,156,15,Rovno
1328,1299,6,664,659,5,664,0,664,24,435,205,22.04.2019 00:04,156,15,Rovno
1200,1177,8,443,750,7,757,0,757,17,558,182,22.04.2019 00:35,156,15,Rovno
1392,1350,18,603,775,14,789,0,789,14,594,181,22.04.2019 00:45,156,15,Rovno
1072,1073,13,411,652,9,661,0,661,11,472,178,22.04.2019 00:10,156,15,Rovno
928,922,9,372,547,9,556,0,556,20,407,129,21.04.2019 21:00,156,15,Rovno
1392,1360,5,590,798,4,802,0,802,12,591,199,22.04.2019 01:40,156,15,Rovno
1280,1243,9,557,715,8,723,0,723,18,520,185,22.04.2019 00:25,156,15,Rovno
1552,1552,9,725,818,9,827,0,827,20,571,236,22.04.2019 00:36,156,15,Rovno
2144,2106,11,981,1153,10,1163,0,1163,22,899,242,22.04.2019 00:15,156,15,Rovno
224,218,6,77,141,6,147,0,147,2,74,71,22.04.2019 00:20,156,15,Rovno
144,145,9,56,79,9,88,0,88,2,60,26,22.04.2019 00:20,156,15,Rovno
96,89,1,45,50,1,51,0,51,1,29,21,22.04.2019 00:30,156,15,Rovno
512,497,20,198,295,19,314,0,314,4,146,164,22.04.2019 00:20,156,15,Rovno
224,215,10,66,148,10,158,0,158,5,95,58,22.04.2019 00:30,156,15,Rovno
1424,1405,28,789,611,24,635,0,635,18,407,210,22.04.2019 00:10,156,15,Rovno
368,365,6,137,226,5,231,0,231,5,157,69,21.04.2019 21:30,156,15,Rovno
224,215,10,87,127,10,137,0,137,1,115,21,21.04.2019 21:50,156,15,Rovno
480,466,15,280,185,15,200,0,200,1,151,48,21.04.2019 22:00,156,15,Rovno
1024,1011,42,571,420,33,453,0,453,6,342,105,22.04.2019 00:03,156,15,Rovno
304,298,7,156,142,6,148,0,148,4,71,73,22.04.2019 00:20,156,15,Rovno
192,189,1,68,123,1,124,0,124,0,88,36,21.04.2019 21:20,156,15,Rovno
480,457,29,205,247,28,275,0,275,8,187,80,21.04.2019 23:00,156,15,Rovno
288,279,17,126,147,15,162,0,162,6,108,48,22.04.2019 00:15,156,15,Rovno
1728,1704,23,761,946,21,967,0,967,13,684,270,21.04.2019 22:50,156,15,Rovno
368,364,5,154,210,4,214,0,214,3,167,44,22.04.2019 00:15,156,15,Rovno
112,95,13,50,49,13,62,0,62,2,44,16,22.04.2019 00:05,156,15,Rovno
656,634,22,297,337,22,359,0,359,7,243,109,22.04.2019 00:15,156,15,Rovno
2416,2399,39,1155,1228,33,1261,0,1261,38,784,439,22.04.2019 00:20,156,15,Rovno
816,796,15,359,442,15,457,0,457,15,250,192,22.04.2019 00:20,156,15,Rovno
848,833,30,356,462,30,492,0,492,13,275,204,22.04.2019 00:30,156,15,Rovno
448,27,15,424,12,12,24,0,24,0,16,8,22.04.2019 00:12,156,15,Rovno
128,31,0,97,31,0,31,0,31,0,19,12,21.04.2019 23:00,156,15,Rovno
96,32,0,67,29,0,29,0,29,0,23,6,22.04.2019 00:25,156,15,Rovno
2304,2263,54,762,1505,37,1542,0,1542,45,1083,414,22.04.2019 00:17,157,16,Sumy
2256,2227,15,812,1434,10,1444,0,1444,28,1104,312,22.04.2019 00:15,157,16,Sumy
2192,2158,22,682,1492,18,1510,0,1510,39,1155,316,22.04.2019 00:10,157,16,Sumy
384,40,20,344,20,20,40,0,40,0,37,3,21.04.2019 20:50,157,16,Sumy
1520,1507,15,568,940,12,952,0,952,20,762,170,22.04.2019 00:21,157,16,Sumy
1968,1929,18,892,1060,16,1076,0,1076,18,859,199,22.04.2019 00:15,157,16,Sumy
1920,1932,16,750,1156,14,1170,0,1170,25,944,201,21.04.2019 22:00,157,16,Sumy
2160,2141,19,702,1444,14,1458,0,1458,37,1103,318,22.04.2019 00:20,157,16,Sumy
2256,2247,20,754,1490,12,1502,0,1502,37,1152,313,22.04.2019 00:02,157,16,Sumy
2240,2229,22,768,1453,19,1472,0,1472,28,1146,298,22.04.2019 00:05,157,16,Sumy
2368,2338,20,965,1388,15,1403,0,1403,30,1159,214,22.04.2019 00:05,157,16,Sumy
192,192,93,12,92,88,180,0,180,5,111,64,21.04.2019 21:04,157,16,Sumy
864,856,2,309,554,1,555,0,555,12,428,115,22.04.2019 00:10,157,16,Sumy
176,51,3,126,47,3,50,0,50,2,34,14,22.04.2019 00:15,157,16,Sumy
240,18,0,222,18,0,18,0,18,0,13,5,21.04.2019 21:30,157,16,Sumy
1360,1337,21,647,697,16,713,0,713,15,617,81,22.04.2019 00:25,158,16,Sumy
1424,1405,26,607,798,19,817,0,817,19,736,62,22.04.2019 00:10,158,16,Sumy
2320,2282,33,972,1320,28,1348,0,1348,37,1111,200,22.04.2019 00:15,158,16,Sumy
2336,2294,40,1150,1152,34,1186,0,1186,22,1029,135,22.04.2019 00:30,158,16,Sumy
1216,1200,32,546,643,27,670,0,670,12,587,71,22.04.2019 00:05,158,16,Sumy
896,878,43,371,485,40,525,0,525,10,470,45,22.04.2019 01:57,158,16,Sumy
1040,1022,36,527,484,29,513,0,513,7,444,62,22.04.2019 00:15,158,16,Sumy
736,718,18,338,383,15,398,0,398,5,355,38,21.04.2019 21:05,158,16,Sumy
400,392,42,149,212,39,251,0,251,5,203,43,22.04.2019 00:30,158,16,Sumy
1104,1081,47,432,626,46,672,0,672,10,570,92,22.04.2019 00:10,158,16,Sumy
944,919,59,364,524,56,580,0,580,7,514,59,21.04.2019 21:30,158,16,Sumy
288,278,33,95,164,29,193,0,193,4,162,27,21.04.2019 21:08,158,16,Sumy
256,243,10,77,170,9,179,0,179,3,137,39,21.04.2019 22:15,158,16,Sumy
240,225,22,86,132,22,154,0,154,0,141,13,21.04.2019 22:10,158,16,Sumy
112,102,25,29,62,21,83,0,83,0,69,14,21.04.2019 22:10,158,16,Sumy
1120,1099,123,509,497,114,611,0,611,6,532,73,21.04.2019 21:05,158,16,Sumy
320,315,39,135,149,36,185,0,185,7,137,41,21.04.2019 20:40,158,16,Sumy
448,436,41,162,247,39,286,0,286,4,233,49,21.04.2019 21:59,158,16,Sumy
128,116,20,47,65,16,81,0,81,0,63,18,21.04.2019 21:35,158,16,Sumy
256,251,43,105,118,33,151,0,151,1,128,22,22.04.2019 00:05,158,16,Sumy
272,264,50,109,114,49,163,0,163,1,152,10,22.04.2019 00:20,158,16,Sumy
96,93,20,35,43,18,61,0,61,0,38,23,21.04.2019 23:05,158,16,Sumy
448,430,39,221,200,27,227,0,227,5,194,28,21.04.2019 20:57,158,16,Sumy
208,199,18,107,86,15,101,0,101,1,71,29,21.04.2019 23:55,158,16,Sumy
432,423,44,189,203,40,243,0,243,6,193,44,22.04.2019 00:10,158,16,Sumy
128,114,21,66,45,17,62,0,62,2,38,22,21.04.2019 20:45,158,16,Sumy
592,575,89,209,300,83,383,0,383,4,347,32,21.04.2019 21:30,158,16,Sumy
336,330,44,113,187,36,223,0,223,2,199,22,21.04.2019 21:30,158,16,Sumy
432,422,55,184,201,47,248,0,248,0,201,47,22.04.2019 00:30,158,16,Sumy
608,589,100,160,354,94,448,0,448,5,378,65,21.04.2019 21:30,158,16,Sumy
544,530,77,160,314,70,384,0,384,6,317,61,22.04.2019 00:10,158,16,Sumy
224,218,29,86,117,21,138,0,138,3,92,43,21.04.2019 20:16,158,16,Sumy
528,517,81,157,296,75,371,0,371,9,275,87,21.04.2019 21:35,158,16,Sumy
400,392,50,79,274,47,321,0,321,0,264,57,21.04.2019 21:00,158,16,Sumy
80,73,8,18,55,7,62,0,62,0,41,21,21.04.2019 20:50,158,16,Sumy
304,299,42,98,167,39,206,0,206,2,174,30,22.04.2019 00:15,158,16,Sumy
192,178,28,82,84,26,110,0,110,1,79,30,22.04.2019 00:15,158,16,Sumy
192,30,18,162,12,18,30,0,30,0,25,5,22.04.2019 00:15,158,16,Sumy
144,133,10,55,79,10,89,0,89,3,79,7,22.04.2019 00:10,158,16,Sumy
432,421,34,135,266,31,297,0,297,1,262,34,21.04.2019 21:10,158,16,Sumy
240,230,20,82,138,20,158,0,158,1,135,22,21.04.2019 21:00,158,16,Sumy
656,640,33,229,396,31,427,0,427,2,342,83,22.04.2019 00:07,158,16,Sumy
368,356,20,139,214,15,229,0,229,7,191,31,22.04.2019 00:05,158,16,Sumy
352,338,46,139,167,46,213,0,213,3,178,32,21.04.2019 22:10,158,16,Sumy
624,612,54,163,408,53,461,0,461,4,375,82,21.04.2019 21:25,158,16,Sumy
160,150,7,57,96,7,103,0,103,0,80,23,21.04.2019 21:00,158,16,Sumy
432,412,22,140,270,22,292,0,292,5,260,27,21.04.2019 22:30,158,16,Sumy
736,729,71,250,415,71,486,0,486,7,409,70,22.04.2019 00:25,158,16,Sumy
256,244,17,111,130,15,145,0,145,2,92,51,21.04.2019 21:00,158,16,Sumy
864,775,77,311,484,69,553,0,553,2,435,116,22.04.2019 00:20,158,16,Sumy
1936,1923,65,857,1023,56,1079,0,1079,18,932,129,21.04.2019 21:00,158,16,Sumy
928,922,62,380,492,56,548,0,548,4,446,98,22.04.2019 00:50,158,16,Sumy
576,570,7,242,327,7,334,0,334,3,280,51,21.04.2019 23:50,158,16,Sumy
1008,995,94,453,467,88,555,0,555,8,451,96,22.04.2019 00:25,158,16,Sumy
368,355,17,134,219,15,234,0,234,2,163,69,21.04.2019 21:20,158,16,Sumy
384,388,37,173,177,34,211,0,211,2,191,18,21.04.2019 23:50,158,16,Sumy
416,401,23,160,233,23,256,0,256,6,218,32,22.04.2019 00:05,158,16,Sumy
1552,1526,96,536,932,84,1016,0,1016,19,832,165,22.04.2019 00:29,158,16,Sumy
224,93,29,132,64,28,92,0,92,3,76,13,21.04.2019 21:00,158,16,Sumy
1952,1920,15,701,1241,10,1251,0,1251,26,938,287,22.04.2019 00:15,158,16,Sumy
2192,2158,15,806,1376,10,1386,0,1386,31,1095,260,22.04.2019 00:35,158,16,Sumy
1184,1164,4,350,831,3,834,0,834,29,638,167,22.04.2019 00:33,158,16,Sumy
272,37,2,237,33,2,35,0,35,0,29,6,22.04.2019 00:07,158,16,Sumy
160,8,2,152,6,2,8,0,8,0,5,3,22.04.2019 00:10,158,16,Sumy
512,507,36,197,279,36,315,0,315,2,275,38,22.04.2019 00:10,159,16,Sumy
1088,1057,65,442,586,60,646,0,646,14,551,81,22.04.2019 00:30,159,16,Sumy
272,267,46,119,109,44,153,0,153,5,122,26,21.04.2019 20:50,159,16,Sumy
320,306,12,112,199,9,208,0,208,2,184,22,21.04.2019 21:10,159,16,Sumy
1872,1815,13,733,1130,9,1139,0,1139,23,1007,109,22.04.2019 00:05,159,16,Sumy
2016,1976,27,693,1305,18,1323,0,1323,32,1124,167,22.04.2019 00:15,159,16,Sumy
1472,1428,16,571,886,15,901,0,901,18,770,113,22.04.2019 00:20,159,16,Sumy
1120,1122,8,434,678,8,686,0,686,19,583,84,22.04.2019 00:05,159,16,Sumy
1248,1213,9,495,747,6,753,0,753,17,626,110,22.04.2019 00:05,159,16,Sumy
1248,1222,18,466,765,17,782,0,782,13,666,103,22.04.2019 00:05,159,16,Sumy
1680,1955,29,370,1287,23,1310,0,1310,19,1050,241,22.04.2019 00:10,159,16,Sumy
192,186,8,42,143,7,150,0,150,5,136,9,22.04.2019 00:10,159,16,Sumy
1360,1339,27,525,812,23,835,0,835,15,740,80,22.04.2019 00:15,159,16,Sumy
1904,1859,18,794,1093,17,1110,0,1110,20,978,112,21.04.2019 21:00,159,16,Sumy
1472,1450,26,551,900,21,921,0,921,6,841,74,22.04.2019 00:30,159,16,Sumy
1392,1354,15,550,829,13,842,0,842,27,702,113,22.04.2019 00:15,159,16,Sumy
288,25,7,264,18,6,24,0,24,0,19,5,22.04.2019 00:20,159,16,Sumy
192,101,0,92,100,0,100,0,100,9,80,11,21.04.2019 23:10,159,16,Sumy
1072,1059,41,440,597,35,632,0,632,15,521,96,22.04.2019 00:15,160,16,Sumy
992,974,23,418,555,19,574,0,574,9,498,67,22.04.2019 01:00,160,16,Sumy
256,241,26,111,122,23,145,0,145,1,116,28,22.04.2019 00:25,160,16,Sumy
176,163,32,56,90,30,120,0,120,5,88,27,21.04.2019 23:45,160,16,Sumy
400,381,29,171,202,27,229,0,229,6,171,52,22.04.2019 00:10,160,16,Sumy
992,974,18,519,455,18,473,0,473,13,388,72,22.04.2019 00:03,160,16,Sumy
224,206,20,148,62,14,76,0,76,0,55,21,22.04.2019 00:25,160,16,Sumy
416,400,30,212,180,24,204,0,204,5,157,42,22.04.2019 00:10,160,16,Sumy
176,174,16,71,89,16,105,0,105,1,71,33,22.04.2019 00:25,160,16,Sumy
624,606,44,263,318,43,361,0,361,6,264,91,22.04.2019 00:10,160,16,Sumy
112,111,15,39,59,14,73,0,73,0,58,15,22.04.2019 00:00,160,16,Sumy
160,149,11,79,71,10,81,0,81,1,57,23,22.04.2019 00:54,160,16,Sumy
496,487,43,166,289,41,330,0,330,5,249,76,22.04.2019 00:20,160,16,Sumy
672,647,28,322,326,24,350,0,350,6,297,47,21.04.2019 21:55,160,16,Sumy
1808,1766,147,879,800,129,929,0,929,15,802,112,22.04.2019 00:35,160,16,Sumy
1328,1291,58,596,675,57,732,0,732,9,642,81,22.04.2019 00:15,160,16,Sumy
1856,1945,30,749,1081,26,1107,0,1107,17,930,160,22.04.2019 00:30,160,16,Sumy
592,582,35,250,310,32,342,0,342,1,298,43,21.04.2019 22:00,160,16,Sumy
288,280,27,71,194,23,217,0,217,0,187,30,22.04.2019 00:05,160,16,Sumy
560,528,48,283,233,44,277,0,277,3,240,34,21.04.2019 21:50,160,16,Sumy
640,614,75,275,295,70,365,0,365,3,314,48,22.04.2019 00:10,160,16,Sumy
128,131,31,54,52,22,74,0,74,0,64,10,22.04.2019 00:30,160,16,Sumy
560,545,25,227,309,24,333,0,333,2,275,56,22.04.2019 00:31,160,16,Sumy
224,219,21,90,114,20,134,0,134,1,114,19,22.04.2019 00:05,160,16,Sumy
288,278,32,102,156,30,186,0,186,4,157,25,22.04.2019 00:05,160,16,Sumy
864,829,90,361,419,84,503,0,503,2,439,62,22.04.2019 00:40,160,16,Sumy
1520,1502,14,650,856,14,870,0,870,17,771,82,22.04.2019 00:50,160,16,Sumy
1488,1473,44,561,891,36,927,0,927,21,776,130,22.04.2019 01:20,160,16,Sumy
2560,2425,21,997,1547,16,1563,0,1563,41,1291,231,22.04.2019 00:25,160,16,Sumy
1904,1896,32,691,1186,27,1213,0,1213,24,1033,156,22.04.2019 00:06,160,16,Sumy
1888,1862,24,755,1114,19,1133,0,1133,25,934,174,22.04.2019 00:15,160,16,Sumy
2032,1996,24,755,1261,16,1277,0,1277,28,1044,205,22.04.2019 00:10,160,16,Sumy
1888,1858,18,764,1116,8,1124,0,1124,23,938,163,22.04.2019 00:30,160,16,Sumy
1344,1329,30,514,803,27,830,0,830,17,711,102,22.04.2019 00:40,160,16,Sumy
2096,2058,42,821,1248,27,1275,0,1275,29,1078,168,22.04.2019 00:24,160,16,Sumy
2176,2137,21,822,1339,15,1354,0,1354,30,1141,183,22.04.2019 01:30,160,16,Sumy
1856,1853,17,660,1182,14,1196,0,1196,23,985,188,22.04.2019 00:20,160,16,Sumy
2032,1991,31,838,1169,25,1194,0,1194,28,1024,142,22.04.2019 01:40,160,16,Sumy
1568,1555,21,608,940,20,960,0,960,23,819,118,22.04.2019 00:21,160,16,Sumy
2048,2019,24,885,1141,22,1163,0,1163,34,962,167,22.04.2019 00:30,160,16,Sumy
2032,2011,27,865,1148,19,1167,0,1167,27,985,155,22.04.2019 00:08,160,16,Sumy
1456,1430,20,659,778,19,797,0,797,24,683,90,22.04.2019 02:30,160,16,Sumy
1552,1539,18,787,751,14,765,0,765,11,650,104,22.04.2019 00:13,160,16,Sumy
1776,1757,32,879,870,27,897,0,897,5,806,86,22.04.2019 00:17,160,16,Sumy
1984,1954,17,757,1212,15,1227,0,1227,27,1031,169,22.04.2019 00:15,160,16,Sumy
128,24,10,104,14,10,24,0,24,0,20,4,22.04.2019 00:05,160,16,Sumy
544,135,91,429,34,81,115,0,115,5,96,14,22.04.2019 00:10,160,16,Sumy
160,142,0,18,142,0,142,0,142,7,132,3,22.04.2019 00:05,160,16,Sumy
736,719,5,321,413,2,415,0,415,8,360,47,22.04.2019 00:37,160,16,Sumy
2112,2061,21,842,1256,14,1270,0,1270,37,1111,122,22.04.2019 00:05,160,16,Sumy
2176,2127,10,882,1284,10,1294,0,1294,26,1125,143,22.04.2019 00:15,160,16,Sumy
2016,2004,14,781,1228,7,1235,0,1235,19,1081,135,22.04.2019 00:50,160,16,Sumy
2288,2226,16,1002,1273,13,1286,0,1286,34,1094,158,22.04.2019 00:29,160,16,Sumy
2160,2122,9,834,1321,5,1326,0,1326,26,1143,157,22.04.2019 00:09,160,16,Sumy
2096,2055,23,859,1219,18,1237,0,1237,25,1074,138,22.04.2019 01:00,160,16,Sumy
1792,1758,17,659,1121,12,1133,0,1133,17,949,167,21.04.2019 22:00,160,16,Sumy
1008,978,8,366,635,7,642,0,642,15,534,93,22.04.2019 00:15,160,16,Sumy
1616,1586,20,640,960,16,976,0,976,28,828,120,22.04.2019 00:05,160,16,Sumy
2224,2194,22,923,1288,13,1301,0,1301,28,1100,173,22.04.2019 00:10,160,16,Sumy
1184,1157,12,422,754,8,762,0,762,20,643,99,22.04.2019 00:55,160,16,Sumy
1920,1880,18,792,1113,15,1128,0,1128,26,970,132,22.04.2019 00:02,160,16,Sumy
2208,2154,12,908,1291,9,1300,0,1300,31,1128,141,21.04.2019 21:30,160,16,Sumy
1456,1435,14,629,820,7,827,0,827,12,732,83,22.04.2019 00:10,160,16,Sumy
1664,1641,13,654,999,11,1010,0,1010,13,884,113,22.04.2019 00:09,160,16,Sumy
1776,1734,13,664,1101,11,1112,0,1112,13,977,122,22.04.2019 00:32,160,16,Sumy
2137,2089,15,979,1147,11,1158,0,1158,18,1001,139,22.04.2019 00:30,160,16,Sumy
1632,1569,18,656,966,10,976,0,976,19,825,132,22.04.2019 00:35,160,16,Sumy
1344,1366,15,509,825,10,835,0,835,16,722,97,22.04.2019 00:15,160,16,Sumy
2096,2053,21,831,1251,14,1265,0,1265,27,1102,136,21.04.2019 21:40,160,16,Sumy
2080,2025,11,800,1273,7,1280,0,1280,34,1096,150,22.04.2019 00:10,160,16,Sumy
2192,2134,15,837,1344,11,1355,0,1355,28,1149,178,22.04.2019 00:07,160,16,Sumy
2224,2177,11,847,1367,10,1377,0,1377,35,1193,149,22.04.2019 00:10,160,16,Sumy
1696,1653,6,719,972,5,977,0,977,20,821,136,22.04.2019 00:15,160,16,Sumy
2208,2161,25,873,1318,17,1335,0,1335,34,1175,126,22.04.2019 00:15,160,16,Sumy
1808,1767,14,726,1074,8,1082,0,1082,22,972,88,22.04.2019 00:30,160,16,Sumy
1520,1483,15,598,909,13,922,0,922,8,828,86,22.04.2019 00:52,160,16,Sumy
1344,1313,12,584,753,7,760,0,760,13,670,77,22.04.2019 00:35,160,16,Sumy
2224,2165,20,837,1376,11,1387,0,1387,29,1211,147,22.04.2019 01:30,160,16,Sumy
448,62,49,388,13,47,60,0,60,0,58,2,22.04.2019 00:10,160,16,Sumy
160,144,14,56,90,14,104,0,104,3,79,22,22.04.2019 00:10,161,16,Sumy
352,336,9,66,277,9,286,0,286,3,258,25,22.04.2019 00:35,161,16,Sumy
128,119,6,50,72,6,78,0,78,0,63,15,22.04.2019 00:15,161,16,Sumy
176,167,29,89,68,19,87,0,87,1,59,27,22.04.2019 00:30,161,16,Sumy
976,949,14,463,499,14,513,0,513,16,446,51,22.04.2019 00:20,161,16,Sumy
1072,1042,53,465,556,51,607,0,607,15,496,96,22.04.2019 00:05,161,16,Sumy
560,549,41,109,412,39,451,0,451,6,243,202,21.04.2019 23:50,161,16,Sumy
496,483,53,129,316,51,367,0,367,6,292,69,21.04.2019 23:00,161,16,Sumy
160,161,14,38,111,11,122,0,122,0,104,18,21.04.2019 20:30,161,16,Sumy
928,914,154,313,476,139,615,0,615,11,484,120,22.04.2019 01:00,161,16,Sumy
480,462,78,175,237,68,305,0,305,3,229,73,21.04.2019 23:50,161,16,Sumy
180,174,19,60,105,15,120,0,120,2,100,18,22.04.2019 00:30,161,16,Sumy
384,367,46,129,210,45,255,0,255,0,198,57,22.04.2019 00:10,161,16,Sumy
272,262,29,79,166,27,193,0,193,2,144,47,22.04.2019 00:30,161,16,Sumy
192,174,29,61,106,25,131,0,131,2,101,28,21.04.2019 21:20,161,16,Sumy
1152,1138,91,411,657,84,741,0,741,13,582,146,22.04.2019 00:20,161,16,Sumy
112,105,7,43,62,7,69,0,69,2,52,15,22.04.2019 00:20,161,16,Sumy
304,304,20,88,197,19,216,0,216,3,176,37,22.04.2019 00:40,161,16,Sumy
288,278,36,77,180,31,211,0,211,1,163,47,22.04.2019 00:50,161,16,Sumy
80,66,13,35,35,10,45,0,45,1,36,8,22.04.2019 00:20,161,16,Sumy
112,106,7,38,68,6,74,0,74,0,53,21,22.04.2019 00:30,161,16,Sumy
128,35,14,98,17,13,30,0,30,2,25,3,22.04.2019 02:15,161,16,Sumy
272,255,23,106,147,19,166,0,166,5,129,32,22.04.2019 01:10,161,16,Sumy
240,238,29,93,122,25,147,0,147,4,113,30,22.04.2019 00:15,161,16,Sumy
400,388,25,130,245,25,270,0,270,10,223,37,22.04.2019 00:30,161,16,Sumy
112,108,7,49,56,7,63,0,63,0,46,17,22.04.2019 00:10,161,16,Sumy
464,453,42,157,267,40,307,0,307,3,191,113,21.04.2019 20:45,161,16,Sumy
112,103,8,38,66,8,74,0,74,0,61,13,22.04.2019 00:45,161,16,Sumy
352,345,42,107,203,42,245,0,245,3,208,34,21.04.2019 21:30,161,16,Sumy
256,240,15,98,145,13,158,0,158,0,114,44,22.04.2019 00:10,161,16,Sumy
144,133,10,34,100,10,110,0,110,0,90,20,21.04.2019 23:25,161,16,Sumy
240,228,13,91,137,12,149,0,149,2,127,20,22.04.2019 00:10,161,16,Sumy
224,204,10,95,121,8,129,0,129,4,109,16,22.04.2019 00:15,161,16,Sumy
144,135,5,57,82,5,87,0,87,1,59,27,22.04.2019 00:15,161,16,Sumy
1008,986,46,301,661,46,707,0,707,14,574,119,22.04.2019 00:30,161,16,Sumy
320,317,48,111,166,43,209,0,209,2,152,55,21.04.2019 20:30,161,16,Sumy
80,74,4,22,54,4,58,0,58,0,46,12,22.04.2019 00:10,161,16,Sumy
256,249,13,98,152,6,158,0,158,3,131,24,22.04.2019 00:15,161,16,Sumy
512,505,30,210,276,26,302,0,302,0,262,40,22.04.2019 00:50,161,16,Sumy
528,523,41,188,300,40,340,0,340,7,280,53,22.04.2019 00:10,161,16,Sumy
336,322,34,117,185,34,219,0,219,4,181,34,22.04.2019 00:15,161,16,Sumy
1056,1038,53,327,677,52,729,0,729,8,563,158,22.04.2019 00:40,161,16,Sumy
368,357,25,166,178,24,202,0,202,4,164,34,22.04.2019 00:30,161,16,Sumy
160,151,1,51,108,1,109,0,109,3,80,26,22.04.2019 00:05,161,16,Sumy
912,908,22,338,553,21,574,0,574,11,491,72,22.04.2019 00:15,161,16,Sumy
288,270,13,109,166,13,179,0,179,3,156,20,22.04.2019 00:20,161,16,Sumy
224,219,16,79,131,14,145,0,145,0,119,26,22.04.2019 00:25,161,16,Sumy
928,910,41,428,461,39,500,0,500,13,389,98,22.04.2019 00:20,161,16,Sumy
256,246,15,95,149,12,161,0,161,3,126,32,22.04.2019 00:20,161,16,Sumy
368,360,16,129,226,13,239,0,239,3,203,33,22.04.2019 00:10,161,16,Sumy
656,557,0,100,556,0,556,0,556,24,508,24,22.04.2019 00:10,161,16,Sumy
1552,1578,40,494,1028,30,1058,0,1058,19,861,178,22.04.2019 00:10,161,16,Sumy
1680,1665,18,611,1054,15,1069,0,1069,31,864,174,22.04.2019 00:40,161,16,Sumy
1584,1561,26,592,975,17,992,0,992,22,753,217,22.04.2019 00:30,161,16,Sumy
1360,1335,24,495,846,19,865,0,865,18,747,100,22.04.2019 00:05,161,16,Sumy
736,68,0,670,66,0,66,0,66,2,59,5,22.04.2019 00:10,161,16,Sumy
112,105,15,40,57,15,72,0,72,1,50,21,21.04.2019 20:45,162,16,Sumy
1760,1729,19,631,1113,16,1129,0,1129,16,968,144,22.04.2019 00:05,162,16,Sumy
2496,2419,3,993,1501,2,1503,0,1503,65,681,757,22.04.2019 00:45,163,17,Ternopol
2448,2401,12,933,1505,10,1515,0,1515,62,706,747,22.04.2019 00:05,163,17,Ternopol
2384,2331,2,1077,1306,1,1307,0,1307,52,672,583,21.04.2019 22:38,163,17,Ternopol
2480,2427,10,889,1582,9,1591,0,1591,59,729,803,22.04.2019 00:10,163,17,Ternopol
2432,2400,14,954,1466,12,1478,0,1478,53,725,700,22.04.2019 00:05,163,17,Ternopol
2208,2184,16,841,1355,12,1367,0,1367,64,627,676,22.04.2019 00:15,163,17,Ternopol
2144,2116,11,801,1332,11,1343,0,1343,60,606,677,22.04.2019 00:38,163,17,Ternopol
2480,2439,9,982,1492,6,1498,0,1498,65,742,691,22.04.2019 00:35,163,17,Ternopol
2512,2483,12,1043,1458,11,1469,0,1469,57,666,746,22.04.2019 00:50,163,17,Ternopol
2448,2430,25,1000,1430,18,1448,0,1448,57,666,725,22.04.2019 00:01,163,17,Ternopol
2160,2154,12,805,1348,7,1355,0,1355,51,606,698,22.04.2019 00:07,163,17,Ternopol
2528,2483,12,984,1533,11,1544,0,1544,33,663,848,22.04.2019 00:01,163,17,Ternopol
1952,1908,10,782,1162,8,1170,0,1170,38,547,585,22.04.2019 00:20,163,17,Ternopol
1696,1667,10,671,1016,9,1025,0,1025,46,499,480,22.04.2019 00:15,163,17,Ternopol
1552,1520,18,591,946,15,961,0,961,31,425,505,22.04.2019 01:15,163,17,Ternopol
1680,1671,15,574,1091,15,1106,0,1106,40,484,582,21.04.2019 22:07,163,17,Ternopol
1632,1600,13,604,1017,11,1028,0,1028,33,492,503,22.04.2019 00:20,163,17,Ternopol
2288,2268,11,847,1431,10,1441,0,1441,52,676,713,22.04.2019 00:05,163,17,Ternopol
2320,2294,9,791,1520,9,1529,0,1529,61,688,780,22.04.2019 00:09,163,17,Ternopol
2272,2239,11,891,1370,11,1381,0,1381,42,654,685,21.04.2019 23:15,163,17,Ternopol
2191,2169,7,791,1394,6,1400,0,1400,54,685,661,22.04.2019 00:46,163,17,Ternopol
2288,2261,13,876,1401,11,1412,0,1412,56,678,678,22.04.2019 00:10,163,17,Ternopol
2112,2069,11,762,1341,9,1350,0,1350,56,608,686,22.04.2019 00:15,163,17,Ternopol
2000,1982,8,743,1250,7,1257,0,1257,47,598,612,22.04.2019 00:15,163,17,Ternopol
1632,1610,6,572,1054,6,1060,0,1060,42,482,536,22.04.2019 00:20,163,17,Ternopol
2384,2346,21,940,1428,16,1444,0,1444,56,686,702,22.04.2019 00:05,163,17,Ternopol
2352,2335,11,859,1485,8,1493,0,1493,49,663,781,22.04.2019 00:05,163,17,Ternopol
2416,2353,13,997,1407,12,1419,0,1419,49,714,656,21.04.2019 22:05,163,17,Ternopol
2352,2271,13,1192,1149,11,1160,0,1160,36,634,490,22.04.2019 00:05,163,17,Ternopol
2336,2291,9,873,1460,3,1463,0,1463,51,688,724,22.04.2019 00:15,163,17,Ternopol
2256,2212,12,868,1378,10,1388,0,1388,55,686,647,21.04.2019 22:55,163,17,Ternopol
2400,2356,7,848,1545,7,1552,0,1552,63,724,765,22.04.2019 00:15,163,17,Ternopol
2064,2031,1,804,1259,1,1260,0,1260,43,614,603,22.04.2019 00:20,163,17,Ternopol
144,7,3,137,4,3,7,0,7,0,4,3,22.04.2019 00:08,163,17,Ternopol
176,21,12,156,8,12,20,0,20,1,12,7,21.04.2019 21:20,163,17,Ternopol
272,45,33,232,11,29,40,0,40,2,17,21,22.04.2019 01:51,163,17,Ternopol
416,105,89,311,16,89,105,0,105,4,57,44,22.04.2019 00:13,163,17,Ternopol
288,76,44,213,32,43,75,0,75,4,28,43,22.04.2019 00:10,163,17,Ternopol
528,503,21,186,323,19,342,0,342,11,151,180,21.04.2019 22:05,164,17,Ternopol
336,327,17,114,205,17,222,0,222,6,113,103,21.04.2019 20:50,164,17,Ternopol
112,112,2,26,84,2,86,0,86,3,43,40,21.04.2019 20:32,164,17,Ternopol
752,733,41,354,360,38,398,0,398,8,252,138,21.04.2019 23:45,164,17,Ternopol
448,435,28,166,254,28,282,0,282,2,115,165,21.04.2019 22:40,164,17,Ternopol
656,642,17,279,360,17,377,0,377,4,273,100,22.04.2019 00:20,164,17,Ternopol
352,340,20,115,217,20,237,0,237,2,168,67,21.04.2019 23:50,164,17,Ternopol
400,383,10,128,262,10,272,0,272,4,150,118,21.04.2019 21:12,164,17,Ternopol
688,671,59,226,403,59,462,0,462,10,199,253,21.04.2019 21:50,164,17,Ternopol
160,145,17,69,77,14,91,0,91,3,56,32,22.04.2019 00:40,164,17,Ternopol
784,772,52,252,484,48,532,0,532,14,211,307,21.04.2019 23:55,164,17,Ternopol
304,287,27,121,158,25,183,0,183,8,116,59,21.04.2019 20:40,164,17,Ternopol
1712,1695,24,931,760,21,781,0,781,21,415,345,22.04.2019 00:05,164,17,Ternopol
976,979,18,498,460,18,478,0,478,10,281,187,21.04.2019 20:59,164,17,Ternopol
832,810,60,285,489,58,547,0,547,13,274,260,21.04.2019 21:15,164,17,Ternopol
176,166,11,48,117,11,128,0,128,1,59,68,21.04.2019 21:00,164,17,Ternopol
176,173,19,32,125,19,144,0,144,6,56,82,21.04.2019 21:50,164,17,Ternopol
608,597,36,254,320,34,354,0,354,3,227,124,21.04.2019 21:25,164,17,Ternopol
1216,1200,70,354,795,67,862,0,862,19,389,454,21.04.2019 21:15,164,17,Ternopol
336,328,25,127,184,25,209,0,209,8,116,85,21.04.2019 21:00,164,17,Ternopol
944,932,33,536,379,29,408,0,408,13,286,109,22.04.2019 00:30,164,17,Ternopol
848,829,35,284,529,35,564,0,564,11,309,244,21.04.2019 22:03,164,17,Ternopol
160,154,3,54,103,3,106,0,106,1,49,56,21.04.2019 21:10,164,17,Ternopol
304,292,16,109,179,16,195,0,195,2,84,109,21.04.2019 20:50,164,17,Ternopol
480,462,15,173,295,12,307,0,307,15,152,140,21.04.2019 21:35,164,17,Ternopol
544,532,45,196,307,41,348,0,348,4,158,186,21.04.2019 21:26,164,17,Ternopol
160,150,6,58,96,6,102,0,102,3,52,47,21.04.2019 20:36,164,17,Ternopol
368,365,35,95,238,35,273,0,273,3,151,119,21.04.2019 20:50,164,17,Ternopol
752,735,5,291,457,4,461,0,461,13,215,233,21.04.2019 20:41,164,17,Ternopol
2048,2032,30,836,1183,29,1212,0,1212,48,567,597,21.04.2019 21:25,164,17,Ternopol
1232,1202,33,503,697,32,729,0,729,33,352,344,21.04.2019 21:10,164,17,Ternopol
1968,1955,21,855,1094,19,1113,0,1113,54,540,519,21.04.2019 22:01,164,17,Ternopol
2272,2246,8,984,1282,6,1288,0,1288,44,653,591,21.04.2019 22:10,164,17,Ternopol
1648,1604,20,713,918,17,935,0,935,38,479,418,21.04.2019 21:30,164,17,Ternopol
480,463,23,77,380,23,403,0,403,2,188,213,21.04.2019 22:00,164,17,Ternopol
160,155,12,35,113,12,125,0,125,2,85,38,22.04.2019 00:10,164,17,Ternopol
192,178,5,67,121,4,125,0,125,3,78,44,21.04.2019 22:30,164,17,Ternopol
224,211,17,73,136,15,151,0,151,4,84,63,21.04.2019 21:40,164,17,Ternopol
576,562,44,157,376,43,419,0,419,3,206,210,21.04.2019 21:00,164,17,Ternopol
544,532,36,112,396,36,432,0,432,7,159,266,21.04.2019 20:43,164,17,Ternopol
464,451,40,189,238,37,275,0,275,6,181,88,21.04.2019 22:00,164,17,Ternopol
512,497,39,202,271,39,310,0,310,5,159,146,21.04.2019 21:30,164,17,Ternopol
320,305,25,125,174,21,195,0,195,5,124,66,21.04.2019 21:10,164,17,Ternopol
224,209,16,95,113,16,129,0,129,2,84,43,21.04.2019 21:30,164,17,Ternopol
256,248,18,90,148,18,166,0,166,2,93,71,22.04.2019 00:30,164,17,Ternopol
160,154,15,60,85,15,100,0,100,1,46,53,21.04.2019 21:30,164,17,Ternopol
304,297,13,86,208,10,218,0,218,6,113,99,21.04.2019 21:15,164,17,Ternopol
256,236,16,76,164,16,180,0,180,5,56,119,21.04.2019 21:30,164,17,Ternopol
432,423,42,118,273,41,314,0,314,13,120,181,21.04.2019 21:25,164,17,Ternopol
432,421,9,175,249,8,257,0,257,6,165,86,21.04.2019 21:40,164,17,Ternopol
528,520,15,230,286,12,298,0,298,11,165,122,21.04.2019 21:15,164,17,Ternopol
672,649,51,269,355,48,403,0,403,9,211,183,21.04.2019 23:15,164,17,Ternopol
144,129,11,60,73,11,84,0,84,1,57,26,21.04.2019 20:35,164,17,Ternopol
208,205,26,85,99,24,123,0,123,3,58,62,21.04.2019 20:15,164,17,Ternopol
1040,1021,67,372,601,67,668,0,668,19,266,383,21.04.2019 22:30,164,17,Ternopol
320,313,8,77,235,8,243,0,243,8,122,113,22.04.2019 00:15,164,17,Ternopol
464,459,38,138,289,37,326,0,326,1,215,110,21.04.2019 20:55,164,17,Ternopol
176,161,21,60,96,20,116,0,116,0,29,87,21.04.2019 20:40,164,17,Ternopol
400,392,29,150,222,28,250,0,250,5,88,157,21.04.2019 22:05,164,17,Ternopol
160,148,12,48,100,12,112,0,112,4,47,61,21.04.2019 21:15,164,17,Ternopol
656,646,49,209,401,46,447,0,447,12,207,228,21.04.2019 21:30,164,17,Ternopol
496,496,38,123,337,36,373,0,373,6,168,199,21.04.2019 21:40,164,17,Ternopol
208,207,29,62,117,29,146,0,146,5,44,97,21.04.2019 23:15,164,17,Ternopol
944,926,22,486,436,22,458,0,458,18,226,214,21.04.2019 22:00,164,17,Ternopol
544,538,38,120,387,37,424,0,424,1,205,218,21.04.2019 21:40,164,17,Ternopol
352,351,34,116,204,32,236,0,236,1,121,114,21.04.2019 20:59,164,17,Ternopol
224,213,16,70,138,16,154,0,154,2,96,56,21.04.2019 22:30,164,17,Ternopol
560,556,33,186,342,32,374,0,374,16,151,207,21.04.2019 22:40,164,17,Ternopol
720,705,37,201,484,35,519,0,519,15,145,359,21.04.2019 22:00,164,17,Ternopol
315,327,9,68,240,7,247,0,247,12,99,136,21.04.2019 21:21,164,17,Ternopol
1088,1072,86,328,682,78,760,0,760,22,363,375,22.04.2019 00:05,164,17,Ternopol
368,370,32,121,218,29,247,0,247,4,119,124,21.04.2019 22:00,164,17,Ternopol
80,82,5,17,59,4,63,0,63,0,40,23,21.04.2019 22:00,164,17,Ternopol
496,483,33,156,310,30,340,0,340,2,185,153,21.04.2019 23:30,164,17,Ternopol
288,274,28,91,169,28,197,0,197,7,73,117,21.04.2019 21:05,164,17,Ternopol
672,224,0,448,224,0,224,0,224,7,145,72,21.04.2019 21:40,164,17,Ternopol
2000,1971,42,836,1136,28,1164,0,1164,35,636,493,22.04.2019 00:56,164,17,Ternopol
192,193,9,80,103,9,112,0,112,2,61,49,21.04.2019 21:45,164,17,Ternopol
272,259,15,90,167,15,182,0,182,3,109,70,21.04.2019 20:40,164,17,Ternopol
112,104,7,47,58,7,65,0,65,3,26,36,21.04.2019 20:30,164,17,Ternopol
784,775,8,333,443,8,451,0,451,19,307,125,21.04.2019 22:00,164,17,Ternopol
144,144,2,41,101,2,103,0,103,2,55,46,21.04.2019 22:10,164,17,Ternopol
608,604,14,279,316,13,329,0,329,12,217,100,21.04.2019 22:55,164,17,Ternopol
1120,1094,58,459,611,50,661,0,661,13,410,238,21.04.2019 23:30,164,17,Ternopol
608,587,22,228,362,18,380,0,380,13,237,130,21.04.2019 20:15,164,17,Ternopol
992,969,14,356,622,14,636,0,636,11,348,277,21.04.2019 20:55,164,17,Ternopol
816,809,5,302,510,4,514,0,514,17,286,211,21.04.2019 21:10,164,17,Ternopol
288,284,12,126,155,7,162,0,162,0,109,53,21.04.2019 20:35,164,17,Ternopol
400,390,12,137,251,12,263,0,263,7,174,82,21.04.2019 23:23,164,17,Ternopol
128,121,2,50,76,2,78,0,78,4,51,23,21.04.2019 23:05,164,17,Ternopol
624,607,6,290,328,6,334,0,334,6,212,116,21.04.2019 21:10,164,17,Ternopol
1008,997,35,426,547,35,582,0,582,12,322,248,21.04.2019 21:06,164,17,Ternopol
544,534,31,180,333,31,364,0,364,11,265,88,21.04.2019 22:00,164,17,Ternopol
96,92,6,38,52,6,58,0,58,0,43,15,21.04.2019 22:10,164,17,Ternopol
384,373,24,137,223,24,247,0,247,11,117,119,21.04.2019 21:00,164,17,Ternopol
288,284,4,98,186,4,190,0,190,3,126,61,21.04.2019 21:00,164,17,Ternopol
320,305,12,85,223,12,235,0,235,7,103,125,21.04.2019 21:05,164,17,Ternopol
304,297,9,115,181,8,189,0,189,7,114,68,21.04.2019 22:40,164,17,Ternopol
784,762,14,270,501,13,514,0,514,12,345,157,22.04.2019 00:20,164,17,Ternopol
288,286,42,89,161,38,199,0,199,4,74,121,21.04.2019 21:05,164,17,Ternopol
256,248,20,85,151,20,171,0,171,4,81,86,21.04.2019 22:26,164,17,Ternopol
80,73,3,26,51,3,54,0,54,0,37,17,21.04.2019 20:36,164,17,Ternopol
272,261,25,116,132,24,156,0,156,0,99,57,21.04.2019 21:30,164,17,Ternopol
112,108,3,27,82,3,85,0,85,0,67,18,21.04.2019 21:40,164,17,Ternopol
432,423,23,133,276,23,299,0,299,6,170,123,21.04.2019 21:30,164,17,Ternopol
896,886,6,427,463,6,469,0,469,24,295,150,21.04.2019 21:20,164,17,Ternopol
1984,1966,14,906,1064,14,1078,0,1078,44,647,387,21.04.2019 21:30,164,17,Ternopol
1696,1669,15,763,918,15,933,0,933,35,545,353,21.04.2019 23:30,164,17,Ternopol
1520,1505,10,716,794,10,804,0,804,35,481,288,21.04.2019 22:10,164,17,Ternopol
1296,1288,27,602,667,27,694,0,694,46,415,233,22.04.2019 00:33,164,17,Ternopol
928,899,17,411,500,17,517,0,517,23,316,178,21.04.2019 21:25,164,17,Ternopol
912,910,6,401,506,5,511,0,511,15,304,192,21.04.2019 22:10,164,17,Ternopol
1456,1429,26,679,755,22,777,0,777,26,429,322,21.04.2019 21:30,164,17,Ternopol
1168,1152,4,527,637,4,641,0,641,16,411,214,21.04.2019 20:00,164,17,Ternopol
1856,1829,9,870,977,9,986,0,986,32,622,332,21.04.2019 21:28,164,17,Ternopol
1712,1667,38,783,895,34,929,0,929,33,556,340,21.04.2019 22:00,164,17,Ternopol
576,572,47,206,331,39,370,0,370,2,269,99,21.04.2019 22:48,164,17,Ternopol
832,814,14,283,537,12,549,0,549,7,287,255,21.04.2019 21:55,164,17,Ternopol
784,779,3,235,546,3,549,0,549,12,373,164,21.04.2019 22:00,164,17,Ternopol
1088,1076,38,406,650,32,682,0,682,17,403,262,21.04.2019 22:00,164,17,Ternopol
128,127,6,54,68,6,74,0,74,4,50,20,21.04.2019 22:15,164,17,Ternopol
544,531,35,214,298,32,330,0,330,10,225,95,21.04.2019 21:00,164,17,Ternopol
416,410,25,201,190,25,215,0,215,10,150,55,21.04.2019 22:15,164,17,Ternopol
304,293,5,111,188,5,193,0,193,4,130,59,21.04.2019 21:21,164,17,Ternopol
272,262,12,107,153,12,165,0,165,2,104,59,21.04.2019 22:10,164,17,Ternopol
2000,1997,18,891,1092,17,1109,0,1109,48,792,269,22.04.2019 00:10,164,17,Ternopol
2032,2007,37,1096,912,24,936,0,936,24,665,247,22.04.2019 00:10,164,17,Ternopol
1184,1160,24,614,549,21,570,0,570,29,383,158,22.04.2019 01:00,164,17,Ternopol
1248,1226,79,648,535,65,600,0,600,33,393,174,21.04.2019 23:15,164,17,Ternopol
368,357,0,209,159,0,159,0,159,3,116,40,22.04.2019 00:10,164,17,Ternopol
1232,1215,78,537,626,69,695,0,695,20,420,255,21.04.2019 20:30,164,17,Ternopol
1184,1161,47,486,652,46,698,0,698,12,542,144,21.04.2019 22:20,164,17,Ternopol
960,947,58,521,399,40,439,0,439,12,318,109,21.04.2019 22:05,164,17,Ternopol
288,277,18,137,133,18,151,0,151,5,79,67,21.04.2019 20:37,164,17,Ternopol
448,437,10,198,241,9,250,0,250,11,161,78,21.04.2019 21:50,164,17,Ternopol
320,316,22,110,190,20,210,0,210,7,135,68,21.04.2019 20:34,164,17,Ternopol
128,11,11,119,0,9,9,0,9,0,7,2,21.04.2019 21:00,164,17,Ternopol
320,307,29,125,166,29,195,0,195,1,109,85,22.04.2019 01:15,164,17,Ternopol
176,169,6,65,105,6,111,0,111,4,56,51,21.04.2019 21:30,164,17,Ternopol
160,146,12,55,93,12,105,0,105,9,56,40,21.04.2019 22:00,164,17,Ternopol
656,652,50,177,429,50,479,0,479,11,221,247,21.04.2019 22:17,164,17,Ternopol
848,838,25,366,460,22,482,0,482,6,289,187,21.04.2019 23:30,164,17,Ternopol
240,231,21,72,148,20,168,0,168,7,108,53,21.04.2019 23:00,164,17,Ternopol
784,771,28,281,476,27,503,0,503,11,222,270,21.04.2019 21:15,164,17,Ternopol
624,616,56,201,370,53,423,0,423,9,280,134,21.04.2019 21:16,164,17,Ternopol
448,442,45,136,267,45,312,0,312,9,188,115,21.04.2019 21:00,164,17,Ternopol
496,477,24,167,305,24,329,0,329,10,193,126,21.04.2019 21:15,164,17,Ternopol
560,549,56,216,290,54,344,0,344,11,196,137,21.04.2019 21:20,164,17,Ternopol
464,449,40,197,228,39,267,0,267,3,101,163,21.04.2019 21:20,164,17,Ternopol
96,81,6,52,38,6,44,0,44,3,24,17,21.04.2019 20:30,164,17,Ternopol
576,568,30,228,320,28,348,0,348,6,210,132,22.04.2019 01:30,164,17,Ternopol
224,215,16,80,129,15,144,0,144,3,93,48,22.04.2019 00:15,164,17,Ternopol
384,381,16,157,212,15,227,0,227,4,115,108,22.04.2019 00:15,164,17,Ternopol
640,632,19,296,325,19,344,0,344,7,211,126,21.04.2019 21:30,164,17,Ternopol
320,310,30,147,143,30,173,0,173,7,94,72,21.04.2019 22:25,164,17,Ternopol
304,293,36,95,174,35,209,0,209,3,95,111,21.04.2019 21:10,164,17,Ternopol
416,412,20,113,283,20,303,0,303,12,156,135,21.04.2019 21:10,164,17,Ternopol
176,182,15,50,113,13,126,0,126,1,47,78,21.04.2019 20:50,164,17,Ternopol
256,249,14,77,166,13,179,0,179,2,104,73,21.04.2019 21:00,164,17,Ternopol
416,413,22,182,214,20,234,0,234,15,129,90,22.04.2019 00:45,164,17,Ternopol
1712,1694,18,701,994,17,1011,0,1011,38,587,386,22.04.2019 00:10,164,17,Ternopol
1472,1445,11,665,799,8,807,0,807,26,487,294,22.04.2019 00:15,164,17,Ternopol
896,881,16,435,445,16,461,0,461,7,308,146,22.04.2019 01:00,164,17,Ternopol
640,628,34,313,296,31,327,0,327,7,198,122,22.04.2019 02:20,164,17,Ternopol
1584,1550,13,723,849,12,861,0,861,27,552,282,22.04.2019 00:30,164,17,Ternopol
128,125,3,47,78,3,81,0,81,3,53,25,22.04.2019 00:30,164,17,Ternopol
160,153,12,52,97,11,108,0,108,1,88,19,21.04.2019 22:10,164,17,Ternopol
304,286,9,129,166,9,175,0,175,5,106,64,21.04.2019 22:00,164,17,Ternopol
480,476,46,169,265,46,311,0,311,8,156,147,21.04.2019 22:20,164,17,Ternopol
112,100,9,43,60,9,69,0,69,3,35,31,21.04.2019 21:45,164,17,Ternopol
256,249,38,111,116,29,145,0,145,6,80,59,22.04.2019 00:05,164,17,Ternopol
432,405,25,140,267,25,292,0,292,8,198,86,22.04.2019 00:20,164,17,Ternopol
160,157,7,41,112,7,119,0,119,3,67,49,21.04.2019 22:30,164,17,Ternopol
400,394,18,161,221,18,239,0,239,9,128,102,22.04.2019 00:23,164,17,Ternopol
192,180,14,72,106,14,120,0,120,8,74,38,21.04.2019 21:35,164,17,Ternopol
496,477,30,173,293,30,323,0,323,10,171,142,21.04.2019 22:00,164,17,Ternopol
240,226,19,98,125,17,142,0,142,7,82,53,21.04.2019 22:59,164,17,Ternopol
112,106,4,39,70,3,73,0,73,2,52,19,21.04.2019 20:25,164,17,Ternopol
592,578,47,167,378,47,425,0,425,25,210,190,21.04.2019 21:00,164,17,Ternopol
288,274,18,95,175,18,193,0,193,6,112,75,21.04.2019 21:00,164,17,Ternopol
384,378,29,144,213,27,240,0,240,6,100,134,22.04.2019 00:05,164,17,Ternopol
656,644,21,242,393,21,414,0,414,9,222,183,21.04.2019 22:05,164,17,Ternopol
336,318,22,148,167,21,188,0,188,9,100,79,21.04.2019 23:47,164,17,Ternopol
336,319,25,136,175,25,200,0,200,4,109,87,22.04.2019 00:30,164,17,Ternopol
784,767,93,249,454,81,535,0,535,5,297,233,21.04.2019 21:15,164,17,Ternopol
176,176,18,63,98,15,113,0,113,0,56,57,21.04.2019 21:18,164,17,Ternopol
352,351,33,100,220,32,252,0,252,6,138,108,21.04.2019 23:50,164,17,Ternopol
96,83,8,26,62,8,70,0,70,0,50,20,21.04.2019 20:20,164,17,Ternopol
64,57,9,15,40,9,49,0,49,0,37,12,21.04.2019 20:50,164,17,Ternopol
480,486,55,81,344,55,399,0,399,4,194,201,22.04.2019 00:10,164,17,Ternopol
448,429,49,191,211,46,257,0,257,0,136,121,21.04.2019 22:20,164,17,Ternopol
752,744,24,171,558,23,581,0,581,13,309,259,21.04.2019 21:30,164,17,Ternopol
352,339,15,129,209,14,223,0,223,9,133,81,21.04.2019 22:00,164,17,Ternopol
464,459,28,190,249,25,274,0,274,5,168,101,22.04.2019 00:10,164,17,Ternopol
352,338,38,110,205,37,242,0,242,3,145,94,21.04.2019 22:00,164,17,Ternopol
736,725,57,231,452,53,505,0,505,12,311,182,22.04.2019 00:05,164,17,Ternopol
1056,1036,65,331,663,62,725,0,725,14,421,290,21.04.2019 22:30,164,17,Ternopol
288,276,9,73,206,9,215,0,215,1,139,75,21.04.2019 23:20,164,17,Ternopol
832,829,31,344,459,29,488,0,488,15,277,196,21.04.2019 21:55,164,17,Ternopol
304,303,24,88,193,23,216,0,216,3,107,106,21.04.2019 21:55,164,17,Ternopol
112,105,7,45,60,7,67,0,67,0,27,40,21.04.2019 22:10,164,17,Ternopol
784,774,61,284,440,60,500,0,500,16,269,215,21.04.2019 22:15,164,17,Ternopol
288,283,17,83,188,17,205,0,205,7,124,74,21.04.2019 22:45,164,17,Ternopol
544,540,59,165,320,59,379,0,379,15,118,246,21.04.2019 21:00,164,17,Ternopol
240,232,14,62,164,14,178,0,178,5,108,65,21.04.2019 20:15,164,17,Ternopol
560,546,11,215,337,8,345,0,345,7,218,120,21.04.2019 22:10,164,17,Ternopol
288,282,17,95,176,17,193,0,193,4,79,110,21.04.2019 22:10,164,17,Ternopol
320,310,16,106,198,16,214,0,214,5,124,85,21.04.2019 20:40,164,17,Ternopol
480,464,16,195,271,14,285,0,285,20,125,140,21.04.2019 23:15,164,17,Ternopol
288,284,21,97,171,20,191,0,191,4,100,87,22.04.2019 00:17,164,17,Ternopol
336,323,17,141,181,14,195,0,195,5,93,97,22.04.2019 00:05,164,17,Ternopol
1088,1077,48,320,720,48,768,0,768,22,411,335,21.04.2019 22:15,164,17,Ternopol
304,292,10,113,182,9,191,0,191,9,93,89,21.04.2019 20:45,164,17,Ternopol
400,390,18,119,263,18,281,0,281,5,190,86,21.04.2019 20:41,164,17,Ternopol
288,273,19,85,185,18,203,0,203,10,132,61,21.04.2019 20:35,164,17,Ternopol
240,231,21,52,167,21,188,0,188,1,124,63,21.04.2019 22:15,164,17,Ternopol
528,524,45,159,324,45,369,0,369,12,139,218,21.04.2019 23:00,164,17,Ternopol
1200,1185,104,270,833,97,930,0,930,30,487,413,21.04.2019 22:10,164,17,Ternopol
368,352,29,134,207,27,234,0,234,4,108,122,21.04.2019 22:55,164,17,Ternopol
64,59,5,20,39,5,44,0,44,1,16,27,21.04.2019 22:10,164,17,Ternopol
1152,1142,22,504,628,20,648,0,648,25,364,259,21.04.2019 22:10,164,17,Ternopol
944,914,21,429,497,18,515,0,515,15,312,188,21.04.2019 23:45,164,17,Ternopol
1904,1864,11,761,1132,11,1143,0,1143,28,638,477,21.04.2019 23:00,164,17,Ternopol
768,741,7,341,422,5,427,0,427,14,229,184,21.04.2019 22:20,164,17,Ternopol
1600,1570,22,714,869,17,886,0,886,31,450,405,22.04.2019 01:00,164,17,Ternopol
368,353,30,106,233,29,262,0,262,3,138,121,21.04.2019 22:15,164,17,Ternopol
112,103,12,38,62,12,74,0,74,2,32,40,21.04.2019 22:00,164,17,Ternopol
208,206,16,88,111,9,120,0,120,1,70,49,21.04.2019 20:35,164,17,Ternopol
1152,1116,15,585,552,15,567,0,567,22,309,236,22.04.2019 00:37,164,17,Ternopol
912,887,23,395,495,22,517,0,517,29,283,205,21.04.2019 21:36,164,17,Ternopol
912,899,14,335,563,14,577,0,577,19,355,203,21.04.2019 23:10,164,17,Ternopol
80,71,9,24,47,9,56,0,56,2,36,18,21.04.2019 22:13,164,17,Ternopol
432,421,40,92,300,40,340,0,340,14,155,171,21.04.2019 20:57,164,17,Ternopol
192,184,26,52,118,22,140,0,140,3,70,67,21.04.2019 22:30,164,17,Ternopol
608,587,32,184,394,30,424,0,424,9,241,174,21.04.2019 22:20,164,17,Ternopol
976,957,24,377,575,24,599,0,599,17,318,264,21.04.2019 21:20,164,17,Ternopol
544,541,16,156,374,14,388,0,388,6,162,220,21.04.2019 21:06,164,17,Ternopol
288,282,18,74,196,18,214,0,214,7,115,92,21.04.2019 22:05,164,17,Ternopol
112,100,14,46,53,13,66,0,66,1,20,45,21.04.2019 20:46,164,17,Ternopol
240,232,12,90,140,10,150,0,150,2,103,45,21.04.2019 22:05,164,17,Ternopol
240,230,13,74,153,13,166,0,166,4,84,78,21.04.2019 21:30,164,17,Ternopol
240,232,21,102,117,21,138,0,138,3,94,41,21.04.2019 21:40,164,17,Ternopol
96,91,8,22,66,8,74,0,74,0,37,37,21.04.2019 21:15,164,17,Ternopol
784,795,80,247,465,72,537,0,537,12,323,202,21.04.2019 21:50,164,17,Ternopol
480,469,48,141,294,45,339,0,339,13,155,171,21.04.2019 20:54,164,17,Ternopol
128,121,16,50,63,15,78,0,78,5,47,26,22.04.2019 00:12,164,17,Ternopol
480,466,41,142,301,37,338,0,338,1,226,111,22.04.2019 00:12,164,17,Ternopol
352,346,30,122,200,30,230,0,230,4,113,113,21.04.2019 23:00,164,17,Ternopol
240,226,20,79,144,17,161,0,161,2,83,76,22.04.2019 00:15,164,17,Ternopol
320,303,8,133,182,5,187,0,187,2,98,87,22.04.2019 00:26,164,17,Ternopol
96,94,7,46,43,7,50,0,50,4,23,23,21.04.2019 21:15,164,17,Ternopol
528,507,34,171,323,34,357,0,357,2,179,176,21.04.2019 21:11,164,17,Ternopol
560,542,54,223,288,49,337,0,337,1,203,133,21.04.2019 21:12,164,17,Ternopol
768,759,43,261,470,37,507,0,507,7,299,201,21.04.2019 21:40,164,17,Ternopol
624,610,9,219,396,9,405,0,405,9,171,225,21.04.2019 21:00,164,17,Ternopol
400,389,22,137,243,20,263,0,263,6,151,106,21.04.2019 23:05,164,17,Ternopol
288,274,11,96,183,9,192,0,192,2,95,95,21.04.2019 20:31,164,17,Ternopol
848,838,58,328,474,46,520,0,520,15,313,192,22.04.2019 00:30,164,17,Ternopol
416,412,26,162,231,23,254,0,254,5,133,116,21.04.2019 21:08,164,17,Ternopol
304,301,20,101,183,20,203,0,203,10,122,71,21.04.2019 21:10,164,17,Ternopol
832,820,62,281,490,61,551,0,551,10,403,138,21.04.2019 21:40,164,17,Ternopol
224,217,21,86,120,18,138,0,138,3,97,38,21.04.2019 20:30,164,17,Ternopol
368,349,11,121,236,11,247,0,247,2,167,78,21.04.2019 21:00,164,17,Ternopol
64,51,7,24,33,7,40,0,40,2,32,6,21.04.2019 20:30,164,17,Ternopol
400,400,34,128,239,33,272,0,272,5,171,96,21.04.2019 22:30,164,17,Ternopol
304,295,12,135,160,9,169,0,169,3,96,70,21.04.2019 21:15,164,17,Ternopol
80,78,6,28,47,5,52,0,52,1,35,16,21.04.2019 20:30,164,17,Ternopol
528,500,40,221,274,33,307,0,307,5,170,132,21.04.2019 21:30,164,17,Ternopol
240,231,21,78,143,19,162,0,162,4,74,84,21.04.2019 21:10,164,17,Ternopol
176,167,16,61,99,16,115,0,115,3,56,56,21.04.2019 21:00,164,17,Ternopol
368,360,28,115,228,25,253,0,253,7,145,101,21.04.2019 20:50,164,17,Ternopol
320,316,22,93,205,22,227,0,227,1,126,100,21.04.2019 21:10,164,17,Ternopol
368,362,34,153,182,33,215,0,215,1,104,110,21.04.2019 22:10,164,17,Ternopol
560,553,51,198,314,48,362,0,362,7,225,130,21.04.2019 22:10,164,17,Ternopol
192,173,11,96,89,7,96,0,96,1,56,39,21.04.2019 21:47,164,17,Ternopol
464,450,26,165,274,25,299,0,299,9,152,138,21.04.2019 21:30,164,17,Ternopol
208,205,15,62,131,15,146,0,146,2,88,56,21.04.2019 21:20,164,17,Ternopol
480,471,20,167,293,20,313,0,313,6,173,134,21.04.2019 21:00,164,17,Ternopol
320,306,20,86,217,17,234,0,234,7,122,105,21.04.2019 22:05,164,17,Ternopol
160,155,14,41,105,14,119,0,119,1,66,52,21.04.2019 21:30,164,17,Ternopol
416,410,46,166,212,38,250,0,250,7,114,129,21.04.2019 21:00,164,17,Ternopol
320,303,22,97,201,22,223,0,223,1,141,81,21.04.2019 22:00,164,17,Ternopol
256,239,29,91,137,28,165,0,165,1,70,94,21.04.2019 21:19,164,17,Ternopol
528,520,10,149,369,10,379,0,379,7,212,160,21.04.2019 20:46,164,17,Ternopol
256,242,11,80,165,11,176,0,176,4,100,72,21.04.2019 21:30,164,17,Ternopol
528,514,16,166,346,16,362,0,362,4,223,135,21.04.2019 21:15,164,17,Ternopol
352,336,33,112,210,30,240,0,240,7,92,141,21.04.2019 21:40,164,17,Ternopol
336,315,18,140,178,18,196,0,196,2,106,88,21.04.2019 23:15,164,17,Ternopol
336,328,8,101,228,7,235,0,235,2,149,84,21.04.2019 21:07,164,17,Ternopol
288,278,18,97,175,16,191,0,191,5,109,77,21.04.2019 20:40,164,17,Ternopol
528,518,35,223,271,34,305,0,305,5,174,126,21.04.2019 21:40,164,17,Ternopol
464,444,32,196,238,30,268,0,268,4,187,77,21.04.2019 21:15,164,17,Ternopol
320,299,27,114,179,27,206,0,206,7,126,73,21.04.2019 21:20,164,17,Ternopol
416,410,39,151,232,33,265,0,265,2,167,96,21.04.2019 21:27,164,17,Ternopol
160,147,20,56,87,17,104,0,104,0,48,56,21.04.2019 21:30,164,17,Ternopol
448,441,62,111,276,61,337,0,337,3,178,156,21.04.2019 20:40,164,17,Ternopol
432,424,31,137,267,28,295,0,295,4,146,145,21.04.2019 20:45,164,17,Ternopol
784,756,50,321,414,49,463,0,463,9,306,148,21.04.2019 22:30,164,17,Ternopol
432,429,36,115,282,35,317,0,317,7,164,146,21.04.2019 21:15,164,17,Ternopol
448,438,26,157,265,26,291,0,291,9,188,94,21.04.2019 21:30,164,17,Ternopol
560,547,36,199,325,36,361,0,361,6,249,106,21.04.2019 21:30,164,17,Ternopol
1840,1805,32,723,1086,31,1117,0,1117,28,664,425,21.04.2019 22:25,164,17,Ternopol
1984,1959,32,717,1241,26,1267,0,1267,31,826,410,21.04.2019 23:47,164,17,Ternopol
48,26,0,23,25,0,25,0,25,0,8,17,21.04.2019 21:05,164,17,Ternopol
160,31,6,134,20,6,26,0,26,2,10,14,21.04.2019 20:45,164,17,Ternopol
240,231,15,85,141,14,155,0,155,4,79,72,21.04.2019 20:45,164,17,Ternopol
128,74,0,108,20,0,20,0,20,0,14,6,22.04.2019 01:10,164,17,Ternopol
368,364,24,73,273,22,295,0,295,9,166,120,21.04.2019 22:22,165,17,Ternopol
400,395,51,126,226,48,274,0,274,10,120,144,21.04.2019 20:30,165,17,Ternopol
640,634,61,179,404,57,461,0,461,12,232,217,21.04.2019 21:30,165,17,Ternopol
256,247,29,92,137,27,164,0,164,5,100,59,21.04.2019 22:15,165,17,Ternopol
560,559,51,240,280,40,320,0,320,9,124,187,21.04.2019 21:10,165,17,Ternopol
320,301,27,95,200,25,225,0,225,5,89,131,21.04.2019 21:30,165,17,Ternopol
224,213,36,103,95,26,121,0,121,1,72,48,21.04.2019 22:45,165,17,Ternopol
464,451,48,111,309,44,353,0,353,12,139,202,21.04.2019 21:30,165,17,Ternopol
240,221,79,74,96,70,166,0,166,2,51,113,21.04.2019 21:05,165,17,Ternopol
256,248,6,126,124,6,130,0,130,2,84,44,22.04.2019 00:05,165,17,Ternopol
64,59,4,29,32,3,35,0,35,0,10,25,22.04.2019 00:10,165,17,Ternopol
192,183,24,83,86,23,109,0,109,3,35,71,22.04.2019 00:10,165,17,Ternopol
144,145,20,23,101,20,121,0,121,2,52,67,22.04.2019 00:23,165,17,Ternopol
608,598,37,197,374,37,411,0,411,13,229,169,22.04.2019 00:10,165,17,Ternopol
400,396,29,170,201,29,230,0,230,10,119,101,22.04.2019 00:10,165,17,Ternopol
192,187,4,65,125,2,127,0,127,4,72,51,22.04.2019 00:05,165,17,Ternopol
320,303,21,102,198,20,218,0,218,15,94,109,22.04.2019 00:05,165,17,Ternopol
240,234,23,56,161,23,184,0,184,5,30,149,21.04.2019 21:35,165,17,Ternopol
528,511,43,79,406,43,449,0,449,8,173,268,22.04.2019 00:15,165,17,Ternopol
576,567,56,175,347,54,401,0,401,8,190,203,22.04.2019 00:05,165,17,Ternopol
112,98,10,42,61,9,70,0,70,2,36,32,22.04.2019 00:03,165,17,Ternopol
272,270,15,45,213,14,227,0,227,6,119,102,21.04.2019 22:00,165,17,Ternopol
336,313,35,117,187,32,219,0,219,4,108,107,22.04.2019 00:15,165,17,Ternopol
224,218,20,78,126,20,146,0,146,4,92,50,21.04.2019 22:05,165,17,Ternopol
224,203,11,99,114,11,125,0,125,0,50,75,22.04.2019 00:18,165,17,Ternopol
304,283,22,94,188,22,210,0,210,11,67,132,21.04.2019 23:15,165,17,Ternopol
352,335,17,119,216,17,233,0,233,7,110,116,21.04.2019 21:55,165,17,Ternopol
240,229,20,99,125,16,141,0,141,5,65,71,22.04.2019 00:20,165,17,Ternopol
160,148,8,54,98,8,106,0,106,3,54,49,22.04.2019 00:15,165,17,Ternopol
336,325,30,75,231,30,261,0,261,3,96,162,21.04.2019 21:10,165,17,Ternopol
208,199,20,73,117,18,135,0,135,8,55,72,21.04.2019 20:30,165,17,Ternopol
144,130,15,45,84,15,99,0,99,0,32,67,22.04.2019 00:15,165,17,Ternopol
160,151,14,65,83,12,95,0,95,2,49,44,22.04.2019 00:15,165,17,Ternopol
48,17,7,31,10,7,17,0,17,0,0,17,22.04.2019 00:12,165,17,Ternopol
1680,1645,26,678,979,23,1002,0,1002,27,456,519,21.04.2019 22:00,165,17,Ternopol
800,785,49,343,411,46,457,0,457,6,228,223,21.04.2019 22:00,165,17,Ternopol
1024,996,11,453,561,10,571,0,571,28,295,248,21.04.2019 21:50,165,17,Ternopol
144,140,7,41,96,7,103,0,103,0,61,42,21.04.2019 21:05,165,17,Ternopol
304,297,23,61,222,21,243,0,243,4,78,161,21.04.2019 21:00,165,17,Ternopol
672,668,47,247,381,44,425,0,425,7,195,223,21.04.2019 22:31,165,17,Ternopol
384,368,25,123,236,25,261,0,261,6,114,141,21.04.2019 20:40,165,17,Ternopol
272,265,19,95,158,19,177,0,177,6,43,128,21.04.2019 22:35,165,17,Ternopol
64,62,12,10,42,12,54,0,54,2,2,50,21.04.2019 23:15,165,17,Ternopol
496,493,21,226,249,21,270,0,270,5,125,140,21.04.2019 20:59,165,17,Ternopol
432,420,25,119,288,25,313,0,313,7,111,195,21.04.2019 22:45,165,17,Ternopol
224,214,11,97,116,11,127,0,127,4,52,71,22.04.2019 00:09,165,17,Ternopol
1984,1971,41,669,1277,38,1315,0,1315,70,596,649,21.04.2019 21:58,165,17,Ternopol
1776,1753,87,652,1041,83,1124,0,1124,39,548,537,21.04.2019 21:14,165,17,Ternopol
992,972,51,303,639,50,689,0,689,11,341,337,22.04.2019 00:25,165,17,Ternopol
560,552,25,207,332,21,353,0,353,14,179,160,21.04.2019 22:00,165,17,Ternopol
336,212,15,124,197,15,212,0,212,7,78,127,21.04.2019 23:10,165,17,Ternopol
496,476,42,146,311,39,350,0,350,16,167,167,21.04.2019 23:45,165,17,Ternopol
688,677,66,237,386,65,451,0,451,10,172,269,21.04.2019 20:56,165,17,Ternopol
400,388,21,94,285,21,306,0,306,12,147,147,21.04.2019 22:20,165,17,Ternopol
208,192,12,52,144,12,156,0,156,4,76,76,21.04.2019 22:20,165,17,Ternopol
432,416,23,148,262,22,284,0,284,5,157,122,21.04.2019 21:45,165,17,Ternopol
624,609,43,153,431,40,471,0,471,8,214,249,21.04.2019 20:30,165,17,Ternopol
1632,1622,44,518,1071,43,1114,0,1114,22,512,580,22.04.2019 00:25,165,17,Ternopol
48,19,0,29,19,0,19,0,19,1,7,11,21.04.2019 20:20,165,17,Ternopol
80,35,22,48,13,19,32,0,32,1,12,19,22.04.2019 00:10,165,17,Ternopol
544,538,36,161,348,35,383,0,383,9,124,250,22.04.2019 00:05,166,17,Ternopol
1120,1096,31,527,564,29,593,0,593,17,309,267,21.04.2019 23:45,166,17,Ternopol
736,728,28,299,412,25,437,0,437,20,217,200,22.04.2019 00:51,166,17,Ternopol
928,910,29,357,542,29,571,0,571,21,274,276,22.04.2019 00:30,166,17,Ternopol
640,634,35,264,341,35,376,0,376,14,175,187,22.04.2019 00:25,166,17,Ternopol
224,209,17,90,117,17,134,0,134,2,60,72,22.04.2019 00:10,166,17,Ternopol
416,408,46,122,253,41,294,0,294,4,103,187,21.04.2019 21:00,166,17,Ternopol
112,108,12,33,68,11,79,0,79,1,31,47,21.04.2019 21:30,166,17,Ternopol
1264,1238,73,490,704,70,774,0,774,25,442,307,22.04.2019 00:10,166,17,Ternopol
224,208,22,73,129,22,151,0,151,0,51,100,22.04.2019 00:40,166,17,Ternopol
208,197,6,93,110,5,115,0,115,5,19,91,22.04.2019 01:05,166,17,Ternopol
720,702,49,266,409,45,454,0,454,11,242,201,22.04.2019 00:05,166,17,Ternopol
688,685,40,197,451,40,491,0,491,7,170,314,21.04.2019 20:45,166,17,Ternopol
1152,1143,70,314,772,66,838,0,838,18,346,474,22.04.2019 00:10,166,17,Ternopol
224,218,22,52,152,20,172,0,172,2,79,91,22.04.2019 00:05,166,17,Ternopol
992,981,23,231,738,23,761,0,761,10,346,405,22.04.2019 01:30,166,17,Ternopol
624,617,18,140,466,18,484,0,484,10,246,228,22.04.2019 00:16,166,17,Ternopol
800,788,82,283,438,79,517,0,517,13,263,241,22.04.2019 00:12,166,17,Ternopol
240,225,1,83,157,0,157,0,157,4,76,77,21.04.2019 21:00,166,17,Ternopol
800,793,40,226,534,40,574,0,574,5,332,237,22.04.2019 00:15,166,17,Ternopol
1392,1370,91,596,705,91,796,0,796,16,368,412,21.04.2019 21:30,166,17,Ternopol
928,916,51,348,534,46,580,0,580,13,325,242,21.04.2019 20:38,166,17,Ternopol
720,709,57,163,500,57,557,0,557,6,329,222,21.04.2019 21:00,166,17,Ternopol
432,425,22,95,315,22,337,0,337,3,193,141,21.04.2019 21:30,166,17,Ternopol
832,817,15,339,478,15,493,0,493,8,241,244,21.04.2019 22:00,166,17,Ternopol
112,101,13,46,53,13,66,0,66,5,36,25,21.04.2019 23:30,166,17,Ternopol
960,958,54,265,643,52,695,0,695,13,394,288,21.04.2019 22:05,166,17,Ternopol
336,324,18,92,226,18,244,0,244,6,159,79,21.04.2019 23:45,166,17,Ternopol
144,134,9,57,78,9,87,0,87,1,65,21,21.04.2019 23:30,166,17,Ternopol
816,794,74,270,475,71,546,0,546,12,268,266,22.04.2019 00:01,166,17,Ternopol
720,724,64,302,356,62,418,0,418,14,240,164,21.04.2019 22:10,166,17,Ternopol
1408,1391,66,564,783,61,844,0,844,29,443,372,22.04.2019 00:30,166,17,Ternopol
480,463,26,145,311,24,335,0,335,10,148,177,22.04.2019 00:05,166,17,Ternopol
320,310,22,82,216,22,238,0,238,10,92,136,21.04.2019 22:00,166,17,Ternopol
448,436,45,125,279,44,323,0,323,3,161,159,21.04.2019 20:50,166,17,Ternopol
384,376,20,112,252,20,272,0,272,10,154,108,22.04.2019 00:05,166,17,Ternopol
96,92,7,42,48,6,54,0,54,0,31,23,21.04.2019 22:00,166,17,Ternopol
1680,1664,65,699,921,60,981,0,981,27,458,496,22.04.2019 00:30,166,17,Ternopol
1520,1494,14,721,786,13,799,0,799,34,387,378,21.04.2019 23:40,166,17,Ternopol
160,158,19,58,85,17,102,0,102,6,40,56,21.04.2019 21:30,166,17,Ternopol
176,169,13,58,106,12,118,0,118,0,50,68,21.04.2019 23:55,166,17,Ternopol
448,440,15,181,252,15,267,0,267,7,170,90,21.04.2019 23:45,166,17,Ternopol
240,237,29,65,146,29,175,0,175,10,110,55,21.04.2019 23:35,166,17,Ternopol
1136,1124,95,446,599,91,690,0,690,24,370,296,22.04.2019 00:15,166,17,Ternopol
336,319,23,75,238,23,261,0,261,11,101,149,21.04.2019 22:30,166,17,Ternopol
992,988,88,382,529,81,610,0,610,12,354,244,21.04.2019 23:05,166,17,Ternopol
496,482,26,137,333,26,359,0,359,11,138,210,22.04.2019 00:15,166,17,Ternopol
576,568,32,122,422,32,454,0,454,13,252,189,21.04.2019 23:50,166,17,Ternopol
720,705,32,220,468,32,500,0,500,6,265,229,22.04.2019 01:05,166,17,Ternopol
464,461,21,139,304,21,325,0,325,5,181,139,21.04.2019 21:30,166,17,Ternopol
160,159,4,43,113,4,117,0,117,1,67,49,22.04.2019 00:20,166,17,Ternopol
1008,992,81,326,601,81,682,0,682,11,439,232,22.04.2019 00:10,166,17,Ternopol
1104,1088,22,517,568,19,587,0,587,15,394,178,22.04.2019 00:05,166,17,Ternopol
1424,1404,12,709,705,10,715,0,715,26,423,266,22.04.2019 00:05,166,17,Ternopol
816,797,52,288,482,46,528,0,528,10,312,206,21.04.2019 21:45,166,17,Ternopol
144,134,21,47,78,19,97,0,97,0,55,42,21.04.2019 23:00,166,17,Ternopol
1296,1282,47,565,685,46,731,0,731,31,463,237,22.04.2019 00:40,166,17,Ternopol
752,741,54,148,550,54,604,0,604,7,291,306,22.04.2019 00:30,166,17,Ternopol
464,453,34,163,269,32,301,0,301,4,178,119,22.04.2019 00:50,166,17,Ternopol
224,206,16,71,137,16,153,0,153,1,90,62,22.04.2019 00:45,166,17,Ternopol
784,778,33,379,372,33,405,0,405,9,194,202,22.04.2019 00:15,166,17,Ternopol
672,660,74,249,349,74,423,0,423,11,182,230,21.04.2019 22:00,166,17,Ternopol
416,411,30,143,243,30,273,0,273,12,151,110,22.04.2019 00:30,166,17,Ternopol
496,484,49,148,299,49,348,0,348,15,160,173,22.04.2019 00:30,166,17,Ternopol
432,413,18,172,247,13,260,0,260,5,161,94,22.04.2019 00:20,166,17,Ternopol
176,169,14,67,95,14,109,0,109,0,59,50,21.04.2019 23:00,166,17,Ternopol
240,227,34,57,153,30,183,0,183,2,77,104,21.04.2019 21:00,166,17,Ternopol
864,849,58,310,497,57,554,0,554,10,183,361,21.04.2019 23:57,166,17,Ternopol
320,319,41,94,187,39,226,0,226,7,122,97,22.04.2019 00:40,166,17,Ternopol
256,243,25,134,103,19,122,0,122,4,58,60,21.04.2019 21:50,166,17,Ternopol
464,440,48,169,249,46,295,0,295,14,172,109,21.04.2019 20:40,166,17,Ternopol
416,425,58,64,294,58,352,0,352,3,107,242,21.04.2019 21:40,166,17,Ternopol
544,527,56,173,317,54,371,0,371,7,179,185,21.04.2019 22:15,166,17,Ternopol
528,512,56,190,285,53,338,0,338,5,133,200,21.04.2019 21:00,166,17,Ternopol
432,433,38,97,298,37,335,0,335,11,122,202,21.04.2019 21:30,166,17,Ternopol
320,312,43,67,210,43,253,0,253,8,150,95,22.04.2019 00:40,166,17,Ternopol
400,401,24,107,269,24,293,0,293,4,168,121,22.04.2019 00:07,166,17,Ternopol
512,504,32,103,377,32,409,0,409,17,211,181,22.04.2019 00:10,166,17,Ternopol
352,344,19,65,268,19,287,0,287,2,122,163,22.04.2019 00:05,166,17,Ternopol
576,572,57,228,292,56,348,0,348,8,182,158,21.04.2019 22:15,166,17,Ternopol
208,211,25,48,135,25,160,0,160,2,59,99,22.04.2019 00:10,166,17,Ternopol
96,83,13,22,61,13,74,0,74,0,31,43,21.04.2019 23:55,166,17,Ternopol
1216,1199,74,496,646,74,720,0,720,13,374,333,22.04.2019 00:25,166,17,Ternopol
1072,1057,38,244,790,38,828,0,828,20,358,450,22.04.2019 00:35,166,17,Ternopol
80,78,15,25,40,15,55,0,55,0,21,34,22.04.2019 00:50,166,17,Ternopol
272,264,36,74,168,30,198,0,198,4,72,122,22.04.2019 00:15,166,17,Ternopol
928,927,80,156,692,80,772,0,772,17,409,346,22.04.2019 00:05,166,17,Ternopol
160,154,16,37,107,16,123,0,123,8,42,73,21.04.2019 23:30,166,17,Ternopol
288,282,19,96,175,17,192,0,192,8,76,108,21.04.2019 20:40,166,17,Ternopol
480,474,22,167,291,22,313,0,313,5,121,187,22.04.2019 00:30,166,17,Ternopol
416,404,13,166,237,13,250,0,250,7,113,130,21.04.2019 21:50,166,17,Ternopol
224,212,8,88,128,8,136,0,136,0,68,68,22.04.2019 00:10,166,17,Ternopol
416,403,46,141,231,44,275,0,275,5,126,144,21.04.2019 23:30,166,17,Ternopol
272,268,16,61,195,16,211,0,211,7,87,117,21.04.2019 20:30,166,17,Ternopol
176,165,6,35,135,6,141,0,141,0,73,68,22.04.2019 00:00,166,17,Ternopol
64,50,0,18,46,0,46,0,46,0,17,29,22.04.2019 00:15,166,17,Ternopol
592,586,83,187,326,79,405,0,405,6,135,264,22.04.2019 00:55,166,17,Ternopol
384,381,51,122,211,51,262,0,262,2,106,154,22.04.2019 00:15,166,17,Ternopol
176,161,15,59,102,15,117,0,117,2,47,68,22.04.2019 00:05,166,17,Ternopol
336,324,21,87,232,17,249,0,249,5,131,113,22.04.2019 00:15,166,17,Ternopol
272,269,26,67,182,23,205,0,205,6,130,69,22.04.2019 00:05,166,17,Ternopol
1056,1034,59,379,622,55,677,0,677,14,334,329,22.04.2019 00:05,166,17,Ternopol
336,327,14,139,183,14,197,0,197,5,103,89,22.04.2019 00:15,166,17,Ternopol
192,181,10,94,90,8,98,0,98,5,41,52,21.04.2019 23:15,166,17,Ternopol
688,682,69,248,381,59,440,0,440,8,191,241,22.04.2019 01:12,166,17,Ternopol
176,165,23,75,80,21,101,0,101,4,29,68,22.04.2019 00:20,166,17,Ternopol
176,163,15,69,92,15,107,0,107,1,52,54,21.04.2019 20:42,166,17,Ternopol
944,945,15,426,504,14,518,0,518,15,243,260,21.04.2019 23:00,166,17,Ternopol
1344,1331,20,574,753,17,770,0,770,27,374,369,21.04.2019 21:30,166,17,Ternopol
2160,2262,17,886,1263,11,1274,0,1274,58,694,522,22.04.2019 01:05,166,17,Ternopol
2160,2133,144,998,1029,133,1162,0,1162,28,620,514,22.04.2019 00:45,166,17,Ternopol
1072,1058,25,417,631,24,655,0,655,27,314,314,22.04.2019 01:00,166,17,Ternopol
272,222,31,51,190,31,221,0,221,25,162,34,21.04.2019 20:50,167,17,Ternopol
1392,1353,4,667,721,4,725,0,725,35,414,276,21.04.2019 21:47,167,17,Ternopol
2032,2001,31,934,1067,31,1098,0,1098,40,689,369,21.04.2019 22:20,167,17,Ternopol
1056,1038,17,461,578,17,595,0,595,31,367,197,22.04.2019 00:15,167,17,Ternopol
752,742,83,303,369,80,449,0,449,6,245,198,21.04.2019 22:15,167,17,Ternopol
384,391,31,117,240,27,267,0,267,8,166,93,21.04.2019 21:25,167,17,Ternopol
240,242,13,80,149,11,160,0,160,8,97,55,21.04.2019 21:10,167,17,Ternopol
1120,1095,66,415,645,60,705,0,705,19,415,271,22.04.2019 00:15,167,17,Ternopol
1904,1865,82,959,866,79,945,0,945,28,506,411,21.04.2019 23:58,167,17,Ternopol
816,855,16,388,412,16,428,0,428,20,205,203,21.04.2019 23:45,167,17,Ternopol
176,162,6,53,117,6,123,0,123,0,71,52,21.04.2019 21:00,167,17,Ternopol
96,83,0,35,61,0,61,0,61,8,40,13,21.04.2019 22:00,167,17,Ternopol
96,89,5,32,59,5,64,0,64,2,42,20,21.04.2019 20:35,167,17,Ternopol
288,280,29,85,174,29,203,0,203,2,92,109,21.04.2019 21:55,167,17,Ternopol
160,157,16,32,113,15,128,0,128,3,96,29,21.04.2019 22:00,167,17,Ternopol
432,418,36,170,232,30,262,0,262,4,139,119,22.04.2019 00:15,167,17,Ternopol
112,104,6,47,60,5,65,0,65,1,36,28,21.04.2019 22:00,167,17,Ternopol
288,272,20,118,157,13,170,0,170,5,123,42,21.04.2019 21:30,167,17,Ternopol
448,438,37,162,250,36,286,0,286,9,125,152,21.04.2019 22:50,167,17,Ternopol
240,227,19,83,140,17,157,0,157,5,96,56,21.04.2019 22:11,167,17,Ternopol
480,474,28,157,295,28,323,0,323,10,215,98,21.04.2019 23:50,167,17,Ternopol
624,631,48,227,349,48,397,0,397,6,182,209,22.04.2019 00:18,167,17,Ternopol
352,344,21,125,206,21,227,0,227,3,113,111,21.04.2019 21:30,167,17,Ternopol
192,189,35,43,116,33,149,0,149,3,68,78,22.04.2019 00:00,167,17,Ternopol
1600,1570,25,813,765,22,787,0,787,26,490,271,22.04.2019 00:13,167,17,Ternopol
1584,1566,23,674,892,18,910,0,910,29,542,339,21.04.2019 22:35,167,17,Ternopol
432,425,16,184,233,15,248,0,248,4,131,113,22.04.2019 00:01,167,17,Ternopol
336,333,19,111,210,15,225,0,225,2,163,60,21.04.2019 22:20,167,17,Ternopol
624,617,60,234,335,55,390,0,390,10,168,212,21.04.2019 21:10,167,17,Ternopol
768,757,22,110,636,22,658,0,658,5,192,461,21.04.2019 23:58,167,17,Ternopol
448,434,10,120,319,9,328,0,328,3,190,135,21.04.2019 21:30,167,17,Ternopol
304,298,13,101,190,13,203,0,203,8,127,68,21.04.2019 21:00,167,17,Ternopol
528,523,47,208,273,47,320,0,320,12,127,181,21.04.2019 23:30,167,17,Ternopol
288,282,29,105,159,24,183,0,183,5,96,82,21.04.2019 20:52,167,17,Ternopol
368,350,19,102,247,19,266,0,266,8,105,153,21.04.2019 23:21,167,17,Ternopol
672,653,50,241,383,48,431,0,431,14,183,234,21.04.2019 21:55,167,17,Ternopol
128,121,9,33,89,6,95,0,95,0,35,60,21.04.2019 20:45,167,17,Ternopol
1104,1090,67,311,731,62,793,0,793,24,513,256,22.04.2019 00:25,167,17,Ternopol
448,436,32,96,320,32,352,0,352,7,183,162,22.04.2019 00:11,167,17,Ternopol
1136,1146,56,497,583,56,639,0,639,17,343,279,22.04.2019 00:00,167,17,Ternopol
1344,1318,40,633,674,37,711,0,711,20,381,310,21.04.2019 22:40,167,17,Ternopol
80,77,7,17,58,5,63,0,63,3,36,24,21.04.2019 22:10,167,17,Ternopol
640,628,74,221,349,70,419,0,419,5,247,167,21.04.2019 21:50,167,17,Ternopol
160,154,6,37,117,6,123,0,123,6,73,44,21.04.2019 20:55,167,17,Ternopol
176,162,19,47,112,17,129,0,129,0,84,45,21.04.2019 22:53,167,17,Ternopol
560,549,53,143,364,53,417,0,417,7,227,183,21.04.2019 23:45,167,17,Ternopol
256,240,22,116,120,20,140,0,140,3,72,65,21.04.2019 22:03,167,17,Ternopol
640,627,29,169,442,29,471,0,471,10,275,186,21.04.2019 21:25,167,17,Ternopol
272,258,13,100,159,13,172,0,172,6,106,60,21.04.2019 21:50,167,17,Ternopol
592,590,51,126,417,49,466,0,466,14,148,304,21.04.2019 23:16,167,17,Ternopol
1488,1478,42,697,749,42,791,0,791,30,374,387,21.04.2019 21:55,167,17,Ternopol
1424,1398,83,604,737,83,820,0,820,16,447,357,21.04.2019 22:51,167,17,Ternopol
208,205,10,66,132,10,142,0,142,1,66,75,21.04.2019 20:45,167,17,Ternopol
112,92,12,46,54,12,66,0,66,3,36,27,21.04.2019 22:50,167,17,Ternopol
208,196,17,104,89,15,104,0,104,2,63,39,21.04.2019 21:30,167,17,Ternopol
800,789,57,192,552,56,608,0,608,11,257,340,21.04.2019 23:08,167,17,Ternopol
832,812,35,343,454,35,489,0,489,7,267,215,21.04.2019 21:10,167,17,Ternopol
944,942,43,379,523,42,565,0,565,21,276,268,21.04.2019 22:48,167,17,Ternopol
336,317,21,94,221,21,242,0,242,4,164,74,21.04.2019 21:15,167,17,Ternopol
384,369,39,104,243,37,280,0,280,9,148,123,21.04.2019 22:45,167,17,Ternopol
448,448,35,147,267,34,301,0,301,9,120,172,21.04.2019 22:15,167,17,Ternopol
752,729,86,310,358,84,442,0,442,10,197,235,21.04.2019 22:15,167,17,Ternopol
80,68,5,37,38,5,43,0,43,0,8,35,21.04.2019 21:50,167,17,Ternopol
288,285,23,116,149,23,172,0,172,3,108,61,21.04.2019 21:05,167,17,Ternopol
304,290,21,106,178,20,198,0,198,4,91,103,22.04.2019 00:09,167,17,Ternopol
1344,1306,68,429,851,64,915,0,915,15,476,424,21.04.2019 23:20,167,17,Ternopol
368,352,28,174,166,28,194,0,194,9,93,92,21.04.2019 21:20,167,17,Ternopol
336,324,17,121,198,17,215,0,215,6,101,108,21.04.2019 22:30,167,17,Ternopol
128,114,15,56,60,12,72,0,72,2,28,42,21.04.2019 21:10,167,17,Ternopol
496,486,42,208,250,38,288,0,288,5,95,188,21.04.2019 20:38,167,17,Ternopol
480,471,24,150,306,24,330,0,330,4,180,146,21.04.2019 22:02,167,17,Ternopol
448,426,51,117,280,51,331,0,331,5,172,154,21.04.2019 21:50,167,17,Ternopol
512,515,45,189,278,45,323,0,323,6,203,114,21.04.2019 21:01,167,17,Ternopol
464,452,34,93,337,34,371,0,371,9,176,186,21.04.2019 22:05,167,17,Ternopol
1328,1308,81,377,886,65,951,0,951,13,303,635,21.04.2019 21:00,167,17,Ternopol
784,774,51,281,452,51,503,0,503,18,315,170,21.04.2019 21:15,167,17,Ternopol
160,155,8,44,108,8,116,0,116,0,63,53,21.04.2019 22:18,167,17,Ternopol
192,179,21,60,111,21,132,0,132,3,52,77,21.04.2019 22:43,167,17,Ternopol
528,517,32,185,317,26,343,0,343,7,143,193,21.04.2019 23:15,167,17,Ternopol
160,153,14,64,87,9,96,0,96,3,55,38,21.04.2019 22:19,167,17,Ternopol
832,816,5,160,667,5,672,0,672,11,253,408,21.04.2019 22:25,167,17,Ternopol
400,384,27,158,217,25,242,0,242,2,111,129,21.04.2019 20:40,167,17,Ternopol
240,235,30,65,146,29,175,0,175,0,76,99,21.04.2019 20:55,167,17,Ternopol
592,586,57,227,309,56,365,0,365,19,245,101,22.04.2019 00:09,167,17,Ternopol
752,734,63,296,393,63,456,0,456,11,261,184,21.04.2019 20:46,167,17,Ternopol
912,898,88,322,503,87,590,0,590,14,307,269,21.04.2019 22:30,167,17,Ternopol
80,82,8,25,48,7,55,0,55,3,27,25,21.04.2019 21:10,167,17,Ternopol
336,332,34,99,205,32,237,0,237,6,101,130,21.04.2019 22:10,167,17,Ternopol
1616,1588,23,661,935,20,955,0,955,29,475,451,21.04.2019 23:30,167,17,Ternopol
1296,1288,20,570,707,19,726,0,726,29,339,358,21.04.2019 21:19,167,17,Ternopol
2016,1998,8,961,1049,6,1055,0,1055,28,521,506,22.04.2019 00:00,167,17,Ternopol
1072,1043,14,473,586,13,599,0,599,24,325,250,21.04.2019 23:10,167,17,Ternopol
1072,1048,20,523,532,17,549,0,549,14,256,279,21.04.2019 21:20,167,17,Ternopol
1040,1071,6,358,676,6,682,0,682,13,376,293,21.04.2019 22:03,167,17,Ternopol
1632,1608,46,680,917,35,952,0,952,36,483,433,21.04.2019 21:19,167,17,Ternopol
768,766,18,314,438,16,454,0,454,13,211,230,21.04.2019 22:12,167,17,Ternopol
1696,1663,46,807,851,38,889,0,889,29,431,429,21.04.2019 21:47,167,17,Ternopol
736,716,15,319,403,14,417,0,417,11,248,158,21.04.2019 22:08,167,17,Ternopol
128,117,4,54,71,3,74,0,74,0,37,37,21.04.2019 22:10,167,17,Ternopol
544,539,46,193,308,43,351,0,351,13,149,189,21.04.2019 21:15,167,17,Ternopol
1088,1064,19,540,530,18,548,0,548,14,283,251,21.04.2019 20:48,167,17,Ternopol
128,119,4,50,74,4,78,0,78,0,52,26,21.04.2019 20:30,167,17,Ternopol
2112,2093,10,935,1167,10,1177,0,1177,21,959,197,21.04.2019 22:20,168,18,Harkov
1808,1801,20,546,1249,13,1262,0,1262,20,1041,201,21.04.2019 21:30,168,18,Harkov
2112,2094,9,703,1404,5,1409,0,1409,39,1175,195,22.04.2019 00:05,168,18,Harkov
1776,1754,5,577,1194,5,1199,0,1199,30,968,201,21.04.2019 22:18,168,18,Harkov
1552,1540,12,535,1005,12,1017,0,1017,30,805,182,21.04.2019 22:55,168,18,Harkov
1312,1315,11,452,853,7,860,0,860,14,668,178,21.04.2019 22:15,168,18,Harkov
1616,1619,9,510,1099,7,1106,0,1106,30,824,252,21.04.2019 22:30,168,18,Harkov
2032,2037,22,694,1319,19,1338,0,1338,51,1027,260,21.04.2019 22:55,168,18,Harkov
1984,1987,15,718,1254,12,1266,0,1266,39,1015,212,21.04.2019 22:30,168,18,Harkov
2160,2120,10,887,1266,7,1273,0,1273,26,1025,222,21.04.2019 22:30,168,18,Harkov
2336,2335,28,774,1534,28,1562,0,1562,41,1164,357,21.04.2019 23:32,168,18,Harkov
2048,2049,27,774,1255,19,1274,0,1274,28,1074,172,21.04.2019 22:18,168,18,Harkov
2128,2146,13,670,1447,11,1458,0,1458,47,1121,290,21.04.2019 21:30,168,18,Harkov
1984,2009,18,601,1374,9,1383,0,1383,57,1041,285,22.04.2019 00:10,168,18,Harkov
2096,2081,11,629,1457,10,1467,0,1467,40,1089,338,22.04.2019 00:00,168,18,Harkov
2272,2276,18,784,1474,14,1488,0,1488,48,1136,304,22.04.2019 00:10,168,18,Harkov
2128,2106,8,613,1509,6,1515,0,1515,34,1299,182,21.04.2019 22:45,168,18,Harkov
2208,2226,12,708,1490,10,1500,0,1500,37,1151,312,21.04.2019 22:30,168,18,Harkov
2048,2054,15,707,1330,11,1341,0,1341,42,1050,249,21.04.2019 22:15,168,18,Harkov
480,138,6,345,130,5,135,0,135,3,126,6,22.04.2019 00:16,168,18,Harkov
1680,1795,28,505,1153,22,1175,0,1174,41,886,247,22.04.2019 00:10,169,18,Harkov
1792,1852,23,554,1217,21,1238,0,1238,28,941,269,22.04.2019 00:30,169,18,Harkov
2368,2370,28,824,1520,24,1544,0,1544,47,1199,298,22.04.2019 00:01,169,18,Harkov
1744,1821,36,516,1201,27,1228,0,1228,27,872,329,21.04.2019 22:45,169,18,Harkov
1760,1776,28,568,1168,24,1192,0,1192,48,884,260,22.04.2019 00:10,169,18,Harkov
1984,1988,31,565,1397,22,1419,0,1419,44,1075,300,22.04.2019 00:15,169,18,Harkov
1504,1432,1,453,1050,1,1051,0,1051,25,877,149,21.04.2019 22:40,169,18,Harkov
2096,2074,17,721,1366,9,1375,0,1375,42,1041,292,21.04.2019 22:05,169,18,Harkov
1744,1780,19,560,1168,16,1184,0,1184,32,862,290,22.04.2019 00:25,169,18,Harkov
1936,1933,25,640,1274,22,1296,0,1296,42,959,295,22.04.2019 00:07,169,18,Harkov
1936,1952,17,690,1233,13,1246,0,1246,31,961,254,22.04.2019 00:12,169,18,Harkov
1936,1918,10,637,1292,7,1299,0,1299,23,1120,156,22.04.2019 00:40,169,18,Harkov
1840,1847,13,591,1236,13,1249,0,1249,26,1040,183,22.04.2019 01:37,169,18,Harkov
1280,1261,3,451,826,3,829,0,829,15,720,94,21.04.2019 23:05,169,18,Harkov
3072,2922,7,1021,2047,4,2051,0,2051,42,1658,351,22.04.2019 01:20,169,18,Harkov
1088,1074,0,436,652,0,652,0,652,11,560,81,22.04.2019 00:05,169,18,Harkov
2480,2455,32,932,1522,26,1548,0,1548,35,1370,143,22.04.2019 00:10,169,18,Harkov
1712,1725,9,560,1145,7,1152,0,1152,27,924,201,22.04.2019 00:09,169,18,Harkov
928,928,24,332,575,21,596,0,596,17,516,63,22.04.2019 00:20,169,18,Harkov
1792,1795,15,731,1049,12,1061,0,1061,16,895,150,22.04.2019 00:30,169,18,Harkov
1760,1776,9,526,1227,7,1234,0,1234,25,991,218,22.04.2019 00:07,169,18,Harkov
1664,1652,11,520,1135,9,1144,0,1144,37,937,170,21.04.2019 22:22,169,18,Harkov
1792,1792,15,558,1223,11,1234,0,1234,23,1015,196,21.04.2019 23:20,169,18,Harkov
1856,1861,15,576,1271,9,1280,0,1280,34,1043,203,21.04.2019 23:30,169,18,Harkov
1840,1843,11,579,1252,9,1261,0,1261,35,1031,195,22.04.2019 00:12,169,18,Harkov
1936,1949,9,591,1338,7,1345,0,1345,44,1101,200,22.04.2019 00:00,169,18,Harkov
2000,1963,13,826,1164,10,1174,0,1174,13,1025,136,21.04.2019 23:50,169,18,Harkov
1904,1870,17,685,1210,9,1219,0,1219,25,1041,153,21.04.2019 23:59,169,18,Harkov
2000,2012,23,624,1363,13,1376,0,1376,26,1122,228,22.04.2019 00:30,169,18,Harkov
2112,2097,10,603,1503,6,1509,0,1509,29,1227,253,22.04.2019 00:05,169,18,Harkov
2144,2133,19,684,1445,15,1460,0,1460,48,1210,202,22.04.2019 00:15,169,18,Harkov
2160,2139,16,624,1525,11,1536,0,1536,38,1255,243,22.04.2019 00:05,169,18,Harkov
1680,1664,15,491,1177,12,1189,0,1189,32,919,238,22.04.2019 00:30,169,18,Harkov
1792,1771,13,660,1125,7,1132,0,1132,31,892,209,22.04.2019 00:17,169,18,Harkov
1840,1834,12,541,1290,9,1299,0,1299,32,948,319,22.04.2019 00:11,169,18,Harkov
1360,1348,9,439,914,7,921,0,921,27,739,155,22.04.2019 00:30,169,18,Harkov
1952,1934,8,611,1334,7,1341,0,1341,45,1141,155,22.04.2019 00:05,169,18,Harkov
1888,1883,8,533,1347,8,1355,0,1355,28,1189,138,22.04.2019 00:30,169,18,Harkov
1856,1836,10,550,1297,9,1306,0,1306,29,1103,174,22.04.2019 00:15,169,18,Harkov
1904,1889,13,610,1281,13,1294,0,1294,32,1084,178,22.04.2019 00:18,169,18,Harkov
1744,1732,6,582,1159,3,1162,0,1162,15,1030,117,22.04.2019 00:07,169,18,Harkov
2048,2020,7,670,1374,4,1378,0,1378,23,1156,199,21.04.2019 21:40,169,18,Harkov
1312,1299,3,389,921,2,923,0,923,12,777,134,22.04.2019 00:01,169,18,Harkov
2112,2079,11,729,1379,4,1383,0,1383,28,1164,191,22.04.2019 00:30,169,18,Harkov
1920,1904,5,553,1365,2,1367,0,1367,25,1176,166,22.04.2019 00:20,169,18,Harkov
1712,1696,8,546,1160,6,1166,0,1166,25,989,152,22.04.2019 00:25,169,18,Harkov
2000,1973,5,685,1311,4,1315,0,1315,21,1116,178,22.04.2019 00:05,169,18,Harkov
128,15,0,113,15,0,15,0,15,1,12,2,22.04.2019 00:05,169,18,Harkov
240,71,24,171,45,24,69,0,69,2,55,12,21.04.2019 22:55,169,18,Harkov
272,91,1,181,90,1,91,0,91,4,80,7,21.04.2019 20:55,169,18,Harkov
256,58,0,200,56,0,56,0,56,2,50,4,21.04.2019 21:10,169,18,Harkov
256,67,34,190,32,34,66,0,66,3,52,11,22.04.2019 00:15,169,18,Harkov
256,192,0,65,191,0,191,0,191,6,156,29,22.04.2019 00:14,169,18,Harkov
128,31,0,97,31,0,31,0,31,0,24,7,22.04.2019 00:15,169,18,Harkov
144,33,6,113,25,6,31,0,31,1,23,7,22.04.2019 00:05,169,18,Harkov
160,69,0,94,66,0,66,0,66,1,56,9,22.04.2019 00:11,169,18,Harkov
512,187,63,333,118,61,179,0,179,9,155,15,22.04.2019 00:10,169,18,Harkov
176,22,2,155,19,2,21,0,21,0,17,4,21.04.2019 21:02,169,18,Harkov
1440,1423,8,544,890,6,896,0,896,24,720,152,22.04.2019 00:30,169,18,Harkov
1744,1796,13,483,1252,9,1261,0,1261,31,1001,229,22.04.2019 00:01,169,18,Harkov
1312,1295,17,481,824,7,831,0,831,17,674,140,22.04.2019 00:15,169,18,Harkov
1216,1203,17,448,753,15,768,0,768,11,643,114,22.04.2019 00:10,169,18,Harkov
1264,1253,21,512,739,13,752,0,752,16,642,94,22.04.2019 00:15,169,18,Harkov
1840,1842,11,590,1240,10,1250,0,1250,33,1008,209,22.04.2019 00:10,169,18,Harkov
1536,1521,19,534,986,16,1002,0,1002,29,843,130,22.04.2019 00:10,169,18,Harkov
1744,1732,12,568,1167,9,1176,0,1176,32,968,176,22.04.2019 00:01,169,18,Harkov
2128,2121,12,683,1436,9,1445,0,1445,25,1187,233,22.04.2019 00:05,169,18,Harkov
96,36,0,60,36,0,36,0,36,0,33,3,22.04.2019 00:05,169,18,Harkov
96,25,2,71,23,2,25,0,25,3,20,2,21.04.2019 22:00,169,18,Harkov
96,20,0,77,19,0,19,0,19,0,17,2,22.04.2019 00:07,169,18,Harkov
1136,1123,17,423,702,11,713,0,713,30,567,116,22.04.2019 00:55,169,18,Harkov
2496,2505,9,843,1646,7,1653,0,1653,35,1310,308,22.04.2019 00:01,169,18,Harkov
1008,997,5,373,631,4,635,0,635,10,539,86,22.04.2019 00:11,169,18,Harkov
832,819,6,271,555,6,561,0,561,10,456,95,22.04.2019 00:24,170,18,Harkov
2096,2081,10,720,1367,9,1376,0,1376,21,1185,170,21.04.2019 21:44,170,18,Harkov
2176,2177,4,710,1463,3,1466,0,1466,24,1267,175,21.04.2019 21:55,170,18,Harkov
1264,1265,4,407,856,1,857,0,857,15,744,98,22.04.2019 00:01,170,18,Harkov
2224,2210,11,937,1280,7,1287,0,1287,31,1105,151,22.04.2019 01:05,170,18,Harkov
2304,2291,22,814,1469,21,1490,0,1490,26,1283,181,21.04.2019 21:51,170,18,Harkov
2096,2090,6,809,1282,5,1287,0,1287,28,1129,130,22.04.2019 00:30,170,18,Harkov
1920,1927,10,675,1240,5,1245,0,1245,26,1117,102,21.04.2019 23:50,170,18,Harkov
2352,2294,14,998,1345,9,1354,0,1354,35,1185,134,22.04.2019 00:13,170,18,Harkov
1872,1873,8,625,1240,7,1247,0,1247,13,1069,165,22.04.2019 00:22,170,18,Harkov
2176,2164,4,738,1436,2,1438,0,1438,28,1229,181,22.04.2019 00:05,170,18,Harkov
2224,2208,14,790,1422,12,1434,0,1434,33,1246,155,22.04.2019 00:10,170,18,Harkov
1984,1969,3,603,1378,3,1381,0,1381,35,1179,167,22.04.2019 00:07,170,18,Harkov
1872,1871,2,719,1152,1,1153,0,1153,19,1024,110,21.04.2019 22:20,170,18,Harkov
2160,2143,7,713,1442,5,1447,0,1447,21,1255,171,22.04.2019 01:30,170,18,Harkov
2288,2282,10,763,1518,7,1525,0,1525,23,1314,188,22.04.2019 00:05,170,18,Harkov
2032,2009,18,707,1310,15,1325,0,1325,25,1166,134,22.04.2019 00:13,170,18,Harkov
2208,2190,10,762,1438,8,1446,0,1446,26,1259,161,22.04.2019 00:10,170,18,Harkov
2208,2199,16,721,1474,13,1487,0,1487,29,1279,179,21.04.2019 22:20,170,18,Harkov
1328,1324,10,414,905,9,914,0,914,10,807,97,21.04.2019 22:03,170,18,Harkov
1504,1497,7,471,1026,7,1033,0,1033,28,910,95,21.04.2019 21:36,170,18,Harkov
1872,1864,11,632,1230,10,1240,0,1240,20,1062,158,21.04.2019 23:55,170,18,Harkov
1952,1927,13,682,1258,12,1270,0,1270,14,1126,130,21.04.2019 21:40,170,18,Harkov
1760,1741,8,593,1159,8,1167,0,1167,32,995,140,22.04.2019 00:35,170,18,Harkov
1968,1962,17,689,1266,13,1279,0,1279,24,1096,159,21.04.2019 21:40,170,18,Harkov
2224,2217,14,715,1500,9,1509,0,1509,22,1315,172,21.04.2019 21:58,170,18,Harkov
2032,2017,10,739,1284,9,1293,0,1293,29,1150,114,21.04.2019 21:27,170,18,Harkov
2112,2108,18,787,1310,15,1325,0,1325,18,1152,155,21.04.2019 21:01,170,18,Harkov
2272,2240,11,817,1447,8,1455,0,1455,36,1226,193,21.04.2019 21:55,170,18,Harkov
2064,2053,12,615,1441,8,1449,0,1449,35,1223,191,21.04.2019 23:55,170,18,Harkov
1664,1654,7,501,1156,7,1163,0,1163,37,965,161,22.04.2019 00:03,170,18,Harkov
2000,1978,7,629,1364,7,1371,0,1371,25,1168,178,22.04.2019 00:15,170,18,Harkov
1744,1746,13,588,1147,9,1156,0,1156,18,995,143,21.04.2019 21:30,170,18,Harkov
1856,1849,13,545,1300,11,1311,0,1311,33,1107,171,21.04.2019 23:10,170,18,Harkov
1888,1892,18,559,1312,17,1329,0,1329,29,1084,216,21.04.2019 22:55,170,18,Harkov
1952,1933,22,627,1306,19,1325,0,1325,28,1106,191,22.04.2019 00:01,170,18,Harkov
2000,1993,10,632,1358,10,1368,0,1368,44,1146,178,21.04.2019 22:30,170,18,Harkov
1920,1912,10,624,1288,8,1296,0,1296,22,1100,174,21.04.2019 22:00,170,18,Harkov
1504,1484,15,469,1021,14,1035,0,1035,21,880,134,22.04.2019 00:05,170,18,Harkov
1968,1962,15,669,1289,10,1299,0,1299,35,1101,163,22.04.2019 00:30,170,18,Harkov
1920,1924,20,623,1281,16,1297,0,1297,26,1087,184,22.04.2019 00:25,170,18,Harkov
2336,2325,12,766,1562,8,1570,0,1570,30,1287,253,22.04.2019 00:05,170,18,Harkov
1856,1853,15,618,1227,11,1238,0,1238,23,1062,153,22.04.2019 00:02,170,18,Harkov
1824,1814,11,597,1216,11,1227,0,1227,25,1038,164,22.04.2019 00:07,170,18,Harkov
1920,1905,12,668,1240,12,1252,0,1252,26,1039,187,22.04.2019 00:10,170,18,Harkov
1904,1911,20,573,1317,14,1331,0,1331,33,1102,196,21.04.2019 21:40,170,18,Harkov
1808,1796,11,621,1178,9,1187,0,1187,26,1020,141,21.04.2019 21:31,170,18,Harkov
1840,1817,9,616,1216,8,1224,0,1224,26,1029,169,21.04.2019 23:50,170,18,Harkov
2192,2183,13,732,1448,12,1460,0,1460,28,1244,188,21.04.2019 22:01,170,18,Harkov
1968,1965,22,599,1351,18,1369,0,1369,31,1156,182,22.04.2019 01:40,170,18,Harkov
1776,1762,12,576,1191,9,1200,0,1200,24,1021,155,21.04.2019 22:35,170,18,Harkov
2080,2054,7,701,1374,5,1379,0,1379,40,1186,153,21.04.2019 22:05,170,18,Harkov
1967,1985,20,639,1315,13,1328,0,1328,29,1155,144,21.04.2019 21:10,170,18,Harkov
1760,1754,12,591,1161,8,1169,0,1169,38,1006,125,21.04.2019 21:00,170,18,Harkov
1920,1909,10,671,1239,10,1249,0,1249,19,1081,149,22.04.2019 00:45,170,18,Harkov
2032,2021,13,628,1393,11,1404,0,1404,26,1212,166,22.04.2019 00:03,170,18,Harkov
2080,2069,10,678,1394,8,1402,0,1402,25,1192,185,22.04.2019 00:03,170,18,Harkov
2432,2399,6,797,1633,2,1635,0,1635,44,1325,266,22.04.2019 00:20,170,18,Harkov
2064,2053,15,679,1371,14,1385,0,1385,36,1161,188,21.04.2019 21:00,170,18,Harkov
1952,1955,15,612,1325,15,1340,0,1340,16,1164,160,21.04.2019 22:30,170,18,Harkov
1840,1848,11,537,1295,8,1303,0,1303,29,1109,165,21.04.2019 22:50,170,18,Harkov
2160,2148,9,690,1463,7,1470,0,1470,37,1246,187,21.04.2019 21:50,170,18,Harkov
1968,1957,7,595,1367,6,1373,0,1373,31,1150,192,22.04.2019 00:06,170,18,Harkov
2287,2278,9,765,1514,8,1522,0,1522,34,1269,219,22.04.2019 00:05,170,18,Harkov
384,293,106,97,184,103,287,0,287,10,245,32,21.04.2019 23:22,170,18,Harkov
512,143,97,371,45,96,141,0,141,3,116,22,21.04.2019 23:22,170,18,Harkov
448,52,16,397,36,15,51,0,51,0,47,4,21.04.2019 20:57,170,18,Harkov
288,54,2,235,51,2,53,0,53,0,50,3,21.04.2019 21:30,170,18,Harkov
2160,2149,35,727,1402,31,1433,0,1433,40,1244,149,21.04.2019 21:40,171,18,Harkov
2096,2109,29,661,1414,21,1435,0,1435,38,1240,157,21.04.2019 21:15,171,18,Harkov
1664,1635,7,529,1129,6,1135,0,1135,29,972,134,21.04.2019 21:30,171,18,Harkov
2112,2090,28,766,1325,21,1346,0,1346,37,1159,150,22.04.2019 00:15,171,18,Harkov
1792,1771,25,582,1198,12,1210,0,1210,28,1017,165,21.04.2019 22:20,171,18,Harkov
1616,1598,25,521,1074,21,1095,0,1095,16,916,163,21.04.2019 22:45,171,18,Harkov
1744,1729,31,556,1169,19,1188,0,1188,21,1024,143,21.04.2019 22:06,171,18,Harkov
2000,1967,22,742,1239,19,1258,0,1258,27,1071,160,21.04.2019 23:02,171,18,Harkov
1520,1517,22,533,972,15,987,0,987,21,867,99,22.04.2019 00:15,171,18,Harkov
1744,1739,25,491,1234,19,1253,0,1253,26,1048,179,21.04.2019 22:00,171,18,Harkov
1456,1456,18,500,943,13,956,0,956,28,803,125,22.04.2019 00:05,171,18,Harkov
2032,2018,18,627,1392,13,1405,0,1405,23,1193,189,22.04.2019 00:05,171,18,Harkov
2032,2023,33,646,1361,25,1386,0,1386,34,1194,158,22.04.2019 00:10,171,18,Harkov
1856,1846,32,582,1245,29,1274,0,1274,34,1084,156,22.04.2019 00:07,171,18,Harkov
1856,1855,11,560,1288,8,1296,0,1296,35,1068,193,22.04.2019 00:15,171,18,Harkov
1808,1802,19,549,1243,16,1259,0,1259,31,1063,165,22.04.2019 00:05,171,18,Harkov
1920,1887,21,691,1213,16,1229,0,1229,30,1047,152,22.04.2019 00:20,171,18,Harkov
2176,2176,14,835,1334,7,1341,0,1341,23,1171,147,22.04.2019 00:50,171,18,Harkov
2096,2105,8,635,1456,5,1461,0,1461,27,1303,131,22.04.2019 00:05,171,18,Harkov
2272,2261,13,711,1552,9,1561,0,1561,36,1321,204,21.04.2019 23:02,171,18,Harkov
2224,2195,13,918,1298,8,1306,0,1306,28,1139,139,22.04.2019 00:01,171,18,Harkov
2208,2199,18,714,1480,14,1494,0,1494,37,1285,172,22.04.2019 00:10,171,18,Harkov
1744,1706,13,744,992,8,1000,0,1000,21,873,106,22.04.2019 00:10,171,18,Harkov
1488,1482,12,503,976,9,985,0,985,18,838,129,21.04.2019 21:40,171,18,Harkov
2000,1964,18,759,1224,17,1241,0,1241,23,1079,139,22.04.2019 00:04,171,18,Harkov
2128,2110,21,737,1377,14,1391,0,1391,33,1161,197,22.04.2019 00:05,171,18,Harkov
2080,2062,21,643,1420,17,1437,0,1437,26,1228,183,22.04.2019 00:12,171,18,Harkov
2192,2171,24,764,1412,16,1428,0,1428,39,1211,178,22.04.2019 00:02,171,18,Harkov
2160,2151,18,700,1448,12,1460,0,1460,38,1251,171,22.04.2019 00:06,171,18,Harkov
1984,1986,29,644,1319,21,1340,0,1340,32,1115,193,22.04.2019 00:02,171,18,Harkov
2128,2133,17,751,1365,12,1377,0,1377,37,1159,181,21.04.2019 22:00,171,18,Harkov
1840,1849,16,629,1200,11,1211,0,1211,22,1038,151,21.04.2019 21:20,171,18,Harkov
2160,2157,22,759,1386,15,1401,0,1401,36,1181,184,21.04.2019 21:37,171,18,Harkov
1872,1883,12,599,1265,8,1273,0,1273,29,1058,186,22.04.2019 00:02,171,18,Harkov
1968,1954,12,671,1288,9,1297,0,1297,35,1090,172,22.04.2019 00:53,171,18,Harkov
1984,1969,17,716,1260,8,1268,0,1268,32,1036,200,21.04.2019 22:45,171,18,Harkov
2288,2284,15,821,1456,11,1467,0,1467,46,1230,191,21.04.2019 23:10,171,18,Harkov
1360,1359,15,425,924,11,935,0,935,30,767,138,21.04.2019 22:25,171,18,Harkov
1760,1763,4,570,1186,4,1190,0,1190,29,1000,161,22.04.2019 00:20,171,18,Harkov
1936,1950,22,666,1254,16,1270,0,1270,20,1092,158,22.04.2019 00:10,171,18,Harkov
1952,1990,14,657,1288,7,1295,0,1295,22,1102,171,22.04.2019 00:25,171,18,Harkov
1808,1791,8,686,1119,3,1122,0,1122,37,933,152,22.04.2019 00:05,171,18,Harkov
1696,1774,12,483,1204,9,1213,0,1213,27,996,190,22.04.2019 00:01,171,18,Harkov
2112,2171,14,563,1539,10,1549,0,1549,49,1232,268,21.04.2019 22:10,171,18,Harkov
2256,2245,8,637,1612,7,1619,0,1619,49,1343,227,22.04.2019 00:40,171,18,Harkov
1824,1821,35,590,1215,19,1234,0,1234,18,1065,151,21.04.2019 22:41,171,18,Harkov
688,681,16,238,442,8,450,0,450,10,406,34,21.04.2019 21:30,171,18,Harkov
944,932,3,324,617,3,620,0,620,13,541,66,21.04.2019 21:20,171,18,Harkov
1424,1415,11,484,931,9,940,0,940,6,804,130,21.04.2019 22:10,171,18,Harkov
1360,1363,12,454,897,9,906,0,906,19,785,102,22.04.2019 00:20,171,18,Harkov
2240,2225,29,861,1357,22,1379,0,1378,33,1193,152,22.04.2019 00:15,171,18,Harkov
1920,1892,15,694,1216,10,1226,0,1226,36,1079,111,21.04.2019 23:47,171,18,Harkov
1840,1816,13,656,1173,11,1184,0,1184,27,1014,143,22.04.2019 00:10,171,18,Harkov
2048,2025,7,675,1370,3,1373,0,1373,31,1177,165,22.04.2019 00:15,171,18,Harkov
2048,2039,13,726,1311,11,1322,0,1322,23,1120,179,21.04.2019 22:45,171,18,Harkov
1632,1620,10,589,1034,9,1043,0,1043,20,932,91,21.04.2019 21:20,171,18,Harkov
1984,1966,16,725,1245,14,1259,0,1259,24,1087,148,21.04.2019 22:22,171,18,Harkov
2112,2093,6,771,1335,6,1341,0,1341,39,1157,145,22.04.2019 00:30,171,18,Harkov
1888,1868,5,693,1190,5,1195,0,1195,20,1023,152,22.04.2019 00:25,171,18,Harkov
1984,1968,9,676,1302,6,1308,0,1308,19,1139,150,21.04.2019 22:00,171,18,Harkov
1904,1892,6,657,1242,5,1247,0,1247,33,1038,176,21.04.2019 22:15,171,18,Harkov
384,114,11,270,103,11,114,0,114,0,100,14,21.04.2019 21:30,171,18,Harkov
240,108,0,143,97,0,97,0,97,2,85,10,22.04.2019 00:12,171,18,Harkov
384,219,28,169,189,26,215,0,215,6,179,30,21.04.2019 22:05,171,18,Harkov
352,121,20,232,100,20,120,0,120,3,102,15,21.04.2019 22:08,171,18,Harkov
272,37,17,235,20,17,37,0,37,0,36,1,21.04.2019 21:50,171,18,Harkov
1008,989,15,401,597,10,607,0,607,6,523,78,21.04.2019 22:05,171,18,Harkov
1728,1700,27,622,1084,22,1106,0,1106,22,946,138,21.04.2019 22:20,171,18,Harkov
320,327,1,82,237,1,238,0,238,8,186,44,21.04.2019 21:10,171,18,Harkov
2032,2031,3,710,1320,2,1322,0,1322,30,1156,136,22.04.2019 00:15,172,18,Harkov
2224,2185,29,788,1409,27,1436,0,1436,32,1246,158,22.04.2019 00:02,172,18,Harkov
1824,1809,13,631,1182,11,1193,0,1193,36,1030,127,21.04.2019 22:30,172,18,Harkov
2016,1986,20,718,1281,17,1298,0,1298,21,1159,118,21.04.2019 22:32,172,18,Harkov
2160,2116,11,768,1386,6,1392,0,1392,27,1202,163,22.04.2019 01:10,172,18,Harkov
1696,1691,19,497,1181,18,1199,0,1199,21,1026,152,22.04.2019 00:30,172,18,Harkov
1680,1665,14,528,1142,10,1152,0,1152,32,1002,118,22.04.2019 00:10,172,18,Harkov
2336,2309,14,712,1613,11,1624,0,1624,25,1384,215,22.04.2019 00:55,172,18,Harkov
2080,2062,13,704,1366,10,1376,0,1376,26,1202,148,22.04.2019 00:01,172,18,Harkov
2432,2444,19,840,1575,17,1592,0,1592,32,1391,169,22.04.2019 00:06,172,18,Harkov
2240,2239,15,681,1546,13,1559,0,1559,38,1346,175,21.04.2019 22:35,172,18,Harkov
2464,2460,13,968,1487,9,1496,0,1496,42,1270,184,22.04.2019 00:10,172,18,Harkov
2272,2264,10,875,1388,9,1397,0,1397,28,1204,165,21.04.2019 22:46,172,18,Harkov
2064,2083,7,711,1348,5,1353,0,1353,44,1185,124,22.04.2019 00:20,172,18,Harkov
2256,2253,17,779,1461,16,1477,0,1477,48,1294,135,22.04.2019 00:01,172,18,Harkov
2032,2018,10,690,1335,7,1342,0,1342,37,1148,157,21.04.2019 22:30,172,18,Harkov
2096,2102,17,643,1445,8,1453,0,1453,27,1278,148,22.04.2019 00:02,172,18,Harkov
2256,2245,13,756,1493,7,1500,0,1500,27,1335,138,22.04.2019 00:20,172,18,Harkov
2112,2078,28,645,1445,22,1467,0,1467,34,1265,168,21.04.2019 23:30,172,18,Harkov
2096,2076,8,902,1187,7,1194,0,1194,28,1082,84,22.04.2019 00:10,172,18,Harkov
2048,2016,15,642,1392,14,1406,0,1406,36,1225,145,22.04.2019 00:05,172,18,Harkov
2240,2242,19,660,1562,18,1580,0,1580,20,1404,156,22.04.2019 00:32,172,18,Harkov
1984,1959,14,657,1318,9,1327,0,1327,31,1170,126,22.04.2019 00:05,172,18,Harkov
2240,2221,24,743,1477,20,1497,0,1497,26,1345,126,22.04.2019 00:30,172,18,Harkov
2192,2175,12,669,1514,9,1523,0,1523,38,1306,179,22.04.2019 00:07,172,18,Harkov
1968,1952,10,630,1330,8,1338,0,1338,27,1180,131,22.04.2019 00:35,172,18,Harkov
2096,2102,14,686,1399,11,1410,0,1410,34,1236,140,22.04.2019 00:10,172,18,Harkov
480,117,41,365,74,41,115,0,115,3,107,5,21.04.2019 20:50,172,18,Harkov
160,48,0,115,45,0,45,0,45,1,39,5,21.04.2019 21:22,172,18,Harkov
128,65,0,73,55,0,55,0,55,0,54,1,21.04.2019 22:10,172,18,Harkov
1344,723,0,626,718,0,718,0,718,12,669,37,22.04.2019 00:20,172,18,Harkov
192,213,1,43,149,0,149,0,149,0,133,16,22.04.2019 00:05,172,18,Harkov
128,126,0,32,96,0,96,0,96,1,79,16,21.04.2019 21:30,172,18,Harkov
1728,1784,14,486,1230,12,1242,0,1242,42,956,244,22.04.2019 00:15,173,18,Harkov
1808,1860,4,523,1283,2,1285,0,1285,34,1046,205,22.04.2019 00:15,173,18,Harkov
1952,2001,10,588,1356,8,1364,0,1364,29,1072,263,22.04.2019 00:10,173,18,Harkov
1408,1469,11,577,824,7,831,0,831,16,695,120,22.04.2019 00:01,173,18,Harkov
2192,2221,21,733,1442,17,1459,0,1459,52,1173,234,22.04.2019 00:40,173,18,Harkov
1968,1957,17,632,1322,14,1336,0,1336,29,1100,207,22.04.2019 00:07,173,18,Harkov
2160,2144,8,730,1425,5,1430,0,1430,23,1168,239,22.04.2019 00:20,173,18,Harkov
2016,2008,23,615,1387,14,1401,0,1401,34,1151,216,22.04.2019 00:05,173,18,Harkov
2128,2133,20,766,1344,18,1362,0,1362,25,1173,164,22.04.2019 00:11,173,18,Harkov
2128,2132,7,846,1278,4,1282,0,1282,22,1142,118,22.04.2019 00:01,173,18,Harkov
2320,2294,16,734,1572,14,1586,0,1586,27,1319,240,22.04.2019 00:01,173,18,Harkov
2080,2072,14,639,1428,13,1441,0,1441,25,1291,125,22.04.2019 00:05,173,18,Harkov
1616,1599,13,492,1111,13,1124,0,1124,21,959,144,22.04.2019 00:40,173,18,Harkov
1392,1397,7,441,946,5,951,0,951,16,844,91,22.04.2019 00:01,173,18,Harkov
2256,2271,19,818,1424,14,1438,0,1438,29,1205,204,22.04.2019 00:03,173,18,Harkov
2064,2061,15,651,1400,13,1413,0,1413,34,1210,169,22.04.2019 00:10,173,18,Harkov
1808,1819,15,560,1233,15,1248,0,1248,30,1066,152,22.04.2019 00:10,173,18,Harkov
2224,2193,29,768,1433,23,1456,0,1456,44,1202,210,22.04.2019 00:10,173,18,Harkov
2144,2146,23,764,1362,18,1380,0,1380,22,1211,147,22.04.2019 00:20,173,18,Harkov
1920,1924,19,804,1102,14,1116,0,1116,14,969,133,22.04.2019 00:04,173,18,Harkov
2112,2091,11,801,1302,9,1311,0,1311,20,1125,166,22.04.2019 00:07,173,18,Harkov
2032,2009,20,749,1266,17,1283,0,1283,26,1134,123,22.04.2019 00:05,173,18,Harkov
1872,1869,23,648,1209,15,1224,0,1224,17,1097,110,22.04.2019 00:05,173,18,Harkov
2112,2102,17,712,1386,14,1400,0,1400,26,1251,123,22.04.2019 00:10,173,18,Harkov
2096,2088,10,738,1352,6,1358,0,1358,18,1212,128,22.04.2019 00:10,173,18,Harkov
1792,1809,14,642,1140,10,1150,0,1150,23,1017,110,22.04.2019 00:01,173,18,Harkov
2128,2134,20,628,1488,12,1500,0,1500,27,1326,147,22.04.2019 00:05,173,18,Harkov
2096,2080,14,652,1433,11,1444,0,1444,42,1262,140,22.04.2019 00:05,173,18,Harkov
2016,2155,10,609,1397,10,1407,0,1407,21,1225,161,22.04.2019 00:05,173,18,Harkov
2688,2605,15,1050,1626,12,1638,0,1638,46,1420,172,22.04.2019 00:11,173,18,Harkov
1760,1738,8,607,1145,8,1153,0,1153,32,1012,109,22.04.2019 00:30,173,18,Harkov
1648,1652,23,553,1074,21,1095,0,1095,12,959,124,22.04.2019 00:24,173,18,Harkov
2064,2057,28,692,1348,24,1372,0,1372,32,1165,175,22.04.2019 00:15,173,18,Harkov
2400,2391,16,933,1456,11,1467,0,1466,27,1301,138,22.04.2019 00:02,173,18,Harkov
1872,1894,12,603,1260,9,1269,0,1269,38,1075,156,22.04.2019 00:05,173,18,Harkov
2112,2113,26,637,1453,22,1475,0,1475,37,1265,173,22.04.2019 00:05,173,18,Harkov
320,187,8,140,172,8,180,0,180,2,161,17,22.04.2019 00:02,173,18,Harkov
256,162,151,114,11,131,142,0,142,3,124,15,22.04.2019 00:03,173,18,Harkov
288,261,0,27,261,0,261,0,261,6,242,13,22.04.2019 00:05,173,18,Harkov
1344,1347,14,538,796,10,806,0,806,26,638,142,22.04.2019 00:15,173,18,Harkov
1232,1218,22,503,714,15,729,0,729,15,587,127,22.04.2019 00:18,173,18,Harkov
2048,2105,22,751,1284,13,1297,0,1297,25,1107,165,22.04.2019 00:28,173,18,Harkov
2128,2139,24,742,1367,19,1386,0,1386,49,1087,250,22.04.2019 00:05,173,18,Harkov
2240,2234,19,805,1417,18,1435,0,1435,36,1180,219,22.04.2019 00:15,173,18,Harkov
1440,1403,19,503,924,13,937,0,937,33,727,177,22.04.2019 00:10,173,18,Harkov
2224,2210,22,862,1347,15,1362,0,1362,26,1177,159,22.04.2019 00:32,173,18,Harkov
1376,1370,6,586,785,5,790,0,790,19,685,86,22.04.2019 00:22,173,18,Harkov
2304,2306,29,691,1590,23,1613,0,1613,35,1278,300,22.04.2019 00:48,173,18,Harkov
1920,1907,41,615,1279,26,1305,0,1305,42,1025,238,22.04.2019 00:03,173,18,Harkov
1760,1762,32,578,1155,27,1182,0,1182,39,933,210,22.04.2019 00:15,173,18,Harkov
2032,2035,34,670,1335,27,1362,0,1362,30,1107,225,22.04.2019 00:05,173,18,Harkov
624,611,3,257,364,3,367,0,367,3,331,33,22.04.2019 00:50,173,18,Harkov
1200,1190,6,478,719,3,722,0,722,17,609,96,22.04.2019 01:05,173,18,Harkov
512,514,2,168,342,2,344,0,344,3,308,33,22.04.2019 00:10,173,18,Harkov
1984,1978,9,784,1194,6,1200,0,1200,31,1025,144,22.04.2019 00:30,173,18,Harkov
1984,1969,14,647,1327,10,1337,0,1337,28,1151,158,22.04.2019 00:08,173,18,Harkov
2000,1997,9,612,1381,7,1388,0,1388,24,1188,176,21.04.2019 23:55,173,18,Harkov
2016,2002,16,626,1378,12,1390,0,1390,31,1183,176,22.04.2019 00:10,173,18,Harkov
2192,2176,38,859,1312,21,1333,0,1333,21,1169,143,22.04.2019 00:15,173,18,Harkov
2288,2258,27,829,1445,14,1459,0,1459,40,1298,121,22.04.2019 00:20,173,18,Harkov
2352,2324,26,862,1471,19,1490,0,1490,27,1352,111,22.04.2019 00:18,173,18,Harkov
2176,2164,22,804,1359,13,1372,0,1372,22,1215,135,22.04.2019 00:15,173,18,Harkov
2192,2182,10,809,1376,7,1383,0,1383,29,1251,103,22.04.2019 00:40,173,18,Harkov
2368,2354,13,780,1578,10,1588,0,1588,22,1414,152,22.04.2019 00:20,173,18,Harkov
1840,1825,14,701,1131,8,1139,0,1139,23,1027,89,22.04.2019 00:58,173,18,Harkov
1712,1709,21,616,1075,21,1096,0,1096,19,979,98,22.04.2019 00:15,173,18,Harkov
1712,1710,15,642,1060,10,1070,0,1070,13,975,82,22.04.2019 00:02,173,18,Harkov
176,52,0,124,52,0,52,0,52,0,48,4,22.04.2019 00:06,173,18,Harkov
624,624,0,0,624,0,624,0,624,18,560,46,22.04.2019 00:01,173,18,Harkov
224,143,18,86,120,18,138,0,138,7,118,13,22.04.2019 00:15,173,18,Harkov
1120,1142,7,416,699,5,704,0,704,19,584,101,21.04.2019 22:42,174,18,Harkov
1712,1723,15,625,1077,10,1087,0,1087,20,914,153,22.04.2019 00:05,174,18,Harkov
2416,2385,9,982,1427,7,1434,0,1434,16,1214,204,22.04.2019 00:11,174,18,Harkov
1200,1180,8,434,761,5,766,0,766,16,670,80,21.04.2019 23:00,174,18,Harkov
1232,1216,7,447,779,6,785,0,785,21,683,81,22.04.2019 00:02,174,18,Harkov
2176,2086,4,891,1283,2,1285,0,1285,20,1093,172,22.04.2019 00:23,174,18,Harkov
1312,1290,5,418,889,5,894,0,894,21,773,100,22.04.2019 00:05,174,18,Harkov
2208,2194,16,622,1572,14,1586,0,1586,27,1358,201,22.04.2019 00:27,174,18,Harkov
2464,2388,17,948,1501,15,1516,0,1516,28,1262,226,22.04.2019 02:35,174,18,Harkov
1328,1298,2,593,734,1,735,0,735,17,614,104,22.04.2019 00:11,174,18,Harkov
1312,1317,10,419,885,8,893,0,893,16,743,134,22.04.2019 00:15,174,18,Harkov
1664,1660,10,448,1206,10,1216,0,1216,26,1000,190,22.04.2019 00:36,174,18,Harkov
1696,1671,6,487,1205,4,1209,0,1209,28,1006,175,22.04.2019 00:15,174,18,Harkov
1360,1350,3,412,945,3,948,0,948,24,766,158,22.04.2019 00:10,174,18,Harkov
1120,1119,9,368,744,8,752,0,752,12,674,66,22.04.2019 00:02,174,18,Harkov
224,88,35,140,53,31,84,0,84,0,79,5,22.04.2019 00:30,174,18,Harkov
176,48,7,130,40,6,46,0,46,1,39,6,22.04.2019 00:30,174,18,Harkov
272,209,6,63,203,6,209,0,209,2,181,26,22.04.2019 00:05,174,18,Harkov
176,72,1,104,71,1,72,0,72,2,67,3,22.04.2019 00:05,174,18,Harkov
1504,466,0,1038,466,0,466,0,466,19,429,18,21.04.2019 23:45,174,18,Harkov
2032,2066,12,612,1410,10,1420,0,1420,33,1179,208,22.04.2019 00:30,174,18,Harkov
2064,2156,11,727,1329,8,1337,0,1337,38,1133,166,22.04.2019 00:40,174,18,Harkov
1520,1532,12,550,959,11,970,0,970,10,848,112,22.04.2019 00:05,174,18,Harkov
2384,2401,22,1016,1351,17,1368,0,1368,32,1176,160,22.04.2019 00:05,174,18,Harkov
1664,1648,10,615,1040,9,1049,0,1049,25,880,144,22.04.2019 00:02,174,18,Harkov
1232,1242,6,391,835,6,841,0,841,15,712,114,22.04.2019 00:06,174,18,Harkov
1728,1706,18,560,1153,15,1168,0,1168,22,1004,142,22.04.2019 00:02,174,18,Harkov
1456,1411,13,557,887,12,899,0,899,17,773,109,22.04.2019 00:11,174,18,Harkov
1168,1345,8,374,790,4,794,0,794,22,648,124,22.04.2019 02:15,174,18,Harkov
1936,1955,28,582,1332,22,1354,0,1354,28,1143,183,22.04.2019 00:15,174,18,Harkov
2096,2060,11,706,1380,10,1390,0,1390,34,1233,123,22.04.2019 00:10,174,18,Harkov
2000,1994,17,654,1332,14,1346,0,1346,20,1200,126,22.04.2019 00:05,174,18,Harkov
2112,2104,25,726,1368,18,1386,0,1386,24,1228,134,22.04.2019 00:15,174,18,Harkov
2176,2169,13,694,1471,11,1482,0,1482,39,1276,167,22.04.2019 00:22,174,18,Harkov
1968,1953,17,605,1350,13,1363,0,1363,38,1166,159,22.04.2019 00:15,174,18,Harkov
240,45,2,197,41,2,43,0,43,1,39,3,22.04.2019 00:05,174,18,Harkov
96,87,1,9,86,1,87,0,87,0,73,14,22.04.2019 00:05,174,18,Harkov
80,13,0,67,13,0,13,0,13,0,12,1,22.04.2019 00:07,174,18,Harkov
1472,1469,9,590,876,6,882,0,882,19,761,102,22.04.2019 00:15,174,18,Harkov
832,832,19,234,580,18,598,0,598,12,514,72,22.04.2019 00:20,175,18,Harkov
1616,1620,24,472,1123,21,1144,0,1144,24,955,165,22.04.2019 00:03,175,18,Harkov
2064,2051,15,649,1401,14,1415,0,1415,25,1198,192,22.04.2019 00:20,175,18,Harkov
1792,1781,21,594,1183,15,1198,0,1198,11,1041,146,22.04.2019 00:20,175,18,Harkov
1744,1731,28,620,1106,18,1124,0,1124,28,959,137,22.04.2019 00:20,175,18,Harkov
1424,1395,23,513,896,15,911,0,911,26,822,63,22.04.2019 01:20,175,18,Harkov
1344,1318,13,496,839,9,848,0,848,13,745,90,22.04.2019 00:30,175,18,Harkov
1728,1714,30,680,1025,23,1048,0,1048,28,903,117,22.04.2019 00:01,175,18,Harkov
2000,1975,26,798,1185,17,1202,0,1202,20,1075,107,22.04.2019 00:02,175,18,Harkov
1760,1752,13,606,1145,9,1154,0,1154,21,973,160,22.04.2019 00:10,175,18,Harkov
2320,2295,8,725,1588,7,1595,0,1595,23,1363,209,21.04.2019 22:00,175,18,Harkov
2112,2097,10,745,1358,9,1367,0,1367,19,1229,119,22.04.2019 00:30,175,18,Harkov
1856,1830,18,713,1126,17,1143,0,1143,13,1049,81,21.04.2019 22:00,175,18,Harkov
992,994,10,348,636,8,644,0,644,8,579,57,21.04.2019 20:50,175,18,Harkov
1632,1612,110,538,1001,93,1094,0,1094,12,992,90,22.04.2019 00:07,175,18,Harkov
768,760,37,265,471,32,503,0,503,4,447,52,22.04.2019 00:10,175,18,Harkov
1616,1592,21,592,1004,20,1024,0,1024,14,934,76,22.04.2019 00:05,175,18,Harkov
192,189,4,72,116,4,120,0,120,1,101,18,22.04.2019 00:10,175,18,Harkov
2176,2148,13,777,1389,10,1399,0,1399,16,1224,159,22.04.2019 00:05,175,18,Harkov
2240,2197,15,803,1426,11,1437,0,1437,24,1268,145,22.04.2019 00:25,175,18,Harkov
1904,1873,14,662,1233,9,1242,0,1242,13,1085,144,22.04.2019 00:10,175,18,Harkov
1424,1402,6,581,839,4,843,0,843,18,766,59,22.04.2019 00:30,175,18,Harkov
1504,1480,17,539,957,8,965,0,965,16,867,82,22.04.2019 00:10,175,18,Harkov
2128,2118,43,755,1345,28,1373,0,1373,17,1254,102,22.04.2019 00:30,175,18,Harkov
304,305,26,93,187,24,211,0,211,2,186,23,22.04.2019 00:07,175,18,Harkov
304,306,3,100,202,2,204,0,204,0,187,17,22.04.2019 00:20,175,18,Harkov
928,906,1,335,592,1,593,0,593,11,532,50,22.04.2019 00:36,175,18,Harkov
352,339,6,128,218,6,224,0,224,2,197,25,22.04.2019 00:25,175,18,Harkov
656,646,44,217,402,37,439,0,439,3,372,64,21.04.2019 22:00,175,18,Harkov
2048,2022,21,776,1254,18,1272,0,1272,19,1194,59,22.04.2019 00:24,175,18,Harkov
2048,2028,37,734,1287,27,1314,0,1314,13,1245,56,22.04.2019 01:25,175,18,Harkov
624,605,50,207,372,45,417,0,417,6,367,44,22.04.2019 00:05,175,18,Harkov
1536,1521,16,510,1012,14,1026,0,1026,24,874,128,21.04.2019 23:10,175,18,Harkov
1824,1824,34,578,1218,28,1246,0,1246,17,1059,170,22.04.2019 00:10,175,18,Harkov
800,775,11,273,516,11,527,0,527,12,465,50,22.04.2019 00:15,175,18,Harkov
112,102,1,104,7,1,8,0,8,0,7,1,21.04.2019 20:37,175,18,Harkov
192,39,0,153,39,0,39,0,39,0,36,3,22.04.2019 00:06,175,18,Harkov
1152,1143,4,441,707,4,711,0,711,10,631,70,22.04.2019 00:48,175,18,Harkov
768,758,5,281,482,5,487,0,487,6,448,33,22.04.2019 00:05,175,18,Harkov
880,855,43,312,528,40,568,0,568,9,477,82,22.04.2019 00:15,175,18,Harkov
480,459,28,211,242,27,269,0,269,3,254,12,22.04.2019 00:10,175,18,Harkov
1184,1161,32,504,652,28,680,0,680,9,601,70,22.04.2019 00:05,175,18,Harkov
1616,1603,46,637,939,40,979,0,979,4,895,80,22.04.2019 00:10,175,18,Harkov
1008,1001,6,348,659,1,660,0,660,16,583,61,21.04.2019 23:10,175,18,Harkov
1248,1233,3,435,810,3,813,0,813,15,716,82,22.04.2019 00:50,175,18,Harkov
2048,2043,39,730,1288,30,1318,0,1318,23,1113,182,22.04.2019 00:20,175,18,Harkov
2320,2291,20,815,1490,15,1505,0,1505,21,1277,207,22.04.2019 00:15,175,18,Harkov
592,576,7,235,351,6,357,0,357,2,319,36,22.04.2019 00:10,175,18,Harkov
560,536,5,191,366,3,369,0,369,10,306,53,22.04.2019 00:05,175,18,Harkov
1056,1040,75,406,585,65,650,0,650,5,592,53,22.04.2019 02:00,175,18,Harkov
80,70,5,30,47,3,50,0,50,1,46,3,22.04.2019 00:20,175,18,Harkov
976,963,28,394,560,22,582,0,582,3,550,29,22.04.2019 00:47,175,18,Harkov
880,865,13,388,484,8,492,0,492,16,444,32,22.04.2019 00:21,175,18,Harkov
848,841,15,287,547,14,561,0,561,15,491,55,22.04.2019 00:05,175,18,Harkov
1280,1254,16,481,792,7,799,0,799,20,702,77,22.04.2019 00:05,175,18,Harkov
912,907,7,352,555,5,560,0,560,11,497,52,22.04.2019 00:40,175,18,Harkov
48,19,0,30,18,0,18,0,18,0,8,10,22.04.2019 00:23,176,18,Harkov
1408,1387,41,491,877,40,917,0,917,11,828,78,22.04.2019 00:49,176,18,Harkov
592,581,27,240,332,20,352,0,352,4,322,26,22.04.2019 00:10,176,18,Harkov
128,120,6,58,65,5,70,0,70,2,60,8,21.04.2019 20:40,176,18,Harkov
992,971,25,392,581,19,600,0,600,5,579,16,21.04.2019 20:59,176,18,Harkov
752,729,14,338,404,10,414,0,414,6,378,30,22.04.2019 00:05,176,18,Harkov
848,834,30,386,437,25,462,0,462,6,421,35,21.04.2019 21:40,176,18,Harkov
160,146,13,59,92,9,101,0,101,1,99,1,22.04.2019 00:05,176,18,Harkov
1008,997,47,514,453,41,494,0,494,12,461,21,22.04.2019 00:02,176,18,Harkov
144,138,13,43,88,13,101,0,101,3,88,10,21.04.2019 21:10,176,18,Harkov
384,368,22,160,204,20,224,0,224,1,204,19,21.04.2019 20:23,176,18,Harkov
240,221,18,108,117,15,132,0,132,3,120,9,21.04.2019 20:40,176,18,Harkov
160,150,15,56,90,14,104,0,104,0,90,14,21.04.2019 21:06,176,18,Harkov
432,411,14,203,217,12,229,0,229,2,219,8,22.04.2019 00:01,176,18,Harkov
592,572,36,278,284,30,314,0,314,2,287,25,21.04.2019 21:30,176,18,Harkov
416,402,31,156,229,31,260,0,260,1,238,21,21.04.2019 20:55,176,18,Harkov
960,925,48,391,526,43,569,0,569,2,504,63,21.04.2019 22:20,176,18,Harkov
2160,2159,26,729,1407,24,1431,0,1431,13,1307,111,22.04.2019 00:10,176,18,Harkov
2064,2024,30,770,1269,25,1294,0,1294,27,1192,75,22.04.2019 00:05,176,18,Harkov
1664,1634,20,710,939,15,954,0,954,9,891,54,22.04.2019 00:35,176,18,Harkov
1664,1628,20,667,981,16,997,0,997,23,916,58,22.04.2019 00:10,176,18,Harkov
496,482,16,219,264,13,277,0,277,0,256,21,22.04.2019 00:55,176,18,Harkov
272,267,10,105,160,7,167,0,167,2,156,9,22.04.2019 00:40,176,18,Harkov
224,204,4,92,128,4,132,0,132,3,120,9,22.04.2019 01:07,176,18,Harkov
320,309,1,118,201,1,202,0,202,2,161,39,22.04.2019 00:01,176,18,Harkov
272,263,25,79,168,25,193,0,193,0,176,17,21.04.2019 21:00,176,18,Harkov
240,222,13,55,173,12,185,0,185,0,177,8,21.04.2019 22:10,176,18,Harkov
320,314,27,65,232,23,255,0,255,3,244,8,21.04.2019 23:50,176,18,Harkov
432,413,9,191,232,9,241,0,241,3,221,17,22.04.2019 00:03,176,18,Harkov
192,187,8,75,109,8,117,0,117,0,111,6,21.04.2019 20:40,176,18,Harkov
336,321,5,139,192,5,197,0,197,4,166,27,22.04.2019 00:10,176,18,Harkov
288,282,18,108,165,15,180,0,180,2,162,16,21.04.2019 20:45,176,18,Harkov
256,247,30,94,132,30,162,0,162,4,122,36,21.04.2019 20:29,176,18,Harkov
208,196,16,74,118,16,134,0,134,0,120,14,22.04.2019 00:18,176,18,Harkov
640,621,23,236,388,16,404,0,404,4,350,50,22.04.2019 00:05,176,18,Harkov
352,345,22,125,208,19,227,0,227,2,218,7,21.04.2019 21:10,176,18,Harkov
528,515,36,231,265,32,297,0,297,2,278,17,22.04.2019 00:45,176,18,Harkov
528,518,33,163,336,29,365,0,365,9,321,35,22.04.2019 00:40,176,18,Harkov
240,299,12,55,178,7,185,0,185,0,160,25,22.04.2019 00:07,176,18,Harkov
416,413,17,129,274,13,287,0,287,4,249,34,22.04.2019 00:10,176,18,Harkov
496,495,9,165,324,7,331,0,331,3,290,38,22.04.2019 00:01,176,18,Harkov
240,220,13,97,130,13,143,0,143,0,125,18,21.04.2019 21:00,176,18,Harkov
960,930,72,381,515,64,579,0,579,10,543,26,22.04.2019 00:23,176,18,Harkov
128,129,11,51,69,8,77,0,77,0,74,3,22.04.2019 00:50,176,18,Harkov
640,634,55,213,372,55,427,0,427,1,407,19,21.04.2019 21:00,176,18,Harkov
752,733,70,275,410,67,477,0,477,4,440,33,21.04.2019 21:05,176,18,Harkov
128,130,9,48,74,6,80,0,80,1,68,11,21.04.2019 21:00,176,18,Harkov
816,784,60,314,445,57,502,0,502,7,465,30,21.04.2019 21:00,176,18,Harkov
112,110,9,31,72,9,81,0,81,0,71,10,21.04.2019 20:30,176,18,Harkov
64,57,2,24,38,2,40,0,40,0,38,2,21.04.2019 20:45,176,18,Harkov
512,506,34,179,303,30,333,0,333,3,310,20,22.04.2019 02:30,176,18,Harkov
400,381,36,155,209,36,245,0,245,3,233,9,22.04.2019 00:15,176,18,Harkov
512,498,70,215,237,60,297,0,297,0,261,36,21.04.2019 20:35,176,18,Harkov
432,422,54,159,221,52,273,0,273,0,255,18,21.04.2019 22:05,176,18,Harkov
416,402,37,88,294,34,328,0,328,6,305,17,21.04.2019 21:05,176,18,Harkov
1568,1560,21,610,937,21,958,0,958,10,853,95,22.04.2019 00:05,176,18,Harkov
1744,1732,11,718,1016,10,1026,0,1026,21,920,85,22.04.2019 00:46,176,18,Harkov
912,898,11,374,527,11,538,0,538,9,477,52,22.04.2019 00:30,176,18,Harkov
112,126,13,17,82,13,95,0,95,1,80,14,22.04.2019 00:01,176,18,Harkov
224,212,14,64,146,14,160,0,160,0,142,18,22.04.2019 00:10,176,18,Harkov
256,249,2,106,148,2,150,0,150,0,135,15,22.04.2019 00:12,176,18,Harkov
832,820,48,308,477,47,524,0,524,14,477,33,22.04.2019 00:40,176,18,Harkov
176,177,23,74,84,18,102,0,102,1,88,13,22.04.2019 00:05,176,18,Harkov
1520,1508,51,654,820,46,866,0,866,12,791,63,22.04.2019 01:05,176,18,Harkov
560,560,49,217,297,46,343,0,343,9,263,71,22.04.2019 00:03,176,18,Harkov
2112,2085,16,746,1355,11,1366,0,1366,23,1273,70,22.04.2019 00:05,176,18,Harkov
1424,1407,30,475,920,29,949,0,949,19,860,70,22.04.2019 00:20,176,18,Harkov
1040,1026,20,334,687,19,706,0,706,23,629,54,22.04.2019 00:08,176,18,Harkov
1568,1562,13,636,922,10,932,0,932,26,834,72,22.04.2019 00:05,176,18,Harkov
1856,1819,14,699,1145,12,1157,0,1157,25,1052,80,22.04.2019 00:10,176,18,Harkov
1984,1966,22,847,1118,19,1137,0,1137,18,1036,83,21.04.2019 23:37,176,18,Harkov
2048,2016,40,683,1330,35,1365,0,1365,23,1271,71,21.04.2019 20:57,176,18,Harkov
2016,1982,31,615,1372,29,1401,0,1401,21,1314,66,22.04.2019 00:16,176,18,Harkov
1776,1775,18,620,1138,18,1156,0,1156,15,1096,45,21.04.2019 22:00,176,18,Harkov
1760,1740,16,657,1090,13,1103,0,1103,14,1029,60,22.04.2019 00:20,176,18,Harkov
352,345,14,134,205,13,218,0,218,6,200,12,22.04.2019 00:30,176,18,Harkov
480,480,24,186,273,21,294,0,294,3,257,34,22.04.2019 00:40,176,18,Harkov
992,969,50,372,572,48,620,0,620,22,530,68,22.04.2019 00:15,176,18,Harkov
560,547,24,192,346,22,368,0,368,5,344,19,22.04.2019 00:09,176,18,Harkov
240,239,15,74,152,14,166,0,166,4,149,13,22.04.2019 00:02,176,18,Harkov
576,561,41,210,327,39,366,0,366,2,267,97,22.04.2019 00:05,176,18,Harkov
896,876,18,263,616,17,633,0,633,8,589,36,22.04.2019 00:27,176,18,Harkov
1600,1580,36,556,1013,31,1044,0,1044,19,986,39,22.04.2019 00:15,176,18,Harkov
320,303,2,120,198,2,200,0,200,3,188,9,22.04.2019 00:10,176,18,Harkov
1280,1258,33,420,831,29,860,0,860,16,739,105,21.04.2019 21:17,176,18,Harkov
752,726,48,347,363,42,405,0,405,11,337,57,21.04.2019 21:50,176,18,Harkov
576,571,25,200,352,24,376,0,376,3,314,59,22.04.2019 00:05,176,18,Harkov
768,761,38,288,444,36,480,0,480,13,451,16,22.04.2019 00:17,176,18,Harkov
272,262,21,129,125,18,143,0,143,1,124,18,22.04.2019 00:59,176,18,Harkov
1664,1648,36,599,1036,29,1065,0,1065,21,987,57,22.04.2019 00:00,176,18,Harkov
1728,1709,24,551,1158,19,1177,0,1177,25,1040,112,22.04.2019 00:10,176,18,Harkov
2160,2130,25,749,1390,21,1411,0,1411,25,1267,119,22.04.2019 00:06,176,18,Harkov
1344,1316,20,474,851,19,870,0,870,19,799,52,22.04.2019 00:01,176,18,Harkov
1824,1808,29,566,1233,25,1258,0,1258,24,1142,92,22.04.2019 00:05,176,18,Harkov
1520,1495,22,518,980,22,1002,0,1002,25,890,87,22.04.2019 00:15,176,18,Harkov
1984,1958,52,553,1389,42,1431,0,1431,26,1276,129,22.04.2019 00:10,176,18,Harkov
1504,1481,13,504,993,7,1000,0,1000,24,896,80,22.04.2019 00:20,176,18,Harkov
1712,1704,32,600,1084,28,1112,0,1112,8,1009,95,21.04.2019 22:10,176,18,Harkov
1904,1890,32,544,1332,28,1360,0,1360,21,1233,106,22.04.2019 00:05,176,18,Harkov
2320,2292,27,788,1511,21,1532,0,1532,15,1404,113,21.04.2019 21:30,176,18,Harkov
1952,1927,43,737,1186,29,1215,0,1215,25,1106,84,22.04.2019 00:15,176,18,Harkov
1200,1190,21,486,696,18,714,0,714,8,651,55,21.04.2019 23:00,176,18,Harkov
1600,1597,34,602,965,33,998,0,998,25,904,69,22.04.2019 02:15,176,18,Harkov
1744,1918,16,531,1204,9,1213,0,1213,27,915,271,22.04.2019 00:05,176,18,Harkov
2208,2190,9,715,1485,8,1493,0,1493,25,1322,146,22.04.2019 00:07,176,18,Harkov
208,45,15,163,30,15,45,0,45,0,30,15,22.04.2019 00:02,176,18,Harkov
1680,1652,15,688,980,12,992,0,992,11,865,116,22.04.2019 00:15,177,18,Harkov
384,392,6,104,274,6,280,0,280,7,225,48,22.04.2019 00:25,177,18,Harkov
1808,1809,21,654,1135,19,1154,0,1154,14,998,142,22.04.2019 00:30,177,18,Harkov
1120,1106,10,462,648,10,658,0,658,6,590,62,22.04.2019 00:15,177,18,Harkov
304,290,25,119,161,24,185,0,185,3,160,22,22.04.2019 00:01,177,18,Harkov
448,420,7,210,231,7,238,0,238,1,206,31,22.04.2019 00:15,177,18,Harkov
352,351,26,135,191,26,217,0,217,2,194,21,21.04.2019 20:25,177,18,Harkov
272,261,11,107,154,11,165,0,165,1,148,16,22.04.2019 00:05,177,18,Harkov
320,314,11,102,207,11,218,0,218,1,185,32,22.04.2019 00:05,177,18,Harkov
304,285,19,120,165,19,184,0,184,3,160,21,22.04.2019 00:20,177,18,Harkov
320,306,3,148,169,3,172,0,172,1,158,13,22.04.2019 00:10,177,18,Harkov
448,438,12,204,232,12,244,0,244,0,230,14,22.04.2019 00:15,177,18,Harkov
864,848,3,461,400,3,403,0,403,8,365,30,22.04.2019 00:05,177,18,Harkov
128,127,9,43,76,9,85,0,85,0,61,24,22.04.2019 01:30,177,18,Harkov
1040,1043,15,429,598,13,611,0,611,3,552,56,22.04.2019 00:11,177,18,Harkov
768,769,58,275,439,54,493,0,493,2,434,57,22.04.2019 01:50,177,18,Harkov
896,892,58,315,527,54,581,0,581,27,505,49,22.04.2019 01:45,177,18,Harkov
112,103,4,45,63,4,67,0,67,1,60,6,22.04.2019 00:04,177,18,Harkov
576,553,30,281,267,28,295,0,295,6,275,14,22.04.2019 00:30,177,18,Harkov
592,598,38,254,302,36,338,0,338,6,311,21,22.04.2019 00:09,177,18,Harkov
592,587,52,233,309,50,359,0,359,3,311,45,22.04.2019 00:20,177,18,Harkov
480,469,29,196,255,29,284,0,284,1,268,15,22.04.2019 00:05,177,18,Harkov
176,164,6,76,95,5,100,0,100,1,84,15,22.04.2019 00:10,177,18,Harkov
592,577,40,259,297,36,333,0,333,2,309,22,22.04.2019 00:10,177,18,Harkov
512,505,32,183,298,31,329,0,329,3,297,29,22.04.2019 00:05,177,18,Harkov
880,874,33,323,526,31,557,0,557,7,510,40,22.04.2019 00:05,177,18,Harkov
448,441,35,197,218,33,251,0,251,0,228,23,22.04.2019 00:15,177,18,Harkov
336,331,26,144,168,24,192,0,192,2,171,19,22.04.2019 00:15,177,18,Harkov
368,354,33,127,212,29,241,0,241,1,235,5,22.04.2019 00:01,177,18,Harkov
912,887,41,337,538,37,575,0,575,11,527,37,22.04.2019 00:30,177,18,Harkov
272,260,26,107,139,26,165,0,165,0,145,20,22.04.2019 00:01,177,18,Harkov
752,746,34,309,412,31,443,0,443,2,417,24,22.04.2019 00:30,177,18,Harkov
128,124,1,59,68,1,69,0,69,0,52,17,22.04.2019 00:05,177,18,Harkov
336,322,9,174,153,9,162,0,162,5,136,21,21.04.2019 20:50,177,18,Harkov
144,130,11,76,60,8,68,0,68,1,56,11,22.04.2019 00:10,177,18,Harkov
208,193,6,95,108,5,113,0,113,0,100,13,22.04.2019 00:10,177,18,Harkov
784,780,57,319,417,48,465,0,465,3,402,60,22.04.2019 00:16,177,18,Harkov
800,790,66,362,375,63,438,0,438,5,396,37,22.04.2019 00:26,177,18,Harkov
1664,1641,33,748,887,29,916,0,916,12,855,49,22.04.2019 00:05,177,18,Harkov
1472,1450,19,474,983,15,998,0,998,8,916,74,22.04.2019 00:05,177,18,Harkov
1744,1712,61,714,979,51,1030,0,1030,12,939,79,22.04.2019 00:30,177,18,Harkov
112,97,10,57,45,10,55,0,55,2,46,7,22.04.2019 00:50,177,18,Harkov
832,824,5,334,493,5,498,0,498,10,465,23,22.04.2019 00:40,177,18,Harkov
320,305,36,105,180,35,215,0,215,1,198,16,22.04.2019 00:40,177,18,Harkov
128,117,11,47,70,11,81,0,81,0,71,10,22.04.2019 00:05,177,18,Harkov
688,666,53,335,307,46,353,0,353,4,331,18,22.04.2019 00:05,177,18,Harkov
352,342,15,164,175,13,188,0,188,4,174,10,22.04.2019 00:05,177,18,Harkov
128,122,4,38,86,4,90,0,90,2,73,15,22.04.2019 00:05,177,18,Harkov
144,134,7,68,70,6,76,0,76,0,68,8,22.04.2019 00:10,177,18,Harkov
1104,1084,34,363,709,32,741,0,741,11,695,35,22.04.2019 01:40,177,18,Harkov
624,604,14,233,378,13,391,0,391,3,371,17,22.04.2019 00:08,177,18,Harkov
272,268,24,105,145,22,167,0,167,2,157,8,22.04.2019 00:10,177,18,Harkov
464,447,17,134,318,12,330,0,330,4,308,18,22.04.2019 00:05,177,18,Harkov
1488,1471,9,596,888,4,892,0,892,17,767,108,22.04.2019 00:40,177,18,Harkov
1488,1472,18,525,951,12,963,0,963,21,833,109,22.04.2019 00:58,177,18,Harkov
1856,1833,12,701,1146,9,1155,0,1155,24,1021,110,22.04.2019 00:45,177,18,Harkov
912,888,4,412,496,4,500,0,500,6,448,46,22.04.2019 00:16,177,18,Harkov
208,209,0,83,125,0,125,0,125,1,113,11,22.04.2019 00:07,177,18,Harkov
320,325,6,117,197,6,203,0,203,2,179,22,22.04.2019 00:45,177,18,Harkov
528,526,5,210,315,3,318,0,318,4,285,29,22.04.2019 00:20,177,18,Harkov
144,129,6,55,84,5,89,0,89,1,84,4,22.04.2019 00:15,177,18,Harkov
400,387,4,224,172,4,176,0,176,1,159,16,22.04.2019 00:05,177,18,Harkov
624,595,11,371,244,9,253,0,253,2,235,16,22.04.2019 00:10,177,18,Harkov
272,258,1,140,131,1,132,0,132,0,112,20,22.04.2019 00:45,177,18,Harkov
640,622,5,240,395,5,400,0,400,6,347,47,22.04.2019 00:30,177,18,Harkov
544,523,7,222,315,7,322,0,322,6,301,15,22.04.2019 00:10,177,18,Harkov
512,499,8,275,230,7,237,0,237,4,213,20,22.04.2019 00:40,177,18,Harkov
560,545,8,256,296,8,304,0,304,0,289,15,22.04.2019 00:05,177,18,Harkov
544,525,3,236,305,3,308,0,308,5,285,18,22.04.2019 00:15,177,18,Harkov
480,469,3,197,282,1,283,0,283,4,251,28,22.04.2019 00:02,177,18,Harkov
496,473,2,268,227,1,228,0,228,3,213,12,22.04.2019 00:02,177,18,Harkov
384,369,1,182,201,1,202,0,202,7,166,29,22.04.2019 00:25,177,18,Harkov
960,929,7,409,545,6,551,0,551,5,498,48,22.04.2019 00:05,177,18,Harkov
2000,1988,39,737,1232,31,1263,0,1263,20,1115,128,22.04.2019 00:15,177,18,Harkov
2096,2086,32,772,1299,25,1324,0,1324,29,1180,115,22.04.2019 00:25,177,18,Harkov
1456,1432,28,519,916,21,937,0,937,17,838,82,22.04.2019 00:05,177,18,Harkov
1456,1431,26,548,892,16,908,0,908,12,842,54,22.04.2019 00:35,177,18,Harkov
2064,2034,50,758,1259,47,1306,0,1306,24,1162,120,22.04.2019 00:30,177,18,Harkov
2224,2180,20,802,1405,17,1422,0,1422,13,1284,125,22.04.2019 00:31,177,18,Harkov
960,944,14,345,606,9,615,0,615,6,570,39,22.04.2019 00:25,177,18,Harkov
1968,1938,83,804,1092,72,1164,0,1164,34,1029,101,22.04.2019 00:25,177,18,Harkov
2032,2009,50,750,1240,42,1282,0,1282,26,1176,80,22.04.2019 00:05,177,18,Harkov
1728,1710,30,693,1009,26,1035,0,1035,20,921,94,21.04.2019 21:30,177,18,Harkov
1072,1061,19,334,722,16,738,0,738,4,700,34,22.04.2019 00:15,177,18,Harkov
1024,1020,12,345,667,12,679,0,679,5,628,46,22.04.2019 00:10,177,18,Harkov
1808,1779,6,674,1128,6,1134,0,1134,17,1072,45,22.04.2019 00:20,177,18,Harkov
1056,1057,11,366,679,11,690,0,690,16,639,35,22.04.2019 00:25,177,18,Harkov
1104,1094,14,429,665,10,675,0,675,10,630,35,22.04.2019 00:38,177,18,Harkov
1232,1203,6,423,803,6,809,0,809,12,754,43,22.04.2019 00:10,177,18,Harkov
1056,1032,11,391,658,7,665,0,665,6,625,34,22.04.2019 00:05,177,18,Harkov
1456,1425,18,647,795,14,809,0,809,9,762,38,22.04.2019 00:03,177,18,Harkov
1632,1609,20,706,911,15,926,0,926,18,842,66,22.04.2019 00:09,177,18,Harkov
1552,1538,15,844,694,14,708,0,708,7,672,29,22.04.2019 00:08,177,18,Harkov
1456,1439,7,618,832,6,838,0,838,14,765,59,22.04.2019 00:30,177,18,Harkov
1328,1317,2,606,720,2,722,0,722,14,663,45,22.04.2019 00:10,177,18,Harkov
1536,1506,20,677,843,16,859,0,859,17,786,56,22.04.2019 00:35,177,18,Harkov
1616,1604,20,667,933,16,949,0,949,23,863,63,22.04.2019 00:01,177,18,Harkov
1664,1640,13,675,976,13,989,0,989,17,926,46,22.04.2019 00:04,177,18,Harkov
288,52,52,242,0,46,46,0,46,0,44,2,22.04.2019 00:10,177,18,Harkov
176,15,0,162,14,0,14,0,14,0,14,0,22.04.2019 00:20,177,18,Harkov
1104,1099,20,365,723,16,739,0,739,9,664,66,22.04.2019 00:01,178,18,Harkov
1744,1715,46,624,1079,41,1120,0,1120,22,1023,75,22.04.2019 00:05,178,18,Harkov
2256,2217,27,831,1402,23,1425,0,1425,24,1322,79,22.04.2019 00:10,178,18,Harkov
2000,1988,35,598,1370,32,1402,0,1402,38,1263,101,22.04.2019 00:10,178,18,Harkov
2288,2232,33,852,1408,28,1436,0,1436,26,1306,104,22.04.2019 00:10,178,18,Harkov
2368,2404,29,805,1537,26,1563,0,1563,24,1458,81,22.04.2019 00:10,178,18,Harkov
2112,2099,33,815,1273,24,1297,0,1297,26,1199,72,22.04.2019 00:15,178,18,Harkov
1328,1305,37,552,744,32,776,0,776,15,707,54,22.04.2019 00:20,178,18,Harkov
2208,2172,37,809,1370,29,1399,0,1399,17,1301,81,22.04.2019 00:10,178,18,Harkov
304,304,9,81,216,7,223,0,223,6,204,13,21.04.2019 21:50,178,18,Harkov
1520,1490,21,559,946,15,961,0,961,7,900,54,22.04.2019 00:03,178,18,Harkov
1792,1773,21,689,1086,17,1103,0,1103,16,1042,45,22.04.2019 00:05,178,18,Harkov
832,824,8,290,535,7,542,0,542,10,501,31,22.04.2019 00:10,178,18,Harkov
2112,2086,29,911,1180,21,1201,0,1201,11,1146,44,21.04.2019 21:07,178,18,Harkov
1328,1299,17,595,717,16,733,0,733,13,661,59,21.04.2019 21:57,178,18,Harkov
608,602,10,308,292,8,300,0,300,8,270,22,22.04.2019 00:05,178,18,Harkov
480,468,17,172,291,17,308,0,308,3,263,42,22.04.2019 00:40,178,18,Harkov
2336,2291,48,764,1546,26,1572,0,1572,21,1458,93,22.04.2019 02:10,178,18,Harkov
720,718,23,288,412,20,432,0,432,4,401,27,22.04.2019 00:36,178,18,Harkov
2224,2210,15,799,1415,10,1425,0,1425,21,1325,79,22.04.2019 00:20,178,18,Harkov
576,568,23,216,337,23,360,0,360,3,350,7,22.04.2019 00:15,178,18,Harkov
336,325,4,139,193,4,197,0,197,2,185,10,22.04.2019 00:02,178,18,Harkov
816,802,48,240,533,43,576,0,576,8,534,34,22.04.2019 00:05,178,18,Harkov
624,605,85,244,299,81,380,0,380,4,346,30,22.04.2019 01:00,178,18,Harkov
1248,1225,47,412,796,40,836,0,836,19,757,60,22.04.2019 00:01,178,18,Harkov
1168,1146,40,395,734,39,773,0,773,14,719,40,22.04.2019 01:22,178,18,Harkov
544,536,8,232,307,5,312,0,312,0,295,17,22.04.2019 00:40,178,18,Harkov
384,365,19,197,168,19,187,0,187,3,174,10,22.04.2019 00:10,178,18,Harkov
480,460,28,210,243,27,270,0,270,1,245,24,22.04.2019 00:05,178,18,Harkov
448,439,40,179,237,32,269,0,269,5,240,24,21.04.2019 21:20,178,18,Harkov
832,814,58,288,488,56,544,0,544,2,514,28,22.04.2019 00:05,178,18,Harkov
192,180,24,71,99,22,121,0,121,0,110,11,22.04.2019 00:05,178,18,Harkov
736,717,45,254,442,40,482,0,482,11,430,41,22.04.2019 00:03,178,18,Harkov
496,469,35,226,239,31,270,0,270,1,244,25,22.04.2019 00:05,178,18,Harkov
880,860,72,422,393,65,458,0,458,3,426,29,22.04.2019 00:05,178,18,Harkov
640,628,21,243,379,18,397,0,397,9,337,51,22.04.2019 00:03,178,18,Harkov
304,299,17,92,200,12,212,0,212,3,178,31,21.04.2019 22:00,178,18,Harkov
592,583,35,178,380,34,414,0,414,3,383,28,22.04.2019 00:05,178,18,Harkov
1280,1263,57,485,746,49,795,0,795,14,752,29,22.04.2019 00:30,178,18,Harkov
320,310,24,118,179,23,202,0,202,1,188,13,22.04.2019 00:15,178,18,Harkov
1600,1571,110,470,1035,95,1130,0,1130,14,1076,40,22.04.2019 00:05,178,18,Harkov
496,485,8,194,297,5,302,0,302,1,289,12,22.04.2019 00:05,178,18,Harkov
704,675,65,288,363,53,416,0,416,3,399,14,21.04.2019 22:00,178,18,Harkov
1792,1757,44,734,1022,36,1058,0,1058,17,992,49,21.04.2019 20:54,178,18,Harkov
560,549,37,224,299,37,336,0,336,11,299,26,22.04.2019 00:25,178,18,Harkov
752,743,38,235,480,37,517,0,517,7,464,46,21.04.2019 21:10,178,18,Harkov
320,314,29,101,193,26,219,0,219,3,199,17,22.04.2019 00:07,178,18,Harkov
672,662,49,208,416,48,464,0,464,5,435,24,22.04.2019 00:55,178,18,Harkov
736,720,54,229,455,52,507,0,507,2,471,34,21.04.2019 23:40,178,18,Harkov
192,192,26,57,109,26,135,0,135,1,104,30,22.04.2019 00:40,178,18,Harkov
272,47,17,225,30,17,47,0,47,2,34,11,22.04.2019 00:10,178,18,Harkov
320,320,15,133,178,9,187,0,187,1,166,20,21.04.2019 21:05,178,18,Harkov
576,568,48,221,314,41,355,0,355,8,309,38,21.04.2019 21:30,178,18,Harkov
544,533,36,209,302,33,335,0,335,2,293,40,22.04.2019 00:10,178,18,Harkov
432,415,22,168,242,22,264,0,264,1,220,43,22.04.2019 00:05,178,18,Harkov
928,910,36,417,477,34,511,0,511,6,470,35,21.04.2019 22:45,178,18,Harkov
272,258,15,102,157,13,170,0,170,1,141,28,22.04.2019 00:10,178,18,Harkov
416,404,29,124,263,29,292,0,292,2,267,23,22.04.2019 00:15,178,18,Harkov
160,157,18,56,89,15,104,0,104,0,81,23,21.04.2019 21:00,178,18,Harkov
80,71,3,24,53,3,56,0,56,0,45,11,21.04.2019 21:05,178,18,Harkov
128,28,12,100,16,12,28,0,28,0,27,1,22.04.2019 00:30,178,18,Harkov
128,65,6,70,52,6,58,0,58,3,44,11,22.04.2019 00:25,178,18,Harkov
1808,1789,11,711,1087,10,1097,0,1097,19,957,121,22.04.2019 01:20,178,18,Harkov
672,652,27,274,374,24,398,0,398,6,342,50,21.04.2019 21:20,178,18,Harkov
432,411,9,224,201,7,208,0,208,5,181,22,21.04.2019 22:30,178,18,Harkov
416,408,2,194,220,2,222,0,222,2,208,12,21.04.2019 21:10,178,18,Harkov
432,420,9,180,244,8,252,0,252,0,225,27,22.04.2019 00:10,178,18,Harkov
272,274,11,123,143,6,149,0,149,0,137,12,22.04.2019 01:28,178,18,Harkov
336,321,16,142,180,14,194,0,194,2,173,19,21.04.2019 21:41,178,18,Harkov
688,667,14,269,407,12,419,0,419,6,375,38,22.04.2019 00:05,178,18,Harkov
96,8,1,88,7,1,8,0,8,0,5,3,22.04.2019 00:20,178,18,Harkov
224,218,29,97,100,27,127,0,127,2,111,14,22.04.2019 00:15,178,18,Harkov
304,293,36,145,128,31,159,0,159,1,146,12,22.04.2019 00:05,178,18,Harkov
144,149,30,59,61,24,85,0,85,1,66,18,22.04.2019 00:05,178,18,Harkov
256,245,23,85,151,20,171,0,171,0,158,13,22.04.2019 00:10,178,18,Harkov
240,240,25,74,143,23,166,0,166,3,150,13,21.04.2019 23:55,178,18,Harkov
400,387,24,156,220,24,244,0,244,2,210,32,22.04.2019 00:05,178,18,Harkov
448,440,47,171,233,44,277,0,277,1,254,22,22.04.2019 00:15,178,18,Harkov
688,683,46,260,384,44,428,0,428,1,401,26,22.04.2019 00:15,178,18,Harkov
528,511,61,248,223,57,280,0,280,5,243,32,22.04.2019 00:10,178,18,Harkov
2160,2118,57,825,1292,43,1335,0,1335,31,1220,84,22.04.2019 00:10,178,18,Harkov
144,24,11,120,13,11,24,0,24,0,19,5,21.04.2019 23:58,178,18,Harkov
608,607,41,211,363,34,397,0,397,6,329,62,22.04.2019 01:16,179,18,Harkov
224,212,18,78,129,17,146,0,146,2,125,19,22.04.2019 00:05,179,18,Harkov
176,179,12,92,72,12,84,0,84,4,72,8,21.04.2019 21:10,179,18,Harkov
1632,1607,17,535,1085,12,1097,0,1097,14,1011,72,22.04.2019 00:01,179,18,Harkov
1456,1430,30,493,936,27,963,0,963,12,890,61,22.04.2019 00:01,179,18,Harkov
816,807,32,278,514,24,538,0,538,6,504,28,21.04.2019 23:32,179,18,Harkov
784,765,26,248,511,25,536,0,536,11,490,35,22.04.2019 00:21,179,18,Harkov
1008,1015,20,301,688,19,707,0,707,12,637,58,22.04.2019 00:40,179,18,Harkov
1152,1157,30,388,744,20,764,0,764,8,704,52,21.04.2019 22:50,179,18,Harkov
800,790,18,298,489,13,502,0,502,7,468,27,21.04.2019 22:05,179,18,Harkov
1520,1511,22,504,999,17,1016,0,1016,13,943,60,22.04.2019 00:07,179,18,Harkov
688,671,17,254,423,11,434,0,434,4,402,28,22.04.2019 00:05,179,18,Harkov
592,571,11,282,300,10,310,0,310,8,285,17,22.04.2019 00:05,179,18,Harkov
368,352,14,149,207,12,219,0,219,7,205,7,21.04.2019 20:23,179,18,Harkov
464,460,37,185,244,35,279,0,279,2,255,22,21.04.2019 21:15,179,18,Harkov
576,567,34,191,357,28,385,0,385,5,329,51,21.04.2019 21:05,179,18,Harkov
384,379,23,120,248,16,264,0,264,2,240,22,21.04.2019 21:04,179,18,Harkov
448,436,31,150,269,29,298,0,298,5,286,7,21.04.2019 21:17,179,18,Harkov
256,241,25,90,142,24,166,0,166,0,152,14,21.04.2019 21:30,179,18,Harkov
896,885,68,396,445,55,500,0,500,8,457,35,22.04.2019 00:10,179,18,Harkov
912,902,76,363,478,71,549,0,549,6,500,43,22.04.2019 00:10,179,18,Harkov
1760,1741,73,584,1116,60,1176,0,1176,24,1083,69,21.04.2019 20:56,179,18,Harkov
688,664,90,242,361,85,446,0,446,4,421,21,21.04.2019 21:50,179,18,Harkov
736,727,50,243,443,50,493,0,493,8,470,15,22.04.2019 00:03,179,18,Harkov
352,337,20,102,232,18,250,0,250,3,224,23,22.04.2019 00:15,179,18,Harkov
1552,1532,35,589,938,25,963,0,963,11,918,34,21.04.2019 23:45,179,18,Harkov
1632,1594,28,549,1058,25,1083,0,1083,10,1005,68,21.04.2019 22:15,179,18,Harkov
1040,1019,19,402,622,16,638,0,638,4,617,17,21.04.2019 23:00,179,18,Harkov
192,179,2,33,157,2,159,0,159,1,134,24,21.04.2019 20:26,179,18,Harkov
1040,1024,25,386,633,21,654,0,654,8,600,46,21.04.2019 21:00,179,18,Harkov
208,204,16,83,111,14,125,0,125,1,106,18,22.04.2019 00:35,179,18,Harkov
640,635,35,229,381,30,411,0,411,7,379,25,22.04.2019 00:03,179,18,Harkov
176,171,10,57,109,10,119,0,119,0,112,7,21.04.2019 21:30,179,18,Harkov
176,167,9,59,110,7,117,0,117,2,110,5,21.04.2019 20:56,179,18,Harkov
240,45,26,197,19,24,43,0,43,0,39,4,21.04.2019 20:40,179,18,Harkov
336,325,1,157,178,1,179,0,179,0,156,23,21.04.2019 21:20,179,18,Harkov
464,455,36,179,250,35,285,0,285,1,252,32,21.04.2019 20:45,179,18,Harkov
128,126,5,49,74,5,79,0,79,3,50,26,21.04.2019 20:55,179,18,Harkov
128,123,0,52,76,0,76,0,76,3,60,13,21.04.2019 21:00,179,18,Harkov
192,177,0,88,104,0,104,0,104,0,91,13,21.04.2019 21:00,179,18,Harkov
576,553,17,262,299,15,314,0,314,6,270,38,22.04.2019 00:08,179,18,Harkov
688,677,32,277,380,31,411,0,411,2,354,55,21.04.2019 22:00,179,18,Harkov
848,821,7,410,431,7,438,0,438,7,398,33,22.04.2019 00:35,179,18,Harkov
624,613,37,259,329,36,365,0,365,8,303,54,21.04.2019 20:59,180,18,Harkov
1424,1414,30,530,868,26,894,0,894,18,779,97,21.04.2019 21:48,180,18,Harkov
2080,2072,20,744,1318,18,1336,0,1336,33,1173,130,22.04.2019 00:05,180,18,Harkov
1360,1330,22,554,786,20,806,0,806,17,740,49,22.04.2019 00:12,180,18,Harkov
256,253,15,135,111,10,121,0,121,0,104,17,22.04.2019 00:03,180,18,Harkov
528,528,30,234,268,26,294,0,294,4,274,16,22.04.2019 00:10,180,18,Harkov
192,180,5,110,80,2,82,0,82,2,65,15,22.04.2019 00:04,180,18,Harkov
1728,1716,25,612,1096,20,1116,0,1116,24,983,109,21.04.2019 22:00,181,18,Harkov
1856,1841,335,541,997,318,1315,0,1315,27,1043,245,21.04.2019 21:40,181,18,Harkov
1840,1820,18,698,1124,18,1142,0,1142,17,1034,91,21.04.2019 21:44,181,18,Harkov
1856,1834,22,611,1226,19,1245,0,1245,26,1079,140,21.04.2019 21:40,181,18,Harkov
2000,1977,29,650,1323,27,1350,0,1350,25,1199,126,21.04.2019 21:30,181,18,Harkov
1936,1908,22,704,1213,19,1232,0,1232,23,1086,123,21.04.2019 21:38,181,18,Harkov
2000,1977,12,785,1205,10,1215,0,1215,24,1091,100,21.04.2019 21:43,181,18,Harkov
992,971,14,355,624,13,637,0,637,18,566,53,21.04.2019 20:55,181,18,Harkov
2208,2178,40,792,1388,28,1416,0,1416,27,1270,119,21.04.2019 21:53,181,18,Harkov
1248,1232,36,536,679,33,712,0,712,18,646,48,22.04.2019 00:15,181,18,Harkov
1872,1850,24,632,1228,12,1240,0,1240,25,1113,102,21.04.2019 23:10,181,18,Harkov
1936,1918,26,692,1225,19,1244,0,1244,13,1149,82,21.04.2019 21:35,181,18,Harkov
1952,1919,30,694,1235,23,1258,0,1258,30,1141,87,21.04.2019 22:00,181,18,Harkov
1872,1855,20,621,1238,13,1251,0,1251,20,1151,80,21.04.2019 22:10,181,18,Harkov
1312,1286,14,525,775,12,787,0,787,4,734,49,22.04.2019 00:10,181,18,Harkov
400,382,10,189,201,10,211,0,211,1,188,22,22.04.2019 00:15,181,18,Harkov
560,550,13,153,395,12,407,0,407,6,387,14,22.04.2019 00:07,181,18,Harkov
832,822,35,316,481,35,516,0,516,8,490,18,21.04.2019 23:30,181,18,Harkov
672,671,47,218,419,35,454,0,454,2,406,46,22.04.2019 00:03,181,18,Harkov
1760,1726,51,693,1023,44,1067,0,1067,20,956,91,21.04.2019 23:10,181,18,Harkov
2192,2166,61,915,1221,56,1277,0,1277,26,1165,86,22.04.2019 00:02,181,18,Harkov
1952,1905,51,936,978,38,1016,0,1016,18,945,53,22.04.2019 00:15,181,18,Harkov
816,798,29,262,528,26,554,0,554,4,497,53,22.04.2019 00:20,181,18,Harkov
736,724,21,335,382,19,401,0,401,4,363,34,21.04.2019 22:40,181,18,Harkov
496,484,31,103,364,29,393,0,393,7,330,56,21.04.2019 21:30,181,18,Harkov
224,40,26,187,12,25,37,0,37,0,32,5,21.04.2019 20:15,181,18,Harkov
1792,1766,23,676,1098,18,1116,0,1116,21,974,121,22.04.2019 00:05,181,18,Harkov
2144,2111,7,909,1230,5,1235,0,1235,31,1077,127,21.04.2019 22:15,181,18,Harkov
2320,2288,10,974,1340,6,1346,0,1346,20,1216,110,21.04.2019 22:50,181,18,Harkov
1248,1228,8,524,718,6,724,0,724,11,628,85,21.04.2019 22:00,181,18,Harkov
1184,1166,6,379,802,3,805,0,805,26,699,80,22.04.2019 00:10,181,18,Harkov
1936,1910,47,711,1182,43,1225,0,1225,22,1128,75,21.04.2019 23:05,181,18,Harkov
1840,1825,15,712,1115,13,1128,0,1128,19,982,127,21.04.2019 22:10,181,18,Harkov
1056,1035,14,339,704,13,717,0,717,11,667,39,22.04.2019 00:20,181,18,Harkov
176,168,2,88,86,2,88,0,88,2,84,2,21.04.2019 22:30,181,18,Harkov
992,881,0,111,881,0,881,0,881,21,761,99,21.04.2019 22:40,181,18,Harkov
432,430,0,2,430,0,430,0,430,44,377,9,22.04.2019 00:07,182,19,Herson
32,17,0,15,17,0,17,0,17,0,14,3,21.04.2019 21:00,182,19,Herson
128,88,0,40,88,0,88,0,88,5,76,7,22.04.2019 00:10,182,19,Herson
1312,1307,5,533,776,3,779,0,779,17,638,124,22.04.2019 00:22,182,19,Herson
1872,1855,8,791,1074,7,1081,0,1081,21,915,145,22.04.2019 00:23,182,19,Herson
1888,1866,8,875,1012,1,1013,0,1013,15,831,167,22.04.2019 00:45,182,19,Herson
1856,1842,8,704,1146,6,1152,0,1152,24,946,182,22.04.2019 00:52,182,19,Herson
1200,1185,4,435,763,2,765,0,765,15,607,143,22.04.2019 00:04,182,19,Herson
1904,1873,5,751,1151,2,1153,0,1153,27,921,205,22.04.2019 00:05,182,19,Herson
960,952,4,427,532,1,533,0,533,10,420,103,22.04.2019 00:17,182,19,Herson
1136,1118,5,427,704,5,709,0,709,19,567,123,22.04.2019 00:30,182,19,Herson
2112,2103,6,796,1311,5,1316,0,1316,30,1077,209,22.04.2019 00:01,182,19,Herson
2080,2070,17,866,1201,13,1214,0,1214,25,945,244,22.04.2019 00:20,182,19,Herson
1808,1786,11,765,1035,8,1043,0,1043,37,814,192,22.04.2019 00:10,182,19,Herson
1424,1426,6,651,770,3,773,0,773,12,642,119,22.04.2019 00:10,182,19,Herson
2112,2083,13,842,1257,13,1270,0,1270,36,1029,205,22.04.2019 00:30,182,19,Herson
1582,1552,9,721,856,5,861,0,861,17,694,150,22.04.2019 00:35,182,19,Herson
2016,2006,8,903,1107,6,1113,0,1113,24,904,185,22.04.2019 00:05,182,19,Herson
1232,1206,2,566,665,1,666,0,666,17,539,110,22.04.2019 00:08,182,19,Herson
1328,1302,8,543,780,5,785,0,785,17,624,144,22.04.2019 00:01,182,19,Herson
1840,1821,4,875,961,4,965,0,965,16,796,153,22.04.2019 00:15,182,19,Herson
1360,1352,10,520,831,9,840,0,840,23,665,152,21.04.2019 21:22,182,19,Herson
1696,1676,14,673,1012,11,1023,0,1023,36,791,196,22.04.2019 00:10,182,19,Herson
2144,2126,14,871,1260,13,1273,0,1273,25,1029,219,21.04.2019 21:10,182,19,Herson
2128,2125,8,771,1352,5,1357,0,1357,31,1067,259,22.04.2019 00:09,182,19,Herson
2144,2108,5,856,1284,4,1288,0,1288,22,1037,229,22.04.2019 01:10,182,19,Herson
2304,2271,14,940,1353,11,1364,0,1364,26,1093,245,22.04.2019 00:40,182,19,Herson
1328,1325,5,610,715,3,718,0,718,17,596,105,22.04.2019 00:05,182,19,Herson
2160,2143,9,854,1298,8,1306,0,1306,17,1087,202,22.04.2019 00:06,182,19,Herson
1712,1702,14,663,1040,9,1049,0,1049,33,868,148,22.04.2019 00:44,182,19,Herson
1632,1608,5,720,907,5,912,0,912,17,787,108,22.04.2019 00:55,182,19,Herson
384,365,0,172,212,0,212,0,212,2,171,39,21.04.2019 20:20,182,19,Herson
240,228,1,145,94,1,95,0,95,0,80,15,21.04.2019 21:30,182,19,Herson
560,560,1,189,370,1,371,0,371,9,301,61,22.04.2019 00:05,182,19,Herson
224,49,0,180,44,0,44,0,44,0,35,9,22.04.2019 00:12,182,19,Herson
96,9,0,87,9,0,9,0,9,0,6,3,22.04.2019 00:11,182,19,Herson
2320,2318,26,973,1326,21,1347,0,1347,20,1087,240,22.04.2019 00:15,182,19,Herson
1904,1950,6,723,1176,5,1181,0,1181,34,880,267,22.04.2019 00:56,182,19,Herson
1680,1655,5,633,1044,3,1047,0,1047,25,818,204,21.04.2019 23:10,182,19,Herson
2320,2301,22,904,1406,10,1416,0,1416,31,1134,251,22.04.2019 00:10,182,19,Herson
1904,1897,8,827,1072,5,1077,0,1077,14,879,184,21.04.2019 22:21,182,19,Herson
1408,1433,4,535,872,1,873,0,873,25,679,169,21.04.2019 21:35,182,19,Herson
2080,2057,10,980,1095,5,1100,0,1100,33,906,161,22.04.2019 00:20,182,19,Herson
1616,1652,6,607,1004,5,1009,0,1009,19,751,239,22.04.2019 00:26,182,19,Herson
2016,1974,17,828,1177,11,1188,0,1188,18,960,210,22.04.2019 00:37,182,19,Herson
1968,1949,11,797,1163,8,1171,0,1171,36,921,214,22.04.2019 00:15,182,19,Herson
2208,2198,15,834,1365,9,1374,0,1374,46,1113,215,22.04.2019 00:15,182,19,Herson
1728,1726,3,682,1043,3,1046,0,1046,31,854,161,21.04.2019 21:45,182,19,Herson
2272,2243,10,997,1266,9,1275,0,1275,30,1045,200,22.04.2019 00:20,182,19,Herson
2160,2121,18,910,1232,18,1250,0,1250,19,1028,203,22.04.2019 00:15,182,19,Herson
2256,2228,21,897,1347,12,1359,0,1359,38,1103,218,22.04.2019 00:20,182,19,Herson
1824,1809,8,724,1096,4,1100,0,1100,24,913,163,21.04.2019 23:45,182,19,Herson
2096,2061,12,838,1248,10,1258,0,1258,21,1034,203,22.04.2019 00:38,182,19,Herson
2176,2181,7,790,1380,6,1386,0,1386,30,1175,181,22.04.2019 00:30,182,19,Herson
2256,2224,5,895,1360,1,1361,0,1361,32,1150,179,22.04.2019 01:10,182,19,Herson
2288,2258,14,880,1400,8,1408,0,1408,36,1188,184,22.04.2019 00:52,182,19,Herson
2288,2282,41,855,1402,31,1433,0,1433,41,1146,246,22.04.2019 00:15,182,19,Herson
2352,2345,16,851,1487,14,1501,0,1501,25,1170,306,22.04.2019 00:40,182,19,Herson
2368,2339,4,928,1437,3,1440,0,1440,44,1129,267,22.04.2019 00:25,182,19,Herson
2272,2257,18,840,1425,7,1432,0,1432,30,1159,243,22.04.2019 00:03,182,19,Herson
2240,2227,4,875,1363,2,1365,0,1365,34,1102,229,22.04.2019 00:17,182,19,Herson
176,51,5,147,28,1,29,0,29,0,26,3,22.04.2019 00:15,182,19,Herson
352,115,20,240,93,19,112,0,112,3,98,11,21.04.2019 22:00,182,19,Herson
96,41,1,56,39,1,40,0,40,1,30,9,22.04.2019 00:10,182,19,Herson
64,53,52,37,1,26,27,0,27,0,18,9,21.04.2019 21:45,182,19,Herson
128,15,0,114,14,0,14,0,14,0,11,3,21.04.2019 20:50,182,19,Herson
368,37,9,331,28,9,37,0,37,2,29,6,22.04.2019 00:20,182,19,Herson
240,108,21,139,82,19,101,0,101,4,77,20,21.04.2019 21:30,182,19,Herson
368,169,21,221,126,21,147,0,147,8,124,15,21.04.2019 22:05,182,19,Herson
1056,688,0,410,646,0,646,0,646,38,570,38,22.04.2019 00:05,182,19,Herson
2224,2176,0,1926,298,0,298,0,298,7,235,56,22.04.2019 00:30,182,19,Herson
176,138,6,38,132,6,138,0,138,13,116,9,22.04.2019 00:23,183,19,Herson
2256,2224,5,990,1261,5,1266,0,1266,24,993,249,22.04.2019 02:17,183,19,Herson
1856,1847,15,779,1065,12,1077,0,1077,18,818,241,22.04.2019 02:28,183,19,Herson
1744,1716,78,852,831,61,892,0,892,10,747,135,22.04.2019 00:00,183,19,Herson
1712,1682,24,823,869,20,889,0,889,9,691,189,21.04.2019 23:23,183,19,Herson
1856,1834,24,960,874,22,896,0,896,12,739,145,22.04.2019 00:10,183,19,Herson
272,271,7,91,175,6,181,0,181,4,144,33,22.04.2019 02:24,183,19,Herson
1744,1719,17,857,874,13,887,0,887,11,771,105,22.04.2019 01:51,183,19,Herson
384,362,7,215,164,5,169,0,169,2,117,50,22.04.2019 01:13,183,19,Herson
1120,1101,24,568,533,19,552,0,552,14,444,94,22.04.2019 01:24,183,19,Herson
496,481,16,256,228,12,240,0,240,2,206,32,21.04.2019 22:52,183,19,Herson
1520,1503,7,796,717,7,724,0,724,6,575,143,22.04.2019 02:30,183,19,Herson
688,668,19,331,339,18,357,0,357,6,283,68,22.04.2019 00:45,183,19,Herson
1136,1124,27,555,560,21,581,0,581,10,471,100,21.04.2019 23:16,183,19,Herson
624,616,16,292,318,14,332,0,332,6,239,87,22.04.2019 01:06,183,19,Herson
288,274,6,151,132,5,137,0,137,0,113,24,22.04.2019 00:25,183,19,Herson
1040,1033,18,480,544,16,560,0,560,7,428,125,22.04.2019 02:31,183,19,Herson
528,514,8,251,270,7,277,0,277,5,189,83,22.04.2019 00:49,183,19,Herson
496,490,8,249,239,8,247,0,247,4,199,44,22.04.2019 02:08,183,19,Herson
864,854,5,362,497,5,502,0,502,0,418,84,21.04.2019 23:20,183,19,Herson
400,394,1,179,220,1,221,0,221,4,188,29,22.04.2019 02:12,183,19,Herson
2400,2378,18,1097,1288,15,1303,0,1303,36,1069,198,22.04.2019 00:35,183,19,Herson
2432,2408,9,991,1436,5,1441,0,1441,30,1161,250,22.04.2019 01:13,183,19,Herson
144,133,0,60,84,0,84,0,84,0,72,12,22.04.2019 00:11,183,19,Herson
1264,372,0,892,372,0,372,0,372,33,321,18,22.04.2019 00:44,183,19,Herson
2160,2127,8,793,1360,7,1367,0,1367,35,1087,245,21.04.2019 22:30,183,19,Herson
2176,2160,8,838,1331,7,1338,0,1338,36,1071,231,22.04.2019 02:55,183,19,Herson
1408,1398,8,545,857,6,863,0,863,20,691,152,22.04.2019 00:47,183,19,Herson
1696,1676,8,749,941,6,947,0,947,28,766,153,22.04.2019 01:43,183,19,Herson
640,629,2,321,317,2,319,0,319,9,247,63,22.04.2019 00:31,183,19,Herson
2176,2158,9,889,1280,7,1287,0,1287,29,1008,250,21.04.2019 22:17,183,19,Herson
2256,2246,6,1004,1247,5,1252,0,1252,29,977,246,22.04.2019 02:02,183,19,Herson
1824,1792,5,709,1111,4,1115,0,1115,35,911,169,22.04.2019 01:40,183,19,Herson
1552,1510,5,631,918,3,921,0,921,23,702,196,22.04.2019 00:37,183,19,Herson
1584,1569,13,700,875,9,884,0,884,18,736,130,22.04.2019 01:25,183,19,Herson
2176,2168,15,881,1283,12,1295,0,1295,25,1029,241,22.04.2019 01:52,183,19,Herson
2000,1976,16,883,1110,7,1117,0,1117,24,904,189,22.04.2019 01:54,183,19,Herson
2064,2040,12,913,1144,7,1151,0,1151,22,928,201,22.04.2019 02:00,183,19,Herson
1968,1942,21,807,1145,16,1161,0,1161,25,948,188,22.04.2019 00:12,183,19,Herson
1296,1272,9,539,748,9,757,0,757,14,607,136,22.04.2019 01:48,183,19,Herson
1472,1458,8,654,812,6,818,0,818,11,686,121,22.04.2019 01:50,183,19,Herson
1712,1686,14,703,996,13,1009,0,1009,31,795,183,22.04.2019 01:28,183,19,Herson
1712,1688,3,673,1037,2,1039,0,1039,25,837,177,22.04.2019 01:38,183,19,Herson
1344,1315,14,582,753,9,762,0,762,12,620,130,22.04.2019 01:08,183,19,Herson
2128,2105,9,820,1299,9,1308,0,1308,39,1051,218,22.04.2019 02:05,183,19,Herson
1344,1330,5,505,834,5,839,0,839,17,669,153,22.04.2019 00:01,183,19,Herson
1584,1574,14,582,989,13,1002,0,1002,27,829,146,22.04.2019 02:55,183,19,Herson
1872,1862,15,790,1071,11,1082,0,1082,28,866,188,22.04.2019 01:47,183,19,Herson
1648,1629,16,824,810,14,824,0,824,31,684,109,22.04.2019 01:39,183,19,Herson
1904,1871,20,890,997,17,1014,0,1014,25,878,111,22.04.2019 02:11,183,19,Herson
2176,2151,21,1089,1073,14,1087,0,1087,21,944,122,22.04.2019 02:23,183,19,Herson
1184,1166,7,501,678,5,683,0,683,10,576,97,22.04.2019 01:06,183,19,Herson
320,305,7,85,228,7,235,0,235,6,210,19,22.04.2019 01:17,183,19,Herson
416,34,18,383,16,17,33,0,33,1,28,4,22.04.2019 01:02,183,19,Herson
112,51,1,63,48,1,49,0,49,0,40,9,22.04.2019 00:15,183,19,Herson
48,14,0,35,13,0,13,0,13,0,13,0,21.04.2019 21:57,183,19,Herson
1584,1547,2,675,909,0,909,0,909,25,741,143,22.04.2019 01:18,183,19,Herson
1424,1405,5,602,819,3,822,0,822,16,706,100,22.04.2019 01:03,183,19,Herson
976,212,202,769,10,197,207,0,207,4,156,47,22.04.2019 00:06,183,19,Herson
80,28,10,53,17,10,27,0,27,2,18,7,22.04.2019 00:29,183,19,Herson
1968,1932,18,959,995,14,1009,0,1009,18,855,136,22.04.2019 00:40,184,19,Herson
1232,1208,15,548,672,12,684,0,684,10,583,91,21.04.2019 21:31,184,19,Herson
1856,1838,20,778,1062,16,1078,0,1078,13,916,149,22.04.2019 01:20,184,19,Herson
1680,1650,18,702,964,14,978,0,978,16,810,152,22.04.2019 00:15,184,19,Herson
848,836,12,412,424,12,436,0,436,2,384,50,21.04.2019 20:40,184,19,Herson
1664,1630,36,704,931,29,960,0,960,20,847,93,22.04.2019 01:10,184,19,Herson
1424,1396,29,685,719,20,739,0,739,14,632,93,21.04.2019 21:55,184,19,Herson
1664,1639,21,775,873,16,889,0,889,20,801,68,21.04.2019 22:25,184,19,Herson
576,560,4,241,331,4,335,0,335,7,308,20,21.04.2019 21:30,184,19,Herson
848,826,40,408,405,35,440,0,440,7,316,117,21.04.2019 20:41,184,19,Herson
1392,1375,56,566,772,54,826,0,826,15,564,247,21.04.2019 21:30,184,19,Herson
336,320,9,161,168,7,175,0,175,1,166,8,21.04.2019 20:45,184,19,Herson
192,180,0,105,87,0,87,0,87,2,42,43,21.04.2019 21:25,184,19,Herson
784,757,17,357,412,15,427,0,427,5,350,72,21.04.2019 22:05,184,19,Herson
80,69,0,39,41,0,41,0,41,3,21,17,21.04.2019 21:05,184,19,Herson
816,805,39,325,458,33,491,0,491,5,450,36,21.04.2019 21:50,184,19,Herson
832,821,25,427,382,23,405,0,405,6,295,104,21.04.2019 20:39,184,19,Herson
176,174,9,62,105,9,114,0,114,1,92,21,21.04.2019 20:32,184,19,Herson
1632,1606,62,768,802,62,864,0,864,8,725,131,21.04.2019 21:30,184,19,Herson
416,393,12,200,204,12,216,0,216,3,161,52,21.04.2019 20:55,184,19,Herson
880,847,19,399,462,19,481,0,481,5,403,73,21.04.2019 20:40,184,19,Herson
320,305,10,78,232,10,242,0,242,4,214,24,21.04.2019 23:00,184,19,Herson
96,89,0,50,46,0,46,0,46,0,40,6,21.04.2019 20:18,184,19,Herson
240,226,10,110,120,10,130,0,130,5,101,24,21.04.2019 20:40,184,19,Herson
784,759,23,355,410,19,429,0,429,6,372,51,21.04.2019 21:30,184,19,Herson
192,29,7,164,22,6,28,0,28,0,25,3,21.04.2019 22:25,184,19,Herson
1232,1200,24,608,608,16,624,0,624,9,528,87,22.04.2019 00:25,184,19,Herson
208,198,3,99,106,3,109,0,109,0,87,22,21.04.2019 23:10,184,19,Herson
128,120,2,40,86,2,88,0,88,0,62,26,21.04.2019 20:45,184,19,Herson
336,328,34,132,170,34,204,0,204,4,187,13,22.04.2019 02:00,184,19,Herson
208,200,0,93,115,0,115,0,115,2,99,14,22.04.2019 01:20,184,19,Herson
1216,1198,57,584,591,41,632,0,632,7,518,107,21.04.2019 21:05,184,19,Herson
288,272,15,93,180,15,195,0,195,2,181,12,21.04.2019 22:30,184,19,Herson
400,384,21,187,195,18,213,0,213,2,174,37,21.04.2019 20:30,184,19,Herson
432,421,21,226,185,21,206,0,206,1,191,14,21.04.2019 20:55,184,19,Herson
336,330,21,119,198,19,217,0,217,3,188,26,21.04.2019 21:20,184,19,Herson
224,208,33,109,85,30,115,0,115,4,84,27,21.04.2019 22:45,184,19,Herson
352,342,22,123,208,21,229,0,229,3,182,44,21.04.2019 20:40,184,19,Herson
336,317,24,161,153,22,175,0,175,4,150,21,21.04.2019 21:30,184,19,Herson
448,441,25,204,222,22,244,0,244,6,207,31,21.04.2019 21:25,184,19,Herson
640,632,43,270,327,43,370,0,370,6,311,53,21.04.2019 20:45,184,19,Herson
80,73,1,38,41,1,42,0,42,0,37,5,21.04.2019 20:20,184,19,Herson
64,58,0,28,36,0,36,0,36,0,26,10,21.04.2019 20:05,184,19,Herson
336,324,19,138,180,18,198,0,198,0,173,25,22.04.2019 00:20,184,19,Herson
176,163,4,93,79,4,83,0,83,4,62,17,21.04.2019 20:28,184,19,Herson
992,969,21,460,512,20,532,0,532,8,450,74,21.04.2019 20:45,184,19,Herson
144,142,15,36,93,15,108,0,108,4,95,9,21.04.2019 20:20,184,19,Herson
144,139,0,73,71,0,71,0,71,0,57,14,21.04.2019 21:00,184,19,Herson
1408,1364,54,688,674,46,720,0,720,10,593,117,21.04.2019 23:30,184,19,Herson
656,639,49,300,317,39,356,0,356,6,293,57,22.04.2019 00:10,184,19,Herson
96,79,13,47,37,12,49,0,49,0,39,10,21.04.2019 21:30,184,19,Herson
688,672,24,300,367,21,388,0,388,3,324,61,22.04.2019 00:10,184,19,Herson
400,394,21,174,207,19,226,0,226,7,168,51,22.04.2019 00:10,184,19,Herson
384,379,12,162,212,10,222,0,222,5,168,49,22.04.2019 00:25,184,19,Herson
768,746,25,287,458,23,481,0,481,10,324,147,22.04.2019 00:05,184,19,Herson
272,262,13,111,152,9,161,0,161,3,133,25,22.04.2019 00:20,184,19,Herson
80,71,6,48,27,5,32,0,32,1,18,13,21.04.2019 21:16,184,19,Herson
688,670,16,310,363,15,378,0,378,2,309,67,22.04.2019 00:10,184,19,Herson
608,584,19,236,354,18,372,0,372,5,293,74,22.04.2019 00:10,184,19,Herson
1104,1074,50,538,521,45,566,0,566,8,462,96,22.04.2019 00:01,184,19,Herson
432,415,27,180,228,24,252,0,252,5,213,34,22.04.2019 00:25,184,19,Herson
80,72,1,33,46,1,47,0,47,1,33,13,21.04.2019 20:35,184,19,Herson
912,892,38,428,452,32,484,0,484,9,302,173,22.04.2019 00:45,184,19,Herson
912,893,60,401,456,55,511,0,511,12,403,96,22.04.2019 00:05,184,19,Herson
912,889,42,391,479,42,521,0,521,16,394,111,21.04.2019 23:59,184,19,Herson
800,776,56,299,448,53,501,0,501,11,356,134,22.04.2019 00:05,184,19,Herson
1392,1368,7,578,810,4,814,0,814,16,716,82,22.04.2019 00:08,184,19,Herson
2352,2307,6,938,1411,3,1414,0,1414,25,1186,203,21.04.2019 22:20,184,19,Herson
2288,2243,7,914,1368,6,1374,0,1374,20,1137,217,22.04.2019 00:10,184,19,Herson
2256,2224,8,922,1329,5,1334,0,1334,33,1107,194,22.04.2019 00:02,184,19,Herson
1312,1284,6,570,738,4,742,0,742,19,629,94,22.04.2019 00:10,184,19,Herson
912,933,14,291,607,14,621,0,621,13,465,143,21.04.2019 21:45,184,19,Herson
1408,1392,13,556,841,11,852,0,852,27,712,113,21.04.2019 20:59,184,19,Herson
1040,1077,6,336,699,5,704,0,704,29,589,86,21.04.2019 23:30,184,19,Herson
1376,1430,9,523,845,8,853,0,853,20,708,125,22.04.2019 00:15,184,19,Herson
480,473,12,210,261,9,270,0,270,1,237,32,21.04.2019 23:00,184,19,Herson
656,643,46,250,365,41,406,0,406,2,347,57,22.04.2019 00:05,185,19,Herson
416,410,16,156,245,15,260,0,260,6,212,42,21.04.2019 22:50,185,19,Herson
976,982,0,388,588,0,588,0,588,14,529,45,22.04.2019 00:35,185,19,Herson
752,735,9,330,413,9,422,0,422,1,386,35,21.04.2019 20:40,185,19,Herson
864,850,41,469,361,34,395,0,395,8,316,71,22.04.2019 00:50,185,19,Herson
512,494,5,273,234,5,239,0,239,5,211,23,22.04.2019 00:05,185,19,Herson
176,169,4,61,111,4,115,0,115,0,90,25,22.04.2019 00:30,185,19,Herson
608,596,25,302,281,25,306,0,306,5,233,68,22.04.2019 01:50,185,19,Herson
336,321,5,87,244,5,249,0,249,1,223,25,21.04.2019 21:20,185,19,Herson
480,470,4,211,267,2,269,0,269,2,236,31,21.04.2019 20:45,185,19,Herson
592,585,0,266,326,0,326,0,326,3,294,29,21.04.2019 21:03,185,19,Herson
2416,2389,16,923,1482,11,1493,0,1493,21,1308,164,22.04.2019 02:10,185,19,Herson
1776,1767,56,756,983,37,1020,0,1020,18,860,142,22.04.2019 00:20,185,19,Herson
624,611,27,317,282,25,307,0,307,2,253,52,21.04.2019 22:32,185,19,Herson
464,449,0,222,242,0,242,0,242,3,185,54,21.04.2019 20:21,185,19,Herson
864,836,16,440,409,15,424,0,424,3,330,91,21.04.2019 22:45,185,19,Herson
304,294,3,148,153,3,156,0,156,4,128,24,21.04.2019 22:40,185,19,Herson
784,770,24,368,400,16,416,0,416,7,336,73,21.04.2019 20:30,185,19,Herson
352,343,7,160,188,4,192,0,192,0,173,19,21.04.2019 23:00,185,19,Herson
656,635,26,311,319,26,345,0,345,3,281,61,21.04.2019 23:35,185,19,Herson
352,342,7,144,201,7,208,0,208,1,178,29,21.04.2019 22:01,185,19,Herson
432,424,4,197,233,2,235,0,235,6,209,20,21.04.2019 21:30,185,19,Herson
400,392,19,150,231,19,250,0,250,0,209,41,21.04.2019 20:45,185,19,Herson
288,278,13,76,199,13,212,0,212,3,198,11,21.04.2019 21:35,185,19,Herson
672,659,20,338,314,20,334,0,334,3,295,36,22.04.2019 00:30,185,19,Herson
112,112,6,22,84,6,90,0,90,1,76,13,21.04.2019 21:50,185,19,Herson
256,252,19,102,140,14,154,0,154,0,141,13,21.04.2019 22:30,185,19,Herson
64,67,0,8,56,0,56,0,56,0,45,11,21.04.2019 21:30,185,19,Herson
1296,1270,21,619,656,21,677,0,677,8,587,82,21.04.2019 23:50,185,19,Herson
1440,1415,31,575,836,29,865,0,865,5,792,68,22.04.2019 00:05,185,19,Herson
704,682,3,333,368,3,371,0,371,6,297,68,21.04.2019 21:20,185,19,Herson
608,592,3,283,323,2,325,0,325,5,259,61,21.04.2019 22:25,185,19,Herson
1536,1491,12,718,812,6,818,0,818,15,700,103,22.04.2019 00:35,185,19,Herson
2096,2057,13,828,1255,13,1268,0,1268,10,1104,154,21.04.2019 20:55,185,19,Herson
1680,1651,21,651,1021,8,1029,0,1029,23,866,140,22.04.2019 00:15,185,19,Herson
2032,2006,24,705,1308,19,1327,0,1327,43,1090,194,22.04.2019 00:25,185,19,Herson
2016,1975,22,832,1165,19,1184,0,1184,22,995,167,22.04.2019 00:58,185,19,Herson
1872,1840,12,675,1187,10,1197,0,1197,24,1014,159,22.04.2019 00:20,185,19,Herson
208,194,110,27,81,100,181,0,181,10,104,67,22.04.2019 00:18,185,19,Herson
256,96,27,168,68,20,88,0,88,0,81,7,21.04.2019 22:00,185,19,Herson
48,17,0,33,15,0,15,0,15,0,12,3,21.04.2019 20:35,185,19,Herson
2048,2025,15,883,1156,9,1165,0,1165,33,963,169,22.04.2019 00:20,186,19,Herson
480,467,20,217,247,16,263,0,263,5,241,17,22.04.2019 00:01,186,19,Herson
1856,1851,17,647,1198,11,1209,0,1209,37,845,327,22.04.2019 00:22,187,20,Hmelnitsk
352,71,13,284,55,13,68,0,68,4,50,14,22.04.2019 00:15,187,20,Hmelnitsk
112,4,0,108,4,0,4,0,4,0,3,1,22.04.2019 00:25,187,20,Hmelnitsk
176,29,6,163,9,4,13,0,13,0,11,2,22.04.2019 00:20,187,20,Hmelnitsk
336,328,46,117,180,39,219,0,219,5,169,45,22.04.2019 00:25,188,20,Hmelnitsk
112,100,9,41,64,7,71,0,71,5,47,19,21.04.2019 21:40,188,20,Hmelnitsk
256,247,28,90,140,26,166,0,166,2,116,48,22.04.2019 00:30,188,20,Hmelnitsk
688,667,27,255,411,22,433,0,433,13,311,109,22.04.2019 00:16,188,20,Hmelnitsk
752,734,54,229,476,47,523,0,523,7,372,144,22.04.2019 02:15,188,20,Hmelnitsk
2096,2078,16,864,1218,14,1232,0,1232,25,926,281,22.04.2019 00:58,188,20,Hmelnitsk
1456,1438,9,612,835,9,844,0,844,20,657,167,22.04.2019 00:10,188,20,Hmelnitsk
320,301,21,119,184,17,201,0,201,4,139,58,22.04.2019 00:14,188,20,Hmelnitsk
416,405,70,129,221,66,287,0,287,8,222,57,22.04.2019 00:25,188,20,Hmelnitsk
288,284,43,107,142,39,181,0,181,7,134,40,22.04.2019 00:25,188,20,Hmelnitsk
672,656,37,228,409,35,444,0,444,11,343,90,22.04.2019 00:03,188,20,Hmelnitsk
1232,1206,29,465,741,26,767,0,767,16,578,173,22.04.2019 00:07,188,20,Hmelnitsk
320,303,33,128,159,33,192,0,192,2,143,47,22.04.2019 00:15,188,20,Hmelnitsk
1152,1136,55,403,700,49,749,0,749,21,465,263,22.04.2019 00:26,188,20,Hmelnitsk
144,140,16,50,80,14,94,0,94,1,73,20,22.04.2019 00:50,188,20,Hmelnitsk
320,306,32,122,170,28,198,0,198,4,151,43,22.04.2019 00:30,188,20,Hmelnitsk
64,68,8,18,41,5,46,0,46,0,27,19,22.04.2019 00:20,188,20,Hmelnitsk
176,167,6,60,112,4,116,0,116,2,74,40,22.04.2019 00:55,188,20,Hmelnitsk
304,300,39,37,232,35,267,0,267,0,215,52,21.04.2019 23:30,188,20,Hmelnitsk
144,136,16,31,102,11,113,0,113,5,91,17,22.04.2019 00:37,188,20,Hmelnitsk
80,80,9,18,55,7,62,0,62,0,47,15,22.04.2019 00:05,188,20,Hmelnitsk
192,191,24,79,93,20,113,0,113,3,72,38,22.04.2019 00:01,188,20,Hmelnitsk
160,159,16,41,105,14,119,0,119,1,86,32,22.04.2019 01:05,188,20,Hmelnitsk
368,357,33,97,240,31,271,0,271,6,204,61,22.04.2019 00:25,188,20,Hmelnitsk
288,275,20,135,135,18,153,0,153,2,97,54,22.04.2019 00:01,188,20,Hmelnitsk
224,209,35,77,112,35,147,0,147,3,88,56,22.04.2019 00:15,188,20,Hmelnitsk
448,436,23,142,285,21,306,0,306,7,239,60,22.04.2019 00:30,188,20,Hmelnitsk
368,356,31,141,196,31,227,0,227,8,171,48,22.04.2019 00:05,188,20,Hmelnitsk
336,323,45,102,190,44,234,0,234,4,185,45,21.04.2019 20:30,188,20,Hmelnitsk
448,447,55,154,242,52,294,0,294,1,219,74,22.04.2019 00:30,188,20,Hmelnitsk
288,274,23,111,154,23,177,0,177,4,125,48,22.04.2019 00:15,188,20,Hmelnitsk
288,282,22,103,164,21,185,0,185,3,143,39,22.04.2019 00:25,188,20,Hmelnitsk
192,187,17,92,83,17,100,0,100,0,73,27,22.04.2019 00:45,188,20,Hmelnitsk
368,352,44,142,189,37,226,0,226,5,160,61,21.04.2019 22:00,188,20,Hmelnitsk
336,322,16,110,210,16,226,0,226,3,172,51,21.04.2019 23:50,188,20,Hmelnitsk
1696,1663,32,650,1017,29,1046,0,1046,25,716,305,22.04.2019 00:03,188,20,Hmelnitsk
480,462,58,169,260,51,311,0,311,10,243,58,22.04.2019 00:05,188,20,Hmelnitsk
352,345,15,160,177,15,192,0,192,2,101,89,22.04.2019 00:49,188,20,Hmelnitsk
144,130,24,45,75,24,99,0,99,1,59,39,21.04.2019 21:20,188,20,Hmelnitsk
448,443,58,122,268,58,326,0,326,9,223,94,22.04.2019 00:05,188,20,Hmelnitsk
352,335,41,138,176,38,214,0,214,4,179,31,22.04.2019 00:01,188,20,Hmelnitsk
528,523,49,207,273,48,321,0,321,7,241,73,22.04.2019 00:25,188,20,Hmelnitsk
240,223,13,48,179,13,192,0,192,3,121,68,22.04.2019 00:00,188,20,Hmelnitsk
320,304,17,110,193,17,210,0,210,2,155,53,22.04.2019 00:01,188,20,Hmelnitsk
192,188,18,70,106,16,122,0,122,3,90,29,22.04.2019 00:05,188,20,Hmelnitsk
400,391,45,150,206,44,250,0,250,6,194,50,22.04.2019 00:05,188,20,Hmelnitsk
80,72,10,27,43,10,53,0,53,0,44,9,22.04.2019 00:10,188,20,Hmelnitsk
144,132,17,54,73,17,90,0,90,1,43,46,22.04.2019 00:05,188,20,Hmelnitsk
112,106,2,46,64,2,66,0,66,1,41,24,22.04.2019 00:10,188,20,Hmelnitsk
784,779,31,308,448,28,476,0,476,13,317,146,21.04.2019 22:35,188,20,Hmelnitsk
128,121,23,55,55,18,73,0,73,2,47,24,22.04.2019 00:03,188,20,Hmelnitsk
1344,1321,23,562,759,23,782,0,782,16,553,213,22.04.2019 00:30,188,20,Hmelnitsk
272,266,17,88,168,16,184,0,184,4,131,49,22.04.2019 00:10,188,20,Hmelnitsk
848,841,18,332,500,16,516,0,516,12,395,109,22.04.2019 00:15,188,20,Hmelnitsk
240,232,15,96,129,15,144,0,144,2,93,49,22.04.2019 00:15,188,20,Hmelnitsk
320,308,17,159,145,16,161,0,161,3,119,39,22.04.2019 00:10,188,20,Hmelnitsk
80,76,6,20,55,5,60,0,60,0,32,28,22.04.2019 00:02,188,20,Hmelnitsk
304,289,15,129,162,13,175,0,175,3,134,38,22.04.2019 00:20,188,20,Hmelnitsk
112,101,14,38,61,13,74,0,74,2,45,27,22.04.2019 00:01,188,20,Hmelnitsk
720,702,38,289,396,35,431,0,431,11,307,113,22.04.2019 00:12,188,20,Hmelnitsk
656,644,24,295,338,23,361,0,361,6,268,87,22.04.2019 00:15,188,20,Hmelnitsk
400,387,25,136,240,24,264,0,264,8,207,49,21.04.2019 23:52,188,20,Hmelnitsk
368,356,43,101,224,43,267,0,267,6,192,69,22.04.2019 00:10,188,20,Hmelnitsk
304,298,17,133,155,16,171,0,171,2,129,40,22.04.2019 00:20,188,20,Hmelnitsk
192,187,14,41,137,14,151,0,151,0,106,45,22.04.2019 00:30,188,20,Hmelnitsk
384,388,43,112,230,42,272,0,272,8,160,104,22.04.2019 00:15,188,20,Hmelnitsk
496,484,31,208,258,30,288,0,288,5,190,93,22.04.2019 00:05,188,20,Hmelnitsk
176,172,15,51,110,15,125,0,125,1,88,36,22.04.2019 00:35,188,20,Hmelnitsk
320,311,39,106,175,39,214,0,214,0,174,40,22.04.2019 00:35,188,20,Hmelnitsk
448,429,39,191,218,39,257,0,257,3,202,52,22.04.2019 00:14,188,20,Hmelnitsk
128,96,0,32,96,0,96,0,96,0,60,36,22.04.2019 00:15,188,20,Hmelnitsk
192,186,17,74,103,15,118,0,118,1,73,44,22.04.2019 00:17,188,20,Hmelnitsk
256,251,37,106,113,37,150,0,150,1,85,64,21.04.2019 21:15,188,20,Hmelnitsk
80,77,5,24,51,5,56,0,56,0,38,18,22.04.2019 00:02,188,20,Hmelnitsk
272,255,22,93,161,18,179,0,179,2,91,86,22.04.2019 00:30,188,20,Hmelnitsk
1824,1802,41,686,1098,40,1138,0,1138,25,876,237,22.04.2019 00:10,188,20,Hmelnitsk
320,313,19,115,188,17,205,0,205,7,133,65,21.04.2019 22:00,188,20,Hmelnitsk
496,488,36,183,277,36,313,0,313,6,235,72,22.04.2019 00:03,188,20,Hmelnitsk
96,22,6,75,15,6,21,0,21,1,18,2,22.04.2019 00:15,188,20,Hmelnitsk
320,128,37,193,90,37,127,0,127,6,86,35,22.04.2019 00:35,188,20,Hmelnitsk
160,44,5,121,34,5,39,0,39,2,30,7,22.04.2019 00:05,188,20,Hmelnitsk
1728,562,0,1166,562,0,562,0,562,35,498,29,22.04.2019 01:00,188,20,Hmelnitsk
1344,1321,20,517,811,16,827,0,827,31,555,241,22.04.2019 00:10,188,20,Hmelnitsk
2192,2170,19,852,1327,13,1340,0,1340,31,930,379,22.04.2019 00:08,188,20,Hmelnitsk
1840,1824,11,638,1193,9,1202,0,1202,43,821,338,22.04.2019 01:01,188,20,Hmelnitsk
2576,2566,8,828,1744,4,1748,0,1748,50,1222,476,22.04.2019 00:24,188,20,Hmelnitsk
1568,1558,15,525,1032,11,1043,0,1043,18,715,310,22.04.2019 00:15,188,20,Hmelnitsk
1776,1762,32,617,1137,22,1159,0,1159,25,812,322,22.04.2019 00:50,188,20,Hmelnitsk
2016,1995,16,628,1379,9,1388,0,1388,37,916,435,22.04.2019 00:30,188,20,Hmelnitsk
2032,2013,6,718,1312,2,1314,0,1314,37,921,356,22.04.2019 00:30,188,20,Hmelnitsk
2320,2293,6,849,1467,4,1471,0,1471,28,1020,423,22.04.2019 00:07,188,20,Hmelnitsk
2512,2511,4,928,1580,4,1584,0,1584,38,1138,408,22.04.2019 00:33,188,20,Hmelnitsk
2064,2042,13,692,1365,7,1372,0,1372,41,945,386,21.04.2019 22:30,188,20,Hmelnitsk
1424,1405,18,513,896,15,911,0,911,21,669,221,22.04.2019 00:20,188,20,Hmelnitsk
256,252,6,104,146,6,152,0,152,2,134,16,21.04.2019 23:15,189,20,Hmelnitsk
160,148,4,62,95,3,98,0,98,1,76,21,21.04.2019 21:00,189,20,Hmelnitsk
208,196,14,81,114,13,127,0,127,2,88,37,22.04.2019 00:27,189,20,Hmelnitsk
240,227,14,84,144,12,156,0,156,4,114,38,21.04.2019 23:45,189,20,Hmelnitsk
224,206,18,87,120,17,137,0,137,3,104,30,22.04.2019 00:20,189,20,Hmelnitsk
144,140,5,59,80,5,85,0,85,1,64,20,21.04.2019 22:05,189,20,Hmelnitsk
288,288,18,47,223,18,241,0,241,1,184,56,21.04.2019 22:19,189,20,Hmelnitsk
224,216,15,61,149,14,163,0,163,2,106,55,21.04.2019 21:41,189,20,Hmelnitsk
384,368,32,160,194,30,224,0,224,13,160,51,22.04.2019 00:15,189,20,Hmelnitsk
192,178,4,87,102,3,105,0,105,1,79,25,21.04.2019 22:10,189,20,Hmelnitsk
80,66,5,41,35,4,39,0,39,1,21,17,21.04.2019 22:55,189,20,Hmelnitsk
80,74,3,32,45,3,48,0,48,0,35,13,22.04.2019 00:15,189,20,Hmelnitsk
192,188,14,35,143,14,157,0,157,0,109,48,22.04.2019 00:30,189,20,Hmelnitsk
304,297,26,114,164,26,190,0,190,1,138,51,21.04.2019 22:00,189,20,Hmelnitsk
336,325,37,122,184,30,214,0,214,6,178,30,22.04.2019 00:35,189,20,Hmelnitsk
336,330,9,115,212,9,221,0,221,1,190,30,21.04.2019 22:15,189,20,Hmelnitsk
400,379,52,152,198,50,248,0,248,3,186,59,22.04.2019 00:05,189,20,Hmelnitsk
240,228,18,90,132,18,150,0,150,4,108,38,22.04.2019 00:35,189,20,Hmelnitsk
320,314,10,146,164,10,174,0,174,2,98,74,21.04.2019 21:24,189,20,Hmelnitsk
192,180,13,70,110,12,122,0,122,2,89,31,21.04.2019 23:10,189,20,Hmelnitsk
448,429,45,160,243,45,288,0,288,5,172,111,21.04.2019 23:58,189,20,Hmelnitsk
288,283,34,104,157,27,184,0,184,4,128,52,21.04.2019 21:00,189,20,Hmelnitsk
112,108,7,26,80,6,86,0,86,2,52,32,22.04.2019 00:11,189,20,Hmelnitsk
560,542,25,283,253,24,277,0,277,7,188,82,22.04.2019 00:23,189,20,Hmelnitsk
144,141,11,31,102,11,113,0,113,1,73,39,21.04.2019 21:00,189,20,Hmelnitsk
256,246,18,118,122,16,138,0,138,2,91,45,21.04.2019 23:00,189,20,Hmelnitsk
192,188,23,82,90,20,110,0,110,1,77,32,21.04.2019 23:00,189,20,Hmelnitsk
192,184,13,67,114,11,125,0,125,1,74,50,21.04.2019 23:00,189,20,Hmelnitsk
368,355,19,170,179,19,198,0,198,0,142,56,21.04.2019 22:05,189,20,Hmelnitsk
80,77,3,22,55,3,58,0,58,7,39,12,21.04.2019 23:00,189,20,Hmelnitsk
128,121,10,42,80,6,86,0,86,3,50,33,21.04.2019 23:00,189,20,Hmelnitsk
160,147,6,57,98,5,103,0,103,4,66,33,21.04.2019 22:30,189,20,Hmelnitsk
288,276,17,91,181,16,197,0,197,6,137,54,21.04.2019 23:30,189,20,Hmelnitsk
176,171,17,77,84,15,99,0,99,1,72,26,21.04.2019 23:15,189,20,Hmelnitsk
208,199,22,73,114,21,135,0,135,2,92,41,21.04.2019 22:30,189,20,Hmelnitsk
128,123,18,36,76,16,92,0,92,3,59,30,21.04.2019 21:20,189,20,Hmelnitsk
160,147,3,50,107,3,110,0,110,1,54,55,21.04.2019 23:20,189,20,Hmelnitsk
336,324,19,136,181,19,200,0,200,4,116,80,21.04.2019 22:05,189,20,Hmelnitsk
160,147,7,61,92,7,99,0,99,3,61,35,21.04.2019 21:10,189,20,Hmelnitsk
160,156,15,38,107,15,122,0,122,0,80,42,21.04.2019 22:06,189,20,Hmelnitsk
672,204,0,476,196,0,196,0,196,9,166,21,22.04.2019 00:13,189,20,Hmelnitsk
896,107,0,791,105,0,105,0,105,4,91,10,21.04.2019 22:45,189,20,Hmelnitsk
1664,1647,12,721,936,7,943,0,943,26,720,197,21.04.2019 23:18,189,20,Hmelnitsk
1456,1434,18,623,817,16,833,0,833,20,647,166,21.04.2019 22:15,189,20,Hmelnitsk
2208,2188,20,983,1209,16,1225,0,1225,43,931,251,21.04.2019 23:11,189,20,Hmelnitsk
1920,1908,23,760,1144,16,1160,0,1160,23,948,189,21.04.2019 22:30,189,20,Hmelnitsk
2064,2037,29,860,1181,23,1204,0,1204,32,914,258,21.04.2019 21:00,189,20,Hmelnitsk
816,790,46,332,438,46,484,0,484,8,345,131,21.04.2019 22:22,189,20,Hmelnitsk
928,921,63,370,495,63,558,0,558,12,438,108,21.04.2019 22:29,189,20,Hmelnitsk
416,407,25,150,241,25,266,0,266,2,204,60,21.04.2019 22:30,189,20,Hmelnitsk
176,164,3,53,120,3,123,0,123,3,84,36,22.04.2019 00:30,189,20,Hmelnitsk
176,171,7,57,113,6,119,0,119,5,79,35,21.04.2019 22:10,189,20,Hmelnitsk
176,166,19,65,94,17,111,0,111,2,76,33,21.04.2019 22:50,189,20,Hmelnitsk
560,546,49,240,272,48,320,0,320,7,286,27,21.04.2019 21:15,189,20,Hmelnitsk
224,216,21,88,115,21,136,0,136,2,117,17,22.04.2019 00:10,189,20,Hmelnitsk
64,62,3,23,38,3,41,0,41,0,35,6,21.04.2019 22:45,189,20,Hmelnitsk
96,80,8,39,49,8,57,0,57,2,23,32,22.04.2019 00:45,189,20,Hmelnitsk
400,392,23,145,233,22,255,0,255,4,210,41,21.04.2019 21:55,189,20,Hmelnitsk
224,219,10,98,116,10,126,0,126,1,99,26,21.04.2019 21:00,189,20,Hmelnitsk
192,191,10,67,117,8,125,0,125,2,98,25,21.04.2019 21:00,189,20,Hmelnitsk
64,58,6,32,28,4,32,0,32,0,19,13,21.04.2019 22:58,189,20,Hmelnitsk
176,160,11,71,94,11,105,0,105,0,71,34,21.04.2019 21:00,189,20,Hmelnitsk
608,588,21,178,412,18,430,0,430,5,303,122,21.04.2019 21:20,189,20,Hmelnitsk
240,242,9,94,137,9,146,0,146,6,112,28,22.04.2019 00:30,189,20,Hmelnitsk
256,254,32,86,141,29,170,0,170,3,134,33,21.04.2019 21:40,189,20,Hmelnitsk
208,198,22,57,130,21,151,0,151,3,110,38,22.04.2019 00:05,189,20,Hmelnitsk
208,209,15,73,122,13,135,0,135,0,102,33,22.04.2019 00:12,189,20,Hmelnitsk
688,675,49,242,397,49,446,0,446,10,319,117,22.04.2019 00:40,189,20,Hmelnitsk
608,601,50,253,312,43,355,0,355,6,275,74,21.04.2019 22:49,189,20,Hmelnitsk
144,135,9,56,80,8,88,0,88,5,63,20,21.04.2019 23:00,189,20,Hmelnitsk
976,960,70,387,524,65,589,0,589,15,472,102,21.04.2019 23:00,189,20,Hmelnitsk
224,215,12,82,133,9,142,0,142,1,101,40,22.04.2019 00:00,189,20,Hmelnitsk
448,432,40,139,279,30,309,0,309,2,239,68,21.04.2019 22:20,189,20,Hmelnitsk
496,487,21,216,259,21,280,0,280,1,223,56,21.04.2019 22:30,189,20,Hmelnitsk
256,241,13,109,135,12,147,0,147,2,130,15,21.04.2019 21:27,189,20,Hmelnitsk
160,149,18,54,88,18,106,0,106,1,88,17,21.04.2019 22:00,189,20,Hmelnitsk
1104,1083,59,456,593,55,648,0,648,4,468,176,22.04.2019 00:10,189,20,Hmelnitsk
128,127,7,36,85,7,92,0,92,1,63,28,21.04.2019 21:35,189,20,Hmelnitsk
160,157,5,61,94,5,99,0,99,0,81,18,21.04.2019 21:49,189,20,Hmelnitsk
224,214,23,135,71,18,89,0,89,0,38,51,21.04.2019 22:45,189,20,Hmelnitsk
128,113,7,50,72,6,78,0,78,3,46,29,21.04.2019 22:00,189,20,Hmelnitsk
752,734,39,274,439,39,478,0,478,3,402,73,22.04.2019 00:02,189,20,Hmelnitsk
640,633,33,229,378,33,411,0,411,7,348,56,22.04.2019 00:30,189,20,Hmelnitsk
704,691,65,255,392,57,449,0,449,6,391,52,21.04.2019 22:30,189,20,Hmelnitsk
512,508,38,173,305,34,339,0,339,5,241,93,21.04.2019 22:35,189,20,Hmelnitsk
640,631,33,249,362,29,391,0,391,5,344,42,21.04.2019 23:35,189,20,Hmelnitsk
144,132,11,44,91,9,100,0,100,0,56,44,22.04.2019 00:15,189,20,Hmelnitsk
128,125,8,27,93,8,101,0,101,0,48,53,21.04.2019 21:55,189,20,Hmelnitsk
96,93,3,35,58,3,61,0,61,0,45,16,21.04.2019 21:22,189,20,Hmelnitsk
336,330,33,95,208,33,241,0,241,8,183,50,21.04.2019 21:45,189,20,Hmelnitsk
368,357,31,111,228,29,257,0,257,5,220,32,21.04.2019 22:15,189,20,Hmelnitsk
320,314,14,123,183,14,197,0,197,3,161,33,21.04.2019 22:30,189,20,Hmelnitsk
176,171,12,79,89,8,97,0,97,1,72,24,21.04.2019 22:15,189,20,Hmelnitsk
224,212,19,77,132,15,147,0,147,1,125,21,21.04.2019 23:00,189,20,Hmelnitsk
416,407,23,142,251,23,274,0,274,6,223,45,21.04.2019 21:30,189,20,Hmelnitsk
432,422,21,165,246,21,267,0,267,11,203,53,21.04.2019 21:05,189,20,Hmelnitsk
256,237,9,105,142,9,151,0,151,8,105,38,21.04.2019 21:00,189,20,Hmelnitsk
96,82,7,18,71,7,78,0,78,1,48,29,21.04.2019 21:00,189,20,Hmelnitsk
368,361,37,104,231,33,264,0,264,5,186,73,21.04.2019 21:00,189,20,Hmelnitsk
304,298,33,98,177,29,206,0,206,1,152,53,21.04.2019 21:00,189,20,Hmelnitsk
480,479,6,228,246,6,252,0,252,2,181,69,22.04.2019 00:10,189,20,Hmelnitsk
304,289,19,104,182,18,200,0,200,3,159,38,21.04.2019 21:05,189,20,Hmelnitsk
96,94,8,32,58,6,64,0,64,3,40,21,21.04.2019 20:50,189,20,Hmelnitsk
272,268,27,68,177,27,204,0,204,6,135,63,21.04.2019 21:50,189,20,Hmelnitsk
224,217,25,70,130,24,154,0,154,3,88,63,21.04.2019 21:00,189,20,Hmelnitsk
768,756,43,294,438,36,474,0,474,11,340,123,22.04.2019 00:01,189,20,Hmelnitsk
720,711,66,334,331,55,386,0,386,7,320,59,21.04.2019 21:00,189,20,Hmelnitsk
256,241,32,93,132,31,163,0,163,2,133,28,21.04.2019 21:12,189,20,Hmelnitsk
112,108,11,31,70,11,81,0,81,0,61,20,21.04.2019 21:00,189,20,Hmelnitsk
192,187,8,73,111,8,119,0,119,3,90,26,21.04.2019 20:20,189,20,Hmelnitsk
576,575,29,186,362,28,390,0,390,6,315,69,21.04.2019 23:40,189,20,Hmelnitsk
672,655,15,195,462,15,477,0,477,11,377,89,21.04.2019 21:58,189,20,Hmelnitsk
192,187,13,48,131,13,144,0,144,1,104,39,21.04.2019 21:00,189,20,Hmelnitsk
224,213,10,55,159,10,169,0,169,0,125,44,21.04.2019 20:50,189,20,Hmelnitsk
480,477,36,165,280,35,315,0,315,10,261,44,21.04.2019 21:20,189,20,Hmelnitsk
496,488,42,184,274,38,312,0,312,5,249,58,21.04.2019 20:45,189,20,Hmelnitsk
288,35,35,256,0,32,32,0,32,1,23,8,21.04.2019 20:30,189,20,Hmelnitsk
48,21,9,27,12,9,21,0,21,1,13,7,21.04.2019 21:00,189,20,Hmelnitsk
128,126,12,38,79,11,90,0,90,2,73,15,22.04.2019 00:31,189,20,Hmelnitsk
304,284,27,145,135,24,159,0,159,1,94,64,21.04.2019 23:25,189,20,Hmelnitsk
128,113,7,45,76,7,83,0,83,2,65,16,21.04.2019 22:55,189,20,Hmelnitsk
144,142,17,33,95,16,111,0,111,0,98,13,21.04.2019 22:10,189,20,Hmelnitsk
96,90,3,15,78,3,81,0,81,0,59,22,21.04.2019 23:49,189,20,Hmelnitsk
96,89,5,29,62,5,67,0,67,2,36,29,21.04.2019 23:19,189,20,Hmelnitsk
208,196,14,53,141,14,155,0,155,2,106,47,22.04.2019 00:08,189,20,Hmelnitsk
160,144,24,49,91,20,111,0,111,3,70,38,22.04.2019 00:25,189,20,Hmelnitsk
352,342,18,124,212,16,228,0,228,4,169,55,21.04.2019 23:20,189,20,Hmelnitsk
384,375,51,116,221,47,268,0,268,5,205,58,21.04.2019 21:30,189,20,Hmelnitsk
384,383,48,71,270,43,313,0,313,6,225,82,21.04.2019 23:13,189,20,Hmelnitsk
288,273,25,86,178,24,202,0,202,1,116,85,21.04.2019 20:21,189,20,Hmelnitsk
160,159,12,50,98,12,110,0,110,3,81,26,21.04.2019 21:00,189,20,Hmelnitsk
320,313,24,100,198,22,220,0,220,3,175,42,21.04.2019 22:00,189,20,Hmelnitsk
96,79,10,42,44,10,54,0,54,0,38,16,21.04.2019 21:35,189,20,Hmelnitsk
560,544,30,181,352,27,379,0,379,2,307,70,21.04.2019 22:45,189,20,Hmelnitsk
272,264,15,62,195,15,210,0,210,1,151,58,21.04.2019 23:10,189,20,Hmelnitsk
224,220,20,67,141,16,157,0,157,1,124,32,21.04.2019 23:05,189,20,Hmelnitsk
272,267,20,76,176,20,196,0,196,1,126,69,21.04.2019 22:00,189,20,Hmelnitsk
288,274,27,87,176,25,201,0,201,3,106,92,21.04.2019 21:00,189,20,Hmelnitsk
272,264,24,78,173,21,194,0,194,5,152,37,21.04.2019 20:50,189,20,Hmelnitsk
288,281,24,95,170,23,193,0,193,2,155,36,21.04.2019 22:50,189,20,Hmelnitsk
1616,1584,63,449,1106,61,1167,0,1167,31,842,294,21.04.2019 23:15,189,20,Hmelnitsk
272,262,27,48,198,26,224,0,224,6,178,40,21.04.2019 20:45,189,20,Hmelnitsk
160,156,25,31,108,21,129,0,129,1,101,27,21.04.2019 21:50,189,20,Hmelnitsk
48,11,0,37,11,0,11,0,11,0,10,1,22.04.2019 00:10,190,20,Hmelnitsk
240,237,7,82,153,5,158,0,158,9,85,64,21.04.2019 22:20,190,20,Hmelnitsk
144,141,12,69,63,12,75,0,75,1,50,24,22.04.2019 00:30,190,20,Hmelnitsk
288,284,36,93,163,32,195,0,195,2,134,59,21.04.2019 22:00,190,20,Hmelnitsk
304,289,28,99,178,27,205,0,205,2,159,44,21.04.2019 22:00,190,20,Hmelnitsk
400,392,20,164,217,19,236,0,236,4,155,77,21.04.2019 22:16,190,20,Hmelnitsk
304,297,16,132,156,16,172,0,172,1,109,62,21.04.2019 21:20,190,20,Hmelnitsk
496,489,37,186,275,35,310,0,310,6,195,109,21.04.2019 20:55,190,20,Hmelnitsk
128,124,1,54,73,1,74,0,74,2,55,17,21.04.2019 23:00,190,20,Hmelnitsk
336,331,19,125,195,16,211,0,211,2,154,55,21.04.2019 21:10,190,20,Hmelnitsk
304,288,20,111,174,19,193,0,193,4,135,54,22.04.2019 00:10,190,20,Hmelnitsk
144,140,12,58,76,10,86,0,86,1,47,38,22.04.2019 00:10,190,20,Hmelnitsk
288,283,21,131,139,18,157,0,157,1,86,70,21.04.2019 20:30,190,20,Hmelnitsk
240,232,51,57,134,49,183,0,183,1,113,69,21.04.2019 21:15,190,20,Hmelnitsk
112,101,8,43,61,8,69,0,69,2,48,19,22.04.2019 00:15,190,20,Hmelnitsk
352,348,17,131,205,16,221,0,221,3,135,83,22.04.2019 00:20,190,20,Hmelnitsk
528,516,63,149,321,58,379,0,379,6,237,136,22.04.2019 00:15,190,20,Hmelnitsk
144,130,19,36,89,19,108,0,108,2,60,46,22.04.2019 00:05,190,20,Hmelnitsk
384,230,14,154,219,11,230,0,230,5,171,54,21.04.2019 22:20,190,20,Hmelnitsk
448,442,27,186,235,27,262,0,262,5,178,79,21.04.2019 20:48,190,20,Hmelnitsk
336,327,23,136,177,23,200,0,200,3,161,36,21.04.2019 20:50,190,20,Hmelnitsk
320,307,20,133,167,20,187,0,187,6,102,79,21.04.2019 23:30,190,20,Hmelnitsk
96,94,7,32,57,7,64,0,64,1,32,31,21.04.2019 20:35,190,20,Hmelnitsk
96,91,8,33,55,8,63,0,63,0,33,30,21.04.2019 21:30,190,20,Hmelnitsk
464,454,9,248,207,9,216,0,216,2,149,65,21.04.2019 21:20,190,20,Hmelnitsk
304,286,32,135,138,31,169,0,169,4,91,74,21.04.2019 21:15,190,20,Hmelnitsk
176,174,16,68,92,16,108,0,108,0,65,43,21.04.2019 20:30,190,20,Hmelnitsk
128,127,0,42,86,0,86,0,86,3,55,28,22.04.2019 00:05,190,20,Hmelnitsk
368,352,5,171,192,5,197,0,197,4,137,56,22.04.2019 00:10,190,20,Hmelnitsk
272,257,3,116,153,3,156,0,156,3,102,51,22.04.2019 00:05,190,20,Hmelnitsk
448,431,37,184,227,37,264,0,264,7,150,107,21.04.2019 22:40,190,20,Hmelnitsk
256,245,14,103,139,14,153,0,153,3,87,63,22.04.2019 00:15,190,20,Hmelnitsk
720,697,37,282,401,37,438,0,438,11,265,162,22.04.2019 00:25,190,20,Hmelnitsk
256,249,12,88,156,12,168,0,168,1,120,47,22.04.2019 00:45,190,20,Hmelnitsk
80,63,5,25,50,5,55,0,55,3,42,10,21.04.2019 22:30,190,20,Hmelnitsk
304,294,6,129,172,3,175,0,175,8,120,47,21.04.2019 21:00,190,20,Hmelnitsk
48,56,4,12,32,4,36,0,36,0,22,14,22.04.2019 00:10,190,20,Hmelnitsk
528,506,6,306,216,6,222,0,222,2,174,46,21.04.2019 20:55,190,20,Hmelnitsk
688,675,34,290,367,31,398,0,398,12,229,157,21.04.2019 21:30,190,20,Hmelnitsk
304,290,17,126,161,17,178,0,178,0,129,49,21.04.2019 21:00,190,20,Hmelnitsk
160,149,5,55,100,5,105,0,105,4,64,37,21.04.2019 23:50,190,20,Hmelnitsk
208,186,21,81,106,21,127,0,127,1,58,68,21.04.2019 21:00,190,20,Hmelnitsk
80,73,6,29,45,6,51,0,51,2,25,24,21.04.2019 21:30,190,20,Hmelnitsk
80,76,0,46,34,0,34,0,34,2,16,16,21.04.2019 21:25,190,20,Hmelnitsk
128,124,8,43,77,8,85,0,85,2,37,46,22.04.2019 00:40,190,20,Hmelnitsk
96,86,8,45,43,8,51,0,51,1,23,27,21.04.2019 20:29,190,20,Hmelnitsk
64,59,1,29,34,1,35,0,35,0,22,13,21.04.2019 20:25,190,20,Hmelnitsk
528,510,46,200,282,46,328,0,328,10,194,124,22.04.2019 00:35,190,20,Hmelnitsk
96,80,9,44,43,9,52,0,52,1,34,17,21.04.2019 22:30,190,20,Hmelnitsk
1712,1669,10,867,836,9,845,0,845,26,581,238,22.04.2019 00:30,190,20,Hmelnitsk
1232,1195,15,565,654,13,667,0,667,20,413,234,22.04.2019 00:15,190,20,Hmelnitsk
416,414,6,195,215,6,221,0,221,9,139,73,22.04.2019 00:30,190,20,Hmelnitsk
512,495,1,228,283,1,284,0,284,6,191,87,22.04.2019 00:00,190,20,Hmelnitsk
144,136,14,61,69,14,83,0,83,0,57,26,22.04.2019 00:10,190,20,Hmelnitsk
384,363,18,163,203,18,221,0,221,6,132,83,21.04.2019 20:50,190,20,Hmelnitsk
496,475,33,205,260,31,291,0,291,4,176,111,22.04.2019 00:30,190,20,Hmelnitsk
544,485,8,62,474,8,482,0,482,40,408,34,21.04.2019 21:00,190,20,Hmelnitsk
1264,1227,12,590,663,11,674,0,674,16,489,169,22.04.2019 00:20,190,20,Hmelnitsk
1136,1127,15,436,689,11,700,0,700,22,516,162,22.04.2019 00:15,190,20,Hmelnitsk
288,48,35,252,14,22,36,0,36,1,28,7,21.04.2019 21:15,190,20,Hmelnitsk
1648,1629,9,734,908,6,914,0,914,29,634,251,21.04.2019 21:45,190,20,Hmelnitsk
1856,1797,5,836,1016,4,1020,0,1020,23,788,209,22.04.2019 00:05,190,20,Hmelnitsk
1600,1566,6,751,843,6,849,0,849,26,612,211,22.04.2019 00:05,190,20,Hmelnitsk
1760,1625,13,883,867,10,877,0,877,20,630,227,21.04.2019 21:35,190,20,Hmelnitsk
320,62,50,265,12,43,55,0,55,2,45,8,22.04.2019 00:05,190,20,Hmelnitsk
96,19,0,77,19,0,19,0,19,0,15,4,22.04.2019 00:04,190,20,Hmelnitsk
304,295,49,81,174,49,223,0,223,1,160,62,21.04.2019 20:40,191,20,Hmelnitsk
144,133,14,47,84,13,97,0,97,1,67,29,22.04.2019 00:05,191,20,Hmelnitsk
144,135,12,48,84,12,96,0,96,1,53,42,21.04.2019 20:35,191,20,Hmelnitsk
352,340,49,149,162,41,203,0,203,3,138,62,21.04.2019 21:00,191,20,Hmelnitsk
304,296,28,168,116,20,136,0,136,1,95,40,21.04.2019 21:20,191,20,Hmelnitsk
272,279,16,106,153,13,166,0,166,2,109,55,21.04.2019 20:30,191,20,Hmelnitsk
160,147,17,75,70,15,85,0,85,4,59,22,22.04.2019 00:15,191,20,Hmelnitsk
128,111,11,65,54,9,63,0,63,0,47,16,22.04.2019 00:06,191,20,Hmelnitsk
160,153,26,73,67,20,87,0,87,0,53,34,22.04.2019 00:10,191,20,Hmelnitsk
608,592,28,276,310,22,332,0,332,5,258,69,21.04.2019 21:40,191,20,Hmelnitsk
144,141,13,30,102,12,114,0,114,3,89,22,22.04.2019 00:50,191,20,Hmelnitsk
320,316,46,150,133,37,170,0,170,2,131,37,21.04.2019 22:35,191,20,Hmelnitsk
672,678,66,221,391,60,451,0,451,11,320,120,21.04.2019 21:35,191,20,Hmelnitsk
352,340,47,132,176,44,220,0,220,4,135,81,22.04.2019 00:07,191,20,Hmelnitsk
336,319,45,133,160,43,203,0,203,2,114,87,22.04.2019 00:10,191,20,Hmelnitsk
336,337,31,112,194,30,224,0,224,1,151,72,21.04.2019 21:00,191,20,Hmelnitsk
496,478,41,223,236,37,273,0,273,5,206,62,22.04.2019 00:10,191,20,Hmelnitsk
224,212,6,81,138,5,143,0,143,2,108,33,21.04.2019 20:32,191,20,Hmelnitsk
144,135,13,50,83,11,94,0,94,0,59,35,22.04.2019 00:30,191,20,Hmelnitsk
704,697,67,283,361,60,421,0,421,1,329,91,21.04.2019 21:50,191,20,Hmelnitsk
368,354,18,135,217,16,233,0,233,5,174,54,22.04.2019 00:15,191,20,Hmelnitsk
288,277,42,116,136,36,172,0,172,1,117,54,22.04.2019 00:15,191,20,Hmelnitsk
240,223,26,107,113,20,133,0,133,0,101,32,21.04.2019 21:00,191,20,Hmelnitsk
144,144,16,23,108,13,121,0,121,1,83,37,22.04.2019 00:17,191,20,Hmelnitsk
96,90,17,30,53,13,66,0,66,1,34,31,22.04.2019 00:05,191,20,Hmelnitsk
944,918,48,361,541,42,583,0,583,13,391,179,22.04.2019 00:40,191,20,Hmelnitsk
256,254,8,94,155,7,162,0,162,8,111,43,22.04.2019 00:03,191,20,Hmelnitsk
432,427,38,157,243,32,275,0,275,2,161,112,21.04.2019 22:00,191,20,Hmelnitsk
288,282,25,78,188,22,210,0,210,2,94,114,21.04.2019 21:30,191,20,Hmelnitsk
464,446,50,177,243,44,287,0,287,4,226,57,22.04.2019 00:05,191,20,Hmelnitsk
352,347,37,86,229,37,266,0,266,3,121,142,21.04.2019 22:00,191,20,Hmelnitsk
336,331,56,138,151,47,198,0,198,6,120,72,21.04.2019 23:00,191,20,Hmelnitsk
736,720,68,259,414,63,477,0,477,11,381,85,21.04.2019 21:20,191,20,Hmelnitsk
768,739,53,290,434,44,478,0,478,11,355,112,21.04.2019 21:35,191,20,Hmelnitsk
208,199,17,81,116,11,127,0,127,3,99,25,21.04.2019 22:55,191,20,Hmelnitsk
208,217,14,70,128,10,138,0,138,7,71,60,21.04.2019 21:26,191,20,Hmelnitsk
176,166,14,67,98,11,109,0,109,2,67,40,22.04.2019 00:10,191,20,Hmelnitsk
496,485,28,207,262,27,289,0,289,2,191,96,22.04.2019 00:15,191,20,Hmelnitsk
672,656,40,240,399,33,432,0,432,5,334,93,21.04.2019 21:05,191,20,Hmelnitsk
144,135,9,54,81,9,90,0,90,0,73,17,22.04.2019 00:05,191,20,Hmelnitsk
96,81,10,43,45,8,53,0,53,3,38,12,22.04.2019 00:08,191,20,Hmelnitsk
128,115,8,51,69,8,77,0,77,0,65,12,22.04.2019 00:20,191,20,Hmelnitsk
64,55,6,24,35,5,40,0,40,0,26,14,21.04.2019 20:20,191,20,Hmelnitsk
144,134,8,75,62,7,69,0,69,3,48,18,21.04.2019 20:40,191,20,Hmelnitsk
160,153,15,59,86,15,101,0,101,3,63,35,21.04.2019 22:20,191,20,Hmelnitsk
320,303,32,129,166,25,191,0,191,4,117,70,21.04.2019 20:30,191,20,Hmelnitsk
80,69,6,31,46,3,49,0,49,2,26,21,21.04.2019 20:45,191,20,Hmelnitsk
560,538,64,204,310,46,356,0,356,5,260,91,21.04.2019 22:15,191,20,Hmelnitsk
112,103,14,43,55,14,69,0,69,1,21,47,21.04.2019 21:10,191,20,Hmelnitsk
384,371,50,106,230,48,278,0,278,12,195,71,21.04.2019 22:10,191,20,Hmelnitsk
48,42,10,22,21,5,26,0,26,0,7,19,21.04.2019 20:30,191,20,Hmelnitsk
304,302,25,100,181,23,204,0,204,5,116,83,22.04.2019 00:10,191,20,Hmelnitsk
80,75,11,23,48,9,57,0,57,0,29,28,22.04.2019 00:03,191,20,Hmelnitsk
144,146,22,49,76,19,95,0,95,2,62,31,21.04.2019 21:30,191,20,Hmelnitsk
128,120,24,15,90,23,113,0,113,1,97,15,21.04.2019 21:00,191,20,Hmelnitsk
2272,2200,29,912,1338,22,1360,0,1360,35,948,377,21.04.2019 22:40,191,20,Hmelnitsk
1472,1446,13,670,793,9,802,0,802,24,563,215,22.04.2019 00:10,191,20,Hmelnitsk
1744,1690,25,687,1044,13,1057,0,1057,26,706,325,21.04.2019 22:00,191,20,Hmelnitsk
1840,1808,67,760,1037,43,1080,0,1080,39,765,276,22.04.2019 00:25,191,20,Hmelnitsk
688,674,20,258,411,19,430,0,430,12,332,86,21.04.2019 21:56,191,20,Hmelnitsk
272,81,18,213,43,16,59,0,59,0,41,18,22.04.2019 00:20,191,20,Hmelnitsk
304,297,45,66,198,40,238,0,238,3,159,76,21.04.2019 20:25,192,20,Hmelnitsk
80,77,2,5,73,2,75,0,75,3,33,39,21.04.2019 20:20,192,20,Hmelnitsk
496,481,44,164,288,44,332,0,332,6,223,103,21.04.2019 21:15,192,20,Hmelnitsk
64,56,14,24,26,14,40,0,40,0,14,26,21.04.2019 20:30,192,20,Hmelnitsk
112,102,9,46,59,7,66,0,66,0,45,21,21.04.2019 21:00,192,20,Hmelnitsk
336,328,35,88,219,29,248,0,248,4,177,67,21.04.2019 21:45,192,20,Hmelnitsk
368,360,30,138,205,25,230,0,230,1,167,62,21.04.2019 23:30,192,20,Hmelnitsk
1792,1769,21,646,1125,21,1146,0,1146,46,805,295,22.04.2019 00:12,192,20,Hmelnitsk
256,254,14,77,165,14,179,0,179,2,146,31,21.04.2019 21:05,192,20,Hmelnitsk
496,486,26,102,368,26,394,0,394,4,290,100,21.04.2019 21:00,192,20,Hmelnitsk
368,355,30,104,234,30,264,0,264,0,204,60,22.04.2019 00:20,192,20,Hmelnitsk
912,891,59,318,537,57,594,0,594,10,490,94,21.04.2019 20:55,192,20,Hmelnitsk
304,291,6,119,181,4,185,0,185,3,147,35,22.04.2019 00:20,192,20,Hmelnitsk
896,876,75,329,499,68,567,0,567,13,417,137,21.04.2019 22:30,192,20,Hmelnitsk
272,257,4,128,140,4,144,0,144,1,94,49,22.04.2019 00:05,192,20,Hmelnitsk
432,414,31,148,253,31,284,0,284,5,188,91,21.04.2019 22:12,192,20,Hmelnitsk
400,379,39,169,197,34,231,0,231,5,189,37,22.04.2019 00:01,192,20,Hmelnitsk
864,851,85,274,523,67,590,0,590,10,414,166,21.04.2019 23:01,192,20,Hmelnitsk
128,117,20,47,64,17,81,0,81,0,63,18,21.04.2019 22:30,192,20,Hmelnitsk
320,307,26,136,161,23,184,0,184,0,155,29,21.04.2019 22:30,192,20,Hmelnitsk
384,376,89,119,180,85,265,0,265,13,167,85,21.04.2019 20:25,192,20,Hmelnitsk
240,231,3,106,131,3,134,0,134,3,101,30,22.04.2019 00:10,192,20,Hmelnitsk
160,161,14,60,88,12,100,0,100,1,64,35,21.04.2019 23:00,192,20,Hmelnitsk
224,209,16,103,108,13,121,0,121,1,97,23,21.04.2019 23:00,192,20,Hmelnitsk
160,153,27,47,90,23,113,0,113,2,78,33,21.04.2019 21:07,192,20,Hmelnitsk
192,187,12,95,90,7,97,0,97,2,68,27,21.04.2019 23:00,192,20,Hmelnitsk
528,513,36,226,271,31,302,0,302,6,235,61,21.04.2019 21:00,192,20,Hmelnitsk
848,832,68,281,505,62,567,0,567,14,438,115,21.04.2019 21:40,192,20,Hmelnitsk
1712,1686,80,742,895,75,970,0,970,12,732,226,22.04.2019 00:55,193,20,Hmelnitsk
432,416,38,198,200,34,234,0,234,3,147,84,22.04.2019 00:30,193,20,Hmelnitsk
368,362,42,148,180,40,220,0,220,0,163,57,22.04.2019 00:35,193,20,Hmelnitsk
96,93,9,39,48,9,57,0,57,2,50,5,22.04.2019 00:03,193,20,Hmelnitsk
1664,1630,32,719,917,28,945,0,945,38,681,226,22.04.2019 00:30,193,20,Hmelnitsk
2032,2008,35,927,1086,19,1105,0,1105,31,791,283,21.04.2019 21:40,193,20,Hmelnitsk
528,524,33,228,271,29,300,0,300,5,216,79,22.04.2019 00:30,193,20,Hmelnitsk
672,657,73,245,356,71,427,0,427,5,312,110,22.04.2019 01:25,193,20,Hmelnitsk
624,602,14,276,337,11,348,0,348,6,244,98,22.04.2019 00:10,193,20,Hmelnitsk
368,351,32,131,210,27,237,0,237,6,170,61,22.04.2019 00:20,193,20,Hmelnitsk
1088,1079,22,465,606,17,623,0,623,16,443,164,22.04.2019 00:25,193,20,Hmelnitsk
128,118,10,54,66,8,74,0,74,1,60,13,22.04.2019 00:28,193,20,Hmelnitsk
1024,1000,65,380,580,64,644,0,644,10,479,155,22.04.2019 02:20,193,20,Hmelnitsk
528,518,20,239,269,20,289,0,289,2,203,84,22.04.2019 01:10,193,20,Hmelnitsk
384,375,16,193,175,16,191,0,191,9,136,46,22.04.2019 00:15,193,20,Hmelnitsk
2032,1992,18,817,1198,17,1215,0,1215,17,868,330,22.04.2019 00:20,193,20,Hmelnitsk
1552,1529,9,704,842,6,848,0,848,11,634,203,22.04.2019 01:45,193,20,Hmelnitsk
976,957,10,419,547,10,557,0,557,20,384,153,21.04.2019 22:00,193,20,Hmelnitsk
752,733,21,358,374,20,394,0,394,11,291,92,22.04.2019 01:10,193,20,Hmelnitsk
448,431,30,186,232,30,262,0,262,2,145,115,22.04.2019 02:15,193,20,Hmelnitsk
320,302,26,137,157,26,183,0,183,19,87,77,22.04.2019 00:30,193,20,Hmelnitsk
416,406,40,155,228,33,261,0,261,6,166,89,22.04.2019 01:25,193,20,Hmelnitsk
160,147,18,60,84,16,100,0,100,2,56,42,21.04.2019 23:30,193,20,Hmelnitsk
656,640,34,285,341,30,371,0,371,15,249,107,21.04.2019 20:55,193,20,Hmelnitsk
160,155,15,40,105,15,120,0,120,0,76,44,22.04.2019 00:05,193,20,Hmelnitsk
224,214,28,81,119,24,143,0,143,6,77,60,21.04.2019 21:04,193,20,Hmelnitsk
240,227,17,81,143,16,159,0,159,3,101,55,21.04.2019 20:40,193,20,Hmelnitsk
80,69,25,28,28,24,52,0,52,1,22,29,22.04.2019 00:15,193,20,Hmelnitsk
304,293,27,102,177,25,202,0,202,9,154,39,22.04.2019 00:10,193,20,Hmelnitsk
80,73,8,37,37,6,43,0,43,1,16,26,22.04.2019 00:20,193,20,Hmelnitsk
944,929,66,411,470,63,533,0,533,11,401,121,21.04.2019 21:06,193,20,Hmelnitsk
128,119,12,58,58,12,70,0,70,4,39,27,21.04.2019 21:00,193,20,Hmelnitsk
240,223,18,88,134,18,152,0,152,1,107,44,21.04.2019 23:45,193,20,Hmelnitsk
416,410,26,153,237,26,263,0,263,4,197,62,21.04.2019 23:00,193,20,Hmelnitsk
496,480,30,176,291,29,320,0,320,7,243,70,22.04.2019 00:05,193,20,Hmelnitsk
144,137,19,42,85,17,102,0,102,2,62,38,21.04.2019 21:20,193,20,Hmelnitsk
80,67,7,31,42,7,49,0,49,1,28,20,21.04.2019 20:35,193,20,Hmelnitsk
80,73,4,44,32,4,36,0,36,0,13,23,21.04.2019 22:45,193,20,Hmelnitsk
448,443,48,166,237,45,282,0,282,4,177,101,21.04.2019 21:10,193,20,Hmelnitsk
32,32,2,5,26,1,27,0,27,2,9,16,21.04.2019 23:00,193,20,Hmelnitsk
272,268,28,103,144,25,169,0,169,1,131,37,21.04.2019 23:30,193,20,Hmelnitsk
752,732,25,329,398,25,423,0,423,7,276,140,22.04.2019 00:40,193,20,Hmelnitsk
368,363,12,107,249,12,261,0,261,4,151,106,22.04.2019 00:15,193,20,Hmelnitsk
848,829,22,118,708,22,730,0,730,22,452,256,22.04.2019 01:45,193,20,Hmelnitsk
272,255,7,120,145,7,152,0,152,3,120,29,22.04.2019 00:08,193,20,Hmelnitsk
592,588,58,233,301,58,359,0,359,11,234,114,21.04.2019 21:30,193,20,Hmelnitsk
240,226,19,78,143,19,162,0,162,3,108,51,21.04.2019 21:00,193,20,Hmelnitsk
272,261,15,102,157,13,170,0,170,2,116,52,22.04.2019 00:35,193,20,Hmelnitsk
240,222,13,101,126,13,139,0,139,0,100,39,21.04.2019 21:20,193,20,Hmelnitsk
560,541,48,207,306,47,353,0,353,7,246,100,21.04.2019 22:00,193,20,Hmelnitsk
160,144,12,52,96,12,108,0,108,6,78,24,22.04.2019 00:15,193,20,Hmelnitsk
80,76,12,24,46,10,56,0,56,0,32,24,22.04.2019 00:15,193,20,Hmelnitsk
912,892,64,388,467,57,524,0,524,14,369,141,22.04.2019 01:10,193,20,Hmelnitsk
400,393,37,150,215,35,250,0,250,4,153,93,22.04.2019 00:45,193,20,Hmelnitsk
336,321,36,129,174,33,207,0,207,1,135,71,21.04.2019 21:33,193,20,Hmelnitsk
464,449,28,201,239,24,263,0,263,3,201,59,21.04.2019 21:30,193,20,Hmelnitsk
80,68,3,39,39,2,41,0,41,0,25,16,21.04.2019 20:30,193,20,Hmelnitsk
192,191,13,76,104,12,116,0,116,0,108,8,22.04.2019 00:05,193,20,Hmelnitsk
592,581,48,182,365,45,410,0,410,10,278,122,22.04.2019 00:20,193,20,Hmelnitsk
432,428,14,118,300,14,314,0,314,8,221,85,22.04.2019 00:10,193,20,Hmelnitsk
560,548,36,253,272,35,307,0,307,6,256,45,22.04.2019 00:10,193,20,Hmelnitsk
192,191,16,66,111,15,126,0,126,2,83,41,22.04.2019 00:15,193,20,Hmelnitsk
224,213,7,37,180,7,187,0,187,1,86,100,22.04.2019 00:20,193,20,Hmelnitsk
384,369,41,162,186,36,222,0,222,2,168,52,21.04.2019 21:30,193,20,Hmelnitsk
176,168,24,58,96,22,118,0,118,4,83,31,21.04.2019 23:30,193,20,Hmelnitsk
256,255,19,107,130,19,149,0,149,7,96,46,21.04.2019 20:46,193,20,Hmelnitsk
160,149,23,57,81,22,103,0,103,0,61,42,21.04.2019 22:00,193,20,Hmelnitsk
1152,1119,70,473,613,66,679,0,679,30,488,161,22.04.2019 00:30,193,20,Hmelnitsk
1392,1380,11,533,850,9,859,0,859,21,605,233,22.04.2019 00:15,193,20,Hmelnitsk
1872,1846,6,749,1119,4,1123,0,1123,31,765,327,22.04.2019 00:20,193,20,Hmelnitsk
1504,1474,13,608,887,9,896,0,896,27,684,185,22.04.2019 00:30,193,20,Hmelnitsk
1840,1799,19,760,1065,15,1080,0,1080,27,764,289,22.04.2019 00:32,193,20,Hmelnitsk
1536,1518,27,609,902,25,927,0,927,22,658,247,22.04.2019 01:45,193,20,Hmelnitsk
1248,1246,9,480,763,5,768,0,768,28,539,201,22.04.2019 00:06,193,20,Hmelnitsk
1488,1459,5,540,946,2,948,0,948,33,676,239,22.04.2019 00:09,193,20,Hmelnitsk
1856,1853,17,711,1139,6,1145,0,1145,29,792,324,22.04.2019 02:10,193,20,Hmelnitsk
1664,1664,15,730,923,11,934,0,934,27,636,271,22.04.2019 00:10,193,20,Hmelnitsk
448,369,0,79,369,0,369,0,369,8,345,16,22.04.2019 00:05,194,21,Cherkassy
2176,2203,29,739,1416,21,1437,0,1437,53,978,406,22.04.2019 00:15,194,21,Cherkassy
1952,1934,14,726,1218,8,1226,0,1226,38,867,321,22.04.2019 00:05,194,21,Cherkassy
1584,1565,16,571,1000,13,1013,0,1013,25,729,259,22.04.2019 00:30,194,21,Cherkassy
1952,1927,12,705,1238,9,1247,0,1247,45,938,264,22.04.2019 00:10,194,21,Cherkassy
1936,1916,8,787,1145,4,1149,0,1149,39,840,270,22.04.2019 00:26,194,21,Cherkassy
2112,2095,15,819,1280,13,1293,0,1293,44,938,311,22.04.2019 00:10,194,21,Cherkassy
2112,2093,13,1092,1009,11,1020,0,1020,23,812,185,22.04.2019 00:40,194,21,Cherkassy
2064,2039,12,723,1333,8,1341,0,1341,47,967,327,22.04.2019 00:02,194,21,Cherkassy
1968,1972,7,775,1187,6,1193,0,1193,45,848,300,22.04.2019 00:02,194,21,Cherkassy
1280,1265,8,532,742,6,748,0,748,15,581,152,22.04.2019 00:45,194,21,Cherkassy
1712,1672,13,700,999,13,1012,0,1012,25,744,243,22.04.2019 00:06,194,21,Cherkassy
2240,2210,21,955,1275,10,1285,0,1285,35,998,252,22.04.2019 00:02,194,21,Cherkassy
848,847,8,325,516,7,523,0,523,20,387,116,22.04.2019 00:10,194,21,Cherkassy
2254,2230,8,830,1418,6,1424,0,1424,54,1008,362,22.04.2019 02:07,194,21,Cherkassy
2192,2193,4,816,1374,2,1376,0,1376,40,963,373,22.04.2019 00:02,194,21,Cherkassy
2384,2374,7,832,1548,4,1552,0,1552,37,1121,394,22.04.2019 00:10,194,21,Cherkassy
2160,2155,13,751,1401,8,1409,0,1409,45,1013,351,22.04.2019 00:15,194,21,Cherkassy
1984,1956,5,766,1213,5,1218,0,1218,42,900,276,22.04.2019 00:05,194,21,Cherkassy
2432,2402,6,853,1576,3,1579,0,1579,39,1082,458,22.04.2019 00:06,194,21,Cherkassy
64,31,0,35,29,0,29,0,29,0,22,7,22.04.2019 00:05,194,21,Cherkassy
128,38,38,91,0,37,37,0,37,1,31,5,22.04.2019 00:05,194,21,Cherkassy
2208,2181,10,862,1338,8,1346,0,1346,44,997,305,22.04.2019 00:10,194,21,Cherkassy
2096,2078,27,818,1256,22,1278,0,1278,38,952,288,22.04.2019 00:10,194,21,Cherkassy
1744,1717,7,688,1050,6,1056,0,1056,11,794,251,22.04.2019 00:15,194,21,Cherkassy
1696,1663,18,740,943,13,956,0,956,23,705,228,22.04.2019 00:15,194,21,Cherkassy
2240,2218,7,951,1287,2,1289,0,1289,29,1025,235,22.04.2019 00:15,194,21,Cherkassy
1984,1960,9,767,1209,8,1217,0,1217,30,942,245,22.04.2019 00:17,194,21,Cherkassy
80,14,0,73,7,0,7,0,7,0,7,0,22.04.2019 00:01,194,21,Cherkassy
128,30,25,100,6,22,28,0,28,0,25,3,22.04.2019 00:05,194,21,Cherkassy
528,78,6,450,72,6,78,4,78,4,62,12,22.04.2019 00:10,194,21,Cherkassy
176,74,0,124,52,0,52,0,52,1,37,14,22.04.2019 00:05,194,21,Cherkassy
576,255,109,369,142,65,207,0,207,6,153,48,22.04.2019 00:30,194,21,Cherkassy
128,19,0,109,19,0,19,0,19,1,18,0,22.04.2019 00:15,194,21,Cherkassy
416,42,28,394,8,14,22,0,22,0,16,6,22.04.2019 00:10,194,21,Cherkassy
224,103,14,123,87,14,101,0,101,0,72,29,22.04.2019 02:07,194,21,Cherkassy
448,123,123,331,0,117,117,0,117,3,94,20,22.04.2019 00:15,194,21,Cherkassy
2128,2083,7,746,1379,3,1382,0,1382,38,992,352,22.04.2019 00:15,194,21,Cherkassy
192,190,17,43,132,17,149,0,149,1,120,28,22.04.2019 00:10,195,21,Cherkassy
800,784,68,326,409,65,474,0,474,8,364,102,22.04.2019 00:03,195,21,Cherkassy
272,272,28,87,158,27,185,0,185,6,151,28,22.04.2019 00:10,195,21,Cherkassy
432,429,37,180,224,28,252,0,252,7,202,43,22.04.2019 00:37,195,21,Cherkassy
816,790,32,308,482,26,508,0,508,9,420,79,22.04.2019 00:20,195,21,Cherkassy
304,297,20,107,181,16,197,0,197,3,162,32,22.04.2019 00:10,195,21,Cherkassy
208,198,7,91,112,5,117,0,117,1,96,20,22.04.2019 00:05,195,21,Cherkassy
464,446,7,197,260,7,267,0,267,10,228,29,22.04.2019 00:30,195,21,Cherkassy
448,438,32,183,236,29,265,0,265,6,206,53,22.04.2019 00:05,195,21,Cherkassy
736,711,17,348,372,16,388,0,388,6,324,58,22.04.2019 00:05,195,21,Cherkassy
864,855,22,464,378,22,400,0,400,9,322,69,22.04.2019 00:02,195,21,Cherkassy
768,748,71,309,400,59,459,0,459,22,329,108,22.04.2019 00:10,195,21,Cherkassy
848,835,46,358,448,42,490,0,490,10,372,108,22.04.2019 00:15,195,21,Cherkassy
464,458,28,197,243,24,267,0,267,6,217,44,22.04.2019 01:30,195,21,Cherkassy
1760,1733,21,676,1063,21,1084,0,1084,26,843,215,22.04.2019 00:10,195,21,Cherkassy
752,749,24,270,459,23,482,0,482,13,369,100,22.04.2019 00:20,195,21,Cherkassy
1104,1071,47,470,589,45,634,0,634,16,538,80,22.04.2019 00:15,195,21,Cherkassy
816,801,46,332,440,44,484,0,484,10,412,62,22.04.2019 00:17,195,21,Cherkassy
928,919,35,357,537,34,571,0,571,8,469,94,22.04.2019 00:10,195,21,Cherkassy
288,285,11,110,167,11,178,4,178,4,146,28,22.04.2019 00:07,195,21,Cherkassy
288,277,28,124,136,28,164,0,164,2,141,21,21.04.2019 23:59,195,21,Cherkassy
64,63,1,19,44,1,45,0,45,1,33,11,22.04.2019 00:05,195,21,Cherkassy
144,136,10,34,100,10,110,0,110,2,88,20,22.04.2019 01:55,195,21,Cherkassy
160,153,27,62,73,25,98,0,98,1,89,8,22.04.2019 00:10,195,21,Cherkassy
224,212,12,71,141,12,153,0,153,0,131,22,22.04.2019 00:25,195,21,Cherkassy
256,248,2,99,155,2,157,0,157,1,125,31,22.04.2019 00:12,195,21,Cherkassy
240,230,17,65,158,17,175,0,175,3,147,25,22.04.2019 00:10,195,21,Cherkassy
336,322,24,119,193,24,217,0,217,3,160,54,21.04.2019 22:45,195,21,Cherkassy
64,61,13,12,39,13,52,0,52,2,28,22,22.04.2019 00:26,195,21,Cherkassy
384,372,84,195,105,84,189,0,189,6,132,51,22.04.2019 00:03,195,21,Cherkassy
1408,865,19,543,847,18,865,0,865,24,637,204,22.04.2019 00:10,195,21,Cherkassy
2208,2161,27,934,1260,14,1274,0,1274,39,945,290,22.04.2019 00:30,195,21,Cherkassy
2176,2128,13,820,1343,13,1356,0,1356,28,1011,317,22.04.2019 00:35,195,21,Cherkassy
1968,1939,8,802,1158,8,1166,0,1166,34,865,267,22.04.2019 00:25,195,21,Cherkassy
1376,1351,3,595,778,3,781,0,781,16,577,188,22.04.2019 00:35,195,21,Cherkassy
2064,2037,9,771,1285,8,1293,0,1293,36,960,297,22.04.2019 00:20,195,21,Cherkassy
1200,1185,28,487,685,28,713,0,713,12,569,132,21.04.2019 21:15,196,21,Cherkassy
576,557,23,264,289,23,312,0,312,3,265,44,21.04.2019 22:00,196,21,Cherkassy
1232,1202,53,495,689,48,737,0,737,12,619,106,22.04.2019 00:01,196,21,Cherkassy
208,204,17,83,110,15,125,0,125,1,104,20,21.04.2019 20:15,196,21,Cherkassy
144,140,13,61,74,9,83,0,83,2,64,17,21.04.2019 20:23,196,21,Cherkassy
224,214,26,88,110,26,136,0,136,6,108,22,21.04.2019 20:30,196,21,Cherkassy
688,671,32,316,340,32,372,0,372,6,300,66,21.04.2019 21:00,196,21,Cherkassy
192,176,26,83,84,25,109,0,109,0,84,25,21.04.2019 21:15,196,21,Cherkassy
1696,1663,32,649,1021,26,1047,0,1047,32,775,240,22.04.2019 00:30,196,21,Cherkassy
1936,1905,35,771,1140,25,1165,0,1165,50,880,234,21.04.2019 21:50,196,21,Cherkassy
560,541,16,241,305,14,319,0,319,9,262,48,22.04.2019 00:10,196,21,Cherkassy
496,486,22,164,314,18,332,0,332,10,258,64,22.04.2019 00:20,196,21,Cherkassy
368,348,56,102,213,53,266,0,266,2,219,45,21.04.2019 21:15,196,21,Cherkassy
128,118,6,37,85,6,91,0,91,0,72,19,21.04.2019 20:50,196,21,Cherkassy
112,109,17,34,61,17,78,0,78,3,49,26,21.04.2019 22:20,196,21,Cherkassy
256,240,17,97,145,14,159,0,159,3,109,47,21.04.2019 22:40,196,21,Cherkassy
1072,1045,78,355,648,69,717,0,717,10,571,136,21.04.2019 21:00,196,21,Cherkassy
192,193,22,46,128,18,146,0,146,0,118,28,21.04.2019 21:05,196,21,Cherkassy
96,99,4,41,51,4,55,0,55,0,47,8,21.04.2019 20:53,196,21,Cherkassy
160,145,22,52,89,19,108,0,108,0,99,9,21.04.2019 21:20,196,21,Cherkassy
528,523,44,204,286,38,324,0,324,8,215,101,22.04.2019 00:30,196,21,Cherkassy
240,33,19,210,14,16,30,0,30,0,19,11,22.04.2019 00:05,196,21,Cherkassy
608,593,26,251,333,24,357,0,357,3,277,77,21.04.2019 21:30,196,21,Cherkassy
128,121,7,66,55,7,62,0,62,0,52,10,22.04.2019 00:27,196,21,Cherkassy
160,147,11,50,101,9,110,0,110,5,70,35,21.04.2019 20:44,196,21,Cherkassy
272,270,19,103,158,11,169,0,169,4,125,40,21.04.2019 21:05,196,21,Cherkassy
768,760,81,267,424,77,501,0,501,8,395,98,21.04.2019 20:40,196,21,Cherkassy
400,389,54,120,235,45,280,0,280,6,224,50,21.04.2019 23:00,196,21,Cherkassy
576,560,33,204,341,31,372,0,372,6,311,55,21.04.2019 20:50,197,21,Cherkassy
336,337,36,111,192,33,225,0,225,1,173,51,21.04.2019 20:45,197,21,Cherkassy
320,318,24,107,191,22,213,0,213,4,195,14,21.04.2019 20:50,197,21,Cherkassy
912,910,98,340,487,85,572,0,572,8,424,140,21.04.2019 22:00,197,21,Cherkassy
752,738,60,275,423,54,477,0,477,9,359,109,21.04.2019 21:00,197,21,Cherkassy
1296,1262,38,498,761,37,798,0,798,21,631,146,21.04.2019 21:05,197,21,Cherkassy
64,64,12,19,35,10,45,0,45,1,42,2,21.04.2019 20:05,197,21,Cherkassy
816,809,80,292,451,73,524,0,524,6,434,84,21.04.2019 20:26,197,21,Cherkassy
336,323,39,57,244,35,279,0,279,0,262,17,21.04.2019 21:20,197,21,Cherkassy
288,288,25,93,177,18,195,0,195,5,149,41,21.04.2019 22:00,197,21,Cherkassy
832,828,79,279,478,75,553,0,553,18,426,109,22.04.2019 00:40,197,21,Cherkassy
176,167,23,75,85,16,101,0,101,1,82,18,21.04.2019 21:23,197,21,Cherkassy
432,431,29,150,257,25,282,0,282,4,190,88,21.04.2019 21:30,197,21,Cherkassy
720,707,65,311,349,60,409,0,409,10,332,67,21.04.2019 21:13,197,21,Cherkassy
1488,1456,43,728,720,40,760,0,760,16,639,105,21.04.2019 21:30,197,21,Cherkassy
1248,1230,24,586,639,23,662,0,662,8,600,54,21.04.2019 21:10,197,21,Cherkassy
128,116,12,52,64,12,76,0,76,2,63,11,21.04.2019 21:05,197,21,Cherkassy
384,378,29,125,231,28,259,0,259,5,210,44,21.04.2019 21:10,197,21,Cherkassy
176,176,24,45,107,24,131,0,131,3,114,14,22.04.2019 00:02,197,21,Cherkassy
144,150,20,59,69,16,85,0,85,1,71,13,21.04.2019 20:30,197,21,Cherkassy
688,680,41,285,362,41,403,0,403,7,302,94,21.04.2019 20:47,197,21,Cherkassy
160,156,16,63,81,16,97,0,97,1,82,14,21.04.2019 20:55,197,21,Cherkassy
480,479,13,182,286,12,298,0,298,4,231,63,22.04.2019 00:30,197,21,Cherkassy
832,841,53,302,486,44,530,0,530,21,442,67,21.04.2019 22:30,197,21,Cherkassy
304,298,23,106,177,21,198,0,198,1,140,57,21.04.2019 22:15,197,21,Cherkassy
240,236,26,65,149,26,175,0,175,2,132,41,22.04.2019 01:07,197,21,Cherkassy
160,161,12,67,81,12,93,0,93,0,68,25,22.04.2019 00:05,197,21,Cherkassy
80,82,10,26,46,8,54,0,54,2,39,13,22.04.2019 00:30,197,21,Cherkassy
96,97,14,35,50,11,61,0,61,0,54,7,22.04.2019 00:10,197,21,Cherkassy
224,222,4,102,119,3,122,0,122,4,103,15,21.04.2019 22:35,197,21,Cherkassy
96,98,9,36,53,7,60,0,60,1,43,16,22.04.2019 00:30,197,21,Cherkassy
192,177,2,75,116,1,117,0,117,1,88,28,22.04.2019 00:15,197,21,Cherkassy
960,949,64,402,500,58,558,0,558,7,446,105,22.04.2019 01:55,197,21,Cherkassy
288,270,29,108,151,29,180,0,180,7,141,32,21.04.2019 21:30,197,21,Cherkassy
1872,1872,16,696,1164,12,1176,0,1176,49,842,285,22.04.2019 01:35,197,21,Cherkassy
1792,1766,10,653,1129,10,1139,0,1139,34,848,257,22.04.2019 00:20,197,21,Cherkassy
2112,2092,23,862,1232,18,1250,0,1250,34,1002,214,22.04.2019 00:07,197,21,Cherkassy
1792,1763,15,678,1100,14,1114,0,1114,30,847,237,22.04.2019 00:10,197,21,Cherkassy
1792,1767,27,819,949,24,973,0,973,22,785,166,21.04.2019 21:05,197,21,Cherkassy
2336,2305,20,971,1346,19,1365,0,1365,28,1031,306,22.04.2019 00:30,197,21,Cherkassy
1632,1608,11,702,921,9,930,0,930,17,758,155,22.04.2019 00:20,197,21,Cherkassy
2016,1986,11,952,1053,11,1064,0,1064,22,823,219,22.04.2019 00:25,197,21,Cherkassy
1920,1897,3,902,1015,3,1018,0,1018,25,792,201,22.04.2019 00:13,197,21,Cherkassy
224,28,7,202,16,6,22,0,22,0,17,5,22.04.2019 00:03,197,21,Cherkassy
1552,1531,16,627,912,13,925,0,925,26,737,162,22.04.2019 00:50,198,21,Cherkassy
1120,1103,20,431,673,16,689,0,689,9,565,115,22.04.2019 00:40,198,21,Cherkassy
592,570,41,301,259,32,291,0,291,4,203,84,22.04.2019 01:20,198,21,Cherkassy
416,399,38,156,224,36,260,0,260,4,197,59,21.04.2019 22:00,198,21,Cherkassy
304,297,22,93,191,20,211,0,211,0,166,45,22.04.2019 00:05,198,21,Cherkassy
448,433,21,182,245,21,266,0,266,2,226,38,22.04.2019 00:10,198,21,Cherkassy
1072,1059,64,474,539,59,598,0,598,18,483,97,22.04.2019 01:30,198,21,Cherkassy
144,140,11,67,67,10,77,0,77,0,57,20,22.04.2019 00:05,198,21,Cherkassy
176,166,7,86,83,7,90,0,90,3,66,21,22.04.2019 00:30,198,21,Cherkassy
144,133,2,71,71,2,73,0,73,2,54,17,22.04.2019 00:35,198,21,Cherkassy
832,811,90,296,451,85,536,0,536,3,431,102,21.04.2019 21:16,198,21,Cherkassy
752,735,43,269,445,38,483,0,483,2,429,52,22.04.2019 00:05,198,21,Cherkassy
848,831,44,343,471,34,505,0,505,11,422,72,22.04.2019 00:15,198,21,Cherkassy
1520,1490,13,717,790,13,803,0,803,18,670,115,22.04.2019 00:20,198,21,Cherkassy
1408,1383,34,595,779,34,813,0,813,17,661,135,22.04.2019 00:20,198,21,Cherkassy
608,591,11,297,300,11,311,0,311,6,259,46,22.04.2019 00:05,198,21,Cherkassy
448,436,27,176,245,27,272,0,272,8,236,28,22.04.2019 00:20,198,21,Cherkassy
464,458,25,221,219,24,243,0,243,5,186,52,22.04.2019 00:15,198,21,Cherkassy
496,492,27,188,284,24,308,0,308,8,244,56,22.04.2019 00:05,198,21,Cherkassy
2096,2056,19,929,1151,16,1167,0,1167,12,980,175,22.04.2019 00:05,198,21,Cherkassy
1056,1043,9,449,598,9,607,0,607,11,498,98,22.04.2019 00:17,198,21,Cherkassy
1264,1241,13,506,746,12,758,0,758,15,560,183,22.04.2019 00:10,198,21,Cherkassy
512,496,17,238,257,17,274,0,274,5,204,65,21.04.2019 23:47,198,21,Cherkassy
480,460,33,231,218,31,249,0,249,5,199,45,21.04.2019 23:00,198,21,Cherkassy
448,429,50,188,214,46,260,0,260,7,195,58,22.04.2019 00:50,198,21,Cherkassy
912,885,13,263,636,13,649,0,649,18,498,133,22.04.2019 00:30,198,21,Cherkassy
624,605,49,245,332,47,379,0,379,20,298,61,22.04.2019 00:12,198,21,Cherkassy
208,198,6,71,131,6,137,0,137,0,114,23,22.04.2019 00:20,198,21,Cherkassy
624,604,71,278,277,69,346,0,346,11,272,63,22.04.2019 01:40,198,21,Cherkassy
416,399,18,169,229,18,247,0,247,7,194,46,21.04.2019 20:40,198,21,Cherkassy
192,176,9,52,131,9,140,0,140,2,125,13,21.04.2019 22:00,198,21,Cherkassy
704,693,71,292,347,65,412,0,412,8,307,97,22.04.2019 00:50,198,21,Cherkassy
64,64,0,18,46,0,46,0,46,0,39,7,21.04.2019 23:15,198,21,Cherkassy
400,383,30,165,208,27,235,0,235,4,179,52,21.04.2019 21:05,198,21,Cherkassy
912,901,56,352,504,56,560,0,560,18,429,113,22.04.2019 00:30,198,21,Cherkassy
640,626,42,305,294,41,335,0,335,5,270,60,21.04.2019 20:45,198,21,Cherkassy
560,541,43,233,286,41,327,0,327,5,283,39,22.04.2019 00:10,198,21,Cherkassy
736,723,28,342,368,26,394,0,394,6,296,92,22.04.2019 00:15,198,21,Cherkassy
1888,1861,21,899,974,15,989,0,989,28,811,150,22.04.2019 00:15,198,21,Cherkassy
1888,1854,14,941,939,8,947,0,947,17,803,127,22.04.2019 00:05,198,21,Cherkassy
1535,1512,11,790,735,10,745,0,745,17,630,98,22.04.2019 00:06,198,21,Cherkassy
544,539,32,241,272,31,303,0,303,6,234,63,22.04.2019 00:05,198,21,Cherkassy
176,166,5,83,88,5,93,0,93,4,58,31,22.04.2019 00:15,198,21,Cherkassy
1344,1325,15,532,800,12,812,0,812,14,645,153,22.04.2019 00:12,198,21,Cherkassy
512,497,4,256,252,4,256,0,256,4,195,57,21.04.2019 20:57,198,21,Cherkassy
2224,2195,12,906,1308,10,1318,0,1318,32,1022,264,22.04.2019 00:50,198,21,Cherkassy
1888,1861,9,802,1077,9,1086,0,1086,27,873,186,22.04.2019 00:30,198,21,Cherkassy
2208,2179,13,851,1344,13,1357,0,1357,31,1096,230,22.04.2019 01:15,198,21,Cherkassy
1632,1601,6,608,1019,5,1024,0,1024,19,819,186,22.04.2019 01:30,198,21,Cherkassy
736,720,15,256,465,15,480,0,480,9,396,75,22.04.2019 00:45,198,21,Cherkassy
272,24,4,248,20,4,24,0,24,0,21,3,22.04.2019 00:02,198,21,Cherkassy
1424,1400,20,588,821,15,836,0,836,24,668,144,22.04.2019 00:25,198,21,Cherkassy
1296,1270,49,506,744,46,790,0,790,31,629,130,22.04.2019 00:30,198,21,Cherkassy
1808,1766,15,707,1087,14,1101,0,1101,26,870,205,22.04.2019 00:25,198,21,Cherkassy
896,879,12,363,524,9,533,0,533,9,419,105,22.04.2019 01:00,198,21,Cherkassy
1456,1419,47,615,802,39,841,0,841,19,665,157,22.04.2019 00:34,198,21,Cherkassy
1584,1556,15,586,983,15,998,0,998,30,768,200,22.04.2019 00:20,198,21,Cherkassy
1520,1498,9,603,909,8,917,0,917,26,711,180,21.04.2019 21:55,198,21,Cherkassy
1248,1228,13,502,736,10,746,0,746,21,587,138,22.04.2019 00:10,198,21,Cherkassy
2032,1984,5,936,1092,4,1096,0,1096,23,842,231,22.04.2019 00:02,198,21,Cherkassy
1840,1811,10,719,1111,10,1121,0,1121,21,896,204,22.04.2019 00:30,198,21,Cherkassy
1568,1517,14,702,852,14,866,0,866,23,680,163,22.04.2019 00:15,198,21,Cherkassy
1200,1173,13,466,723,11,734,0,734,23,571,140,22.04.2019 00:02,198,21,Cherkassy
992,973,11,402,581,9,590,0,590,16,472,102,22.04.2019 00:10,198,21,Cherkassy
1728,1698,5,739,985,4,989,0,989,31,794,164,22.04.2019 00:05,198,21,Cherkassy
2080,2032,7,909,1164,7,1171,0,1171,34,933,204,22.04.2019 00:15,198,21,Cherkassy
2080,2023,4,845,1231,4,1235,0,1235,36,991,208,22.04.2019 00:15,198,21,Cherkassy
320,49,36,279,13,28,41,0,41,0,30,11,22.04.2019 00:05,198,21,Cherkassy
192,32,15,163,16,13,29,0,29,1,23,5,22.04.2019 00:10,198,21,Cherkassy
80,14,0,68,12,0,12,0,12,0,10,2,22.04.2019 00:02,198,21,Cherkassy
2048,2004,9,979,1062,7,1069,0,1069,38,799,232,22.04.2019 00:45,199,21,Cherkassy
2368,2332,14,988,1376,4,1380,0,1380,35,1026,319,22.04.2019 00:10,199,21,Cherkassy
2400,2370,6,1039,1355,6,1361,0,1361,29,1053,279,22.04.2019 00:40,199,21,Cherkassy
1168,1157,10,482,679,7,686,0,686,15,551,120,22.04.2019 00:22,199,21,Cherkassy
624,606,59,119,453,52,505,0,505,12,434,59,21.04.2019 22:30,199,21,Cherkassy
304,297,22,105,177,22,199,0,199,5,127,67,21.04.2019 20:40,199,21,Cherkassy
224,224,21,67,136,21,157,0,157,1,108,48,22.04.2019 00:15,199,21,Cherkassy
736,731,66,304,391,41,432,0,432,7,340,85,21.04.2019 22:35,199,21,Cherkassy
544,542,35,208,304,32,336,0,336,4,244,88,22.04.2019 00:03,199,21,Cherkassy
112,101,11,45,56,11,67,0,67,0,44,23,21.04.2019 21:30,199,21,Cherkassy
128,127,13,26,89,13,102,0,102,5,83,14,22.04.2019 00:20,199,21,Cherkassy
448,436,43,173,235,40,275,0,275,8,203,64,21.04.2019 21:05,199,21,Cherkassy
656,640,48,214,398,44,442,0,442,5,361,76,22.04.2019 00:10,199,21,Cherkassy
160,153,12,43,106,11,117,0,117,1,61,55,22.04.2019 00:50,199,21,Cherkassy
800,782,73,307,433,60,493,0,493,14,367,112,22.04.2019 00:07,199,21,Cherkassy
464,456,46,154,274,36,310,0,310,8,234,68,21.04.2019 20:35,199,21,Cherkassy
544,525,36,211,300,33,333,0,333,8,257,68,22.04.2019 00:15,199,21,Cherkassy
640,627,68,237,335,68,403,0,403,11,315,77,21.04.2019 20:45,199,21,Cherkassy
544,527,76,173,296,75,371,0,371,2,302,67,21.04.2019 20:20,199,21,Cherkassy
752,735,40,316,399,37,436,0,436,12,310,114,22.04.2019 00:07,199,21,Cherkassy
1472,1461,60,552,868,52,920,0,920,18,719,183,22.04.2019 00:40,199,21,Cherkassy
704,687,62,233,415,56,471,0,471,3,373,95,21.04.2019 21:40,199,21,Cherkassy
848,837,68,332,448,68,516,0,516,9,400,107,22.04.2019 00:40,199,21,Cherkassy
432,433,47,177,210,45,255,0,255,5,153,97,21.04.2019 21:10,199,21,Cherkassy
512,502,43,216,259,37,296,0,296,12,217,67,22.04.2019 00:04,199,21,Cherkassy
368,364,34,136,201,31,232,0,232,7,189,36,21.04.2019 22:00,199,21,Cherkassy
176,70,5,118,54,4,58,0,58,0,48,10,22.04.2019 00:10,199,21,Cherkassy
512,499,2,237,273,2,275,0,275,4,243,28,21.04.2019 20:50,199,21,Cherkassy
608,605,35,217,357,34,391,0,391,8,299,84,22.04.2019 00:45,199,21,Cherkassy
464,450,40,106,318,40,358,0,358,4,269,85,21.04.2019 20:30,199,21,Cherkassy
304,297,5,114,186,4,190,0,190,0,165,25,22.04.2019 01:40,199,21,Cherkassy
288,280,23,108,160,20,180,0,180,4,144,32,22.04.2019 00:10,199,21,Cherkassy
272,276,15,75,183,14,197,0,197,6,145,46,22.04.2019 00:10,199,21,Cherkassy
32,29,2,13,17,2,19,0,19,0,14,5,22.04.2019 00:15,199,21,Cherkassy
1408,1414,60,619,734,55,789,0,789,18,576,195,22.04.2019 02:00,199,21,Cherkassy
1968,1936,24,813,1131,24,1155,0,1155,37,883,235,22.04.2019 00:40,199,21,Cherkassy
432,418,31,182,220,30,250,0,250,5,172,73,22.04.2019 00:05,199,21,Cherkassy
1200,1199,37,470,699,31,730,0,730,9,560,161,21.04.2019 21:10,199,21,Cherkassy
256,256,34,77,146,33,179,0,179,4,112,63,22.04.2019 00:15,199,21,Cherkassy
960,940,25,380,558,22,580,0,580,18,467,95,22.04.2019 00:40,199,21,Cherkassy
384,372,41,170,180,34,214,0,214,2,135,77,22.04.2019 00:15,199,21,Cherkassy
128,122,7,39,82,7,89,0,89,2,58,29,21.04.2019 22:15,199,21,Cherkassy
640,625,2,333,305,2,307,0,307,6,246,55,21.04.2019 21:30,199,21,Cherkassy
688,679,4,284,400,4,404,0,404,13,289,102,21.04.2019 20:30,199,21,Cherkassy
688,678,29,298,361,29,390,0,390,13,325,52,22.04.2019 00:05,200,21,Cherkassy
752,737,1,331,420,1,421,0,421,8,309,104,22.04.2019 00:01,200,21,Cherkassy
368,356,9,159,201,8,209,0,209,5,182,22,22.04.2019 01:05,200,21,Cherkassy
384,383,36,158,196,30,226,0,226,8,173,45,22.04.2019 00:45,200,21,Cherkassy
1648,1623,71,787,792,69,861,0,861,18,681,162,22.04.2019 00:35,200,21,Cherkassy
592,577,46,201,346,45,391,0,391,12,268,111,22.04.2019 00:43,200,21,Cherkassy
192,183,11,61,124,7,131,0,131,5,97,29,22.04.2019 00:45,200,21,Cherkassy
128,119,6,41,82,5,87,0,87,1,46,40,22.04.2019 00:00,200,21,Cherkassy
576,557,40,247,294,35,329,0,329,5,265,59,22.04.2019 00:35,200,21,Cherkassy
1136,1118,66,400,677,59,736,0,736,18,558,160,22.04.2019 00:20,200,21,Cherkassy
752,740,45,326,381,45,426,0,426,8,324,94,22.04.2019 01:15,200,21,Cherkassy
864,852,67,326,478,60,538,0,538,13,355,170,22.04.2019 01:05,200,21,Cherkassy
1664,1634,81,627,959,78,1037,0,1037,21,835,181,22.04.2019 00:26,200,21,Cherkassy
640,625,58,220,368,52,420,0,420,6,347,67,22.04.2019 00:38,200,21,Cherkassy
368,360,11,117,241,10,251,0,251,4,180,67,22.04.2019 00:44,200,21,Cherkassy
752,739,84,258,420,74,494,0,494,13,374,107,22.04.2019 01:31,200,21,Cherkassy
176,177,28,43,106,27,133,0,133,8,112,13,22.04.2019 00:50,200,21,Cherkassy
1120,1105,38,553,532,35,567,0,567,9,389,169,22.04.2019 00:05,200,21,Cherkassy
368,357,26,140,205,23,228,0,228,5,179,44,22.04.2019 00:02,200,21,Cherkassy
128,115,13,43,72,13,85,0,85,0,56,29,22.04.2019 00:34,200,21,Cherkassy
160,148,9,78,73,9,82,0,82,0,71,11,22.04.2019 00:30,200,21,Cherkassy
656,650,39,246,374,36,410,0,410,11,270,129,22.04.2019 00:51,200,21,Cherkassy
1120,1098,38,459,625,36,661,0,661,15,507,139,22.04.2019 00:52,200,21,Cherkassy
608,603,40,177,395,36,431,0,431,12,334,85,22.04.2019 00:20,200,21,Cherkassy
624,614,55,154,419,51,470,0,470,9,351,110,22.04.2019 00:15,200,21,Cherkassy
1712,1682,82,761,881,70,951,0,951,31,644,276,22.04.2019 01:00,200,21,Cherkassy
320,314,37,134,155,31,186,0,186,6,152,28,22.04.2019 00:40,200,21,Cherkassy
272,252,17,81,175,16,191,0,191,6,135,50,22.04.2019 00:30,200,21,Cherkassy
1232,1219,73,382,780,70,850,0,850,18,606,226,22.04.2019 00:15,200,21,Cherkassy
592,581,30,240,327,25,352,0,352,4,259,89,22.04.2019 00:10,200,21,Cherkassy
1072,1053,35,410,627,35,662,0,662,17,499,146,22.04.2019 00:50,200,21,Cherkassy
256,242,20,115,124,17,141,0,141,2,124,15,22.04.2019 01:02,200,21,Cherkassy
464,459,37,171,260,33,293,0,293,1,240,52,22.04.2019 01:00,200,21,Cherkassy
112,110,4,44,64,4,68,0,68,2,47,19,22.04.2019 00:20,200,21,Cherkassy
592,584,48,197,349,46,395,0,395,7,326,62,22.04.2019 00:06,200,21,Cherkassy
320,300,23,125,173,22,195,0,195,3,125,67,22.04.2019 00:41,200,21,Cherkassy
1344,1326,7,550,790,4,794,0,794,29,586,179,22.04.2019 00:55,200,21,Cherkassy
1488,1460,7,562,919,7,926,0,926,20,712,194,22.04.2019 00:45,200,21,Cherkassy
464,448,30,182,254,28,282,0,282,5,199,78,22.04.2019 00:05,200,21,Cherkassy
208,198,16,73,119,16,135,0,135,2,131,2,22.04.2019 00:15,200,21,Cherkassy
608,599,26,258,334,16,350,0,350,2,268,80,22.04.2019 00:37,200,21,Cherkassy
1248,1225,61,530,662,56,718,0,718,17,572,129,22.04.2019 00:42,200,21,Cherkassy
256,257,25,104,130,22,152,0,152,0,123,29,22.04.2019 00:30,200,21,Cherkassy
864,852,29,364,476,24,500,0,500,7,415,78,22.04.2019 00:55,200,21,Cherkassy
160,143,19,82,64,14,78,0,78,3,50,25,22.04.2019 00:33,200,21,Cherkassy
608,598,45,196,368,44,412,0,412,7,299,106,22.04.2019 01:05,200,21,Cherkassy
688,677,61,312,317,59,376,0,376,11,239,126,22.04.2019 00:30,200,21,Cherkassy
432,423,40,154,242,36,278,0,278,3,219,56,22.04.2019 00:05,200,21,Cherkassy
368,356,35,149,189,30,219,0,219,3,157,59,22.04.2019 00:10,200,21,Cherkassy
528,520,35,229,268,31,299,0,299,7,236,56,22.04.2019 00:06,200,21,Cherkassy
384,372,12,140,236,8,244,0,244,6,184,54,22.04.2019 00:24,200,21,Cherkassy
672,657,57,228,389,55,444,0,444,12,311,121,22.04.2019 00:00,200,21,Cherkassy
608,591,15,264,331,13,344,0,344,4,281,59,22.04.2019 00:39,200,21,Cherkassy
880,840,1,50,829,1,830,0,830,29,714,87,22.04.2019 00:33,200,21,Cherkassy
1504,1488,15,559,935,10,945,0,945,26,686,233,22.04.2019 00:35,200,21,Cherkassy
1552,1548,71,585,906,61,967,0,967,29,714,224,22.04.2019 00:30,200,21,Cherkassy
1488,1463,12,598,881,9,890,0,890,25,601,264,22.04.2019 01:30,200,21,Cherkassy
2224,2206,34,847,1351,26,1377,0,1377,33,1038,306,22.04.2019 00:06,200,21,Cherkassy
1600,1567,13,718,871,11,882,0,882,31,668,183,22.04.2019 00:10,200,21,Cherkassy
416,62,28,357,32,27,59,0,59,3,41,15,22.04.2019 00:03,200,21,Cherkassy
512,120,0,398,114,0,114,0,114,1,105,8,22.04.2019 00:15,200,21,Cherkassy
272,46,19,232,25,15,40,0,40,0,37,3,22.04.2019 00:01,200,21,Cherkassy
240,226,0,15,225,0,225,0,225,5,143,77,21.04.2019 23:56,201,22,Chernovtsy
2448,2398,9,1535,908,5,913,0,913,26,666,221,22.04.2019 00:38,201,22,Chernovtsy
816,806,9,319,490,7,497,0,497,19,314,164,22.04.2019 00:05,201,22,Chernovtsy
880,866,9,355,516,9,525,0,525,16,363,146,22.04.2019 00:04,201,22,Chernovtsy
912,899,6,348,559,5,564,0,564,26,378,160,22.04.2019 00:05,201,22,Chernovtsy
1680,1654,9,692,981,7,988,0,988,33,635,320,22.04.2019 00:06,201,22,Chernovtsy
2048,2022,13,838,1200,10,1210,0,1210,39,818,353,21.04.2019 22:05,201,22,Chernovtsy
1488,1465,12,622,856,10,866,0,866,20,625,221,22.04.2019 00:30,201,22,Chernovtsy
2272,2245,15,802,1457,13,1470,0,1470,53,1079,338,22.04.2019 00:25,201,22,Chernovtsy
1744,1720,4,803,939,2,941,0,941,21,657,263,22.04.2019 00:05,201,22,Chernovtsy
2112,2086,7,843,1263,6,1269,0,1269,24,859,386,22.04.2019 01:17,201,22,Chernovtsy
2272,2155,12,1132,1131,9,1140,0,1140,21,787,332,22.04.2019 00:20,201,22,Chernovtsy
640,29,18,618,8,14,22,0,22,0,20,2,22.04.2019 00:25,201,22,Chernovtsy
480,82,48,409,34,37,71,0,71,1,55,15,22.04.2019 00:10,201,22,Chernovtsy
160,60,50,102,10,48,58,0,58,1,48,9,22.04.2019 00:02,201,22,Chernovtsy
400,21,0,381,19,0,19,0,19,1,9,9,21.04.2019 22:07,201,22,Chernovtsy
224,76,2,156,66,2,68,0,68,4,46,18,22.04.2019 00:15,201,22,Chernovtsy
144,133,53,27,71,46,117,0,117,11,52,54,22.04.2019 00:12,201,22,Chernovtsy
96,19,2,79,15,2,17,0,17,0,11,6,21.04.2019 23:25,201,22,Chernovtsy
1744,1747,7,689,1050,5,1055,0,1055,32,680,343,22.04.2019 00:32,201,22,Chernovtsy
976,977,2,395,580,1,581,0,581,11,411,159,22.04.2019 00:07,201,22,Chernovtsy
2000,1988,10,755,1237,8,1245,0,1245,39,827,379,22.04.2019 00:02,201,22,Chernovtsy
2272,2236,11,952,1311,9,1320,0,1320,43,876,401,22.04.2019 00:07,201,22,Chernovtsy
1344,1318,5,646,693,5,698,0,698,12,476,210,22.04.2019 00:12,201,22,Chernovtsy
1856,1845,10,765,1084,7,1091,0,1091,25,735,331,22.04.2019 00:02,201,22,Chernovtsy
2272,2249,10,947,1316,9,1325,0,1325,32,924,369,22.04.2019 01:57,201,22,Chernovtsy
2224,2215,8,858,1359,7,1366,0,1366,34,963,369,22.04.2019 00:10,201,22,Chernovtsy
2128,2092,9,861,1260,7,1267,0,1267,39,833,395,22.04.2019 00:20,201,22,Chernovtsy
992,981,4,399,589,4,593,0,593,23,399,171,22.04.2019 00:40,201,22,Chernovtsy
896,887,0,331,565,0,565,0,565,13,343,209,22.04.2019 01:05,201,22,Chernovtsy
2080,2062,5,805,1273,2,1275,0,1275,31,887,357,22.04.2019 00:30,201,22,Chernovtsy
1328,1320,8,549,771,8,779,0,779,18,520,241,22.04.2019 00:10,201,22,Chernovtsy
2192,2171,4,880,1309,3,1312,0,1312,34,879,399,22.04.2019 00:30,201,22,Chernovtsy
2160,2138,6,876,1279,5,1284,0,1284,29,900,355,22.04.2019 00:30,201,22,Chernovtsy
1344,1330,6,626,716,2,718,0,718,21,501,196,22.04.2019 00:10,201,22,Chernovtsy
2224,2195,6,998,1221,5,1226,0,1226,27,826,373,22.04.2019 00:34,201,22,Chernovtsy
1552,1535,5,703,844,5,849,0,849,25,611,213,22.04.2019 00:25,201,22,Chernovtsy
544,37,0,510,34,0,34,0,34,2,23,9,22.04.2019 00:23,201,22,Chernovtsy
240,40,12,205,24,11,35,0,35,0,28,7,22.04.2019 00:17,201,22,Chernovtsy
192,21,12,172,9,11,20,0,20,1,13,6,22.04.2019 00:12,201,22,Chernovtsy
64,18,0,48,16,0,16,0,16,0,10,6,22.04.2019 00:03,201,22,Chernovtsy
192,38,34,173,2,17,19,0,19,1,14,4,22.04.2019 00:21,201,22,Chernovtsy
224,20,17,205,3,16,19,0,19,0,11,8,21.04.2019 23:45,201,22,Chernovtsy
192,23,0,173,19,0,19,0,19,0,15,4,22.04.2019 00:07,201,22,Chernovtsy
80,2,0,78,2,0,2,0,2,0,2,0,22.04.2019 00:10,201,22,Chernovtsy
176,50,0,129,47,0,47,0,47,5,36,6,22.04.2019 00:08,201,22,Chernovtsy
1328,1311,4,592,734,2,736,0,736,14,493,229,22.04.2019 00:30,201,22,Chernovtsy
2208,2228,8,866,1335,7,1342,0,1342,40,874,428,22.04.2019 01:20,201,22,Chernovtsy
48,24,0,24,24,0,24,0,24,0,6,18,22.04.2019 00:10,202,22,Chernovtsy
1584,1563,56,662,868,54,922,0,922,22,539,361,22.04.2019 00:45,202,22,Chernovtsy
768,751,39,328,402,38,440,0,440,7,319,114,21.04.2019 21:25,202,22,Chernovtsy
272,269,16,74,186,12,198,0,198,4,152,42,22.04.2019 00:05,202,22,Chernovtsy
656,643,31,283,342,31,373,0,373,8,261,104,22.04.2019 00:05,202,22,Chernovtsy
1856,1844,18,878,960,18,978,0,978,37,579,362,22.04.2019 00:10,202,22,Chernovtsy
416,400,22,211,183,22,205,0,205,5,147,53,22.04.2019 00:02,202,22,Chernovtsy
784,774,28,324,432,28,460,0,460,11,328,121,22.04.2019 00:10,202,22,Chernovtsy
1280,1246,30,644,606,30,636,0,636,14,458,164,21.04.2019 22:00,202,22,Chernovtsy
880,857,52,384,445,51,496,0,496,8,386,102,22.04.2019 00:13,202,22,Chernovtsy
224,212,13,71,140,13,153,0,153,0,87,66,22.04.2019 00:05,202,22,Chernovtsy
1552,1532,56,719,781,52,833,0,833,17,566,250,22.04.2019 00:11,202,22,Chernovtsy
2320,2308,16,1066,1241,13,1254,0,1254,33,956,265,22.04.2019 00:15,202,22,Chernovtsy
1744,1717,10,880,858,6,864,0,864,25,691,148,22.04.2019 00:05,202,22,Chernovtsy
128,129,0,23,105,0,105,0,105,1,78,26,22.04.2019 00:30,202,22,Chernovtsy
32,24,0,20,12,0,12,0,12,1,6,5,22.04.2019 00:05,203,22,Chernovtsy
464,446,19,232,214,18,232,0,232,8,201,23,22.04.2019 00:12,203,22,Chernovtsy
672,670,8,302,363,7,370,0,370,4,357,9,22.04.2019 00:20,203,22,Chernovtsy
400,392,0,135,265,0,265,0,265,7,192,66,22.04.2019 00:11,203,22,Chernovtsy
1088,1064,42,487,559,42,601,0,601,19,477,105,22.04.2019 00:10,203,22,Chernovtsy
400,402,24,182,196,22,218,0,218,7,161,50,22.04.2019 00:30,203,22,Chernovtsy
688,670,41,282,369,37,406,0,406,12,353,41,22.04.2019 00:10,203,22,Chernovtsy
1088,1082,15,604,469,15,484,0,484,16,396,72,22.04.2019 00:30,203,22,Chernovtsy
272,262,13,91,168,13,181,0,181,7,156,18,22.04.2019 00:10,203,22,Chernovtsy
224,221,10,74,140,10,150,0,150,7,96,47,22.04.2019 00:05,203,22,Chernovtsy
2432,2418,50,1197,1193,42,1235,0,1235,37,983,215,22.04.2019 00:05,203,22,Chernovtsy
1840,1821,40,925,881,34,915,0,915,18,732,165,22.04.2019 00:20,203,22,Chernovtsy
512,506,28,283,210,19,229,0,229,5,154,70,22.04.2019 00:05,203,22,Chernovtsy
2208,2185,58,1220,939,49,988,0,988,38,820,130,22.04.2019 00:30,203,22,Chernovtsy
2224,2203,24,969,1231,24,1255,0,1255,22,1198,35,22.04.2019 00:15,203,22,Chernovtsy
1040,1027,17,608,415,17,432,0,432,14,379,39,22.04.2019 00:05,203,22,Chernovtsy
1904,1908,26,1056,822,26,848,0,848,14,749,85,22.04.2019 00:20,203,22,Chernovtsy
240,233,19,77,146,17,163,0,163,5,127,31,22.04.2019 00:15,203,22,Chernovtsy
2112,2078,47,1256,812,44,856,0,856,29,791,36,22.04.2019 00:15,203,22,Chernovtsy
544,540,26,279,241,24,265,0,265,8,209,48,22.04.2019 00:05,203,22,Chernovtsy
1136,1114,56,595,487,54,541,0,541,10,487,44,22.04.2019 00:10,203,22,Chernovtsy
1216,1199,12,426,778,12,790,0,790,20,724,46,22.04.2019 00:17,203,22,Chernovtsy
528,522,6,251,272,5,277,0,277,11,234,32,21.04.2019 21:00,204,22,Chernovtsy
240,234,14,110,116,14,130,0,130,0,102,28,21.04.2019 20:30,204,22,Chernovtsy
944,922,63,476,413,55,468,0,468,7,388,73,21.04.2019 22:10,204,22,Chernovtsy
768,761,54,367,348,53,401,0,401,8,331,62,21.04.2019 21:00,204,22,Chernovtsy
144,142,7,37,100,7,107,0,107,0,94,13,22.04.2019 00:05,204,22,Chernovtsy
880,867,43,378,459,43,502,0,502,7,431,64,21.04.2019 20:55,204,22,Chernovtsy
272,270,30,97,146,29,175,0,175,2,146,27,21.04.2019 21:00,204,22,Chernovtsy
1520,1488,78,912,544,64,608,0,608,13,514,81,21.04.2019 21:20,204,22,Chernovtsy
272,270,8,54,210,8,218,0,218,2,162,54,21.04.2019 20:30,204,22,Chernovtsy
1328,1309,7,371,950,7,957,0,957,25,913,19,21.04.2019 20:48,204,22,Chernovtsy
1312,1295,35,639,644,29,673,0,673,15,578,80,21.04.2019 22:10,204,22,Chernovtsy
448,444,9,201,239,8,247,0,247,2,179,66,21.04.2019 21:30,204,22,Chernovtsy
720,704,40,315,369,36,405,0,405,10,286,109,21.04.2019 22:30,204,22,Chernovtsy
1088,1073,27,534,531,23,554,0,554,10,464,80,21.04.2019 21:05,204,22,Chernovtsy
352,353,16,136,202,14,216,0,216,2,197,17,21.04.2019 21:00,204,22,Chernovtsy
656,647,57,188,411,57,468,0,468,18,400,50,21.04.2019 21:00,204,22,Chernovtsy
640,634,25,277,338,25,363,0,363,13,301,49,21.04.2019 21:00,204,22,Chernovtsy
1120,1109,42,521,559,40,599,0,599,19,437,143,21.04.2019 22:15,204,22,Chernovtsy
208,48,18,166,25,17,42,0,42,0,40,2,21.04.2019 20:45,204,22,Chernovtsy
80,78,12,32,37,11,48,0,48,0,37,11,21.04.2019 20:25,206,23,Chernigov
336,328,45,125,170,41,211,0,211,4,168,39,21.04.2019 21:07,206,23,Chernigov
352,350,33,131,197,24,221,0,221,6,147,68,21.04.2019 23:00,206,23,Chernigov
192,178,14,86,94,12,106,0,106,1,71,34,21.04.2019 21:28,206,23,Chernigov
160,153,36,65,65,30,95,0,95,1,57,37,22.04.2019 00:30,206,23,Chernigov
352,334,70,152,145,55,200,0,200,1,139,60,21.04.2019 23:50,206,23,Chernigov
128,124,37,50,50,28,78,0,78,2,65,11,22.04.2019 00:15,206,23,Chernigov
240,225,31,113,104,23,127,0,127,1,106,20,21.04.2019 20:37,206,23,Chernigov
352,333,80,134,147,71,218,0,218,0,155,63,21.04.2019 21:08,206,23,Chernigov
208,194,44,46,126,36,162,0,162,2,135,25,22.04.2019 00:15,206,23,Chernigov
160,155,22,51,91,18,109,0,109,3,66,40,22.04.2019 00:10,206,23,Chernigov
512,506,81,204,231,77,308,0,308,3,254,51,22.04.2019 00:30,206,23,Chernigov
208,197,15,88,105,15,120,0,120,1,84,35,22.04.2019 00:40,206,23,Chernigov
288,284,34,98,157,33,190,0,190,2,156,32,21.04.2019 21:00,206,23,Chernigov
992,969,94,426,476,90,566,0,566,11,429,126,22.04.2019 00:20,206,23,Chernigov
304,287,25,119,160,25,185,0,185,1,133,51,21.04.2019 23:00,206,23,Chernigov
400,390,24,142,234,24,258,0,258,9,186,63,21.04.2019 21:01,206,23,Chernigov
112,99,14,35,64,13,77,0,77,0,57,20,21.04.2019 20:20,206,23,Chernigov
128,114,7,63,58,7,65,0,65,3,46,16,22.04.2019 00:55,206,23,Chernigov
992,984,3,438,553,1,554,0,554,12,428,114,21.04.2019 23:00,206,23,Chernigov
1104,1088,4,440,660,4,664,0,664,21,447,196,22.04.2019 00:02,206,23,Chernigov
208,199,34,72,104,32,136,0,136,1,113,22,22.04.2019 00:05,206,23,Chernigov
480,459,36,199,246,35,281,0,281,5,192,84,22.04.2019 00:20,206,23,Chernigov
176,178,20,73,84,19,103,0,103,3,73,27,21.04.2019 22:30,206,23,Chernigov
1264,1262,53,497,716,51,767,0,767,10,613,144,22.04.2019 00:15,206,23,Chernigov
336,319,2,121,214,1,215,0,215,3,170,42,22.04.2019 00:05,206,23,Chernigov
896,883,32,364,502,30,532,0,532,9,301,222,22.04.2019 00:15,206,23,Chernigov
144,133,9,55,80,9,89,0,89,3,30,56,22.04.2019 00:05,206,23,Chernigov
1040,1012,4,490,546,4,550,0,550,15,440,95,22.04.2019 00:05,206,23,Chernigov
528,516,49,205,274,49,323,0,323,3,234,86,22.04.2019 00:15,206,23,Chernigov
128,119,16,59,54,15,69,0,69,1,45,23,21.04.2019 22:15,206,23,Chernigov
80,75,10,20,50,10,60,0,60,2,44,14,21.04.2019 21:00,206,23,Chernigov
464,460,32,170,266,28,294,0,294,5,200,89,22.04.2019 00:30,206,23,Chernigov
368,364,50,122,198,48,246,0,246,7,163,76,21.04.2019 20:49,206,23,Chernigov
496,487,53,221,226,49,275,0,275,8,200,67,21.04.2019 20:40,206,23,Chernigov
1360,1351,39,540,796,24,820,0,820,20,600,200,22.04.2019 00:15,206,23,Chernigov
144,141,10,65,73,6,79,0,79,0,72,7,21.04.2019 21:37,206,23,Chernigov
112,100,9,61,44,7,51,0,51,0,40,11,21.04.2019 23:25,206,23,Chernigov
320,314,33,153,136,31,167,0,167,3,123,41,21.04.2019 22:20,206,23,Chernigov
144,136,15,71,61,12,73,0,73,3,51,19,21.04.2019 20:22,206,23,Chernigov
816,807,57,313,452,51,503,0,503,15,393,95,22.04.2019 00:30,206,23,Chernigov
400,389,20,202,180,18,198,0,198,5,148,45,21.04.2019 21:05,206,23,Chernigov
224,203,18,71,138,15,153,0,153,1,104,48,21.04.2019 21:06,206,23,Chernigov
480,464,39,212,237,31,268,0,268,1,224,43,21.04.2019 22:30,206,23,Chernigov
416,409,61,143,215,58,273,0,273,1,192,80,21.04.2019 22:20,206,23,Chernigov
112,100,18,49,47,16,63,0,63,0,46,17,21.04.2019 23:35,206,23,Chernigov
320,305,17,122,182,16,198,0,198,3,150,45,21.04.2019 22:10,206,23,Chernigov
240,235,27,92,125,23,148,0,148,6,121,21,21.04.2019 20:46,206,23,Chernigov
160,159,3,61,96,3,99,0,99,3,76,20,21.04.2019 20:45,206,23,Chernigov
560,553,21,147,392,21,413,0,413,13,341,59,21.04.2019 22:10,206,23,Chernigov
656,644,26,206,425,25,450,0,450,5,390,55,21.04.2019 21:28,206,23,Chernigov
784,776,28,344,412,28,440,0,440,5,348,87,21.04.2019 21:20,206,23,Chernigov
224,210,17,85,124,15,139,0,139,4,102,33,21.04.2019 21:17,206,23,Chernigov
528,512,31,196,302,30,332,0,332,4,262,66,21.04.2019 22:15,206,23,Chernigov
480,475,16,140,324,16,340,0,340,3,253,84,21.04.2019 22:55,206,23,Chernigov
256,249,17,105,134,17,151,0,151,2,112,37,21.04.2019 22:00,206,23,Chernigov
288,280,19,115,155,18,173,0,173,2,135,36,21.04.2019 22:35,206,23,Chernigov
272,267,5,120,148,4,152,0,152,4,117,31,21.04.2019 20:51,206,23,Chernigov
128,116,10,51,67,10,77,0,77,0,65,12,21.04.2019 20:25,206,23,Chernigov
1808,1793,15,757,1038,13,1051,0,1051,26,826,199,22.04.2019 00:10,206,23,Chernigov
1936,1933,17,658,1264,14,1278,0,1278,26,952,300,22.04.2019 00:10,206,23,Chernigov
1184,930,4,472,709,3,712,0,712,16,541,155,22.04.2019 00:05,206,23,Chernigov
1424,1400,14,528,887,9,896,0,896,22,672,202,21.04.2019 21:30,206,23,Chernigov
416,405,240,19,160,237,397,0,397,14,171,212,22.04.2019 00:15,206,23,Chernigov
2256,2231,24,769,1467,20,1487,0,1487,40,1169,278,22.04.2019 00:02,206,23,Chernigov
2336,2304,8,841,1489,6,1495,0,1495,47,1161,287,21.04.2019 22:40,206,23,Chernigov
64,10,0,55,9,0,9,0,9,1,6,2,21.04.2019 21:15,206,23,Chernigov
432,427,43,167,226,39,265,0,265,5,220,40,21.04.2019 20:35,207,23,Chernigov
96,85,8,38,51,7,58,0,58,2,35,21,21.04.2019 20:36,207,23,Chernigov
368,309,40,178,153,37,190,0,190,4,145,41,21.04.2019 20:45,207,23,Chernigov
240,229,30,98,115,27,142,0,142,3,101,38,21.04.2019 22:20,207,23,Chernigov
400,390,58,176,175,49,224,0,224,4,177,43,21.04.2019 20:55,207,23,Chernigov
576,566,79,211,302,63,365,0,365,8,281,76,22.04.2019 00:15,207,23,Chernigov
192,183,23,70,101,21,122,0,122,1,103,18,21.04.2019 20:40,207,23,Chernigov
160,149,13,72,79,9,88,0,88,3,76,9,21.04.2019 21:00,207,23,Chernigov
320,313,45,115,164,41,205,0,205,1,151,53,21.04.2019 20:50,207,23,Chernigov
112,101,7,52,53,7,60,0,60,1,38,21,22.04.2019 00:05,207,23,Chernigov
720,707,43,349,332,39,371,0,371,13,307,51,21.04.2019 21:00,207,23,Chernigov
128,127,4,41,85,2,87,0,87,6,60,21,22.04.2019 00:04,207,23,Chernigov
2096,1263,23,833,1243,20,1263,0,1263,31,1063,169,22.04.2019 00:20,208,23,Chernigov
864,848,23,395,449,20,469,0,469,7,414,48,22.04.2019 00:12,208,23,Chernigov
1968,1933,15,780,1177,11,1188,0,1188,32,956,200,22.04.2019 00:15,208,23,Chernigov
848,835,41,336,473,39,512,0,512,6,424,82,22.04.2019 00:03,208,23,Chernigov
752,741,46,286,427,39,466,0,466,10,367,89,22.04.2019 00:30,208,23,Chernigov
864,856,50,373,450,41,491,0,491,12,382,97,22.04.2019 00:08,208,23,Chernigov
368,359,23,152,204,12,216,0,216,3,172,41,22.04.2019 00:30,208,23,Chernigov
608,591,56,207,349,52,401,0,401,4,312,85,22.04.2019 00:30,208,23,Chernigov
928,909,88,410,452,66,518,0,518,9,428,81,22.04.2019 00:10,208,23,Chernigov
320,313,31,50,245,25,270,0,270,3,216,51,22.04.2019 00:05,208,23,Chernigov
80,67,9,34,38,8,46,0,46,0,29,17,22.04.2019 00:05,208,23,Chernigov
800,766,3,353,444,3,447,0,447,9,376,62,22.04.2019 00:31,209,23,Chernigov
96,87,14,38,47,11,58,0,58,1,48,9,22.04.2019 00:05,209,23,Chernigov
112,107,11,29,72,11,83,0,83,6,54,23,21.04.2019 22:20,209,23,Chernigov
256,243,15,85,157,14,171,0,171,7,129,35,22.04.2019 00:04,209,23,Chernigov
512,515,30,108,374,30,404,0,404,5,281,118,22.04.2019 00:10,209,23,Chernigov
352,334,47,129,179,44,223,0,223,1,169,53,22.04.2019 00:05,209,23,Chernigov
480,469,5,193,282,5,287,0,287,4,241,42,22.04.2019 00:01,209,23,Chernigov
320,321,25,121,175,24,199,0,199,4,132,63,21.04.2019 21:00,209,23,Chernigov
576,559,40,261,280,35,315,0,315,3,242,70,22.04.2019 00:45,209,23,Chernigov
256,249,39,72,148,36,184,0,184,4,121,59,21.04.2019 23:55,209,23,Chernigov
2368,2340,11,1006,1358,4,1362,0,1362,35,1091,236,22.04.2019 00:01,209,23,Chernigov
1856,1832,18,757,1084,15,1099,0,1099,18,897,184,22.04.2019 00:45,209,23,Chernigov
1952,1914,18,858,1079,15,1094,0,1094,13,897,184,22.04.2019 00:05,209,23,Chernigov
480,37,25,450,12,18,30,0,30,0,25,5,22.04.2019 00:03,209,23,Chernigov
96,95,28,37,33,26,59,0,59,2,36,21,21.04.2019 20:45,210,23,Chernigov
416,407,43,115,259,42,301,0,301,9,210,82,21.04.2019 22:00,210,23,Chernigov
704,692,64,264,377,63,440,0,440,10,299,131,21.04.2019 20:55,210,23,Chernigov
496,480,45,220,238,38,276,0,276,4,214,58,22.04.2019 00:12,210,23,Chernigov
304,308,41,91,174,39,213,0,213,3,174,36,22.04.2019 00:01,210,23,Chernigov
480,454,24,172,290,18,308,0,308,6,246,56,22.04.2019 00:25,210,23,Chernigov
48,47,7,19,23,6,29,0,29,0,19,10,22.04.2019 00:05,210,23,Chernigov
608,591,53,257,302,49,351,0,351,8,273,70,21.04.2019 21:25,210,23,Chernigov
912,903,93,285,539,88,627,0,627,11,484,132,22.04.2019 00:15,210,23,Chernigov
176,168,18,74,88,14,102,0,102,0,87,15,21.04.2019 22:17,210,23,Chernigov
64,64,14,13,38,13,51,0,51,0,31,20,22.04.2019 00:15,210,23,Chernigov
368,365,55,172,155,41,196,0,196,3,142,51,22.04.2019 00:07,210,23,Chernigov
208,204,9,88,111,9,120,0,120,3,90,27,22.04.2019 00:05,210,23,Chernigov
112,100,16,43,54,15,69,0,69,1,50,18,21.04.2019 21:00,210,23,Chernigov
560,555,44,253,268,39,307,0,307,4,252,51,22.04.2019 00:30,210,23,Chernigov
96,93,5,37,54,5,59,0,59,1,45,13,22.04.2019 00:05,210,23,Chernigov
1344,1333,39,495,810,39,849,0,849,14,677,158,22.04.2019 00:10,210,23,Chernigov
1184,1165,21,448,720,16,736,0,736,23,580,133,22.04.2019 00:29,210,23,Chernigov
1232,1212,11,460,764,8,772,0,772,10,620,142,22.04.2019 00:20,210,23,Chernigov
1616,1613,23,558,1039,19,1058,0,1058,26,809,223,21.04.2019 22:36,210,23,Chernigov
1376,1355,21,503,858,15,873,0,873,25,692,156,22.04.2019 00:25,210,23,Chernigov
1232,1210,26,497,715,20,735,0,735,14,583,138,22.04.2019 00:05,210,23,Chernigov
2032,2005,37,749,1252,31,1283,0,1283,36,1001,246,22.04.2019 00:25,210,23,Chernigov
240,18,0,222,18,0,18,0,18,0,15,3,21.04.2019 20:20,210,23,Chernigov
2592,2583,7,812,1773,7,1780,0,1780,45,994,741,21.04.2019 22:00,211,24,Kiev (city)
1600,1659,0,597,1003,0,1003,0,1003,20,719,264,21.04.2019 22:30,211,24,Kiev (city)
1856,1869,9,706,1143,7,1150,0,1150,47,714,389,22.04.2019 00:10,211,24,Kiev (city)
2480,2524,10,804,1667,9,1676,0,1676,49,910,717,21.04.2019 23:15,211,24,Kiev (city)
1680,1691,7,631,1045,4,1049,0,1049,20,693,336,22.04.2019 00:02,211,24,Kiev (city)
2096,2200,5,651,1444,1,1445,0,1445,38,737,670,21.04.2019 22:35,211,24,Kiev (city)
1264,1249,9,441,820,3,823,0,823,25,464,334,22.04.2019 00:05,211,24,Kiev (city)
2112,2245,9,598,1508,6,1514,0,1513,48,902,563,22.04.2019 00:05,211,24,Kiev (city)
2096,2098,13,712,1376,8,1384,0,1384,32,845,507,21.04.2019 22:10,211,24,Kiev (city)
2016,1991,1,776,1239,1,1240,0,1240,47,759,434,22.04.2019 00:05,211,24,Kiev (city)
2064,2084,4,857,1203,4,1207,0,1207,40,824,343,21.04.2019 22:10,211,24,Kiev (city)
2336,2423,10,704,1624,8,1632,0,1632,40,929,663,21.04.2019 23:20,211,24,Kiev (city)
1920,1982,0,766,1154,0,1154,0,1154,42,778,334,21.04.2019 21:05,211,24,Kiev (city)
1904,1885,4,774,1126,4,1130,0,1130,24,744,362,21.04.2019 21:50,211,24,Kiev (city)
2016,1995,1,698,1317,1,1318,0,1318,34,819,465,21.04.2019 21:20,211,24,Kiev (city)
2016,2013,5,708,1304,4,1308,0,1308,35,817,456,21.04.2019 21:42,211,24,Kiev (city)
2048,2092,5,660,1385,3,1388,0,1388,35,807,546,22.04.2019 00:02,211,24,Kiev (city)
2240,2257,4,700,1536,4,1540,0,1540,62,830,648,21.04.2019 21:40,211,24,Kiev (city)
2272,2273,3,741,1528,3,1531,0,1531,59,795,677,22.04.2019 00:10,211,24,Kiev (city)
2192,2192,5,734,1455,3,1458,0,1458,44,906,508,21.04.2019 21:00,211,24,Kiev (city)
2128,2136,3,670,1456,2,1458,0,1458,42,908,508,22.04.2019 00:12,211,24,Kiev (city)
2208,2200,6,753,1450,5,1455,0,1455,39,881,535,22.04.2019 00:01,211,24,Kiev (city)
2144,2161,3,658,1484,2,1486,0,1486,58,871,557,22.04.2019 00:10,211,24,Kiev (city)
1728,1906,0,413,1315,0,1315,0,1315,35,683,597,21.04.2019 21:30,211,24,Kiev (city)
2144,2307,0,490,1654,0,1654,0,1654,30,899,725,21.04.2019 22:47,211,24,Kiev (city)
2240,2238,1,757,1482,1,1483,0,1483,40,896,547,21.04.2019 22:05,211,24,Kiev (city)
2352,2399,17,886,1459,7,1466,0,1466,41,913,512,22.04.2019 00:20,211,24,Kiev (city)
2080,2082,4,656,1421,3,1424,0,1424,57,869,498,21.04.2019 22:01,211,24,Kiev (city)
2016,2015,8,664,1346,6,1352,0,1352,39,844,469,21.04.2019 21:30,211,24,Kiev (city)
2112,2143,2,657,1453,2,1455,0,1455,43,816,596,22.04.2019 00:10,211,24,Kiev (city)
2000,2000,1,683,1316,1,1317,0,1317,41,806,469,22.04.2019 00:40,211,24,Kiev (city)
2224,2252,2,708,1514,2,1516,0,1516,54,840,622,22.04.2019 00:05,211,24,Kiev (city)
2480,2585,7,832,1644,4,1648,0,1648,49,981,618,21.04.2019 21:30,211,24,Kiev (city)
1824,1867,5,589,1230,5,1235,0,1235,34,768,433,21.04.2019 21:45,211,24,Kiev (city)
2384,2346,5,1148,1231,5,1236,0,1236,39,752,445,21.04.2019 21:20,211,24,Kiev (city)
2224,2265,8,747,1472,5,1477,0,1477,51,794,632,22.04.2019 00:03,211,24,Kiev (city)
2224,2399,3,359,1864,1,1865,0,1865,58,967,840,21.04.2019 22:45,211,24,Kiev (city)
1872,1884,4,605,1263,4,1267,0,1267,36,773,458,21.04.2019 21:30,211,24,Kiev (city)
2048,2096,12,685,1356,7,1363,0,1363,42,768,553,21.04.2019 22:00,211,24,Kiev (city)
2240,2309,8,904,1329,7,1336,0,1336,40,795,501,21.04.2019 21:47,211,24,Kiev (city)
2560,2558,8,909,1644,7,1651,0,1651,55,969,627,21.04.2019 23:30,211,24,Kiev (city)
2032,2113,11,503,1521,8,1529,0,1529,54,845,630,21.04.2019 21:42,211,24,Kiev (city)
2096,2162,5,613,1481,2,1483,0,1483,45,830,608,22.04.2019 00:10,211,24,Kiev (city)
2272,2378,9,700,1563,9,1572,0,1572,42,873,657,22.04.2019 00:15,211,24,Kiev (city)
1600,1651,6,453,1143,4,1147,0,1147,32,713,402,22.04.2019 00:00,211,24,Kiev (city)
1856,1885,3,581,1272,3,1275,0,1275,55,654,566,21.04.2019 22:20,211,24,Kiev (city)
2272,2324,5,832,1438,2,1440,0,1438,35,755,648,21.04.2019 21:50,211,24,Kiev (city)
1856,1882,10,612,1234,10,1244,0,1244,43,667,534,21.04.2019 21:58,211,24,Kiev (city)
1920,1952,5,675,1240,5,1245,0,1245,38,677,530,21.04.2019 22:30,211,24,Kiev (city)
1936,1967,5,687,1245,4,1249,0,1249,46,650,553,22.04.2019 00:10,211,24,Kiev (city)
2096,2163,15,680,1404,12,1416,0,1416,42,775,599,21.04.2019 23:00,211,24,Kiev (city)
1856,1924,5,551,1302,3,1305,0,1305,35,692,578,21.04.2019 23:05,211,24,Kiev (city)
576,139,70,460,58,58,116,0,116,4,63,49,21.04.2019 22:12,211,24,Kiev (city)
624,92,18,553,56,15,71,0,71,0,47,24,21.04.2019 21:20,211,24,Kiev (city)
368,65,25,303,40,25,65,0,65,1,44,20,21.04.2019 20:40,211,24,Kiev (city)
96,40,2,57,37,2,39,0,39,1,29,9,21.04.2019 20:20,211,24,Kiev (city)
2272,2378,0,529,1743,0,1743,0,1743,43,926,774,22.04.2019 00:10,211,24,Kiev (city)
1952,1948,7,692,1256,4,1260,0,1260,35,855,370,21.04.2019 22:00,212,24,Kiev (city)
2336,2460,4,530,1803,3,1806,0,1806,38,1034,734,21.04.2019 23:10,212,24,Kiev (city)
2368,1685,5,683,1681,4,1685,0,1685,37,999,649,21.04.2019 22:50,212,24,Kiev (city)
2144,2192,2,649,1493,2,1495,0,1495,27,901,567,21.04.2019 21:36,212,24,Kiev (city)
2256,2264,2,698,1556,2,1558,0,1558,41,926,591,22.04.2019 00:37,212,24,Kiev (city)
2304,2301,3,692,1610,2,1612,0,1612,49,1001,562,21.04.2019 23:10,212,24,Kiev (city)
2400,2451,5,683,1713,4,1717,0,1717,44,949,724,21.04.2019 22:10,212,24,Kiev (city)
1472,1481,7,404,1062,6,1068,0,1068,35,589,444,22.04.2019 00:03,212,24,Kiev (city)
1952,1964,15,586,1352,14,1366,0,1366,36,851,479,21.04.2019 22:37,212,24,Kiev (city)
2464,2455,8,731,1727,6,1733,0,1733,56,1026,651,21.04.2019 23:48,212,24,Kiev (city)
1328,1444,0,335,993,0,993,0,993,14,541,438,21.04.2019 20:45,212,24,Kiev (city)
2144,2256,8,479,1662,3,1665,0,1665,36,879,750,21.04.2019 22:30,212,24,Kiev (city)
1568,1602,7,403,1161,4,1165,0,1165,34,621,510,21.04.2019 22:40,212,24,Kiev (city)
2304,2337,4,656,1646,2,1648,0,1648,42,977,629,21.04.2019 21:03,212,24,Kiev (city)
2368,2414,6,712,1651,5,1656,0,1656,43,952,661,21.04.2019 23:03,212,24,Kiev (city)
2320,2332,3,713,1604,3,1607,0,1607,45,956,606,21.04.2019 22:44,212,24,Kiev (city)
2032,2049,5,613,1415,4,1419,0,1419,42,743,634,21.04.2019 22:15,212,24,Kiev (city)
1856,1839,4,586,1266,4,1270,0,1270,40,725,505,22.04.2019 00:15,212,24,Kiev (city)
2304,2304,9,743,1555,6,1561,0,1561,46,932,583,21.04.2019 21:25,212,24,Kiev (city)
2208,2208,8,688,1515,5,1520,0,1520,37,958,525,21.04.2019 22:00,212,24,Kiev (city)
2480,2499,1,700,1780,0,1780,0,1780,35,1032,713,22.04.2019 00:28,212,24,Kiev (city)
1456,1452,4,425,1029,2,1031,0,1031,37,606,388,21.04.2019 21:20,212,24,Kiev (city)
2160,2149,4,713,1443,4,1447,0,1447,36,879,532,21.04.2019 22:00,212,24,Kiev (city)
2208,2247,4,597,1607,4,1611,0,1611,47,912,652,21.04.2019 22:09,212,24,Kiev (city)
1792,1817,5,545,1244,3,1247,0,1247,33,678,536,21.04.2019 21:30,212,24,Kiev (city)
1968,1976,5,618,1346,4,1350,0,1350,50,721,579,21.04.2019 22:00,212,24,Kiev (city)
2368,2380,2,675,1692,1,1693,0,1693,53,981,659,21.04.2019 22:00,212,24,Kiev (city)
2384,2402,8,778,1600,6,1606,0,1606,49,950,607,21.04.2019 21:15,212,24,Kiev (city)
1488,1563,7,417,1066,5,1071,0,1071,27,696,348,22.04.2019 00:05,212,24,Kiev (city)
2288,2298,4,685,1600,3,1603,0,1603,37,1050,516,22.04.2019 00:00,212,24,Kiev (city)
2128,2116,5,715,1409,4,1413,0,1413,47,858,508,21.04.2019 22:10,212,24,Kiev (city)
2416,2481,4,653,1759,4,1763,0,1763,50,1074,639,22.04.2019 00:05,212,24,Kiev (city)
2336,2323,7,749,1582,5,1587,0,1587,49,1065,473,21.04.2019 21:30,212,24,Kiev (city)
2048,2047,10,655,1389,4,1393,0,1393,43,890,460,21.04.2019 20:25,212,24,Kiev (city)
1968,1971,2,587,1380,1,1381,0,1381,31,876,474,22.04.2019 00:05,212,24,Kiev (city)
1856,1853,4,610,1243,3,1246,0,1246,38,765,443,21.04.2019 22:52,212,24,Kiev (city)
2224,2207,6,792,1426,6,1432,0,1432,41,902,489,21.04.2019 22:19,212,24,Kiev (city)
2272,2265,7,770,1496,6,1502,0,1502,53,951,498,21.04.2019 21:00,212,24,Kiev (city)
2160,2140,7,713,1441,6,1447,0,1447,43,945,459,21.04.2019 20:56,212,24,Kiev (city)
2256,2247,22,701,1539,16,1555,0,1555,41,1008,506,21.04.2019 21:30,212,24,Kiev (city)
2240,2226,9,773,1459,8,1467,0,1467,55,924,488,21.04.2019 21:37,212,24,Kiev (city)
2288,2288,8,861,1420,7,1427,0,1427,44,923,460,22.04.2019 00:00,212,24,Kiev (city)
2384,2368,2,854,1530,0,1530,0,1530,32,1009,489,21.04.2019 22:30,212,24,Kiev (city)
2544,2528,2,1129,1414,1,1415,0,1415,42,956,417,21.04.2019 22:30,212,24,Kiev (city)
880,188,71,702,108,70,178,0,178,4,126,48,21.04.2019 20:50,212,24,Kiev (city)
192,22,0,170,22,0,22,0,22,0,16,6,21.04.2019 20:20,212,24,Kiev (city)
208,38,14,172,22,14,36,0,36,0,27,9,22.04.2019 00:15,212,24,Kiev (city)
2016,1989,4,585,1428,3,1431,0,1431,46,806,579,21.04.2019 21:23,212,24,Kiev (city)
2272,2318,1,692,1579,1,1580,0,1580,38,905,637,21.04.2019 22:21,212,24,Kiev (city)
1888,1954,2,478,1408,2,1410,0,1410,38,767,605,21.04.2019 22:00,212,24,Kiev (city)
1808,1852,2,488,1318,2,1320,0,1320,29,720,571,22.04.2019 00:05,212,24,Kiev (city)
2608,2699,3,747,1859,2,1861,0,1861,40,1102,719,22.04.2019 00:15,212,24,Kiev (city)
2096,2079,14,637,1450,9,1459,0,1459,48,866,545,21.04.2019 21:15,213,24,Kiev (city)
2256,2241,10,734,1513,9,1522,0,1522,39,929,554,21.04.2019 21:30,213,24,Kiev (city)
2304,2294,9,792,1507,5,1512,0,1512,39,944,529,21.04.2019 21:43,213,24,Kiev (city)
2240,2224,7,654,1581,5,1586,0,1586,35,1004,547,21.04.2019 21:30,213,24,Kiev (city)
2272,2269,16,825,1437,10,1447,0,1447,44,985,418,21.04.2019 21:30,213,24,Kiev (city)
1936,1929,7,670,1261,5,1266,0,1266,35,791,440,21.04.2019 21:07,213,24,Kiev (city)
2192,2179,2,722,1468,2,1470,0,1470,43,941,486,21.04.2019 21:16,213,24,Kiev (city)
2480,2419,6,1104,1371,5,1376,0,1376,28,958,390,21.04.2019 22:30,213,24,Kiev (city)
1936,1895,4,654,1278,4,1282,0,1282,27,829,426,21.04.2019 22:40,213,24,Kiev (city)
1808,1795,6,589,1215,4,1219,0,1219,40,788,391,21.04.2019 23:05,213,24,Kiev (city)
2208,2188,3,711,1495,2,1497,0,1497,30,943,524,21.04.2019 21:50,213,24,Kiev (city)
1984,1963,3,619,1364,1,1365,0,1365,30,849,486,22.04.2019 00:10,213,24,Kiev (city)
1744,1717,4,626,1116,2,1118,0,1118,21,733,364,21.04.2019 22:00,213,24,Kiev (city)
2176,2153,6,716,1455,5,1460,0,1460,30,915,515,21.04.2019 22:30,213,24,Kiev (city)
2400,2409,5,754,1642,4,1646,0,1646,49,1057,540,21.04.2019 22:05,213,24,Kiev (city)
1840,1810,0,597,1243,0,1243,0,1243,31,774,438,21.04.2019 21:06,213,24,Kiev (city)
1408,1386,13,491,905,12,917,0,917,27,631,259,21.04.2019 21:56,213,24,Kiev (city)
2080,2080,5,800,1276,4,1280,0,1280,32,830,418,21.04.2019 21:05,214,24,Kiev (city)
2368,2387,4,851,1515,2,1517,0,1517,49,911,557,22.04.2019 00:15,214,24,Kiev (city)
2368,2506,11,786,1574,8,1582,0,1582,33,1019,530,21.04.2019 21:59,214,24,Kiev (city)
2048,2112,4,553,1493,2,1495,0,1495,49,858,588,22.04.2019 00:50,214,24,Kiev (city)
2320,2343,8,670,1645,5,1650,0,1650,46,921,683,21.04.2019 20:45,214,24,Kiev (city)
2144,2178,10,615,1523,6,1529,0,1529,66,858,605,21.04.2019 22:20,214,24,Kiev (city)
1504,1504,0,489,1015,0,1015,0,1015,29,634,352,21.04.2019 22:05,214,24,Kiev (city)
2288,2329,9,709,1574,5,1579,0,1579,54,923,602,21.04.2019 21:56,214,24,Kiev (city)
2256,2303,2,790,1464,2,1466,0,1466,54,876,536,21.04.2019 21:48,214,24,Kiev (city)
2112,2128,14,688,1414,10,1424,0,1424,46,805,573,22.04.2019 00:10,214,24,Kiev (city)
2032,2062,7,768,1258,6,1264,0,1264,38,814,412,21.04.2019 22:37,214,24,Kiev (city)
2016,2031,8,712,1298,6,1304,0,1304,39,859,406,21.04.2019 21:05,214,24,Kiev (city)
2288,2289,8,905,1379,4,1383,0,1383,42,920,421,22.04.2019 00:01,214,24,Kiev (city)
1200,1189,0,275,925,0,925,0,925,12,439,474,21.04.2019 21:00,214,24,Kiev (city)
2064,2130,10,636,1420,8,1428,0,1428,44,767,617,21.04.2019 21:39,214,24,Kiev (city)
2272,2298,14,748,1517,7,1524,0,1524,53,890,581,21.04.2019 21:50,214,24,Kiev (city)
2064,2082,19,645,1408,11,1419,0,1419,65,792,562,21.04.2019 23:00,214,24,Kiev (city)
2288,2302,14,687,1590,11,1601,0,1601,54,908,639,22.04.2019 00:22,214,24,Kiev (city)
2032,2060,12,680,1345,7,1352,0,1352,40,774,538,22.04.2019 00:03,214,24,Kiev (city)
2272,2282,16,709,1551,12,1563,0,1563,44,907,612,21.04.2019 22:42,214,24,Kiev (city)
2128,2158,17,698,1420,10,1430,0,1430,49,817,564,21.04.2019 21:45,214,24,Kiev (city)
2352,2373,15,819,1520,13,1533,0,1533,54,910,569,21.04.2019 21:20,214,24,Kiev (city)
2208,2226,9,728,1471,9,1480,0,1480,37,889,554,21.04.2019 21:45,214,24,Kiev (city)
2144,2149,9,710,1428,6,1434,0,1434,47,898,489,22.04.2019 00:10,214,24,Kiev (city)
1600,1614,0,588,1012,0,1012,0,1012,27,585,400,21.04.2019 21:00,214,24,Kiev (city)
2192,2184,1,722,1469,1,1470,0,1470,55,952,463,22.04.2019 00:07,214,24,Kiev (city)
2048,2060,2,715,1331,2,1333,0,1333,47,835,451,21.04.2019 22:08,214,24,Kiev (city)
896,219,90,679,128,89,217,0,217,10,150,57,21.04.2019 20:51,214,24,Kiev (city)
320,61,47,259,14,47,61,0,61,0,46,15,21.04.2019 21:15,214,24,Kiev (city)
2176,2159,13,710,1458,8,1466,0,1466,43,946,477,21.04.2019 22:20,215,24,Kiev (city)
2256,2226,7,800,1450,6,1456,0,1456,42,951,463,21.04.2019 23:03,215,24,Kiev (city)
2016,2016,7,705,1307,4,1311,0,1311,40,832,439,21.04.2019 21:30,215,24,Kiev (city)
1984,1972,13,691,1282,11,1293,0,1293,34,775,484,21.04.2019 22:20,215,24,Kiev (city)
2176,2164,7,654,1516,6,1522,0,1522,42,940,540,21.04.2019 21:40,215,24,Kiev (city)
2368,2377,15,932,1428,8,1436,0,1436,34,953,449,21.04.2019 21:52,215,24,Kiev (city)
2352,2354,13,782,1565,5,1570,0,1570,31,951,588,21.04.2019 22:21,215,24,Kiev (city)
2288,2277,5,848,1436,4,1440,0,1440,41,986,413,21.04.2019 21:54,215,24,Kiev (city)
2272,2264,11,794,1470,8,1478,0,1478,51,920,507,21.04.2019 22:15,215,24,Kiev (city)
2256,2236,8,804,1445,7,1452,0,1452,38,946,468,21.04.2019 22:15,215,24,Kiev (city)
2192,2166,8,811,1375,6,1381,0,1381,52,890,439,21.04.2019 22:00,215,24,Kiev (city)
2032,2030,14,668,1353,11,1364,0,1364,27,876,461,21.04.2019 21:10,215,24,Kiev (city)
2224,2207,11,767,1448,9,1457,0,1457,41,968,448,21.04.2019 22:20,215,24,Kiev (city)
2112,2092,4,675,1433,4,1437,0,1437,33,913,491,21.04.2019 22:01,215,24,Kiev (city)
2128,2109,2,733,1393,2,1395,0,1395,41,882,472,21.04.2019 22:03,215,24,Kiev (city)
2208,2186,15,831,1366,11,1377,0,1377,41,850,486,21.04.2019 22:26,215,24,Kiev (city)
2144,2117,3,765,1376,3,1379,0,1379,35,834,510,21.04.2019 21:21,215,24,Kiev (city)
2144,2121,9,766,1370,8,1378,0,1378,55,940,383,21.04.2019 23:25,215,24,Kiev (city)
2400,2391,6,764,1632,4,1636,0,1636,46,987,603,21.04.2019 21:40,215,24,Kiev (city)
2272,2252,4,711,1558,3,1561,0,1561,48,997,516,21.04.2019 22:30,215,24,Kiev (city)
2112,2116,16,825,1279,8,1287,0,1287,48,820,419,21.04.2019 22:30,215,24,Kiev (city)
2176,2177,8,764,1405,7,1412,0,1412,47,930,435,22.04.2019 00:15,215,24,Kiev (city)
2240,2229,3,870,1367,3,1370,0,1370,36,1026,308,21.04.2019 22:00,215,24,Kiev (city)
1664,1665,15,622,1033,9,1042,0,1042,38,663,341,21.04.2019 21:45,215,24,Kiev (city)
1632,1623,11,561,1064,7,1071,0,1071,35,700,336,21.04.2019 21:45,215,24,Kiev (city)
2000,1990,16,666,1323,11,1334,0,1334,37,835,462,21.04.2019 22:15,215,24,Kiev (city)
2256,2252,24,869,1368,19,1387,0,1387,42,878,467,21.04.2019 22:10,215,24,Kiev (city)
2272,2270,14,876,1386,10,1396,0,1396,50,923,423,21.04.2019 21:55,215,24,Kiev (city)
1920,1926,23,699,1202,19,1221,0,1221,35,771,415,21.04.2019 22:18,215,24,Kiev (city)
2144,2129,16,783,1351,10,1361,0,1361,50,829,482,21.04.2019 22:40,215,24,Kiev (city)
2256,2252,34,786,1448,22,1470,0,1470,49,943,478,22.04.2019 00:15,215,24,Kiev (city)
2352,2341,18,889,1453,10,1463,0,1463,46,891,526,21.04.2019 21:30,215,24,Kiev (city)
2368,2360,20,816,1532,20,1552,0,1552,45,978,529,21.04.2019 22:00,215,24,Kiev (city)
2336,2333,23,870,1447,19,1466,0,1466,41,941,484,21.04.2019 22:30,215,24,Kiev (city)
2208,2189,24,775,1419,14,1433,0,1433,45,972,416,22.04.2019 00:10,215,24,Kiev (city)
240,229,147,46,86,108,194,0,194,9,147,38,21.04.2019 22:22,215,24,Kiev (city)
2224,2215,16,841,1370,13,1383,0,1383,37,920,426,21.04.2019 23:46,215,24,Kiev (city)
2160,2145,10,808,1347,5,1352,0,1352,60,872,420,21.04.2019 22:57,215,24,Kiev (city)
2256,2246,18,788,1454,14,1468,0,1468,52,943,473,21.04.2019 22:22,215,24,Kiev (city)
2288,2279,17,746,1530,12,1542,0,1542,40,1005,497,21.04.2019 22:00,215,24,Kiev (city)
1872,1850,20,650,1205,17,1222,0,1222,32,755,435,22.04.2019 00:20,215,24,Kiev (city)
2112,2100,8,800,1305,7,1312,0,1312,59,856,397,21.04.2019 22:10,215,24,Kiev (city)
1936,1912,8,714,1216,6,1222,0,1222,30,857,335,21.04.2019 20:45,215,24,Kiev (city)
2208,2198,17,859,1341,8,1349,0,1349,39,884,426,22.04.2019 00:05,215,24,Kiev (city)
2480,2497,24,808,1659,13,1672,0,1672,41,1104,527,21.04.2019 21:15,215,24,Kiev (city)
1600,1518,2,637,963,0,963,0,963,10,454,499,21.04.2019 20:53,215,24,Kiev (city)
736,230,172,566,48,122,170,0,170,10,111,49,21.04.2019 21:07,215,24,Kiev (city)
160,34,0,126,34,0,34,0,34,1,22,11,21.04.2019 20:45,215,24,Kiev (city)
288,83,0,205,83,0,83,0,83,2,59,22,21.04.2019 20:35,215,24,Kiev (city)
176,109,93,96,9,71,80,0,80,0,60,20,21.04.2019 21:08,215,24,Kiev (city)
2288,2270,11,782,1497,9,1506,0,1506,40,960,506,21.04.2019 21:20,215,24,Kiev (city)
2304,2300,10,813,1484,7,1491,0,1491,40,927,524,21.04.2019 22:05,215,24,Kiev (city)
2208,2189,8,794,1409,5,1414,0,1414,31,859,524,21.04.2019 22:40,215,24,Kiev (city)
2144,2140,9,758,1378,8,1386,0,1386,39,853,494,21.04.2019 21:53,215,24,Kiev (city)
2160,2141,9,717,1434,9,1443,0,1443,46,905,492,21.04.2019 23:20,215,24,Kiev (city)
2192,2201,7,807,1380,5,1385,0,1385,41,846,498,22.04.2019 00:20,215,24,Kiev (city)
2160,2174,11,752,1398,10,1408,0,1408,48,851,509,21.04.2019 22:00,215,24,Kiev (city)
2144,2135,6,655,1486,3,1489,0,1489,39,891,559,21.04.2019 22:45,215,24,Kiev (city)
2032,2057,11,801,1225,6,1231,0,1231,35,828,368,21.04.2019 22:19,215,24,Kiev (city)
2096,2086,8,720,1370,6,1376,0,1376,35,884,457,21.04.2019 23:11,215,24,Kiev (city)
2128,2095,6,754,1371,3,1374,0,1374,52,869,453,21.04.2019 22:17,215,24,Kiev (city)
1824,1802,9,666,1155,3,1158,0,1158,38,713,407,21.04.2019 22:20,215,24,Kiev (city)
1472,1473,4,485,983,4,987,0,987,27,674,286,21.04.2019 22:00,215,24,Kiev (city)
1472,905,3,567,903,2,905,0,905,27,629,249,22.04.2019 00:10,215,24,Kiev (city)
2304,2303,8,881,1419,4,1423,0,1423,40,899,484,21.04.2019 22:46,215,24,Kiev (city)
2224,2246,5,825,1395,4,1399,0,1399,28,916,455,22.04.2019 01:35,215,24,Kiev (city)
2368,2348,8,886,1474,8,1482,0,1482,39,1009,434,22.04.2019 00:10,215,24,Kiev (city)
2368,2353,5,828,1538,2,1540,0,1540,43,922,575,21.04.2019 23:05,215,24,Kiev (city)
1248,1224,11,474,764,10,774,0,774,19,517,238,21.04.2019 21:25,215,24,Kiev (city)
1392,1433,0,473,919,0,919,0,919,16,725,178,21.04.2019 22:05,215,24,Kiev (city)
272,95,0,186,86,0,86,0,86,1,65,20,21.04.2019 20:30,216,24,Kiev (city)
1200,1309,0,269,931,0,931,0,931,12,633,286,21.04.2019 22:00,216,24,Kiev (city)
2080,2059,8,775,1301,4,1305,0,1305,29,881,395,21.04.2019 22:00,216,24,Kiev (city)
2096,2071,5,871,1223,2,1225,0,1225,39,881,305,21.04.2019 21:30,216,24,Kiev (city)
2064,2065,6,728,1333,3,1336,0,1336,43,869,424,21.04.2019 22:15,216,24,Kiev (city)
2000,1979,15,676,1314,10,1324,0,1324,42,856,426,21.04.2019 20:55,216,24,Kiev (city)
816,804,0,341,475,0,475,0,475,11,349,115,21.04.2019 22:00,216,24,Kiev (city)
2304,2289,6,855,1445,4,1449,0,1449,34,1063,352,21.04.2019 21:16,216,24,Kiev (city)
2000,1978,4,711,1288,1,1289,0,1289,41,854,394,21.04.2019 21:10,216,24,Kiev (city)
2144,2250,8,713,1428,3,1431,0,1431,38,902,491,21.04.2019 22:00,216,24,Kiev (city)
2400,2381,3,896,1504,0,1504,0,1504,37,1003,464,21.04.2019 21:18,216,24,Kiev (city)
1584,1567,6,689,889,6,895,0,895,16,559,320,21.04.2019 21:10,216,24,Kiev (city)
2304,2277,9,861,1437,6,1443,0,1443,39,957,447,21.04.2019 22:30,216,24,Kiev (city)
1664,1608,5,1089,574,1,575,0,575,13,342,220,21.04.2019 22:15,216,24,Kiev (city)
2256,2233,14,836,1410,10,1420,0,1420,26,965,429,21.04.2019 21:10,216,24,Kiev (city)
2400,2365,3,1151,1247,2,1249,0,1249,22,908,319,21.04.2019 21:30,216,24,Kiev (city)
1680,1669,4,598,1080,2,1082,0,1082,20,676,386,21.04.2019 21:15,216,24,Kiev (city)
1440,1455,7,538,897,5,902,0,902,38,598,266,21.04.2019 21:45,216,24,Kiev (city)
2416,2432,6,1049,1365,2,1367,0,1367,27,869,471,22.04.2019 00:05,217,24,Kiev (city)
2112,2142,17,627,1472,13,1485,0,1485,46,790,649,21.04.2019 22:00,217,24,Kiev (city)
2096,2133,14,653,1436,7,1443,0,1443,46,838,559,21.04.2019 22:15,217,24,Kiev (city)
1856,1888,7,590,1261,5,1266,0,1266,41,727,498,21.04.2019 23:27,217,24,Kiev (city)
2112,2199,24,623,1471,18,1489,0,1489,47,867,575,22.04.2019 00:10,217,24,Kiev (city)
1824,1867,12,545,1270,9,1279,0,1279,57,726,496,21.04.2019 22:15,217,24,Kiev (city)
2080,2119,6,602,1476,2,1478,0,1478,45,861,572,21.04.2019 21:30,217,24,Kiev (city)
2000,2032,20,640,1346,14,1360,0,1360,36,797,527,21.04.2019 22:40,217,24,Kiev (city)
1936,1984,11,572,1358,6,1364,0,1364,40,812,512,21.04.2019 22:30,217,24,Kiev (city)
2176,2234,10,640,1533,3,1536,0,1536,45,894,597,21.04.2019 22:34,217,24,Kiev (city)
2256,2276,20,669,1575,12,1587,0,1587,53,904,630,21.04.2019 23:06,217,24,Kiev (city)
2238,2314,12,622,1611,5,1616,0,1616,58,932,626,21.04.2019 21:25,217,24,Kiev (city)
2208,2228,15,716,1482,10,1492,0,1492,48,895,549,21.04.2019 22:10,217,24,Kiev (city)
2032,2076,6,591,1436,5,1441,0,1441,53,813,575,21.04.2019 22:00,217,24,Kiev (city)
2128,2145,14,685,1433,10,1443,0,1443,49,827,567,21.04.2019 22:50,217,24,Kiev (city)
2128,2145,11,718,1402,8,1410,0,1410,39,863,508,22.04.2019 00:12,217,24,Kiev (city)
2192,2210,18,712,1465,15,1480,0,1480,44,897,539,21.04.2019 21:58,217,24,Kiev (city)
2096,2106,14,678,1409,9,1418,0,1418,49,803,566,21.04.2019 22:32,217,24,Kiev (city)
2304,2331,15,719,1575,10,1585,0,1585,38,918,629,22.04.2019 00:14,217,24,Kiev (city)
2000,2033,15,664,1324,12,1336,0,1336,38,784,514,22.04.2019 00:05,217,24,Kiev (city)
2144,2157,13,657,1477,10,1487,0,1487,46,881,560,22.04.2019 00:15,217,24,Kiev (city)
2048,2069,11,681,1361,6,1367,0,1367,45,844,478,21.04.2019 23:55,217,24,Kiev (city)
2208,2249,17,714,1481,13,1494,0,1494,53,894,547,21.04.2019 21:59,217,24,Kiev (city)
2112,2123,20,663,1437,12,1449,0,1449,49,899,501,21.04.2019 22:00,217,24,Kiev (city)
1984,1997,6,582,1398,4,1402,0,1402,38,864,500,21.04.2019 22:12,217,24,Kiev (city)
2112,2176,11,717,1389,6,1395,0,1395,45,826,524,22.04.2019 00:30,217,24,Kiev (city)
2000,2060,11,691,1304,5,1309,0,1309,45,801,463,21.04.2019 22:00,217,24,Kiev (city)
2000,2059,21,551,1432,17,1449,0,1449,41,841,567,22.04.2019 00:10,217,24,Kiev (city)
1824,1817,7,556,1261,7,1268,0,1268,26,754,488,21.04.2019 21:45,217,24,Kiev (city)
2384,2467,13,685,1692,7,1699,0,1699,51,989,659,22.04.2019 00:45,217,24,Kiev (city)
128,35,0,93,35,0,35,0,35,1,19,15,21.04.2019 20:35,217,24,Kiev (city)
96,18,0,78,18,0,18,0,18,2,10,6,21.04.2019 20:21,217,24,Kiev (city)
2144,2155,9,717,1418,9,1427,0,1427,52,829,546,22.04.2019 00:05,218,24,Kiev (city)
2144,2172,17,670,1461,13,1474,0,1474,31,982,461,22.04.2019 00:10,218,24,Kiev (city)
2208,2214,12,819,1379,10,1389,0,1389,41,839,509,21.04.2019 22:15,218,24,Kiev (city)
2080,2071,6,663,1414,3,1417,0,1417,49,878,490,21.04.2019 22:10,218,24,Kiev (city)
144,5,0,139,5,0,5,0,5,1,4,0,21.04.2019 20:39,218,24,Kiev (city)
288,59,19,232,37,19,56,0,56,3,40,13,21.04.2019 20:55,218,24,Kiev (city)
960,269,142,738,111,111,222,0,222,4,157,61,21.04.2019 22:00,218,24,Kiev (city)
2144,2164,7,678,1460,6,1466,0,1466,41,796,629,22.04.2019 00:10,218,24,Kiev (city)
2384,2378,21,800,1570,14,1584,0,1584,48,1015,521,21.04.2019 23:30,218,24,Kiev (city)
2272,2265,10,764,1500,8,1508,0,1508,61,910,537,21.04.2019 21:27,218,24,Kiev (city)
2016,2000,6,750,1263,3,1266,0,1266,26,769,471,21.04.2019 22:00,218,24,Kiev (city)
2176,2163,9,755,1414,7,1421,0,1421,48,806,567,22.04.2019 00:01,218,24,Kiev (city)
2160,2176,6,700,1455,5,1460,0,1460,46,840,574,22.04.2019 00:15,218,24,Kiev (city)
2128,2125,2,690,1437,1,1438,0,1438,39,861,538,21.04.2019 22:36,218,24,Kiev (city)
2224,2249,4,705,1518,1,1519,0,1519,32,893,594,22.04.2019 00:10,218,24,Kiev (city)
2016,2003,7,683,1327,6,1333,0,1333,28,819,486,21.04.2019 21:15,218,24,Kiev (city)
2192,2187,6,720,1466,6,1472,0,1472,32,899,541,22.04.2019 00:15,218,24,Kiev (city)
2144,2131,6,728,1411,5,1416,0,1416,47,866,503,21.04.2019 23:30,218,24,Kiev (city)
2192,2250,9,724,1464,4,1468,0,1468,44,857,567,21.04.2019 22:20,218,24,Kiev (city)
2320,2320,7,726,1590,4,1594,0,1594,45,871,678,21.04.2019 21:48,218,24,Kiev (city)
2240,2268,3,744,1493,3,1496,0,1496,61,740,695,22.04.2019 00:20,218,24,Kiev (city)
2112,2113,6,600,1506,6,1512,0,1512,60,821,631,21.04.2019 22:00,218,24,Kiev (city)
2256,2264,1,795,1460,1,1461,0,1461,37,936,488,21.04.2019 21:45,218,24,Kiev (city)
2208,2233,5,665,1540,3,1543,0,1543,50,877,616,21.04.2019 22:08,218,24,Kiev (city)
2080,2063,7,649,1429,2,1431,0,1431,41,731,659,21.04.2019 21:19,218,24,Kiev (city)
2240,2238,13,779,1452,9,1461,0,1461,45,777,639,22.04.2019 00:05,218,24,Kiev (city)
2352,2396,18,684,1653,15,1668,0,1668,49,910,709,21.04.2019 22:00,218,24,Kiev (city)
2288,2340,10,726,1556,6,1562,0,1562,50,881,631,21.04.2019 21:03,218,24,Kiev (city)
2224,2216,5,714,1507,3,1510,0,1510,45,847,618,22.04.2019 00:15,218,24,Kiev (city)
2304,2293,8,815,1481,8,1489,0,1489,59,872,558,22.04.2019 00:10,218,24,Kiev (city)
1344,1375,0,460,884,0,884,0,884,21,555,308,21.04.2019 21:25,218,24,Kiev (city)
64,52,2,19,45,0,45,0,45,7,23,15,21.04.2019 20:15,218,24,Kiev (city)
176,171,148,17,23,136,159,0,159,9,102,48,21.04.2019 21:20,218,24,Kiev (city)
2112,2122,4,615,1494,3,1497,0,1497,54,822,621,21.04.2019 22:55,218,24,Kiev (city)
2464,2445,13,895,1562,7,1569,0,1569,44,930,595,22.04.2019 00:07,219,24,Kiev (city)
2368,2374,9,706,1655,7,1662,0,1662,42,971,649,22.04.2019 00:15,219,24,Kiev (city)
2352,2326,8,600,1745,7,1752,0,1752,56,937,759,22.04.2019 00:15,219,24,Kiev (city)
2256,2265,13,811,1433,12,1445,0,1445,27,889,529,22.04.2019 00:19,219,24,Kiev (city)
2368,2346,5,784,1580,4,1584,0,1584,29,965,590,22.04.2019 00:10,219,24,Kiev (city)
1616,1602,1,491,1124,1,1125,0,1125,30,696,399,22.04.2019 00:20,219,24,Kiev (city)
2272,2251,17,751,1511,10,1521,0,1521,30,919,572,22.04.2019 00:14,219,24,Kiev (city)
1712,1714,10,563,1144,5,1149,0,1149,26,732,391,22.04.2019 00:07,219,24,Kiev (city)
1488,1469,3,496,990,2,992,0,992,24,612,356,22.04.2019 00:10,219,24,Kiev (city)
1776,1763,5,668,1105,3,1108,0,1108,26,672,410,22.04.2019 00:13,219,24,Kiev (city)
2160,2157,7,732,1425,3,1428,0,1428,35,872,521,22.04.2019 00:05,219,24,Kiev (city)
1856,1853,9,633,1220,3,1223,0,1223,38,733,452,22.04.2019 00:11,219,24,Kiev (city)
1840,1830,11,746,1089,5,1094,0,1094,36,711,347,22.04.2019 00:15,219,24,Kiev (city)
1920,1938,17,661,1247,12,1259,0,1259,38,808,413,22.04.2019 00:20,219,24,Kiev (city)
2176,2162,7,827,1343,6,1349,0,1349,45,890,414,22.04.2019 00:20,219,24,Kiev (city)
1904,1902,15,664,1231,9,1240,0,1240,41,788,411,21.04.2019 22:25,219,24,Kiev (city)
1504,1500,11,487,1010,7,1017,0,1017,33,616,368,22.04.2019 00:01,219,24,Kiev (city)
1856,1836,21,655,1185,16,1201,0,1201,29,745,427,22.04.2019 00:15,219,24,Kiev (city)
2048,2037,16,658,1383,7,1390,0,1390,35,865,490,22.04.2019 00:30,219,24,Kiev (city)
2096,2092,15,795,1293,8,1301,0,1301,38,854,409,22.04.2019 00:12,219,24,Kiev (city)
2063,2035,11,754,1305,4,1309,0,1309,27,841,441,22.04.2019 00:07,219,24,Kiev (city)
1936,1925,18,647,1279,10,1289,0,1289,29,820,440,22.04.2019 00:30,219,24,Kiev (city)
1904,1890,14,621,1272,11,1283,0,1283,38,774,471,22.04.2019 00:20,219,24,Kiev (city)
1744,1734,9,691,1045,8,1053,0,1053,23,695,335,22.04.2019 00:01,219,24,Kiev (city)
2032,2024,9,719,1309,4,1313,0,1313,45,791,477,22.04.2019 00:30,219,24,Kiev (city)
1472,1459,4,469,1000,3,1003,0,1003,28,597,378,22.04.2019 00:10,219,24,Kiev (city)
1344,1346,1,360,983,1,984,0,984,28,567,389,22.04.2019 00:15,219,24,Kiev (city)
2192,2206,14,757,1427,8,1435,0,1435,38,883,514,22.04.2019 00:05,219,24,Kiev (city)
2208,2205,17,733,1464,11,1475,0,1475,36,935,504,22.04.2019 00:23,219,24,Kiev (city)
2352,2340,3,700,1650,2,1652,0,1652,41,912,699,22.04.2019 00:10,219,24,Kiev (city)
2224,2214,11,841,1378,5,1383,0,1383,46,803,534,22.04.2019 00:05,219,24,Kiev (city)
1872,1898,7,625,1241,6,1247,0,1247,38,774,435,22.04.2019 00:15,219,24,Kiev (city)
1712,1692,8,630,1075,7,1082,0,1082,30,706,346,21.04.2019 21:15,219,24,Kiev (city)
1840,1823,20,648,1177,15,1192,0,1192,36,736,420,22.04.2019 00:02,219,24,Kiev (city)
1984,1970,13,698,1278,8,1286,0,1286,27,786,473,22.04.2019 00:15,219,24,Kiev (city)
1712,1717,6,583,1125,4,1129,0,1129,45,719,365,22.04.2019 00:20,219,24,Kiev (city)
2176,2177,10,736,1432,8,1440,0,1440,50,879,511,22.04.2019 00:10,219,24,Kiev (city)
2240,2250,10,811,1425,4,1429,0,1429,34,932,463,22.04.2019 00:15,219,24,Kiev (city)
2272,2268,8,785,1483,4,1487,0,1487,38,910,539,22.04.2019 00:10,219,24,Kiev (city)
2096,2087,3,662,1431,3,1434,0,1434,55,905,474,22.04.2019 00:35,219,24,Kiev (city)
1920,1899,7,664,1251,5,1256,0,1256,29,818,409,22.04.2019 00:30,219,24,Kiev (city)
2032,2038,21,679,1340,13,1353,0,1353,32,829,492,22.04.2019 00:30,219,24,Kiev (city)
1872,1856,13,718,1146,8,1154,0,1154,41,748,365,22.04.2019 00:10,219,24,Kiev (city)
1776,1765,17,619,1145,12,1157,0,1157,24,735,398,22.04.2019 00:05,219,24,Kiev (city)
1872,1878,7,652,1216,4,1220,0,1220,44,742,434,22.04.2019 00:05,219,24,Kiev (city)
2096,2108,21,713,1364,19,1383,0,1383,48,889,446,22.04.2019 00:10,219,24,Kiev (city)
1936,1913,8,758,1171,7,1178,0,1171,20,750,401,22.04.2019 00:05,219,24,Kiev (city)
2256,2235,4,821,1432,3,1435,0,1435,32,910,493,22.04.2019 00:05,219,24,Kiev (city)
2192,2187,8,679,1510,3,1513,0,1513,47,848,618,22.04.2019 00:05,219,24,Kiev (city)
2368,2335,4,792,1575,1,1576,0,1576,38,964,574,22.04.2019 00:10,219,24,Kiev (city)
2320,2368,4,631,1686,3,1689,0,1689,52,857,780,22.04.2019 00:15,219,24,Kiev (city)
2304,2378,8,695,1604,5,1609,0,1609,37,913,659,22.04.2019 00:05,219,24,Kiev (city)
2320,2361,9,695,1617,8,1625,0,1625,51,995,579,21.04.2019 21:30,219,24,Kiev (city)
2192,2250,1,627,1565,0,1565,0,1565,44,942,579,22.04.2019 00:05,219,24,Kiev (city)
2256,2283,6,770,1483,3,1486,0,1486,45,835,606,22.04.2019 00:25,219,24,Kiev (city)
2368,2477,27,624,1726,18,1744,0,1744,54,975,715,21.04.2019 23:35,219,24,Kiev (city)
2224,2241,8,836,1381,7,1388,0,1388,43,862,483,21.04.2019 22:00,219,24,Kiev (city)
2128,2156,6,631,1491,6,1497,0,1497,40,825,632,22.04.2019 00:30,219,24,Kiev (city)
1744,1998,6,516,1222,6,1228,0,1228,41,784,403,22.04.2019 00:05,219,24,Kiev (city)
1840,1879,4,622,1215,3,1218,0,1218,35,678,505,22.04.2019 00:20,219,24,Kiev (city)
1952,1937,10,666,1276,10,1286,0,1286,26,751,509,22.04.2019 00:30,219,24,Kiev (city)
2112,2132,5,759,1350,3,1353,0,1353,38,821,494,22.04.2019 00:05,219,24,Kiev (city)
1008,997,3,343,662,3,665,0,665,21,390,254,22.04.2019 00:12,219,24,Kiev (city)
416,143,41,292,90,34,124,0,124,12,75,37,22.04.2019 00:30,219,24,Kiev (city)
240,24,0,221,19,0,19,0,19,0,17,2,21.04.2019 20:40,219,24,Kiev (city)
288,103,45,197,59,32,91,0,91,5,64,22,22.04.2019 00:20,219,24,Kiev (city)
560,91,14,476,72,12,84,0,84,2,59,23,22.04.2019 00:05,219,24,Kiev (city)
352,94,4,273,76,3,79,0,79,1,50,28,22.04.2019 00:05,219,24,Kiev (city)
560,549,0,173,387,0,387,0,387,9,212,166,21.04.2019 21:31,219,24,Kiev (city)
144,26,5,118,21,5,26,0,26,0,18,8,22.04.2019 00:02,220,24,Kiev (city)
1328,222,29,1117,182,29,211,0,211,17,138,56,22.04.2019 00:10,220,24,Kiev (city)
240,35,24,208,10,22,32,0,32,1,23,8,22.04.2019 00:10,220,24,Kiev (city)
208,46,0,164,44,0,44,0,44,1,27,16,21.04.2019 20:44,220,24,Kiev (city)
64,24,1,41,22,1,23,0,23,1,15,7,22.04.2019 00:02,220,24,Kiev (city)
32,13,0,19,13,0,13,0,13,0,9,4,21.04.2019 20:40,221,24,Kiev (city)
2416,2466,3,835,1578,3,1581,0,1580,52,901,627,21.04.2019 22:12,221,24,Kiev (city)
2416,2454,10,801,1608,7,1615,0,1615,39,888,688,21.04.2019 22:00,221,24,Kiev (city)
2240,2270,5,940,1295,5,1300,0,1300,34,825,441,21.04.2019 22:20,221,24,Kiev (city)
2400,2448,21,760,1624,16,1640,0,1640,66,877,697,21.04.2019 23:00,221,24,Kiev (city)
2160,2298,15,699,1448,13,1461,0,1461,34,818,609,21.04.2019 21:55,221,24,Kiev (city)
224,60,9,168,47,9,56,0,56,2,34,20,21.04.2019 20:45,221,24,Kiev (city)
176,53,0,123,53,0,53,0,53,0,41,12,21.04.2019 20:30,221,24,Kiev (city)
640,117,69,529,47,64,111,0,111,4,76,31,21.04.2019 20:45,221,24,Kiev (city)
144,31,0,113,31,0,31,0,31,0,24,7,21.04.2019 20:35,221,24,Kiev (city)
224,105,0,121,103,0,103,0,103,1,75,27,21.04.2019 20:40,221,24,Kiev (city)
1376,1393,18,417,944,15,959,0,959,33,575,351,22.04.2019 00:15,221,24,Kiev (city)
384,102,19,304,61,19,80,0,80,3,61,16,21.04.2019 21:01,221,24,Kiev (city)
144,55,0,101,43,0,43,0,43,1,33,9,21.04.2019 20:30,221,24,Kiev (city)
224,86,0,150,74,0,74,0,74,1,53,20,21.04.2019 20:45,221,24,Kiev (city)
352,76,31,278,45,29,74,0,74,3,53,18,21.04.2019 21:00,221,24,Kiev (city)
336,76,0,263,73,0,73,0,73,2,55,16,21.04.2019 21:30,221,24,Kiev (city)
144,34,10,116,21,7,28,0,28,0,20,8,21.04.2019 20:31,221,24,Kiev (city)
2160,2119,7,830,1326,4,1330,0,1330,34,646,650,21.04.2019 23:00,221,24,Kiev (city)
96,28,0,74,22,0,22,0,22,0,14,8,21.04.2019 20:45,221,24,Kiev (city)
2096,2103,0,918,1178,0,1178,0,1178,23,813,342,22.04.2019 00:10,221,24,Kiev (city)
2416,2428,8,826,1586,4,1590,0,1590,39,963,588,21.04.2019 21:45,222,24,Kiev (city)
1728,1738,10,560,1163,5,1168,0,1168,28,696,444,21.04.2019 21:54,222,24,Kiev (city)
1840,1816,0,740,1100,0,1100,0,1100,40,800,260,21.04.2019 22:18,222,24,Kiev (city)
1632,1611,0,567,1065,0,1065,0,1065,33,695,337,21.04.2019 22:17,222,24,Kiev (city)
2464,2482,9,798,1659,7,1666,0,1666,60,921,685,21.04.2019 21:15,222,24,Kiev (city)
1968,1960,0,649,1319,0,1319,0,1319,49,860,410,21.04.2019 21:13,222,24,Kiev (city)
1760,1746,0,645,1115,0,1115,0,1115,41,753,321,21.04.2019 21:00,222,24,Kiev (city)
1664,1687,9,532,1125,7,1132,0,1132,40,640,452,21.04.2019 21:09,222,24,Kiev (city)
2096,2135,18,623,1455,18,1473,0,1473,56,845,572,22.04.2019 00:01,222,24,Kiev (city)
2304,2318,2,753,1549,2,1551,0,1551,58,862,631,21.04.2019 21:50,222,24,Kiev (city)
2144,2015,5,823,1318,3,1321,0,1321,25,933,363,21.04.2019 21:30,222,24,Kiev (city)
2064,2041,0,898,1166,0,1166,0,1166,19,769,378,21.04.2019 22:15,222,24,Kiev (city)
2432,2482,12,683,1739,10,1749,0,1749,49,1001,699,21.04.2019 22:05,222,24,Kiev (city)
2224,2207,12,839,1378,7,1385,0,1385,40,810,535,21.04.2019 21:40,222,24,Kiev (city)
1632,1628,15,604,1018,10,1028,0,1028,48,567,413,21.04.2019 22:30,222,24,Kiev (city)
2032,2028,21,720,1293,19,1312,0,1312,24,752,536,21.04.2019 22:01,222,24,Kiev (city)
1648,1627,6,570,1076,2,1078,0,1078,30,678,370,21.04.2019 21:28,222,24,Kiev (city)
1856,1839,6,709,1143,4,1147,0,1147,36,719,392,21.04.2019 21:46,222,24,Kiev (city)
2160,2147,34,778,1353,29,1382,0,1380,29,894,457,21.04.2019 21:37,222,24,Kiev (city)
2112,2103,23,782,1309,21,1330,0,1330,41,856,433,21.04.2019 21:05,222,24,Kiev (city)
1328,1318,7,441,881,6,887,0,887,28,505,354,21.04.2019 21:33,222,24,Kiev (city)
1776,1724,16,671,1092,13,1105,0,1105,33,681,391,21.04.2019 21:49,222,24,Kiev (city)
1520,1520,0,664,856,0,856,0,856,25,601,230,21.04.2019 21:47,222,24,Kiev (city)
2144,2125,1,835,1308,1,1309,0,1309,20,820,469,21.04.2019 21:57,222,24,Kiev (city)
2464,2502,12,843,1610,11,1621,0,1621,44,939,638,21.04.2019 21:43,222,24,Kiev (city)
2016,2002,6,681,1329,6,1335,0,1335,33,759,543,21.04.2019 21:35,222,24,Kiev (city)
2320,2314,9,738,1577,5,1582,0,1582,40,921,621,21.04.2019 22:15,222,24,Kiev (city)
512,124,123,388,1,123,124,0,124,4,76,44,21.04.2019 22:30,222,24,Kiev (city)
64,74,0,15,49,0,49,0,49,0,40,9,21.04.2019 21:00,223,24,Kiev (city)
1344,1346,7,490,848,6,854,0,854,40,415,399,22.04.2019 00:15,223,24,Kiev (city)
1072,1094,5,327,741,4,745,0,745,27,397,321,22.04.2019 00:30,223,24,Kiev (city)
1488,1480,8,604,878,6,884,0,884,32,447,405,22.04.2019 00:23,223,24,Kiev (city)
784,781,8,261,518,5,523,0,523,20,267,236,22.04.2019 00:35,223,24,Kiev (city)
1056,1087,9,362,691,3,694,0,694,25,343,326,22.04.2019 00:30,223,24,Kiev (city)
1072,1071,3,319,751,2,753,0,753,35,365,353,22.04.2019 00:03,223,24,Kiev (city)
816,812,5,306,505,5,510,0,510,13,265,232,21.04.2019 20:51,223,24,Kiev (city)
1232,1220,7,416,809,7,816,0,816,21,402,393,22.04.2019 00:10,223,24,Kiev (city)
1616,1618,13,574,1037,5,1042,0,1042,50,508,484,22.04.2019 00:10,223,24,Kiev (city)
2080,2094,13,792,1278,10,1288,0,1288,48,629,611,22.04.2019 00:02,223,24,Kiev (city)
1712,1715,11,505,1203,4,1207,0,1207,45,626,536,22.04.2019 01:15,223,24,Kiev (city)
2000,2007,8,711,1284,5,1289,0,1289,34,708,547,22.04.2019 00:05,223,24,Kiev (city)
2480,2495,12,813,1657,10,1667,0,1667,53,881,733,22.04.2019 00:15,223,24,Kiev (city)
1344,1329,4,501,841,2,843,0,843,29,427,387,21.04.2019 22:30,223,24,Kiev (city)
1360,1368,6,511,844,5,849,0,849,22,446,381,22.04.2019 00:08,223,24,Kiev (city)
2400,2384,14,876,1516,8,1524,0,1524,46,869,609,21.04.2019 23:49,223,24,Kiev (city)
2240,2246,13,754,1476,10,1486,0,1486,48,788,650,22.04.2019 00:30,223,24,Kiev (city)
2320,2317,10,710,1600,10,1610,0,1610,45,846,719,22.04.2019 00:30,223,24,Kiev (city)
2432,2414,9,869,1554,9,1563,0,1563,40,859,664,22.04.2019 00:35,223,24,Kiev (city)
2336,2259,4,930,1403,3,1406,0,1406,31,811,564,21.04.2019 21:47,223,24,Kiev (city)
2480,2494,18,865,1601,14,1615,0,1615,66,854,695,22.04.2019 00:15,223,24,Kiev (city)
2384,2352,8,882,1497,5,1502,0,1502,38,881,583,22.04.2019 00:45,223,24,Kiev (city)
2224,2219,10,700,1519,5,1524,0,1524,61,830,633,22.04.2019 00:05,223,24,Kiev (city)
2416,2428,15,826,1580,10,1590,0,1590,46,850,694,22.04.2019 00:18,223,24,Kiev (city)
2192,2202,18,728,1451,13,1464,0,1464,53,764,647,22.04.2019 00:23,223,24,Kiev (city)
2080,2120,17,624,1445,11,1456,0,1456,65,821,570,22.04.2019 00:22,223,24,Kiev (city)
2192,2198,9,720,1464,8,1472,0,1472,58,833,581,21.04.2019 23:10,223,24,Kiev (city)
2064,1943,1,776,1287,1,1288,0,1288,32,810,446,22.04.2019 00:07,223,24,Kiev (city)
2112,2120,8,882,1226,4,1230,0,1230,29,752,449,22.04.2019 01:05,223,24,Kiev (city)
2208,2209,7,779,1423,6,1429,0,1429,32,709,688,22.04.2019 00:05,223,24,Kiev (city)
2464,2488,16,821,1629,14,1643,0,1643,71,930,642,21.04.2019 22:44,223,24,Kiev (city)
2288,2319,15,759,1520,9,1529,0,1529,45,832,652,22.04.2019 00:25,223,24,Kiev (city)
2416,2416,10,861,1548,7,1555,0,1555,42,916,597,22.04.2019 00:05,223,24,Kiev (city)
2288,2279,16,871,1409,8,1417,0,1417,40,824,553,21.04.2019 21:04,223,24,Kiev (city)
2336,2326,14,900,1426,10,1436,0,1436,42,833,561,22.04.2019 00:05,223,24,Kiev (city)
1520,1533,3,569,949,2,951,0,951,31,582,338,22.04.2019 00:05,223,24,Kiev (city)
2000,2001,3,836,1162,2,1164,0,1164,38,674,452,22.04.2019 00:35,223,24,Kiev (city)
1728,1717,11,623,1098,7,1105,0,1105,36,657,412,22.04.2019 00:25,223,24,Kiev (city)
1616,1610,8,602,1009,5,1014,0,1014,27,585,402,22.04.2019 00:06,223,24,Kiev (city)
1984,2024,7,642,1338,4,1342,0,1342,36,742,564,22.04.2019 00:15,223,24,Kiev (city)
1824,1835,7,699,1120,5,1125,0,1125,30,633,462,21.04.2019 21:40,223,24,Kiev (city)
1568,1555,10,587,974,7,981,0,981,26,561,394,22.04.2019 00:20,223,24,Kiev (city)
1440,1438,12,502,931,7,938,0,938,18,527,393,21.04.2019 22:00,223,24,Kiev (city)
2064,2054,9,778,1283,3,1286,0,1286,14,764,508,22.04.2019 00:21,223,24,Kiev (city)
2400,2389,8,931,1462,7,1469,0,1469,41,897,531,22.04.2019 00:07,223,24,Kiev (city)
2432,2460,8,793,1633,6,1639,0,1639,45,838,755,21.04.2019 22:38,223,24,Kiev (city)
2384,2379,3,950,1434,0,1434,0,1434,62,803,569,22.04.2019 00:05,223,24,Kiev (city)
1760,1781,0,777,983,0,983,0,983,27,566,390,22.04.2019 00:20,223,24,Kiev (city)
2368,2402,0,975,1393,0,1393,0,1393,30,767,596,21.04.2019 21:35,223,24,Kiev (city)
2384,2381,8,945,1433,6,1439,0,1439,35,817,587,22.04.2019 00:02,223,24,Kiev (city)
2080,2106,8,707,1368,5,1373,0,1373,37,709,627,22.04.2019 00:03,223,24,Kiev (city)
2352,2354,9,788,1558,6,1564,0,1564,53,818,693,22.04.2019 00:16,223,24,Kiev (city)
2224,2228,7,780,1439,5,1444,0,1444,38,886,520,22.04.2019 00:10,223,24,Kiev (city)
2320,1554,66,766,1550,4,1554,0,1554,44,948,562,21.04.2019 22:10,223,24,Kiev (city)
2288,2291,12,835,1444,9,1453,0,1453,58,812,583,21.04.2019 22:00,223,24,Kiev (city)
2240,2248,1,835,1404,1,1405,0,1405,28,860,517,22.04.2019 00:12,223,24,Kiev (city)
1696,1697,3,597,1096,3,1099,0,1099,28,698,373,22.04.2019 00:10,223,24,Kiev (city)
1280,1256,2,523,755,2,757,0,757,23,441,293,22.04.2019 00:10,223,24,Kiev (city)
1872,1902,6,652,1217,3,1220,0,1220,33,695,492,22.04.2019 00:22,223,24,Kiev (city)
2208,2235,9,808,1398,2,1400,0,1400,34,844,522,22.04.2019 00:26,223,24,Kiev (city)
2128,2098,11,808,1313,7,1320,0,1320,39,821,460,22.04.2019 00:20,223,24,Kiev (city)
1872,1900,7,666,1201,5,1206,0,1206,34,761,411,22.04.2019 00:40,223,24,Kiev (city)
2192,2189,4,837,1353,2,1355,0,1355,37,807,511,22.04.2019 00:25,223,24,Kiev (city)
2336,2339,8,747,1584,5,1589,0,1589,41,956,592,22.04.2019 00:10,223,24,Kiev (city)
2368,2402,7,884,1479,5,1484,0,1484,41,924,519,22.04.2019 01:00,223,24,Kiev (city)
2464,2528,3,972,1490,2,1492,0,1492,31,994,467,22.04.2019 00:15,223,24,Kiev (city)
1824,1841,9,768,1051,5,1056,0,1056,34,672,350,22.04.2019 00:03,223,24,Kiev (city)
2432,2515,9,734,1692,6,1698,0,1698,55,974,669,22.04.2019 00:15,223,24,Kiev (city)
112,41,0,71,41,0,41,0,41,2,21,18,21.04.2019 20:30,223,24,Kiev (city)
448,168,20,282,147,19,166,0,166,7,109,50,21.04.2019 21:00,223,24,Kiev (city)
0,12,0,1,12,0,12,0,12,0,4,8,21.04.2019 08:45,223,24,Kiev (city)
224,61,1,163,60,1,61,0,61,4,42,15,22.04.2019 01:05,223,24,Kiev (city)
224,57,2,171,51,2,53,0,53,0,40,13,22.04.2019 00:20,223,24,Kiev (city)
224,98,4,129,91,4,95,0,95,5,64,26,21.04.2019 22:50,223,24,Kiev (city)
256,61,26,199,32,25,57,0,57,0,42,15,21.04.2019 20:45,223,24,Kiev (city)
448,120,67,352,40,56,96,0,96,5,65,26,21.04.2019 21:01,223,24,Kiev (city)
640,118,0,544,96,0,96,0,96,3,82,11,21.04.2019 22:00,223,24,Kiev (city)
384,177,47,287,73,24,97,0,97,0,77,20,21.04.2019 20:31,223,24,Kiev (city)
256,40,25,217,15,24,39,0,39,1,28,10,21.04.2019 20:20,223,24,Kiev (city)
528,103,81,430,21,77,98,0,98,3,76,19,21.04.2019 21:00,223,24,Kiev (city)
656,254,150,504,61,91,152,0,152,5,107,40,22.04.2019 01:05,223,24,Kiev (city)
288,32,0,257,31,0,31,0,31,0,23,8,21.04.2019 20:25,223,24,Kiev (city)
592,192,23,410,160,22,182,0,182,10,132,40,22.04.2019 00:15,223,24,Kiev (city)
640,236,21,415,204,21,225,0,225,3,161,61,21.04.2019 21:00,223,24,Kiev (city)
1744,1744,,1645,99,0,99,0,99,1,26,72,21.04.2019 21:30,226,-1,
2384,2761,0,1284,1100,0,1100,0,1100,21,349,730,21.04.2019 22:07,226,-1,
304,363,0,71,233,0,233,0,233,0,120,113,21.04.2019 20:48,226,-1,
304,291,0,241,63,0,63,0,63,1,31,31,21.04.2019 20:25,226,-1,
2272,2356,0,1582,690,0,690,0,690,11,242,437,21.04.2019 21:00,226,-1,
7216,7315,0,6394,822,0,822,0,822,11,529,282,22.04.2019 00:05,226,-1,
4992,4970,0,4694,298,0,298,0,298,1,238,59,21.04.2019 21:15,226,-1,
2880,2920,0,2655,225,0,225,0,225,4,91,130,21.04.2019 20:45,226,-1,
192,204,0,119,73,0,73,0,73,0,15,58,21.04.2019 20:10,226,-1,
2592,2847,0,1251,1341,0,1341,0,1340,23,373,944,21.04.2019 23:27,226,-1,
160,168,0,88,72,0,72,0,72,2,28,42,21.04.2019 20:17,226,-1,
416,412,0,280,136,0,136,0,136,4,92,40,21.04.2019 20:34,226,-1,
2640,2780,0,1528,1112,0,1112,0,1112,29,415,668,21.04.2019 22:35,226,-1,
944,957,0,799,145,0,145,0,145,4,72,69,21.04.2019 20:45,226,-1,
8433,8593,0,8044,389,0,389,0,389,7,196,186,21.04.2019 21:57,226,-1,
2768,2900,0,2297,471,0,471,0,471,5,165,301,21.04.2019 21:20,226,-1,
4528,4574,0,3390,1138,0,1138,0,1137,17,822,298,22.04.2019 00:10,226,-1,
160,181,0,74,86,0,86,0,86,2,33,51,21.04.2019 20:34,226,-1,
14016,14340,0,13370,646,0,646,0,646,5,315,326,21.04.2019 22:59,226,-1,
160,168,0,91,69,0,69,0,69,0,27,42,21.04.2019 20:32,226,-1,
240,228,0,176,64,0,64,0,64,1,31,32,21.04.2019 20:14,226,-1,
704,766,0,343,361,0,361,0,361,5,100,256,21.04.2019 21:50,226,-1,
4576,5043,0,2367,2209,0,2209,0,2209,53,930,1226,21.04.2019 23:36,226,-1,
5280,5813,0,3772,1508,0,1508,0,1508,22,580,906,21.04.2019 21:20,226,-1,
2672,2907,0,1576,1096,0,1096,0,1096,23,509,564,21.04.2019 21:40,226,-1,
7936,8129,0,5753,2183,0,2183,0,2183,27,550,1606,21.04.2019 22:22,226,-1,
5360,5887,0,3673,1687,0,1687,0,1687,40,756,891,21.04.2019 22:40,226,-1,
5568,5683,0,4117,1451,0,1451,0,1451,34,643,774,22.04.2019 00:15,226,-1,
656,688,0,455,201,0,201,0,201,2,126,73,21.04.2019 20:31,226,-1,
4192,4109,0,4017,175,0,175,0,175,2,87,86,21.04.2019 21:07,226,-1,
144,140,0,92,52,0,52,0,52,0,37,15,21.04.2019 20:30,226,-1,
352,418,0,76,276,0,276,0,276,2,142,132,21.04.2019 20:50,226,-1,
448,504,0,155,293,0,293,0,293,4,124,165,21.04.2019 20:50,226,-1,
528,681,0,137,391,0,391,0,391,7,139,245,21.04.2019 21:02,226,-1,
224,231,0,114,110,0,110,0,110,1,47,62,21.04.2019 21:09,226,-1,
208,211,0,116,92,0,92,0,92,0,46,46,21.04.2019 20:20,226,-1,
2240,2387,0,1517,723,0,723,0,723,10,445,268,21.04.2019 21:05,226,-1,
3008,3104,0,2531,477,0,477,0,477,10,252,215,21.04.2019 21:33,226,-1,
1376,1435,0,1109,267,0,267,0,267,4,127,136,22.04.2019 00:10,226,-1,
80,71,0,34,46,0,46,0,46,0,22,24,21.04.2019 20:12,226,-1,
128,125,0,17,111,0,111,0,111,0,32,79,21.04.2019 20:20,226,-1,
592,586,0,442,150,0,150,0,150,0,92,58,21.04.2019 21:00,226,-1,
52320,52035,0,51891,429,0,429,0,429,10,291,128,21.04.2019 22:50,226,-1,
13600,13536,0,13419,181,0,181,0,181,4,144,33,22.04.2019 00:30,226,-1,
1584,1943,0,678,906,0,906,0,906,8,222,676,21.04.2019 23:45,226,-1,
16752,17030,0,15083,1669,0,1669,0,1669,19,696,954,22.04.2019 00:12,226,-1,
14224,14279,0,13306,918,0,918,0,918,16,396,506,21.04.2019 21:25,226,-1,
25968,26191,0,24143,1825,0,1825,0,1825,26,701,1098,22.04.2019 00:15,226,-1,
13360,13413,0,12337,1023,0,1023,0,1023,13,434,576,21.04.2019 22:03,226,-1,
496,544,0,293,203,0,203,0,203,0,62,141,21.04.2019 21:26,226,-1,
288,351,0,107,181,0,181,0,181,3,72,106,21.04.2019 20:40,226,-1,
352,351,0,281,71,0,71,0,71,0,29,42,21.04.2019 20:05,226,-1,
16960,18057,0,12743,4217,0,4217,0,4217,55,2141,2021,21.04.2019 23:30,226,-1,
4192,4781,0,2939,1253,0,1253,0,1253,15,781,457,21.04.2019 22:20,226,-1,
10144,10977,0,8206,1938,0,1938,0,1937,22,840,1075,22.04.2019 00:10,226,-1,
3712,3830,0,3239,473,0,473,0,473,6,230,237,22.04.2019 00:10,226,-1,
2560,2805,0,1359,1201,0,1201,0,1201,14,486,701,21.04.2019 23:06,226,-1,
784,844,0,505,279,0,279,0,279,4,118,157,22.04.2019 00:05,226,-1,
288,314,0,165,123,0,123,0,123,1,58,64,21.04.2019 20:50,226,-1,
112,101,0,64,48,0,48,0,48,1,18,29,21.04.2019 20:35,226,-1,
352,349,0,251,101,0,101,0,101,1,40,60,21.04.2019 20:45,226,-1,
272,278,0,104,168,0,168,0,168,2,72,94,21.04.2019 20:45,226,-1,
3680,3788,0,3229,451,0,451,0,451,2,234,215,21.04.2019 20:45,226,-1,
688,688,0,436,252,0,252,0,252,2,106,144,21.04.2019 21:10,226,-1,
176,209,0,74,102,0,102,0,102,0,38,64,21.04.2019 20:38,226,-1,
368,351,0,269,99,0,99,0,99,0,57,42,21.04.2019 20:20,226,-1,
256,237,0,89,167,0,167,0,167,2,68,97,21.04.2019 21:25,226,-1,
560,600,0,142,418,0,418,0,418,4,174,240,21.04.2019 20:40,226,-1,
208,210,0,137,71,0,71,0,71,0,50,21,21.04.2019 20:50,226,-1,
2384,2500,0,2042,342,0,342,0,342,7,152,183,21.04.2019 21:18,226,-1,
4080,4068,0,3983,97,0,97,0,97,2,70,25,21.04.2019 20:10,226,-1,
1200,1211,0,1087,113,0,113,0,113,1,48,64,21.04.2019 20:30,226,-1,
20861,20806,0,20347,514,0,514,0,514,6,235,273,22.04.2019 00:01,226,-1,
3456,3738,0,2262,1194,0,1194,0,1194,24,375,795,21.04.2019 21:42,226,-1,
256,263,0,169,87,0,87,0,87,3,37,47,21.04.2019 20:30,226,-1,
5056,5321,0,4070,986,0,986,0,986,12,625,349,21.04.2019 21:20,226,-1,
192,214,0,61,131,0,131,0,131,2,33,96,21.04.2019 20:35,226,-1,
1296,1380,0,894,402,0,402,0,402,6,99,297,21.04.2019 21:25,226,-1,
768,904,0,381,387,0,387,0,387,2,127,258,21.04.2019 21:00,226,-1,
464,483,0,299,165,0,165,0,165,1,68,96,21.04.2019 23:15,226,-1,
272,268,0,20,252,0,252,0,252,2,147,103,21.04.2019 21:35,226,-1,
48,42,0,7,41,0,41,0,41,1,25,15,21.04.2019 20:25,226,-1,
1120,1298,0,437,683,0,683,0,683,10,336,337,21.04.2019 21:00,226,-1,
176,185,0,66,110,0,110,0,110,0,67,43,21.04.2019 20:50,226,-1,
4192,4314,0,3612,580,0,580,0,580,6,178,396,21.04.2019 22:21,226,-1,
21280,21386,0,19753,1527,0,1527,0,1527,26,795,706,21.04.2019 22:17,226,-1,
384,408,0,59,325,0,325,0,325,4,151,170,21.04.2019 21:20,226,-1,
